timestamp,step,action,reward,balance,roulette_result
2025-08-14_08-18-36,1,"[np.float32(0.0), np.float32(0.0), np.float32(0.0), np.float32(1.0), np.float32(1.0), np.float32(0.0), np.float32(0.0), np.float32(1.0), np.float32(0.0), np.float32(1.0), np.float32(0.0), np.float32(0.0), np.float32(1.0), np.float32(1.0), np.float32(0.0), np.float32(0.0)]",-1.0,99999.0,12
2025-08-14_08-18-36,2,"[np.float32(0.0), np.float32(1.0), np.float32(0.0), np.float32(1.0), np.float32(1.0), np.float32(0.0), np.float32(0.0), np.float32(0.0), np.float32(0.0), np.float32(1.0), np.float32(0.0), np.float32(1.0), np.float32(0.0), np.float32(0.0), np.float32(1.0), np.float32(0.0)]",2.0,100001.0,27
2025-08-14_08-18-36,3,"[np.float32(1.0), np.float32(0.0), np.float32(1.0), np.float32(1.0), np.float32(1.0), np.float32(0.0), np.float32(1.0), np.float32(1.0), np.float32(0.0), np.float32(1.0), np.float32(1.0), np.float32(0.0), np.float32(1.0), np.float32(1.0), np.float32(1.0), np.float32(0.0)]",-1.0,100000.0,17
2025-08-14_08-18-36,4,"[np.float32(0.0), np.float32(0.0), np.float32(0.0), np.float32(1.0), np.float32(0.0), np.float32(1.0), np.float32(0.0), np.float32(0.0), np.float32(0.0), np.float32(0.0), np.float32(1.0), np.float32(0.0), np.float32(0.0), np.float32(1.0), np.float32(0.0), np.float32(0.0)]",1.0,100001.0,7
2025-08-14_08-18-36,5,"[np.float32(0.0), np.float32(1.0), np.float32(0.0), np.float32(0.0), np.float32(0.0), np.float32(0.0), np.float32(0.0), np.float32(0.0), np.float32(0.0), np.float32(0.0), np.float32(1.0), np.float32(1.0), np.float32(1.0), np.float32(0.0), np.float32(1.0), np.float32(0.0)]",-3.0,99998.0,4
2025-08-14_08-18-36,6,"[np.float32(0.0), np.float32(1.0), np.float32(0.0), np.float32(1.0), np.float32(1.0), np.float32(0.0), np.float32(0.0), np.float32(0.0), np.float32(1.0), np.float32(0.0), np.float32(1.0), np.float32(1.0), np.float32(0.0), np.float32(0.0), np.float32(1.0), np.float32(0.0)]",3.0,100001.0,35
2025-08-14_08-18-36,7,"[np.float32(1.0), np.float32(0.0), np.float32(1.0), np.float32(1.0), np.float32(0.0), np.float32(0.0), np.float32(1.0), np.float32(0.0), np.float32(0.0), np.float32(1.0), np.float32(0.0), np.float32(1.0), np.float32(0.0), np.float32(1.0), np.float32(1.0), np.float32(0.0)]",0.0,100001.0,33
2025-08-14_08-18-36,8,"[np.float32(0.0), np.float32(1.0), np.float32(1.0), np.float32(0.0), np.float32(0.0), np.float32(0.0), np.float32(1.0), np.float32(1.0), np.float32(1.0), np.float32(1.0), np.float32(0.0), np.float32(1.0), np.float32(0.0), np.float32(0.0), np.float32(0.0), np.float32(1.0)]",-2.0,99999.0,19
2025-08-14_08-18-36,9,"[np.float32(0.0), np.float32(0.0), np.float32(0.0), np.float32(1.0), np.float32(1.0), np.float32(1.0), np.float32(0.0), np.float32(0.0), np.float32(1.0), np.float32(1.0), np.float32(1.0), np.float32(1.0), np.float32(0.0), np.float32(0.0), np.float32(1.0), np.float32(1.0)]",2.0,100001.0,34
2025-08-14_08-18-36,10,"[np.float32(0.0), np.float32(0.0), np.float32(0.0), np.float32(1.0), np.float32(1.0), np.float32(1.0), np.float32(0.0), np.float32(1.0), np.float32(1.0), np.float32(0.0), np.float32(0.0), np.float32(0.0), np.float32(1.0), np.float32(1.0), np.float32(0.0), np.float32(1.0)]",-1.0,100000.0,3
2025-08-14_08-18-36,11,"[np.float32(0.0), np.float32(1.0), np.float32(0.0), np.float32(1.0), np.float32(0.0), np.float32(0.0), np.float32(1.0), np.float32(1.0), np.float32(0.0), np.float32(1.0), np.float32(0.0), np.float32(0.0), np.float32(0.0), np.float32(0.0), np.float32(0.0), np.float32(1.0)]",-1.0,99999.0,5
2025-08-14_08-18-36,12,"[np.float32(0.0), np.float32(0.0), np.float32(0.0), np.float32(1.0), np.float32(0.0), np.float32(1.0), np.float32(1.0), np.float32(0.0), np.float32(0.0), np.float32(1.0), np.float32(0.0), np.float32(0.0), np.float32(0.0), np.float32(1.0), np.float32(0.0), np.float32(0.0)]",4.0,100003.0,4
2025-08-14_08-18-36,13,"[np.float32(0.0), np.float32(0.0), np.float32(1.0), np.float32(0.0), np.float32(0.0), np.float32(0.0), np.float32(0.0), np.float32(1.0), np.float32(1.0), np.float32(0.0), np.float32(1.0), np.float32(1.0), np.float32(1.0), np.float32(0.0), np.float32(1.0), np.float32(1.0)]",-3.0,100000.0,10
2025-08-14_08-18-36,14,"[np.float32(0.0), np.float32(1.0), np.float32(1.0), np.float32(1.0), np.float32(0.0), np.float32(1.0), np.float32(0.0), np.float32(1.0), np.float32(0.0), np.float32(0.0), np.float32(1.0), np.float32(1.0), np.float32(0.0), np.float32(1.0), np.float32(1.0), np.float32(0.0)]",0.0,100000.0,0
2025-08-14_08-18-36,15,"[np.float32(0.0), np.float32(1.0), np.float32(1.0), np.float32(0.0), np.float32(0.0), np.float32(1.0), np.float32(0.0), np.float32(1.0), np.float32(0.0), np.float32(0.0), np.float32(0.0), np.float32(0.0), np.float32(0.0), np.float32(1.0), np.float32(0.0), np.float32(0.0)]",-5.0,99995.0,9
2025-08-14_08-18-36,16,"[np.float32(1.0), np.float32(1.0), np.float32(1.0), np.float32(0.0), np.float32(0.0), np.float32(1.0), np.float32(1.0), np.float32(0.0), np.float32(0.0), np.float32(1.0), np.float32(0.0), np.float32(0.0), np.float32(0.0), np.float32(1.0), np.float32(1.0), np.float32(1.0)]",1.0,99996.0,2
2025-08-14_08-18-36,17,"[np.float32(0.0), np.float32(1.0), np.float32(0.0), np.float32(1.0), np.float32(1.0), np.float32(1.0), np.float32(1.0), np.float32(0.0), np.float32(1.0), np.float32(0.0), np.float32(1.0), np.float32(0.0), np.float32(0.0), np.float32(0.0), np.float32(1.0), np.float32(0.0)]",-2.0,99994.0,15
2025-08-14_08-18-36,18,"[np.float32(1.0), np.float32(0.0), np.float32(0.0), np.float32(0.0), np.float32(1.0), np.float32(0.0), np.float32(0.0), np.float32(1.0), np.float32(0.0), np.float32(0.0), np.float32(0.0), np.float32(0.0), np.float32(0.0), np.float32(0.0), np.float32(0.0), np.float32(1.0)]",-2.0,99992.0,30
2025-08-14_08-18-36,19,"[np.float32(1.0), np.float32(1.0), np.float32(1.0), np.float32(0.0), np.float32(0.0), np.float32(0.0), np.float32(0.0), np.float32(0.0), np.float32(1.0), np.float32(0.0), np.float32(1.0), np.float32(0.0), np.float32(0.0), np.float32(1.0), np.float32(0.0), np.float32(1.0)]",0.0,99992.0,6
2025-08-14_08-18-36,20,"[np.float32(0.0), np.float32(1.0), np.float32(1.0), np.float32(1.0), np.float32(0.0), np.float32(1.0), np.float32(1.0), np.float32(0.0), np.float32(0.0), np.float32(0.0), np.float32(0.0), np.float32(1.0), np.float32(0.0), np.float32(0.0), np.float32(1.0), np.float32(0.0)]",-2.0,99990.0,16
2025-08-14_08-18-36,21,"[np.float32(0.0), np.float32(1.0), np.float32(0.0), np.float32(0.0), np.float32(0.0), np.float32(0.0), np.float32(1.0), np.float32(1.0), np.float32(1.0), np.float32(1.0), np.float32(0.0), np.float32(0.0), np.float32(0.0), np.float32(0.0), np.float32(1.0), np.float32(1.0)]",-1.0,99989.0,27
2025-08-14_08-18-36,22,"[np.float32(1.0), np.float32(1.0), np.float32(0.0), np.float32(0.0), np.float32(1.0), np.float32(0.0), np.float32(1.0), np.float32(1.0), np.float32(0.0), np.float32(0.0), np.float32(1.0), np.float32(1.0), np.float32(0.0), np.float32(1.0), np.float32(0.0), np.float32(0.0)]",3.0,99992.0,21
2025-08-14_08-18-36,23,"[np.float32(1.0), np.float32(0.0), np.float32(1.0), np.float32(0.0), np.float32(0.0), np.float32(1.0), np.float32(0.0), np.float32(0.0), np.float32(1.0), np.float32(0.0), np.float32(0.0), np.float32(0.0), np.float32(0.0), np.float32(1.0), np.float32(1.0), np.float32(1.0)]",-2.0,99990.0,4
2025-08-14_08-18-36,24,"[np.float32(0.0), np.float32(1.0), np.float32(0.0), np.float32(1.0), np.float32(1.0), np.float32(0.0), np.float32(0.0), np.float32(1.0), np.float32(1.0), np.float32(0.0), np.float32(0.0), np.float32(0.0), np.float32(0.0), np.float32(0.0), np.float32(0.0), np.float32(1.0)]",1.0,99991.0,29
2025-08-14_08-18-36,25,"[np.float32(0.0), np.float32(0.0), np.float32(0.0), np.float32(1.0), np.float32(0.0), np.float32(1.0), np.float32(0.0), np.float32(0.0), np.float32(1.0), np.float32(0.0), np.float32(0.0), np.float32(1.0), np.float32(1.0), np.float32(0.0), np.float32(1.0), np.float32(1.0)]",-3.0,99988.0,19
2025-08-14_08-18-36,26,"[np.float32(0.0), np.float32(0.0), np.float32(1.0), np.float32(1.0), np.float32(0.0), np.float32(1.0), np.float32(1.0), np.float32(0.0), np.float32(0.0), np.float32(0.0), np.float32(1.0), np.float32(1.0), np.float32(1.0), np.float32(1.0), np.float32(1.0), np.float32(1.0)]",-3.0,99985.0,31
2025-08-14_08-18-36,27,"[np.float32(0.0), np.float32(0.0), np.float32(0.0), np.float32(0.0), np.float32(0.0), np.float32(0.0), np.float32(0.0), np.float32(1.0), np.float32(1.0), np.float32(1.0), np.float32(1.0), np.float32(1.0), np.float32(1.0), np.float32(1.0), np.float32(1.0), np.float32(1.0)]",0.0,99985.0,19
2025-08-14_08-18-36,28,"[np.float32(0.0), np.float32(0.0), np.float32(1.0), np.float32(1.0), np.float32(0.0), np.float32(1.0), np.float32(1.0), np.float32(0.0), np.float32(1.0), np.float32(1.0), np.float32(1.0), np.float32(0.0), np.float32(0.0), np.float32(1.0), np.float32(0.0), np.float32(0.0)]",5.0,99990.0,32
2025-08-14_08-18-36,29,"[np.float32(0.0), np.float32(1.0), np.float32(0.0), np.float32(0.0), np.float32(1.0), np.float32(1.0), np.float32(1.0), np.float32(1.0), np.float32(0.0), np.float32(0.0), np.float32(0.0), np.float32(0.0), np.float32(1.0), np.float32(1.0), np.float32(0.0), np.float32(0.0)]",0.0,99990.0,20
2025-08-14_08-18-36,30,"[np.float32(1.0), np.float32(0.0), np.float32(1.0), np.float32(1.0), np.float32(1.0), np.float32(1.0), np.float32(1.0), np.float32(1.0), np.float32(1.0), np.float32(1.0), np.float32(1.0), np.float32(1.0), np.float32(1.0), np.float32(0.0), np.float32(1.0), np.float32(1.0)]",1.0,99991.0,14
2025-08-14_08-18-36,31,"[np.float32(0.0), np.float32(1.0), np.float32(1.0), np.float32(1.0), np.float32(1.0), np.float32(1.0), np.float32(1.0), np.float32(1.0), np.float32(1.0), np.float32(0.0), np.float32(1.0), np.float32(0.0), np.float32(0.0), np.float32(0.0), np.float32(1.0), np.float32(1.0)]",2.0,99993.0,23
2025-08-14_08-18-36,32,"[np.float32(1.0), np.float32(1.0), np.float32(1.0), np.float32(1.0), np.float32(0.0), np.float32(1.0), np.float32(1.0), np.float32(1.0), np.float32(0.0), np.float32(0.0), np.float32(1.0), np.float32(0.0), np.float32(1.0), np.float32(1.0), np.float32(1.0), np.float32(0.0)]",-1.0,99992.0,18
2025-08-14_08-18-36,33,"[np.float32(1.0), np.float32(0.0), np.float32(1.0), np.float32(0.0), np.float32(0.0), np.float32(1.0), np.float32(0.0), np.float32(0.0), np.float32(0.0), np.float32(0.0), np.float32(1.0), np.float32(0.0), np.float32(1.0), np.float32(1.0), np.float32(0.0), np.float32(1.0)]",-4.0,99988.0,11
2025-08-14_08-18-36,34,"[np.float32(0.0), np.float32(0.0), np.float32(1.0), np.float32(0.0), np.float32(1.0), np.float32(1.0), np.float32(1.0), np.float32(1.0), np.float32(1.0), np.float32(0.0), np.float32(1.0), np.float32(0.0), np.float32(1.0), np.float32(0.0), np.float32(0.0), np.float32(0.0)]",0.0,99988.0,17
2025-08-14_08-18-36,35,"[np.float32(1.0), np.float32(1.0), np.float32(0.0), np.float32(1.0), np.float32(1.0), np.float32(1.0), np.float32(0.0), np.float32(0.0), np.float32(1.0), np.float32(1.0), np.float32(1.0), np.float32(0.0), np.float32(1.0), np.float32(1.0), np.float32(1.0), np.float32(0.0)]",-1.0,99987.0,16
2025-08-14_08-18-36,36,"[np.float32(0.0), np.float32(0.0), np.float32(0.0), np.float32(0.0), np.float32(1.0), np.float32(0.0), np.float32(1.0), np.float32(1.0), np.float32(0.0), np.float32(1.0), np.float32(0.0), np.float32(1.0), np.float32(0.0), np.float32(0.0), np.float32(0.0), np.float32(0.0)]",1.0,99988.0,21
2025-08-14_08-18-36,37,"[np.float32(1.0), np.float32(1.0), np.float32(0.0), np.float32(1.0), np.float32(0.0), np.float32(0.0), np.float32(1.0), np.float32(1.0), np.float32(1.0), np.float32(1.0), np.float32(0.0), np.float32(0.0), np.float32(0.0), np.float32(0.0), np.float32(1.0), np.float32(0.0)]",-1.0,99987.0,3
2025-08-14_08-18-36,38,"[np.float32(1.0), np.float32(1.0), np.float32(1.0), np.float32(0.0), np.float32(1.0), np.float32(1.0), np.float32(0.0), np.float32(0.0), np.float32(0.0), np.float32(0.0), np.float32(0.0), np.float32(1.0), np.float32(0.0), np.float32(0.0), np.float32(0.0), np.float32(0.0)]",3.0,99990.0,6
2025-08-14_08-18-36,39,"[np.float32(1.0), np.float32(0.0), np.float32(1.0), np.float32(0.0), np.float32(0.0), np.float32(1.0), np.float32(0.0), np.float32(1.0), np.float32(0.0), np.float32(0.0), np.float32(0.0), np.float32(0.0), np.float32(1.0), np.float32(0.0), np.float32(1.0), np.float32(0.0)]",-3.0,99987.0,17
2025-08-14_08-18-36,40,"[np.float32(0.0), np.float32(1.0), np.float32(1.0), np.float32(0.0), np.float32(1.0), np.float32(1.0), np.float32(1.0), np.float32(0.0), np.float32(0.0), np.float32(0.0), np.float32(1.0), np.float32(0.0), np.float32(0.0), np.float32(0.0), np.float32(1.0), np.float32(1.0)]",-6.0,99981.0,25
2025-08-14_08-18-36,41,"[np.float32(0.0), np.float32(1.0), np.float32(1.0), np.float32(1.0), np.float32(0.0), np.float32(0.0), np.float32(1.0), np.float32(1.0), np.float32(0.0), np.float32(1.0), np.float32(1.0), np.float32(1.0), np.float32(0.0), np.float32(0.0), np.float32(0.0), np.float32(0.0)]",-1.0,99980.0,26
2025-08-14_08-18-36,42,"[np.float32(1.0), np.float32(0.0), np.float32(1.0), np.float32(1.0), np.float32(0.0), np.float32(1.0), np.float32(1.0), np.float32(1.0), np.float32(0.0), np.float32(0.0), np.float32(1.0), np.float32(0.0), np.float32(1.0), np.float32(1.0), np.float32(0.0), np.float32(1.0)]",2.0,99982.0,19
2025-08-14_08-18-36,43,"[np.float32(1.0), np.float32(0.0), np.float32(1.0), np.float32(1.0), np.float32(1.0), np.float32(0.0), np.float32(0.0), np.float32(1.0), np.float32(1.0), np.float32(0.0), np.float32(0.0), np.float32(1.0), np.float32(1.0), np.float32(0.0), np.float32(1.0), np.float32(0.0)]",4.0,99986.0,36
2025-08-14_08-18-36,44,"[np.float32(0.0), np.float32(1.0), np.float32(1.0), np.float32(0.0), np.float32(0.0), np.float32(0.0), np.float32(0.0), np.float32(1.0), np.float32(1.0), np.float32(1.0), np.float32(1.0), np.float32(0.0), np.float32(0.0), np.float32(1.0), np.float32(0.0), np.float32(1.0)]",5.0,99991.0,20
2025-08-14_08-18-36,45,"[np.float32(1.0), np.float32(1.0), np.float32(0.0), np.float32(0.0), np.float32(0.0), np.float32(1.0), np.float32(0.0), np.float32(1.0), np.float32(0.0), np.float32(1.0), np.float32(0.0), np.float32(0.0), np.float32(0.0), np.float32(1.0), np.float32(0.0), np.float32(0.0)]",7.0,99998.0,22
2025-08-14_08-18-36,46,"[np.float32(0.0), np.float32(0.0), np.float32(1.0), np.float32(1.0), np.float32(1.0), np.float32(1.0), np.float32(0.0), np.float32(0.0), np.float32(0.0), np.float32(0.0), np.float32(0.0), np.float32(0.0), np.float32(0.0), np.float32(1.0), np.float32(1.0), np.float32(0.0)]",1.0,99999.0,0
2025-08-14_08-18-36,47,"[np.float32(0.0), np.float32(1.0), np.float32(0.0), np.float32(0.0), np.float32(1.0), np.float32(0.0), np.float32(1.0), np.float32(0.0), np.float32(0.0), np.float32(0.0), np.float32(0.0), np.float32(1.0), np.float32(0.0), np.float32(1.0), np.float32(1.0), np.float32(1.0)]",-1.0,99998.0,30
2025-08-14_08-18-36,48,"[np.float32(0.0), np.float32(0.0), np.float32(1.0), np.float32(0.0), np.float32(1.0), np.float32(1.0), np.float32(0.0), np.float32(1.0), np.float32(1.0), np.float32(1.0), np.float32(1.0), np.float32(0.0), np.float32(1.0), np.float32(1.0), np.float32(1.0), np.float32(0.0)]",0.0,99998.0,20
2025-08-14_08-18-36,49,"[np.float32(0.0), np.float32(1.0), np.float32(0.0), np.float32(0.0), np.float32(1.0), np.float32(1.0), np.float32(1.0), np.float32(0.0), np.float32(1.0), np.float32(0.0), np.float32(0.0), np.float32(0.0), np.float32(0.0), np.float32(1.0), np.float32(1.0), np.float32(1.0)]",2.0,100000.0,29
2025-08-14_08-18-36,50,"[np.float32(0.0), np.float32(0.0), np.float32(0.0), np.float32(1.0), np.float32(0.0), np.float32(1.0), np.float32(0.0), np.float32(1.0), np.float32(0.0), np.float32(1.0), np.float32(1.0), np.float32(0.0), np.float32(1.0), np.float32(1.0), np.float32(0.0), np.float32(0.0)]",3.0,100003.0,21
2025-08-14_08-18-36,51,"[np.float32(1.0), np.float32(1.0), np.float32(1.0), np.float32(1.0), np.float32(0.0), np.float32(1.0), np.float32(0.0), np.float32(1.0), np.float32(1.0), np.float32(0.0), np.float32(0.0), np.float32(1.0), np.float32(1.0), np.float32(1.0), np.float32(1.0), np.float32(0.0)]",1.0,100004.0,22
2025-08-14_08-18-36,52,"[np.float32(0.0), np.float32(0.0), np.float32(0.0), np.float32(0.0), np.float32(0.0), np.float32(0.0), np.float32(1.0), np.float32(1.0), np.float32(0.0), np.float32(1.0), np.float32(1.0), np.float32(1.0), np.float32(1.0), np.float32(1.0), np.float32(1.0), np.float32(0.0)]",-2.0,100002.0,33
2025-08-14_08-18-36,53,"[np.float32(0.0), np.float32(0.0), np.float32(0.0), np.float32(1.0), np.float32(0.0), np.float32(0.0), np.float32(1.0), np.float32(1.0), np.float32(1.0), np.float32(1.0), np.float32(1.0), np.float32(0.0), np.float32(0.0), np.float32(1.0), np.float32(1.0), np.float32(1.0)]",-3.0,99999.0,36
2025-08-14_08-18-36,54,"[np.float32(1.0), np.float32(0.0), np.float32(0.0), np.float32(0.0), np.float32(0.0), np.float32(1.0), np.float32(0.0), np.float32(0.0), np.float32(1.0), np.float32(0.0), np.float32(1.0), np.float32(1.0), np.float32(1.0), np.float32(1.0), np.float32(1.0), np.float32(1.0)]",2.0,100001.0,26
2025-08-14_08-18-36,55,"[np.float32(0.0), np.float32(1.0), np.float32(0.0), np.float32(0.0), np.float32(1.0), np.float32(0.0), np.float32(0.0), np.float32(1.0), np.float32(0.0), np.float32(1.0), np.float32(0.0), np.float32(0.0), np.float32(1.0), np.float32(0.0), np.float32(1.0), np.float32(1.0)]",4.0,100005.0,16
2025-08-14_08-18-36,56,"[np.float32(1.0), np.float32(1.0), np.float32(0.0), np.float32(1.0), np.float32(0.0), np.float32(1.0), np.float32(0.0), np.float32(1.0), np.float32(1.0), np.float32(1.0), np.float32(0.0), np.float32(0.0), np.float32(1.0), np.float32(0.0), np.float32(0.0), np.float32(0.0)]",-1.0,100004.0,26
2025-08-14_08-18-36,57,"[np.float32(1.0), np.float32(0.0), np.float32(1.0), np.float32(1.0), np.float32(0.0), np.float32(0.0), np.float32(1.0), np.float32(1.0), np.float32(0.0), np.float32(1.0), np.float32(0.0), np.float32(0.0), np.float32(0.0), np.float32(0.0), np.float32(1.0), np.float32(1.0)]",-1.0,100003.0,27
2025-08-14_08-18-36,58,"[np.float32(1.0), np.float32(0.0), np.float32(0.0), np.float32(1.0), np.float32(0.0), np.float32(1.0), np.float32(0.0), np.float32(0.0), np.float32(1.0), np.float32(0.0), np.float32(1.0), np.float32(1.0), np.float32(1.0), np.float32(0.0), np.float32(0.0), np.float32(0.0)]",-2.0,100001.0,12
2025-08-14_08-18-36,59,"[np.float32(1.0), np.float32(0.0), np.float32(0.0), np.float32(1.0), np.float32(1.0), np.float32(0.0), np.float32(0.0), np.float32(0.0), np.float32(0.0), np.float32(0.0), np.float32(1.0), np.float32(1.0), np.float32(1.0), np.float32(1.0), np.float32(0.0), np.float32(1.0)]",-3.0,99998.0,34
2025-08-14_08-18-36,60,"[np.float32(1.0), np.float32(1.0), np.float32(1.0), np.float32(0.0), np.float32(1.0), np.float32(0.0), np.float32(0.0), np.float32(1.0), np.float32(0.0), np.float32(1.0), np.float32(1.0), np.float32(1.0), np.float32(0.0), np.float32(0.0), np.float32(1.0), np.float32(0.0)]",-4.0,99994.0,29
2025-08-14_08-18-36,61,"[np.float32(0.0), np.float32(0.0), np.float32(1.0), np.float32(1.0), np.float32(0.0), np.float32(0.0), np.float32(1.0), np.float32(1.0), np.float32(1.0), np.float32(0.0), np.float32(1.0), np.float32(0.0), np.float32(1.0), np.float32(1.0), np.float32(1.0), np.float32(1.0)]",-2.0,99992.0,18
2025-08-14_08-18-36,62,"[np.float32(1.0), np.float32(0.0), np.float32(1.0), np.float32(0.0), np.float32(0.0), np.float32(1.0), np.float32(1.0), np.float32(0.0), np.float32(1.0), np.float32(1.0), np.float32(1.0), np.float32(0.0), np.float32(0.0), np.float32(1.0), np.float32(1.0), np.float32(0.0)]",1.0,99993.0,12
2025-08-14_08-18-36,63,"[np.float32(1.0), np.float32(1.0), np.float32(1.0), np.float32(1.0), np.float32(0.0), np.float32(1.0), np.float32(1.0), np.float32(1.0), np.float32(1.0), np.float32(1.0), np.float32(0.0), np.float32(1.0), np.float32(1.0), np.float32(0.0), np.float32(1.0), np.float32(0.0)]",1.0,99994.0,10
2025-08-14_08-18-36,64,"[np.float32(1.0), np.float32(1.0), np.float32(0.0), np.float32(1.0), np.float32(1.0), np.float32(1.0), np.float32(1.0), np.float32(1.0), np.float32(1.0), np.float32(0.0), np.float32(0.0), np.float32(1.0), np.float32(1.0), np.float32(0.0), np.float32(1.0), np.float32(1.0)]",0.0,99994.0,15
2025-08-14_08-18-36,65,"[np.float32(0.0), np.float32(0.0), np.float32(1.0), np.float32(1.0), np.float32(0.0), np.float32(0.0), np.float32(0.0), np.float32(0.0), np.float32(0.0), np.float32(1.0), np.float32(1.0), np.float32(1.0), np.float32(1.0), np.float32(1.0), np.float32(0.0), np.float32(0.0)]",1.0,99995.0,3
2025-08-14_08-18-36,66,"[np.float32(0.0), np.float32(0.0), np.float32(1.0), np.float32(0.0), np.float32(0.0), np.float32(1.0), np.float32(1.0), np.float32(0.0), np.float32(0.0), np.float32(1.0), np.float32(0.0), np.float32(0.0), np.float32(0.0), np.float32(1.0), np.float32(0.0), np.float32(1.0)]",0.0,99995.0,3
2025-08-14_08-18-36,67,"[np.float32(1.0), np.float32(1.0), np.float32(0.0), np.float32(1.0), np.float32(1.0), np.float32(1.0), np.float32(0.0), np.float32(0.0), np.float32(1.0), np.float32(0.0), np.float32(1.0), np.float32(1.0), np.float32(1.0), np.float32(0.0), np.float32(1.0), np.float32(1.0)]",-7.0,99988.0,4
2025-08-14_08-18-36,68,"[np.float32(1.0), np.float32(0.0), np.float32(1.0), np.float32(0.0), np.float32(0.0), np.float32(1.0), np.float32(1.0), np.float32(0.0), np.float32(1.0), np.float32(1.0), np.float32(1.0), np.float32(1.0), np.float32(1.0), np.float32(0.0), np.float32(1.0), np.float32(0.0)]",1.0,99989.0,33
2025-08-14_08-18-36,69,"[np.float32(1.0), np.float32(0.0), np.float32(1.0), np.float32(0.0), np.float32(0.0), np.float32(1.0), np.float32(1.0), np.float32(1.0), np.float32(0.0), np.float32(1.0), np.float32(1.0), np.float32(1.0), np.float32(0.0), np.float32(1.0), np.float32(1.0), np.float32(0.0)]",0.0,99989.0,26
2025-08-14_08-18-36,70,"[np.float32(0.0), np.float32(1.0), np.float32(1.0), np.float32(0.0), np.float32(0.0), np.float32(0.0), np.float32(1.0), np.float32(0.0), np.float32(1.0), np.float32(0.0), np.float32(1.0), np.float32(1.0), np.float32(0.0), np.float32(0.0), np.float32(0.0), np.float32(1.0)]",3.0,99992.0,26
2025-08-14_08-18-36,71,"[np.float32(0.0), np.float32(0.0), np.float32(1.0), np.float32(1.0), np.float32(0.0), np.float32(1.0), np.float32(1.0), np.float32(1.0), np.float32(1.0), np.float32(1.0), np.float32(1.0), np.float32(0.0), np.float32(1.0), np.float32(0.0), np.float32(0.0), np.float32(1.0)]",-2.0,99990.0,13
2025-08-14_08-18-36,72,"[np.float32(0.0), np.float32(0.0), np.float32(1.0), np.float32(1.0), np.float32(0.0), np.float32(1.0), np.float32(1.0), np.float32(1.0), np.float32(0.0), np.float32(1.0), np.float32(1.0), np.float32(0.0), np.float32(1.0), np.float32(0.0), np.float32(1.0), np.float32(0.0)]",-4.0,99986.0,15
2025-08-14_08-18-36,73,"[np.float32(0.0), np.float32(1.0), np.float32(0.0), np.float32(0.0), np.float32(0.0), np.float32(0.0), np.float32(1.0), np.float32(1.0), np.float32(1.0), np.float32(0.0), np.float32(0.0), np.float32(1.0), np.float32(0.0), np.float32(0.0), np.float32(1.0), np.float32(1.0)]",-1.0,99985.0,34
2025-08-14_08-18-36,74,"[np.float32(1.0), np.float32(1.0), np.float32(0.0), np.float32(0.0), np.float32(0.0), np.float32(1.0), np.float32(0.0), np.float32(1.0), np.float32(0.0), np.float32(0.0), np.float32(1.0), np.float32(0.0), np.float32(0.0), np.float32(0.0), np.float32(0.0), np.float32(0.0)]",0.0,99985.0,13
2025-08-14_08-18-36,75,"[np.float32(0.0), np.float32(1.0), np.float32(1.0), np.float32(0.0), np.float32(1.0), np.float32(1.0), np.float32(1.0), np.float32(0.0), np.float32(1.0), np.float32(0.0), np.float32(0.0), np.float32(1.0), np.float32(0.0), np.float32(1.0), np.float32(1.0), np.float32(1.0)]",1.0,99986.0,27
2025-08-14_08-18-36,76,"[np.float32(0.0), np.float32(1.0), np.float32(0.0), np.float32(0.0), np.float32(0.0), np.float32(1.0), np.float32(1.0), np.float32(0.0), np.float32(1.0), np.float32(1.0), np.float32(0.0), np.float32(0.0), np.float32(0.0), np.float32(0.0), np.float32(1.0), np.float32(0.0)]",2.0,99988.0,36
2025-08-14_08-18-36,77,"[np.float32(1.0), np.float32(1.0), np.float32(0.0), np.float32(0.0), np.float32(1.0), np.float32(0.0), np.float32(0.0), np.float32(1.0), np.float32(0.0), np.float32(0.0), np.float32(0.0), np.float32(1.0), np.float32(0.0), np.float32(1.0), np.float32(1.0), np.float32(1.0)]",-3.0,99985.0,0
2025-08-14_08-18-36,78,"[np.float32(1.0), np.float32(0.0), np.float32(1.0), np.float32(0.0), np.float32(1.0), np.float32(0.0), np.float32(0.0), np.float32(1.0), np.float32(0.0), np.float32(1.0), np.float32(1.0), np.float32(1.0), np.float32(0.0), np.float32(1.0), np.float32(1.0), np.float32(1.0)]",0.0,99985.0,4
2025-08-14_08-18-36,79,"[np.float32(1.0), np.float32(1.0), np.float32(1.0), np.float32(1.0), np.float32(0.0), np.float32(1.0), np.float32(0.0), np.float32(0.0), np.float32(1.0), np.float32(0.0), np.float32(0.0), np.float32(1.0), np.float32(1.0), np.float32(1.0), np.float32(0.0), np.float32(1.0)]",0.0,99985.0,6
2025-08-14_08-18-36,80,"[np.float32(0.0), np.float32(1.0), np.float32(1.0), np.float32(1.0), np.float32(1.0), np.float32(0.0), np.float32(1.0), np.float32(1.0), np.float32(0.0), np.float32(0.0), np.float32(1.0), np.float32(0.0), np.float32(0.0), np.float32(1.0), np.float32(0.0), np.float32(1.0)]",0.0,99985.0,10
2025-08-14_08-18-36,81,"[np.float32(0.0), np.float32(1.0), np.float32(0.0), np.float32(0.0), np.float32(0.0), np.float32(0.0), np.float32(0.0), np.float32(0.0), np.float32(1.0), np.float32(0.0), np.float32(0.0), np.float32(1.0), np.float32(1.0), np.float32(1.0), np.float32(1.0), np.float32(0.0)]",-1.0,99984.0,11
2025-08-14_08-18-36,82,"[np.float32(0.0), np.float32(0.0), np.float32(1.0), np.float32(0.0), np.float32(1.0), np.float32(1.0), np.float32(1.0), np.float32(1.0), np.float32(1.0), np.float32(0.0), np.float32(1.0), np.float32(0.0), np.float32(1.0), np.float32(1.0), np.float32(0.0), np.float32(0.0)]",-2.0,99982.0,0
2025-08-14_08-18-36,83,"[np.float32(1.0), np.float32(0.0), np.float32(1.0), np.float32(0.0), np.float32(0.0), np.float32(1.0), np.float32(1.0), np.float32(0.0), np.float32(1.0), np.float32(1.0), np.float32(0.0), np.float32(0.0), np.float32(0.0), np.float32(1.0), np.float32(1.0), np.float32(0.0)]",-8.0,99974.0,17
2025-08-14_08-18-36,84,"[np.float32(0.0), np.float32(0.0), np.float32(0.0), np.float32(0.0), np.float32(1.0), np.float32(0.0), np.float32(0.0), np.float32(1.0), np.float32(0.0), np.float32(0.0), np.float32(0.0), np.float32(0.0), np.float32(0.0), np.float32(0.0), np.float32(1.0), np.float32(0.0)]",-3.0,99971.0,32
2025-08-14_08-18-36,85,"[np.float32(0.0), np.float32(1.0), np.float32(0.0), np.float32(1.0), np.float32(0.0), np.float32(0.0), np.float32(1.0), np.float32(1.0), np.float32(0.0), np.float32(0.0), np.float32(1.0), np.float32(0.0), np.float32(0.0), np.float32(1.0), np.float32(1.0), np.float32(0.0)]",3.0,99974.0,29
2025-08-14_08-18-36,86,"[np.float32(0.0), np.float32(0.0), np.float32(1.0), np.float32(1.0), np.float32(0.0), np.float32(0.0), np.float32(1.0), np.float32(0.0), np.float32(1.0), np.float32(1.0), np.float32(0.0), np.float32(0.0), np.float32(0.0), np.float32(0.0), np.float32(1.0), np.float32(0.0)]",-1.0,99973.0,2
2025-08-14_08-18-36,87,"[np.float32(1.0), np.float32(0.0), np.float32(0.0), np.float32(0.0), np.float32(0.0), np.float32(1.0), np.float32(0.0), np.float32(1.0), np.float32(1.0), np.float32(1.0), np.float32(1.0), np.float32(0.0), np.float32(0.0), np.float32(1.0), np.float32(0.0), np.float32(1.0)]",5.0,99978.0,32
2025-08-14_08-18-36,88,"[np.float32(1.0), np.float32(1.0), np.float32(0.0), np.float32(0.0), np.float32(0.0), np.float32(0.0), np.float32(1.0), np.float32(0.0), np.float32(1.0), np.float32(1.0), np.float32(1.0), np.float32(1.0), np.float32(0.0), np.float32(1.0), np.float32(1.0), np.float32(1.0)]",1.0,99979.0,7
2025-08-14_08-18-36,89,"[np.float32(1.0), np.float32(0.0), np.float32(0.0), np.float32(0.0), np.float32(1.0), np.float32(1.0), np.float32(0.0), np.float32(1.0), np.float32(1.0), np.float32(0.0), np.float32(0.0), np.float32(0.0), np.float32(0.0), np.float32(1.0), np.float32(0.0), np.float32(0.0)]",1.0,99980.0,7
2025-08-14_08-18-36,90,"[np.float32(1.0), np.float32(0.0), np.float32(0.0), np.float32(1.0), np.float32(1.0), np.float32(1.0), np.float32(0.0), np.float32(1.0), np.float32(0.0), np.float32(0.0), np.float32(0.0), np.float32(1.0), np.float32(1.0), np.float32(0.0), np.float32(1.0), np.float32(1.0)]",-4.0,99976.0,10
2025-08-14_08-18-36,91,"[np.float32(0.0), np.float32(1.0), np.float32(1.0), np.float32(1.0), np.float32(1.0), np.float32(1.0), np.float32(0.0), np.float32(1.0), np.float32(0.0), np.float32(1.0), np.float32(1.0), np.float32(0.0), np.float32(1.0), np.float32(1.0), np.float32(1.0), np.float32(0.0)]",4.0,99980.0,13
2025-08-14_08-18-36,92,"[np.float32(0.0), np.float32(0.0), np.float32(1.0), np.float32(1.0), np.float32(1.0), np.float32(0.0), np.float32(1.0), np.float32(0.0), np.float32(0.0), np.float32(0.0), np.float32(0.0), np.float32(0.0), np.float32(0.0), np.float32(0.0), np.float32(0.0), np.float32(0.0)]",-2.0,99978.0,21
2025-08-14_08-18-36,93,"[np.float32(0.0), np.float32(1.0), np.float32(0.0), np.float32(1.0), np.float32(1.0), np.float32(0.0), np.float32(1.0), np.float32(0.0), np.float32(1.0), np.float32(1.0), np.float32(0.0), np.float32(0.0), np.float32(1.0), np.float32(0.0), np.float32(1.0), np.float32(1.0)]",-4.0,99974.0,23
2025-08-14_08-18-36,94,"[np.float32(0.0), np.float32(0.0), np.float32(1.0), np.float32(0.0), np.float32(1.0), np.float32(1.0), np.float32(1.0), np.float32(1.0), np.float32(0.0), np.float32(1.0), np.float32(0.0), np.float32(0.0), np.float32(0.0), np.float32(1.0), np.float32(1.0), np.float32(0.0)]",5.0,99979.0,16
2025-08-14_08-18-36,95,"[np.float32(1.0), np.float32(0.0), np.float32(0.0), np.float32(0.0), np.float32(0.0), np.float32(0.0), np.float32(1.0), np.float32(0.0), np.float32(0.0), np.float32(1.0), np.float32(0.0), np.float32(1.0), np.float32(1.0), np.float32(0.0), np.float32(1.0), np.float32(1.0)]",-2.0,99977.0,21
2025-08-14_08-18-36,96,"[np.float32(1.0), np.float32(1.0), np.float32(1.0), np.float32(1.0), np.float32(1.0), np.float32(0.0), np.float32(1.0), np.float32(1.0), np.float32(1.0), np.float32(0.0), np.float32(1.0), np.float32(0.0), np.float32(0.0), np.float32(1.0), np.float32(1.0), np.float32(0.0)]",2.0,99979.0,26
2025-08-14_08-18-36,97,"[np.float32(0.0), np.float32(0.0), np.float32(1.0), np.float32(1.0), np.float32(0.0), np.float32(1.0), np.float32(1.0), np.float32(0.0), np.float32(1.0), np.float32(0.0), np.float32(1.0), np.float32(1.0), np.float32(1.0), np.float32(0.0), np.float32(0.0), np.float32(1.0)]",-1.0,99978.0,17
2025-08-14_08-18-36,98,"[np.float32(1.0), np.float32(1.0), np.float32(1.0), np.float32(1.0), np.float32(0.0), np.float32(1.0), np.float32(1.0), np.float32(0.0), np.float32(1.0), np.float32(1.0), np.float32(0.0), np.float32(0.0), np.float32(1.0), np.float32(1.0), np.float32(0.0), np.float32(0.0)]",-1.0,99977.0,21
2025-08-14_08-18-36,99,"[np.float32(0.0), np.float32(0.0), np.float32(1.0), np.float32(0.0), np.float32(1.0), np.float32(1.0), np.float32(1.0), np.float32(0.0), np.float32(1.0), np.float32(0.0), np.float32(0.0), np.float32(0.0), np.float32(1.0), np.float32(0.0), np.float32(1.0), np.float32(1.0)]",0.0,99977.0,33
2025-08-14_08-18-36,100,"[np.float32(0.0), np.float32(1.0), np.float32(1.0), np.float32(0.0), np.float32(0.0), np.float32(1.0), np.float32(1.0), np.float32(0.0), np.float32(1.0), np.float32(0.0), np.float32(1.0), np.float32(1.0), np.float32(1.0), np.float32(0.0), np.float32(1.0), np.float32(1.0)]",-4.0,99973.0,1
2025-08-14_08-18-36,101,"[np.float32(1.0), np.float32(0.0), np.float32(0.0), np.float32(0.0), np.float32(1.0), np.float32(1.0), np.float32(0.0), np.float32(0.0), np.float32(1.0), np.float32(1.0), np.float32(0.0), np.float32(0.0), np.float32(0.0), np.float32(1.0), np.float32(1.0), np.float32(0.0)]",3.0,99976.0,16
2025-08-14_08-18-36,102,"[np.float32(1.0), np.float32(0.0), np.float32(1.0), np.float32(1.0), np.float32(0.0), np.float32(0.0), np.float32(1.0), np.float32(1.0), np.float32(0.0), np.float32(1.0), np.float32(1.0), np.float32(1.0), np.float32(0.0), np.float32(0.0), np.float32(0.0), np.float32(1.0)]",-1.0,99975.0,15
2025-08-14_08-18-36,103,"[np.float32(1.0), np.float32(1.0), np.float32(0.0), np.float32(1.0), np.float32(0.0), np.float32(1.0), np.float32(1.0), np.float32(1.0), np.float32(1.0), np.float32(1.0), np.float32(1.0), np.float32(1.0), np.float32(0.0), np.float32(0.0), np.float32(1.0), np.float32(0.0)]",-1.0,99974.0,1
2025-08-14_08-18-36,104,"[np.float32(1.0), np.float32(0.0), np.float32(1.0), np.float32(1.0), np.float32(0.0), np.float32(0.0), np.float32(0.0), np.float32(1.0), np.float32(1.0), np.float32(1.0), np.float32(1.0), np.float32(0.0), np.float32(0.0), np.float32(0.0), np.float32(0.0), np.float32(0.0)]",-2.0,99972.0,4
2025-08-14_08-18-36,105,"[np.float32(1.0), np.float32(0.0), np.float32(0.0), np.float32(1.0), np.float32(1.0), np.float32(1.0), np.float32(0.0), np.float32(1.0), np.float32(0.0), np.float32(1.0), np.float32(0.0), np.float32(0.0), np.float32(1.0), np.float32(0.0), np.float32(0.0), np.float32(1.0)]",-1.0,99971.0,18
2025-08-14_08-18-36,106,"[np.float32(0.0), np.float32(0.0), np.float32(0.0), np.float32(1.0), np.float32(1.0), np.float32(1.0), np.float32(1.0), np.float32(0.0), np.float32(0.0), np.float32(0.0), np.float32(1.0), np.float32(1.0), np.float32(1.0), np.float32(1.0), np.float32(1.0), np.float32(1.0)]",-2.0,99969.0,30
2025-08-14_08-18-36,107,"[np.float32(0.0), np.float32(1.0), np.float32(0.0), np.float32(1.0), np.float32(0.0), np.float32(0.0), np.float32(1.0), np.float32(1.0), np.float32(0.0), np.float32(0.0), np.float32(0.0), np.float32(0.0), np.float32(0.0), np.float32(0.0), np.float32(1.0), np.float32(0.0)]",1.0,99970.0,16
2025-08-14_08-18-36,108,"[np.float32(1.0), np.float32(1.0), np.float32(0.0), np.float32(1.0), np.float32(1.0), np.float32(0.0), np.float32(0.0), np.float32(1.0), np.float32(0.0), np.float32(0.0), np.float32(1.0), np.float32(0.0), np.float32(0.0), np.float32(0.0), np.float32(0.0), np.float32(0.0)]",-1.0,99969.0,24
2025-08-14_08-18-36,109,"[np.float32(1.0), np.float32(0.0), np.float32(1.0), np.float32(0.0), np.float32(0.0), np.float32(1.0), np.float32(0.0), np.float32(1.0), np.float32(1.0), np.float32(0.0), np.float32(0.0), np.float32(0.0), np.float32(1.0), np.float32(0.0), np.float32(1.0), np.float32(1.0)]",2.0,99971.0,16
2025-08-14_08-18-36,110,"[np.float32(0.0), np.float32(0.0), np.float32(1.0), np.float32(1.0), np.float32(0.0), np.float32(1.0), np.float32(1.0), np.float32(0.0), np.float32(0.0), np.float32(1.0), np.float32(0.0), np.float32(1.0), np.float32(1.0), np.float32(0.0), np.float32(1.0), np.float32(1.0)]",35.0,100006.0,7
2025-08-14_08-18-36,111,"[np.float32(1.0), np.float32(0.0), np.float32(1.0), np.float32(1.0), np.float32(1.0), np.float32(1.0), np.float32(1.0), np.float32(1.0), np.float32(0.0), np.float32(1.0), np.float32(0.0), np.float32(1.0), np.float32(1.0), np.float32(0.0), np.float32(1.0), np.float32(1.0)]",-8.0,99998.0,29
2025-08-14_08-18-36,112,"[np.float32(1.0), np.float32(1.0), np.float32(0.0), np.float32(0.0), np.float32(0.0), np.float32(1.0), np.float32(1.0), np.float32(1.0), np.float32(0.0), np.float32(0.0), np.float32(1.0), np.float32(1.0), np.float32(0.0), np.float32(0.0), np.float32(1.0), np.float32(0.0)]",0.0,99998.0,6
2025-08-14_08-18-36,113,"[np.float32(0.0), np.float32(1.0), np.float32(1.0), np.float32(1.0), np.float32(1.0), np.float32(1.0), np.float32(1.0), np.float32(1.0), np.float32(1.0), np.float32(0.0), np.float32(0.0), np.float32(1.0), np.float32(1.0), np.float32(0.0), np.float32(0.0), np.float32(0.0)]",-3.0,99995.0,5
2025-08-14_08-18-36,114,"[np.float32(0.0), np.float32(1.0), np.float32(1.0), np.float32(0.0), np.float32(0.0), np.float32(1.0), np.float32(1.0), np.float32(0.0), np.float32(1.0), np.float32(0.0), np.float32(0.0), np.float32(0.0), np.float32(0.0), np.float32(0.0), np.float32(0.0), np.float32(0.0)]",2.0,99997.0,6
2025-08-14_08-18-36,115,"[np.float32(1.0), np.float32(1.0), np.float32(1.0), np.float32(0.0), np.float32(0.0), np.float32(0.0), np.float32(0.0), np.float32(0.0), np.float32(1.0), np.float32(1.0), np.float32(0.0), np.float32(0.0), np.float32(1.0), np.float32(1.0), np.float32(1.0), np.float32(1.0)]",1.0,99998.0,4
2025-08-14_08-18-36,116,"[np.float32(0.0), np.float32(0.0), np.float32(0.0), np.float32(1.0), np.float32(1.0), np.float32(1.0), np.float32(0.0), np.float32(0.0), np.float32(0.0), np.float32(0.0), np.float32(0.0), np.float32(1.0), np.float32(0.0), np.float32(0.0), np.float32(1.0), np.float32(0.0)]",0.0,99998.0,6
2025-08-14_08-18-36,117,"[np.float32(1.0), np.float32(0.0), np.float32(0.0), np.float32(1.0), np.float32(1.0), np.float32(0.0), np.float32(1.0), np.float32(1.0), np.float32(1.0), np.float32(1.0), np.float32(1.0), np.float32(0.0), np.float32(0.0), np.float32(1.0), np.float32(0.0), np.float32(1.0)]",-1.0,99997.0,20
2025-08-14_08-18-36,118,"[np.float32(1.0), np.float32(1.0), np.float32(0.0), np.float32(1.0), np.float32(0.0), np.float32(1.0), np.float32(0.0), np.float32(0.0), np.float32(1.0), np.float32(1.0), np.float32(0.0), np.float32(1.0), np.float32(1.0), np.float32(1.0), np.float32(0.0), np.float32(0.0)]",1.0,99998.0,26
2025-08-14_08-18-36,119,"[np.float32(0.0), np.float32(0.0), np.float32(1.0), np.float32(1.0), np.float32(0.0), np.float32(0.0), np.float32(1.0), np.float32(1.0), np.float32(1.0), np.float32(0.0), np.float32(0.0), np.float32(0.0), np.float32(0.0), np.float32(1.0), np.float32(1.0), np.float32(1.0)]",0.0,99998.0,9
2025-08-14_08-18-36,120,"[np.float32(1.0), np.float32(1.0), np.float32(0.0), np.float32(1.0), np.float32(1.0), np.float32(1.0), np.float32(1.0), np.float32(1.0), np.float32(0.0), np.float32(1.0), np.float32(0.0), np.float32(0.0), np.float32(0.0), np.float32(1.0), np.float32(1.0), np.float32(0.0)]",2.0,100000.0,5
2025-08-14_08-18-36,121,"[np.float32(1.0), np.float32(1.0), np.float32(1.0), np.float32(0.0), np.float32(1.0), np.float32(1.0), np.float32(1.0), np.float32(1.0), np.float32(1.0), np.float32(1.0), np.float32(0.0), np.float32(0.0), np.float32(0.0), np.float32(0.0), np.float32(1.0), np.float32(1.0)]",-2.0,99998.0,18
2025-08-14_08-18-36,122,"[np.float32(0.0), np.float32(0.0), np.float32(1.0), np.float32(0.0), np.float32(1.0), np.float32(1.0), np.float32(1.0), np.float32(0.0), np.float32(0.0), np.float32(1.0), np.float32(0.0), np.float32(0.0), np.float32(0.0), np.float32(1.0), np.float32(1.0), np.float32(1.0)]",0.0,99998.0,3
2025-08-14_08-18-36,123,"[np.float32(1.0), np.float32(1.0), np.float32(0.0), np.float32(0.0), np.float32(0.0), np.float32(1.0), np.float32(0.0), np.float32(0.0), np.float32(0.0), np.float32(1.0), np.float32(1.0), np.float32(0.0), np.float32(0.0), np.float32(1.0), np.float32(0.0), np.float32(0.0)]",-1.0,99997.0,15
2025-08-14_08-18-36,124,"[np.float32(1.0), np.float32(0.0), np.float32(0.0), np.float32(1.0), np.float32(0.0), np.float32(1.0), np.float32(1.0), np.float32(1.0), np.float32(0.0), np.float32(0.0), np.float32(0.0), np.float32(0.0), np.float32(0.0), np.float32(1.0), np.float32(1.0), np.float32(0.0)]",3.0,100000.0,3
2025-08-14_08-18-36,125,"[np.float32(1.0), np.float32(0.0), np.float32(0.0), np.float32(1.0), np.float32(1.0), np.float32(0.0), np.float32(1.0), np.float32(0.0), np.float32(1.0), np.float32(1.0), np.float32(1.0), np.float32(1.0), np.float32(0.0), np.float32(0.0), np.float32(0.0), np.float32(1.0)]",-2.0,99998.0,18
2025-08-14_08-18-36,126,"[np.float32(0.0), np.float32(0.0), np.float32(0.0), np.float32(1.0), np.float32(1.0), np.float32(0.0), np.float32(1.0), np.float32(0.0), np.float32(1.0), np.float32(0.0), np.float32(0.0), np.float32(1.0), np.float32(1.0), np.float32(0.0), np.float32(0.0), np.float32(0.0)]",-4.0,99994.0,23
2025-08-14_08-18-36,127,"[np.float32(0.0), np.float32(0.0), np.float32(1.0), np.float32(1.0), np.float32(1.0), np.float32(1.0), np.float32(0.0), np.float32(0.0), np.float32(1.0), np.float32(0.0), np.float32(1.0), np.float32(1.0), np.float32(0.0), np.float32(0.0), np.float32(0.0), np.float32(0.0)]",3.0,99997.0,30
2025-08-14_08-18-36,128,"[np.float32(0.0), np.float32(0.0), np.float32(0.0), np.float32(0.0), np.float32(1.0), np.float32(0.0), np.float32(1.0), np.float32(1.0), np.float32(1.0), np.float32(1.0), np.float32(0.0), np.float32(0.0), np.float32(1.0), np.float32(1.0), np.float32(1.0), np.float32(0.0)]",3.0,100000.0,10
2025-08-14_08-18-36,129,"[np.float32(0.0), np.float32(0.0), np.float32(0.0), np.float32(0.0), np.float32(0.0), np.float32(0.0), np.float32(1.0), np.float32(0.0), np.float32(0.0), np.float32(0.0), np.float32(0.0), np.float32(1.0), np.float32(1.0), np.float32(1.0), np.float32(0.0), np.float32(1.0)]",1.0,100001.0,15
2025-08-14_08-18-36,130,"[np.float32(0.0), np.float32(1.0), np.float32(0.0), np.float32(1.0), np.float32(0.0), np.float32(0.0), np.float32(0.0), np.float32(1.0), np.float32(0.0), np.float32(0.0), np.float32(0.0), np.float32(1.0), np.float32(0.0), np.float32(0.0), np.float32(1.0), np.float32(0.0)]",1.0,100002.0,16
2025-08-14_08-18-36,131,"[np.float32(0.0), np.float32(1.0), np.float32(1.0), np.float32(1.0), np.float32(0.0), np.float32(0.0), np.float32(0.0), np.float32(1.0), np.float32(1.0), np.float32(1.0), np.float32(1.0), np.float32(1.0), np.float32(1.0), np.float32(0.0), np.float32(1.0), np.float32(1.0)]",0.0,100002.0,27
2025-08-14_08-18-36,132,"[np.float32(1.0), np.float32(1.0), np.float32(1.0), np.float32(1.0), np.float32(1.0), np.float32(1.0), np.float32(0.0), np.float32(0.0), np.float32(0.0), np.float32(0.0), np.float32(0.0), np.float32(1.0), np.float32(0.0), np.float32(0.0), np.float32(0.0), np.float32(0.0)]",-1.0,100001.0,11
2025-08-14_08-18-36,133,"[np.float32(0.0), np.float32(1.0), np.float32(0.0), np.float32(0.0), np.float32(0.0), np.float32(0.0), np.float32(1.0), np.float32(0.0), np.float32(0.0), np.float32(0.0), np.float32(0.0), np.float32(0.0), np.float32(1.0), np.float32(1.0), np.float32(0.0), np.float32(0.0)]",-2.0,99999.0,24
2025-08-14_08-18-36,134,"[np.float32(0.0), np.float32(0.0), np.float32(0.0), np.float32(0.0), np.float32(0.0), np.float32(0.0), np.float32(0.0), np.float32(1.0), np.float32(0.0), np.float32(0.0), np.float32(0.0), np.float32(0.0), np.float32(0.0), np.float32(0.0), np.float32(0.0), np.float32(0.0)]",-1.0,99998.0,11
2025-08-14_08-18-36,135,"[np.float32(1.0), np.float32(0.0), np.float32(1.0), np.float32(1.0), np.float32(0.0), np.float32(1.0), np.float32(1.0), np.float32(0.0), np.float32(0.0), np.float32(1.0), np.float32(0.0), np.float32(0.0), np.float32(0.0), np.float32(0.0), np.float32(1.0), np.float32(1.0)]",1.0,99999.0,25
2025-08-14_08-18-36,136,"[np.float32(0.0), np.float32(1.0), np.float32(0.0), np.float32(1.0), np.float32(0.0), np.float32(0.0), np.float32(0.0), np.float32(1.0), np.float32(1.0), np.float32(0.0), np.float32(0.0), np.float32(0.0), np.float32(1.0), np.float32(1.0), np.float32(0.0), np.float32(0.0)]",-4.0,99995.0,9
2025-08-14_08-18-36,137,"[np.float32(1.0), np.float32(0.0), np.float32(0.0), np.float32(1.0), np.float32(1.0), np.float32(0.0), np.float32(0.0), np.float32(1.0), np.float32(0.0), np.float32(1.0), np.float32(0.0), np.float32(1.0), np.float32(1.0), np.float32(1.0), np.float32(0.0), np.float32(1.0)]",-3.0,99992.0,28
2025-08-14_08-18-36,138,"[np.float32(1.0), np.float32(1.0), np.float32(0.0), np.float32(1.0), np.float32(0.0), np.float32(0.0), np.float32(1.0), np.float32(1.0), np.float32(1.0), np.float32(1.0), np.float32(1.0), np.float32(1.0), np.float32(1.0), np.float32(1.0), np.float32(0.0), np.float32(0.0)]",0.0,99992.0,22
2025-08-14_08-18-36,139,"[np.float32(1.0), np.float32(1.0), np.float32(1.0), np.float32(1.0), np.float32(0.0), np.float32(0.0), np.float32(1.0), np.float32(1.0), np.float32(1.0), np.float32(0.0), np.float32(1.0), np.float32(1.0), np.float32(0.0), np.float32(1.0), np.float32(0.0), np.float32(0.0)]",0.0,99992.0,27
2025-08-14_08-18-36,140,"[np.float32(0.0), np.float32(0.0), np.float32(0.0), np.float32(0.0), np.float32(0.0), np.float32(0.0), np.float32(1.0), np.float32(0.0), np.float32(1.0), np.float32(0.0), np.float32(0.0), np.float32(0.0), np.float32(0.0), np.float32(0.0), np.float32(1.0), np.float32(1.0)]",2.0,99994.0,11
2025-08-14_08-18-36,141,"[np.float32(0.0), np.float32(1.0), np.float32(0.0), np.float32(1.0), np.float32(1.0), np.float32(1.0), np.float32(0.0), np.float32(1.0), np.float32(1.0), np.float32(1.0), np.float32(1.0), np.float32(1.0), np.float32(0.0), np.float32(0.0), np.float32(0.0), np.float32(0.0)]",-1.0,99993.0,14
2025-08-14_08-18-36,142,"[np.float32(1.0), np.float32(1.0), np.float32(1.0), np.float32(0.0), np.float32(0.0), np.float32(0.0), np.float32(1.0), np.float32(0.0), np.float32(0.0), np.float32(0.0), np.float32(0.0), np.float32(1.0), np.float32(1.0), np.float32(0.0), np.float32(1.0), np.float32(1.0)]",0.0,99993.0,33
2025-08-14_08-18-36,143,"[np.float32(0.0), np.float32(1.0), np.float32(0.0), np.float32(0.0), np.float32(1.0), np.float32(1.0), np.float32(1.0), np.float32(1.0), np.float32(1.0), np.float32(1.0), np.float32(1.0), np.float32(0.0), np.float32(1.0), np.float32(0.0), np.float32(1.0), np.float32(1.0)]",-1.0,99992.0,24
2025-08-14_08-18-36,144,"[np.float32(1.0), np.float32(1.0), np.float32(1.0), np.float32(0.0), np.float32(1.0), np.float32(1.0), np.float32(1.0), np.float32(1.0), np.float32(1.0), np.float32(0.0), np.float32(0.0), np.float32(0.0), np.float32(1.0), np.float32(0.0), np.float32(0.0), np.float32(0.0)]",-2.0,99990.0,29
2025-08-14_08-18-36,145,"[np.float32(1.0), np.float32(0.0), np.float32(1.0), np.float32(0.0), np.float32(1.0), np.float32(0.0), np.float32(0.0), np.float32(0.0), np.float32(1.0), np.float32(1.0), np.float32(1.0), np.float32(1.0), np.float32(1.0), np.float32(1.0), np.float32(1.0), np.float32(1.0)]",-3.0,99987.0,15
2025-08-14_08-18-36,146,"[np.float32(0.0), np.float32(0.0), np.float32(1.0), np.float32(1.0), np.float32(0.0), np.float32(0.0), np.float32(0.0), np.float32(1.0), np.float32(1.0), np.float32(0.0), np.float32(0.0), np.float32(1.0), np.float32(1.0), np.float32(1.0), np.float32(1.0), np.float32(0.0)]",3.0,99990.0,30
2025-08-14_08-18-36,147,"[np.float32(0.0), np.float32(0.0), np.float32(0.0), np.float32(1.0), np.float32(0.0), np.float32(1.0), np.float32(1.0), np.float32(1.0), np.float32(0.0), np.float32(1.0), np.float32(0.0), np.float32(1.0), np.float32(1.0), np.float32(0.0), np.float32(0.0), np.float32(0.0)]",-5.0,99985.0,32
2025-08-14_08-18-36,148,"[np.float32(0.0), np.float32(0.0), np.float32(0.0), np.float32(1.0), np.float32(1.0), np.float32(1.0), np.float32(0.0), np.float32(0.0), np.float32(0.0), np.float32(0.0), np.float32(0.0), np.float32(0.0), np.float32(1.0), np.float32(0.0), np.float32(0.0), np.float32(0.0)]",-2.0,99983.0,22
2025-08-14_08-18-36,149,"[np.float32(1.0), np.float32(1.0), np.float32(1.0), np.float32(1.0), np.float32(1.0), np.float32(0.0), np.float32(1.0), np.float32(0.0), np.float32(0.0), np.float32(1.0), np.float32(0.0), np.float32(1.0), np.float32(0.0), np.float32(1.0), np.float32(0.0), np.float32(0.0)]",-2.0,99981.0,24
2025-08-14_08-18-36,150,"[np.float32(1.0), np.float32(1.0), np.float32(0.0), np.float32(0.0), np.float32(1.0), np.float32(0.0), np.float32(1.0), np.float32(0.0), np.float32(1.0), np.float32(1.0), np.float32(0.0), np.float32(0.0), np.float32(0.0), np.float32(0.0), np.float32(1.0), np.float32(0.0)]",-2.0,99979.0,32
2025-08-14_08-18-36,151,"[np.float32(1.0), np.float32(0.0), np.float32(1.0), np.float32(1.0), np.float32(0.0), np.float32(1.0), np.float32(1.0), np.float32(1.0), np.float32(1.0), np.float32(1.0), np.float32(0.0), np.float32(1.0), np.float32(1.0), np.float32(1.0), np.float32(0.0), np.float32(1.0)]",1.0,99980.0,28
2025-08-14_08-18-36,152,"[np.float32(1.0), np.float32(0.0), np.float32(1.0), np.float32(0.0), np.float32(1.0), np.float32(1.0), np.float32(1.0), np.float32(1.0), np.float32(0.0), np.float32(0.0), np.float32(0.0), np.float32(1.0), np.float32(1.0), np.float32(1.0), np.float32(0.0), np.float32(1.0)]",3.0,99983.0,3
2025-08-14_08-18-36,153,"[np.float32(1.0), np.float32(1.0), np.float32(0.0), np.float32(1.0), np.float32(0.0), np.float32(1.0), np.float32(0.0), np.float32(0.0), np.float32(0.0), np.float32(0.0), np.float32(0.0), np.float32(1.0), np.float32(0.0), np.float32(1.0), np.float32(1.0), np.float32(1.0)]",-1.0,99982.0,32
2025-08-14_08-18-36,154,"[np.float32(1.0), np.float32(0.0), np.float32(1.0), np.float32(1.0), np.float32(0.0), np.float32(1.0), np.float32(0.0), np.float32(0.0), np.float32(0.0), np.float32(1.0), np.float32(0.0), np.float32(1.0), np.float32(0.0), np.float32(1.0), np.float32(1.0), np.float32(0.0)]",4.0,99986.0,30
2025-08-14_08-18-36,155,"[np.float32(1.0), np.float32(0.0), np.float32(1.0), np.float32(0.0), np.float32(1.0), np.float32(0.0), np.float32(1.0), np.float32(1.0), np.float32(1.0), np.float32(0.0), np.float32(1.0), np.float32(1.0), np.float32(0.0), np.float32(1.0), np.float32(1.0), np.float32(1.0)]",2.0,99988.0,8
2025-08-14_08-18-36,156,"[np.float32(0.0), np.float32(1.0), np.float32(1.0), np.float32(1.0), np.float32(0.0), np.float32(1.0), np.float32(1.0), np.float32(0.0), np.float32(1.0), np.float32(0.0), np.float32(0.0), np.float32(0.0), np.float32(1.0), np.float32(1.0), np.float32(0.0), np.float32(1.0)]",-2.0,99986.0,8
2025-08-14_08-18-36,157,"[np.float32(1.0), np.float32(1.0), np.float32(1.0), np.float32(1.0), np.float32(0.0), np.float32(0.0), np.float32(1.0), np.float32(1.0), np.float32(1.0), np.float32(0.0), np.float32(0.0), np.float32(1.0), np.float32(0.0), np.float32(1.0), np.float32(0.0), np.float32(0.0)]",1.0,99987.0,26
2025-08-14_08-18-36,158,"[np.float32(0.0), np.float32(0.0), np.float32(0.0), np.float32(1.0), np.float32(0.0), np.float32(0.0), np.float32(1.0), np.float32(1.0), np.float32(0.0), np.float32(0.0), np.float32(0.0), np.float32(0.0), np.float32(0.0), np.float32(0.0), np.float32(1.0), np.float32(0.0)]",-1.0,99986.0,6
2025-08-14_08-18-36,159,"[np.float32(1.0), np.float32(1.0), np.float32(1.0), np.float32(1.0), np.float32(0.0), np.float32(1.0), np.float32(1.0), np.float32(0.0), np.float32(0.0), np.float32(1.0), np.float32(0.0), np.float32(0.0), np.float32(1.0), np.float32(0.0), np.float32(0.0), np.float32(0.0)]",-2.0,99984.0,27
2025-08-14_08-18-36,160,"[np.float32(0.0), np.float32(0.0), np.float32(0.0), np.float32(0.0), np.float32(0.0), np.float32(0.0), np.float32(0.0), np.float32(0.0), np.float32(1.0), np.float32(0.0), np.float32(1.0), np.float32(1.0), np.float32(1.0), np.float32(0.0), np.float32(1.0), np.float32(1.0)]",-3.0,99981.0,10
2025-08-14_08-18-36,161,"[np.float32(1.0), np.float32(1.0), np.float32(1.0), np.float32(0.0), np.float32(0.0), np.float32(0.0), np.float32(1.0), np.float32(1.0), np.float32(1.0), np.float32(0.0), np.float32(1.0), np.float32(1.0), np.float32(1.0), np.float32(0.0), np.float32(0.0), np.float32(0.0)]",-1.0,99980.0,21
2025-08-14_08-18-36,162,"[np.float32(0.0), np.float32(1.0), np.float32(0.0), np.float32(0.0), np.float32(1.0), np.float32(1.0), np.float32(0.0), np.float32(0.0), np.float32(0.0), np.float32(0.0), np.float32(1.0), np.float32(0.0), np.float32(0.0), np.float32(0.0), np.float32(1.0), np.float32(1.0)]",-4.0,99976.0,25
2025-08-14_08-18-36,163,"[np.float32(0.0), np.float32(1.0), np.float32(0.0), np.float32(0.0), np.float32(1.0), np.float32(0.0), np.float32(1.0), np.float32(1.0), np.float32(1.0), np.float32(1.0), np.float32(0.0), np.float32(0.0), np.float32(1.0), np.float32(1.0), np.float32(0.0), np.float32(0.0)]",-1.0,99975.0,11
2025-08-14_08-18-36,164,"[np.float32(1.0), np.float32(1.0), np.float32(0.0), np.float32(0.0), np.float32(0.0), np.float32(1.0), np.float32(1.0), np.float32(0.0), np.float32(1.0), np.float32(0.0), np.float32(1.0), np.float32(1.0), np.float32(1.0), np.float32(1.0), np.float32(1.0), np.float32(0.0)]",1.0,99976.0,3
2025-08-14_08-18-36,165,"[np.float32(0.0), np.float32(0.0), np.float32(1.0), np.float32(0.0), np.float32(0.0), np.float32(1.0), np.float32(0.0), np.float32(0.0), np.float32(1.0), np.float32(1.0), np.float32(1.0), np.float32(0.0), np.float32(0.0), np.float32(0.0), np.float32(0.0), np.float32(0.0)]",-2.0,99974.0,11
2025-08-14_08-18-36,166,"[np.float32(0.0), np.float32(1.0), np.float32(1.0), np.float32(1.0), np.float32(0.0), np.float32(1.0), np.float32(1.0), np.float32(1.0), np.float32(1.0), np.float32(0.0), np.float32(1.0), np.float32(0.0), np.float32(0.0), np.float32(0.0), np.float32(1.0), np.float32(0.0)]",1.0,99975.0,30
2025-08-14_08-18-36,167,"[np.float32(0.0), np.float32(1.0), np.float32(0.0), np.float32(1.0), np.float32(0.0), np.float32(1.0), np.float32(0.0), np.float32(1.0), np.float32(1.0), np.float32(1.0), np.float32(1.0), np.float32(0.0), np.float32(1.0), np.float32(1.0), np.float32(0.0), np.float32(0.0)]",0.0,99975.0,33
2025-08-14_08-18-36,168,"[np.float32(0.0), np.float32(0.0), np.float32(1.0), np.float32(0.0), np.float32(0.0), np.float32(1.0), np.float32(1.0), np.float32(1.0), np.float32(0.0), np.float32(1.0), np.float32(0.0), np.float32(1.0), np.float32(0.0), np.float32(1.0), np.float32(0.0), np.float32(0.0)]",4.0,99979.0,12
2025-08-14_08-18-36,169,"[np.float32(1.0), np.float32(0.0), np.float32(0.0), np.float32(0.0), np.float32(1.0), np.float32(1.0), np.float32(0.0), np.float32(0.0), np.float32(0.0), np.float32(1.0), np.float32(1.0), np.float32(0.0), np.float32(1.0), np.float32(0.0), np.float32(1.0), np.float32(0.0)]",-3.0,99976.0,12
2025-08-14_08-18-36,170,"[np.float32(1.0), np.float32(1.0), np.float32(1.0), np.float32(1.0), np.float32(1.0), np.float32(0.0), np.float32(1.0), np.float32(1.0), np.float32(0.0), np.float32(1.0), np.float32(0.0), np.float32(0.0), np.float32(1.0), np.float32(0.0), np.float32(1.0), np.float32(1.0)]",-4.0,99972.0,27
2025-08-14_08-18-36,171,"[np.float32(1.0), np.float32(0.0), np.float32(1.0), np.float32(1.0), np.float32(0.0), np.float32(0.0), np.float32(0.0), np.float32(0.0), np.float32(1.0), np.float32(0.0), np.float32(0.0), np.float32(0.0), np.float32(0.0), np.float32(0.0), np.float32(0.0), np.float32(0.0)]",-2.0,99970.0,24
2025-08-14_08-18-36,172,"[np.float32(1.0), np.float32(0.0), np.float32(1.0), np.float32(0.0), np.float32(1.0), np.float32(0.0), np.float32(0.0), np.float32(0.0), np.float32(1.0), np.float32(0.0), np.float32(0.0), np.float32(1.0), np.float32(0.0), np.float32(1.0), np.float32(1.0), np.float32(0.0)]",-5.0,99965.0,20
2025-08-14_08-18-36,173,"[np.float32(0.0), np.float32(1.0), np.float32(1.0), np.float32(1.0), np.float32(1.0), np.float32(0.0), np.float32(0.0), np.float32(1.0), np.float32(1.0), np.float32(1.0), np.float32(1.0), np.float32(0.0), np.float32(0.0), np.float32(0.0), np.float32(1.0), np.float32(0.0)]",-1.0,99964.0,19
2025-08-14_08-18-36,174,"[np.float32(1.0), np.float32(1.0), np.float32(1.0), np.float32(1.0), np.float32(0.0), np.float32(1.0), np.float32(0.0), np.float32(1.0), np.float32(0.0), np.float32(0.0), np.float32(1.0), np.float32(1.0), np.float32(0.0), np.float32(0.0), np.float32(0.0), np.float32(1.0)]",0.0,99964.0,26
2025-08-14_08-18-36,175,"[np.float32(0.0), np.float32(0.0), np.float32(0.0), np.float32(1.0), np.float32(1.0), np.float32(1.0), np.float32(0.0), np.float32(1.0), np.float32(1.0), np.float32(1.0), np.float32(0.0), np.float32(1.0), np.float32(0.0), np.float32(0.0), np.float32(0.0), np.float32(1.0)]",2.0,99966.0,15
2025-08-14_08-18-36,176,"[np.float32(1.0), np.float32(0.0), np.float32(1.0), np.float32(0.0), np.float32(1.0), np.float32(0.0), np.float32(1.0), np.float32(0.0), np.float32(1.0), np.float32(0.0), np.float32(0.0), np.float32(1.0), np.float32(0.0), np.float32(1.0), np.float32(0.0), np.float32(0.0)]",-1.0,99965.0,35
2025-08-14_08-18-36,177,"[np.float32(1.0), np.float32(0.0), np.float32(1.0), np.float32(0.0), np.float32(0.0), np.float32(1.0), np.float32(0.0), np.float32(0.0), np.float32(0.0), np.float32(1.0), np.float32(0.0), np.float32(1.0), np.float32(1.0), np.float32(1.0), np.float32(0.0), np.float32(0.0)]",1.0,99966.0,3
2025-08-14_08-18-36,178,"[np.float32(0.0), np.float32(0.0), np.float32(1.0), np.float32(0.0), np.float32(0.0), np.float32(1.0), np.float32(1.0), np.float32(0.0), np.float32(1.0), np.float32(1.0), np.float32(0.0), np.float32(0.0), np.float32(0.0), np.float32(0.0), np.float32(0.0), np.float32(0.0)]",-1.0,99965.0,24
2025-08-14_08-18-36,179,"[np.float32(1.0), np.float32(0.0), np.float32(1.0), np.float32(1.0), np.float32(1.0), np.float32(0.0), np.float32(1.0), np.float32(1.0), np.float32(1.0), np.float32(1.0), np.float32(0.0), np.float32(1.0), np.float32(0.0), np.float32(0.0), np.float32(1.0), np.float32(0.0)]",3.0,99968.0,13
2025-08-14_08-18-36,180,"[np.float32(0.0), np.float32(0.0), np.float32(1.0), np.float32(1.0), np.float32(0.0), np.float32(0.0), np.float32(0.0), np.float32(1.0), np.float32(1.0), np.float32(1.0), np.float32(1.0), np.float32(0.0), np.float32(1.0), np.float32(1.0), np.float32(0.0), np.float32(1.0)]",-4.0,99964.0,11
2025-08-14_08-18-36,181,"[np.float32(1.0), np.float32(1.0), np.float32(1.0), np.float32(0.0), np.float32(0.0), np.float32(0.0), np.float32(1.0), np.float32(1.0), np.float32(1.0), np.float32(0.0), np.float32(0.0), np.float32(1.0), np.float32(1.0), np.float32(0.0), np.float32(1.0), np.float32(0.0)]",-2.0,99962.0,22
2025-08-14_08-18-36,182,"[np.float32(0.0), np.float32(1.0), np.float32(0.0), np.float32(0.0), np.float32(1.0), np.float32(0.0), np.float32(0.0), np.float32(1.0), np.float32(1.0), np.float32(1.0), np.float32(1.0), np.float32(1.0), np.float32(1.0), np.float32(1.0), np.float32(0.0), np.float32(0.0)]",-4.0,99958.0,5
2025-08-14_08-18-36,183,"[np.float32(1.0), np.float32(1.0), np.float32(0.0), np.float32(0.0), np.float32(0.0), np.float32(1.0), np.float32(1.0), np.float32(1.0), np.float32(0.0), np.float32(0.0), np.float32(1.0), np.float32(0.0), np.float32(1.0), np.float32(1.0), np.float32(1.0), np.float32(1.0)]",-3.0,99955.0,33
2025-08-14_08-18-36,184,"[np.float32(0.0), np.float32(1.0), np.float32(1.0), np.float32(1.0), np.float32(1.0), np.float32(1.0), np.float32(0.0), np.float32(0.0), np.float32(0.0), np.float32(1.0), np.float32(0.0), np.float32(0.0), np.float32(0.0), np.float32(0.0), np.float32(1.0), np.float32(0.0)]",0.0,99955.0,7
2025-08-14_08-18-36,185,"[np.float32(1.0), np.float32(0.0), np.float32(1.0), np.float32(1.0), np.float32(0.0), np.float32(1.0), np.float32(0.0), np.float32(0.0), np.float32(0.0), np.float32(1.0), np.float32(0.0), np.float32(1.0), np.float32(0.0), np.float32(0.0), np.float32(1.0), np.float32(1.0)]",-1.0,99954.0,5
2025-08-14_08-18-36,186,"[np.float32(0.0), np.float32(0.0), np.float32(1.0), np.float32(1.0), np.float32(1.0), np.float32(1.0), np.float32(0.0), np.float32(1.0), np.float32(1.0), np.float32(0.0), np.float32(1.0), np.float32(0.0), np.float32(1.0), np.float32(0.0), np.float32(0.0), np.float32(0.0)]",-1.0,99953.0,25
2025-08-14_08-18-36,187,"[np.float32(1.0), np.float32(0.0), np.float32(1.0), np.float32(1.0), np.float32(1.0), np.float32(1.0), np.float32(0.0), np.float32(0.0), np.float32(1.0), np.float32(0.0), np.float32(1.0), np.float32(0.0), np.float32(1.0), np.float32(0.0), np.float32(1.0), np.float32(0.0)]",3.0,99956.0,30
2025-08-14_08-18-36,188,"[np.float32(0.0), np.float32(1.0), np.float32(1.0), np.float32(1.0), np.float32(0.0), np.float32(0.0), np.float32(1.0), np.float32(1.0), np.float32(1.0), np.float32(1.0), np.float32(0.0), np.float32(1.0), np.float32(1.0), np.float32(1.0), np.float32(1.0), np.float32(0.0)]",-3.0,99953.0,23
2025-08-14_08-18-36,189,"[np.float32(1.0), np.float32(1.0), np.float32(0.0), np.float32(0.0), np.float32(0.0), np.float32(1.0), np.float32(0.0), np.float32(0.0), np.float32(1.0), np.float32(1.0), np.float32(1.0), np.float32(0.0), np.float32(0.0), np.float32(0.0), np.float32(0.0), np.float32(1.0)]",6.0,99959.0,31
2025-08-14_08-18-36,190,"[np.float32(1.0), np.float32(0.0), np.float32(0.0), np.float32(0.0), np.float32(1.0), np.float32(0.0), np.float32(0.0), np.float32(1.0), np.float32(1.0), np.float32(0.0), np.float32(1.0), np.float32(0.0), np.float32(1.0), np.float32(0.0), np.float32(1.0), np.float32(1.0)]",1.0,99960.0,20
2025-08-14_08-18-36,191,"[np.float32(0.0), np.float32(1.0), np.float32(1.0), np.float32(1.0), np.float32(0.0), np.float32(1.0), np.float32(1.0), np.float32(1.0), np.float32(1.0), np.float32(1.0), np.float32(1.0), np.float32(1.0), np.float32(1.0), np.float32(0.0), np.float32(0.0), np.float32(1.0)]",-2.0,99958.0,13
2025-08-14_08-18-36,192,"[np.float32(0.0), np.float32(1.0), np.float32(0.0), np.float32(0.0), np.float32(0.0), np.float32(1.0), np.float32(1.0), np.float32(1.0), np.float32(1.0), np.float32(1.0), np.float32(1.0), np.float32(0.0), np.float32(0.0), np.float32(0.0), np.float32(0.0), np.float32(1.0)]",-5.0,99953.0,3
2025-08-14_08-18-36,193,"[np.float32(0.0), np.float32(0.0), np.float32(1.0), np.float32(1.0), np.float32(0.0), np.float32(1.0), np.float32(1.0), np.float32(1.0), np.float32(0.0), np.float32(0.0), np.float32(0.0), np.float32(0.0), np.float32(0.0), np.float32(0.0), np.float32(1.0), np.float32(1.0)]",3.0,99956.0,20
2025-08-14_08-18-36,194,"[np.float32(1.0), np.float32(0.0), np.float32(0.0), np.float32(0.0), np.float32(1.0), np.float32(1.0), np.float32(1.0), np.float32(0.0), np.float32(1.0), np.float32(0.0), np.float32(0.0), np.float32(0.0), np.float32(1.0), np.float32(0.0), np.float32(0.0), np.float32(1.0)]",0.0,99956.0,30
2025-08-14_08-18-36,195,"[np.float32(0.0), np.float32(1.0), np.float32(1.0), np.float32(0.0), np.float32(0.0), np.float32(1.0), np.float32(1.0), np.float32(1.0), np.float32(0.0), np.float32(1.0), np.float32(1.0), np.float32(0.0), np.float32(0.0), np.float32(1.0), np.float32(0.0), np.float32(1.0)]",-5.0,99951.0,30
2025-08-14_08-18-36,196,"[np.float32(1.0), np.float32(1.0), np.float32(0.0), np.float32(0.0), np.float32(0.0), np.float32(1.0), np.float32(1.0), np.float32(0.0), np.float32(0.0), np.float32(1.0), np.float32(1.0), np.float32(1.0), np.float32(0.0), np.float32(0.0), np.float32(1.0), np.float32(0.0)]",3.0,99954.0,11
2025-08-14_08-18-36,197,"[np.float32(0.0), np.float32(0.0), np.float32(0.0), np.float32(0.0), np.float32(0.0), np.float32(1.0), np.float32(1.0), np.float32(1.0), np.float32(0.0), np.float32(1.0), np.float32(1.0), np.float32(1.0), np.float32(0.0), np.float32(1.0), np.float32(0.0), np.float32(0.0)]",-2.0,99952.0,0
2025-08-14_08-18-36,198,"[np.float32(0.0), np.float32(1.0), np.float32(1.0), np.float32(0.0), np.float32(1.0), np.float32(1.0), np.float32(1.0), np.float32(0.0), np.float32(1.0), np.float32(0.0), np.float32(1.0), np.float32(1.0), np.float32(0.0), np.float32(1.0), np.float32(1.0), np.float32(1.0)]",-1.0,99951.0,34
2025-08-14_08-18-36,199,"[np.float32(0.0), np.float32(0.0), np.float32(1.0), np.float32(1.0), np.float32(0.0), np.float32(1.0), np.float32(1.0), np.float32(1.0), np.float32(1.0), np.float32(0.0), np.float32(1.0), np.float32(0.0), np.float32(0.0), np.float32(0.0), np.float32(0.0), np.float32(1.0)]",-1.0,99950.0,33
2025-08-14_08-18-36,200,"[np.float32(1.0), np.float32(0.0), np.float32(1.0), np.float32(0.0), np.float32(0.0), np.float32(1.0), np.float32(1.0), np.float32(1.0), np.float32(0.0), np.float32(0.0), np.float32(1.0), np.float32(0.0), np.float32(1.0), np.float32(0.0), np.float32(1.0), np.float32(0.0)]",33.0,99983.0,7
2025-08-14_08-18-36,201,"[np.float32(1.0), np.float32(0.0), np.float32(1.0), np.float32(0.0), np.float32(1.0), np.float32(1.0), np.float32(1.0), np.float32(1.0), np.float32(1.0), np.float32(0.0), np.float32(0.0), np.float32(1.0), np.float32(1.0), np.float32(0.0), np.float32(0.0), np.float32(1.0)]",0.0,99983.0,21
2025-08-14_08-18-36,202,"[np.float32(0.0), np.float32(1.0), np.float32(0.0), np.float32(1.0), np.float32(0.0), np.float32(1.0), np.float32(1.0), np.float32(1.0), np.float32(1.0), np.float32(0.0), np.float32(1.0), np.float32(0.0), np.float32(1.0), np.float32(0.0), np.float32(1.0), np.float32(0.0)]",-1.0,99982.0,10
2025-08-14_08-18-36,203,"[np.float32(1.0), np.float32(0.0), np.float32(1.0), np.float32(1.0), np.float32(1.0), np.float32(0.0), np.float32(0.0), np.float32(0.0), np.float32(0.0), np.float32(1.0), np.float32(1.0), np.float32(0.0), np.float32(0.0), np.float32(1.0), np.float32(0.0), np.float32(1.0)]",2.0,99984.0,2
2025-08-14_08-18-36,204,"[np.float32(0.0), np.float32(0.0), np.float32(0.0), np.float32(0.0), np.float32(0.0), np.float32(1.0), np.float32(1.0), np.float32(1.0), np.float32(1.0), np.float32(1.0), np.float32(1.0), np.float32(1.0), np.float32(0.0), np.float32(1.0), np.float32(1.0), np.float32(0.0)]",0.0,99984.0,15
2025-08-14_08-18-36,205,"[np.float32(0.0), np.float32(1.0), np.float32(1.0), np.float32(1.0), np.float32(1.0), np.float32(0.0), np.float32(0.0), np.float32(1.0), np.float32(1.0), np.float32(1.0), np.float32(1.0), np.float32(0.0), np.float32(1.0), np.float32(0.0), np.float32(1.0), np.float32(0.0)]",2.0,99986.0,8
2025-08-14_08-18-36,206,"[np.float32(0.0), np.float32(1.0), np.float32(0.0), np.float32(0.0), np.float32(0.0), np.float32(1.0), np.float32(1.0), np.float32(0.0), np.float32(1.0), np.float32(0.0), np.float32(0.0), np.float32(1.0), np.float32(1.0), np.float32(1.0), np.float32(1.0), np.float32(1.0)]",-2.0,99984.0,20
2025-08-14_08-18-36,207,"[np.float32(0.0), np.float32(0.0), np.float32(1.0), np.float32(1.0), np.float32(1.0), np.float32(0.0), np.float32(1.0), np.float32(0.0), np.float32(1.0), np.float32(0.0), np.float32(0.0), np.float32(1.0), np.float32(1.0), np.float32(1.0), np.float32(1.0), np.float32(0.0)]",4.0,99988.0,3
2025-08-14_08-18-36,208,"[np.float32(0.0), np.float32(0.0), np.float32(1.0), np.float32(0.0), np.float32(1.0), np.float32(1.0), np.float32(0.0), np.float32(0.0), np.float32(1.0), np.float32(0.0), np.float32(0.0), np.float32(1.0), np.float32(1.0), np.float32(0.0), np.float32(1.0), np.float32(0.0)]",6.0,99994.0,30
2025-08-14_08-18-36,209,"[np.float32(1.0), np.float32(1.0), np.float32(1.0), np.float32(0.0), np.float32(1.0), np.float32(1.0), np.float32(1.0), np.float32(1.0), np.float32(1.0), np.float32(0.0), np.float32(0.0), np.float32(1.0), np.float32(1.0), np.float32(0.0), np.float32(1.0), np.float32(1.0)]",3.0,99997.0,6
2025-08-14_08-18-36,210,"[np.float32(0.0), np.float32(0.0), np.float32(1.0), np.float32(1.0), np.float32(1.0), np.float32(0.0), np.float32(0.0), np.float32(1.0), np.float32(1.0), np.float32(0.0), np.float32(1.0), np.float32(0.0), np.float32(1.0), np.float32(1.0), np.float32(1.0), np.float32(0.0)]",-4.0,99993.0,34
2025-08-14_08-18-36,211,"[np.float32(1.0), np.float32(1.0), np.float32(1.0), np.float32(0.0), np.float32(0.0), np.float32(0.0), np.float32(0.0), np.float32(0.0), np.float32(0.0), np.float32(1.0), np.float32(1.0), np.float32(1.0), np.float32(0.0), np.float32(0.0), np.float32(0.0), np.float32(1.0)]",-2.0,99991.0,25
2025-08-14_08-18-36,212,"[np.float32(1.0), np.float32(1.0), np.float32(0.0), np.float32(1.0), np.float32(0.0), np.float32(1.0), np.float32(1.0), np.float32(0.0), np.float32(1.0), np.float32(1.0), np.float32(1.0), np.float32(1.0), np.float32(1.0), np.float32(0.0), np.float32(1.0), np.float32(1.0)]",-3.0,99988.0,19
2025-08-14_08-18-36,213,"[np.float32(1.0), np.float32(1.0), np.float32(1.0), np.float32(0.0), np.float32(1.0), np.float32(0.0), np.float32(0.0), np.float32(1.0), np.float32(1.0), np.float32(1.0), np.float32(0.0), np.float32(0.0), np.float32(0.0), np.float32(0.0), np.float32(0.0), np.float32(1.0)]",-1.0,99987.0,32
2025-08-14_08-18-36,214,"[np.float32(1.0), np.float32(0.0), np.float32(0.0), np.float32(1.0), np.float32(0.0), np.float32(1.0), np.float32(0.0), np.float32(1.0), np.float32(0.0), np.float32(1.0), np.float32(0.0), np.float32(0.0), np.float32(1.0), np.float32(0.0), np.float32(1.0), np.float32(0.0)]",-2.0,99985.0,28
2025-08-14_08-18-36,215,"[np.float32(0.0), np.float32(1.0), np.float32(0.0), np.float32(1.0), np.float32(0.0), np.float32(0.0), np.float32(1.0), np.float32(0.0), np.float32(0.0), np.float32(1.0), np.float32(1.0), np.float32(0.0), np.float32(1.0), np.float32(1.0), np.float32(0.0), np.float32(0.0)]",1.0,99986.0,22
2025-08-14_08-18-36,216,"[np.float32(1.0), np.float32(1.0), np.float32(0.0), np.float32(0.0), np.float32(0.0), np.float32(0.0), np.float32(0.0), np.float32(0.0), np.float32(1.0), np.float32(1.0), np.float32(1.0), np.float32(0.0), np.float32(1.0), np.float32(1.0), np.float32(1.0), np.float32(1.0)]",-4.0,99982.0,12
2025-08-14_08-18-36,217,"[np.float32(1.0), np.float32(0.0), np.float32(1.0), np.float32(1.0), np.float32(0.0), np.float32(1.0), np.float32(1.0), np.float32(1.0), np.float32(1.0), np.float32(0.0), np.float32(0.0), np.float32(0.0), np.float32(0.0), np.float32(1.0), np.float32(1.0), np.float32(0.0)]",1.0,99983.0,26
2025-08-14_08-18-36,218,"[np.float32(0.0), np.float32(1.0), np.float32(0.0), np.float32(1.0), np.float32(0.0), np.float32(1.0), np.float32(1.0), np.float32(0.0), np.float32(0.0), np.float32(0.0), np.float32(0.0), np.float32(0.0), np.float32(0.0), np.float32(0.0), np.float32(0.0), np.float32(1.0)]",3.0,99986.0,6
2025-08-14_08-18-36,219,"[np.float32(0.0), np.float32(0.0), np.float32(1.0), np.float32(0.0), np.float32(0.0), np.float32(0.0), np.float32(1.0), np.float32(1.0), np.float32(1.0), np.float32(1.0), np.float32(1.0), np.float32(1.0), np.float32(0.0), np.float32(0.0), np.float32(0.0), np.float32(1.0)]",0.0,99986.0,2
2025-08-14_08-18-36,220,"[np.float32(1.0), np.float32(1.0), np.float32(0.0), np.float32(1.0), np.float32(0.0), np.float32(0.0), np.float32(1.0), np.float32(0.0), np.float32(0.0), np.float32(1.0), np.float32(0.0), np.float32(0.0), np.float32(0.0), np.float32(1.0), np.float32(1.0), np.float32(0.0)]",3.0,99989.0,5
2025-08-14_08-18-36,221,"[np.float32(0.0), np.float32(0.0), np.float32(0.0), np.float32(1.0), np.float32(0.0), np.float32(1.0), np.float32(0.0), np.float32(1.0), np.float32(0.0), np.float32(0.0), np.float32(1.0), np.float32(1.0), np.float32(0.0), np.float32(0.0), np.float32(0.0), np.float32(0.0)]",-2.0,99987.0,2
2025-08-14_08-18-36,222,"[np.float32(1.0), np.float32(0.0), np.float32(0.0), np.float32(0.0), np.float32(0.0), np.float32(1.0), np.float32(1.0), np.float32(1.0), np.float32(0.0), np.float32(0.0), np.float32(1.0), np.float32(1.0), np.float32(0.0), np.float32(1.0), np.float32(0.0), np.float32(1.0)]",-2.0,99985.0,8
2025-08-14_08-18-36,223,"[np.float32(0.0), np.float32(1.0), np.float32(0.0), np.float32(1.0), np.float32(0.0), np.float32(0.0), np.float32(1.0), np.float32(1.0), np.float32(0.0), np.float32(0.0), np.float32(0.0), np.float32(0.0), np.float32(1.0), np.float32(1.0), np.float32(0.0), np.float32(0.0)]",-1.0,99984.0,1
2025-08-14_08-18-36,224,"[np.float32(1.0), np.float32(0.0), np.float32(0.0), np.float32(0.0), np.float32(1.0), np.float32(1.0), np.float32(0.0), np.float32(0.0), np.float32(0.0), np.float32(0.0), np.float32(0.0), np.float32(1.0), np.float32(1.0), np.float32(1.0), np.float32(1.0), np.float32(0.0)]",3.0,99987.0,12
2025-08-14_08-18-36,225,"[np.float32(1.0), np.float32(1.0), np.float32(0.0), np.float32(0.0), np.float32(1.0), np.float32(1.0), np.float32(1.0), np.float32(0.0), np.float32(0.0), np.float32(1.0), np.float32(1.0), np.float32(1.0), np.float32(1.0), np.float32(0.0), np.float32(0.0), np.float32(0.0)]",-2.0,99985.0,32
2025-08-14_08-18-36,226,"[np.float32(0.0), np.float32(0.0), np.float32(1.0), np.float32(0.0), np.float32(0.0), np.float32(1.0), np.float32(1.0), np.float32(1.0), np.float32(1.0), np.float32(1.0), np.float32(1.0), np.float32(1.0), np.float32(0.0), np.float32(1.0), np.float32(0.0), np.float32(0.0)]",-3.0,99982.0,11
2025-08-14_08-18-36,227,"[np.float32(1.0), np.float32(0.0), np.float32(1.0), np.float32(1.0), np.float32(0.0), np.float32(0.0), np.float32(0.0), np.float32(0.0), np.float32(0.0), np.float32(0.0), np.float32(1.0), np.float32(0.0), np.float32(1.0), np.float32(1.0), np.float32(0.0), np.float32(1.0)]",0.0,99982.0,34
2025-08-14_08-18-36,228,"[np.float32(1.0), np.float32(1.0), np.float32(0.0), np.float32(0.0), np.float32(0.0), np.float32(0.0), np.float32(0.0), np.float32(1.0), np.float32(1.0), np.float32(0.0), np.float32(0.0), np.float32(1.0), np.float32(0.0), np.float32(1.0), np.float32(1.0), np.float32(1.0)]",0.0,99982.0,9
2025-08-14_08-18-36,229,"[np.float32(1.0), np.float32(1.0), np.float32(1.0), np.float32(1.0), np.float32(0.0), np.float32(0.0), np.float32(0.0), np.float32(0.0), np.float32(1.0), np.float32(1.0), np.float32(0.0), np.float32(1.0), np.float32(0.0), np.float32(1.0), np.float32(0.0), np.float32(0.0)]",2.0,99984.0,3
2025-08-14_08-18-36,230,"[np.float32(0.0), np.float32(0.0), np.float32(1.0), np.float32(1.0), np.float32(1.0), np.float32(1.0), np.float32(1.0), np.float32(1.0), np.float32(1.0), np.float32(0.0), np.float32(1.0), np.float32(0.0), np.float32(0.0), np.float32(1.0), np.float32(1.0), np.float32(0.0)]",0.0,99984.0,30
2025-08-14_08-18-36,231,"[np.float32(0.0), np.float32(1.0), np.float32(1.0), np.float32(1.0), np.float32(0.0), np.float32(0.0), np.float32(1.0), np.float32(1.0), np.float32(1.0), np.float32(1.0), np.float32(1.0), np.float32(0.0), np.float32(1.0), np.float32(0.0), np.float32(0.0), np.float32(0.0)]",1.0,99985.0,2
2025-08-14_08-18-36,232,"[np.float32(1.0), np.float32(1.0), np.float32(1.0), np.float32(0.0), np.float32(0.0), np.float32(1.0), np.float32(1.0), np.float32(0.0), np.float32(0.0), np.float32(1.0), np.float32(0.0), np.float32(1.0), np.float32(1.0), np.float32(1.0), np.float32(1.0), np.float32(0.0)]",-2.0,99983.0,15
2025-08-14_08-18-36,233,"[np.float32(0.0), np.float32(0.0), np.float32(0.0), np.float32(0.0), np.float32(1.0), np.float32(1.0), np.float32(0.0), np.float32(1.0), np.float32(0.0), np.float32(1.0), np.float32(0.0), np.float32(0.0), np.float32(1.0), np.float32(0.0), np.float32(0.0), np.float32(0.0)]",-3.0,99980.0,6
2025-08-14_08-18-36,234,"[np.float32(1.0), np.float32(0.0), np.float32(1.0), np.float32(0.0), np.float32(0.0), np.float32(0.0), np.float32(0.0), np.float32(1.0), np.float32(0.0), np.float32(0.0), np.float32(1.0), np.float32(0.0), np.float32(1.0), np.float32(1.0), np.float32(1.0), np.float32(0.0)]",-1.0,99979.0,13
2025-08-14_08-18-36,235,"[np.float32(1.0), np.float32(0.0), np.float32(1.0), np.float32(1.0), np.float32(0.0), np.float32(1.0), np.float32(0.0), np.float32(1.0), np.float32(0.0), np.float32(1.0), np.float32(1.0), np.float32(1.0), np.float32(0.0), np.float32(1.0), np.float32(0.0), np.float32(1.0)]",-3.0,99976.0,5
2025-08-14_08-18-36,236,"[np.float32(0.0), np.float32(0.0), np.float32(1.0), np.float32(1.0), np.float32(0.0), np.float32(1.0), np.float32(1.0), np.float32(0.0), np.float32(0.0), np.float32(1.0), np.float32(1.0), np.float32(0.0), np.float32(1.0), np.float32(0.0), np.float32(0.0), np.float32(1.0)]",0.0,99976.0,2
2025-08-14_08-18-36,237,"[np.float32(1.0), np.float32(0.0), np.float32(0.0), np.float32(0.0), np.float32(1.0), np.float32(0.0), np.float32(1.0), np.float32(1.0), np.float32(0.0), np.float32(1.0), np.float32(1.0), np.float32(1.0), np.float32(1.0), np.float32(1.0), np.float32(1.0), np.float32(0.0)]",-4.0,99972.0,20
2025-08-14_08-18-36,238,"[np.float32(0.0), np.float32(1.0), np.float32(0.0), np.float32(0.0), np.float32(1.0), np.float32(1.0), np.float32(0.0), np.float32(1.0), np.float32(0.0), np.float32(0.0), np.float32(0.0), np.float32(1.0), np.float32(1.0), np.float32(1.0), np.float32(0.0), np.float32(0.0)]",3.0,99975.0,22
2025-08-14_08-18-36,239,"[np.float32(1.0), np.float32(0.0), np.float32(0.0), np.float32(1.0), np.float32(0.0), np.float32(0.0), np.float32(1.0), np.float32(0.0), np.float32(0.0), np.float32(1.0), np.float32(0.0), np.float32(1.0), np.float32(1.0), np.float32(0.0), np.float32(1.0), np.float32(0.0)]",-2.0,99973.0,31
2025-08-14_08-18-36,240,"[np.float32(1.0), np.float32(1.0), np.float32(0.0), np.float32(1.0), np.float32(1.0), np.float32(1.0), np.float32(0.0), np.float32(0.0), np.float32(0.0), np.float32(1.0), np.float32(1.0), np.float32(0.0), np.float32(0.0), np.float32(0.0), np.float32(1.0), np.float32(0.0)]",2.0,99975.0,8
2025-08-14_08-18-36,241,"[np.float32(1.0), np.float32(0.0), np.float32(0.0), np.float32(0.0), np.float32(0.0), np.float32(1.0), np.float32(1.0), np.float32(1.0), np.float32(1.0), np.float32(0.0), np.float32(1.0), np.float32(0.0), np.float32(1.0), np.float32(0.0), np.float32(0.0), np.float32(0.0)]",0.0,99975.0,34
2025-08-14_08-18-36,242,"[np.float32(0.0), np.float32(1.0), np.float32(0.0), np.float32(1.0), np.float32(0.0), np.float32(0.0), np.float32(1.0), np.float32(1.0), np.float32(1.0), np.float32(1.0), np.float32(1.0), np.float32(1.0), np.float32(0.0), np.float32(1.0), np.float32(1.0), np.float32(0.0)]",1.0,99976.0,22
2025-08-14_08-18-36,243,"[np.float32(1.0), np.float32(0.0), np.float32(0.0), np.float32(0.0), np.float32(0.0), np.float32(1.0), np.float32(1.0), np.float32(0.0), np.float32(1.0), np.float32(0.0), np.float32(1.0), np.float32(1.0), np.float32(1.0), np.float32(1.0), np.float32(1.0), np.float32(1.0)]",34.0,100010.0,7
2025-08-14_08-18-36,244,"[np.float32(1.0), np.float32(1.0), np.float32(0.0), np.float32(0.0), np.float32(1.0), np.float32(0.0), np.float32(0.0), np.float32(0.0), np.float32(1.0), np.float32(1.0), np.float32(0.0), np.float32(1.0), np.float32(0.0), np.float32(0.0), np.float32(1.0), np.float32(0.0)]",-2.0,100008.0,35
2025-08-14_08-18-36,245,"[np.float32(1.0), np.float32(1.0), np.float32(1.0), np.float32(1.0), np.float32(0.0), np.float32(1.0), np.float32(0.0), np.float32(1.0), np.float32(1.0), np.float32(0.0), np.float32(1.0), np.float32(1.0), np.float32(0.0), np.float32(0.0), np.float32(1.0), np.float32(0.0)]",5.0,100013.0,30
2025-08-14_08-18-36,246,"[np.float32(1.0), np.float32(0.0), np.float32(1.0), np.float32(1.0), np.float32(0.0), np.float32(0.0), np.float32(0.0), np.float32(1.0), np.float32(0.0), np.float32(0.0), np.float32(1.0), np.float32(0.0), np.float32(0.0), np.float32(0.0), np.float32(1.0), np.float32(0.0)]",-1.0,100012.0,22
2025-08-14_08-18-36,247,"[np.float32(0.0), np.float32(0.0), np.float32(1.0), np.float32(1.0), np.float32(0.0), np.float32(1.0), np.float32(0.0), np.float32(1.0), np.float32(0.0), np.float32(0.0), np.float32(0.0), np.float32(1.0), np.float32(0.0), np.float32(1.0), np.float32(1.0), np.float32(0.0)]",0.0,100012.0,25
2025-08-14_08-18-36,248,"[np.float32(1.0), np.float32(1.0), np.float32(0.0), np.float32(1.0), np.float32(0.0), np.float32(0.0), np.float32(0.0), np.float32(1.0), np.float32(1.0), np.float32(1.0), np.float32(1.0), np.float32(1.0), np.float32(1.0), np.float32(1.0), np.float32(0.0), np.float32(0.0)]",3.0,100015.0,21
2025-08-14_08-18-36,249,"[np.float32(0.0), np.float32(1.0), np.float32(1.0), np.float32(0.0), np.float32(1.0), np.float32(0.0), np.float32(0.0), np.float32(1.0), np.float32(0.0), np.float32(1.0), np.float32(1.0), np.float32(0.0), np.float32(0.0), np.float32(1.0), np.float32(1.0), np.float32(1.0)]",1.0,100016.0,28
2025-08-14_08-18-36,250,"[np.float32(0.0), np.float32(0.0), np.float32(0.0), np.float32(1.0), np.float32(0.0), np.float32(1.0), np.float32(0.0), np.float32(1.0), np.float32(0.0), np.float32(0.0), np.float32(0.0), np.float32(1.0), np.float32(1.0), np.float32(1.0), np.float32(1.0), np.float32(1.0)]",-3.0,100013.0,1
2025-08-14_08-18-36,251,"[np.float32(0.0), np.float32(1.0), np.float32(1.0), np.float32(0.0), np.float32(1.0), np.float32(1.0), np.float32(1.0), np.float32(1.0), np.float32(0.0), np.float32(0.0), np.float32(0.0), np.float32(0.0), np.float32(1.0), np.float32(1.0), np.float32(1.0), np.float32(1.0)]",-3.0,100010.0,34
2025-08-14_08-18-36,252,"[np.float32(0.0), np.float32(0.0), np.float32(1.0), np.float32(1.0), np.float32(0.0), np.float32(0.0), np.float32(0.0), np.float32(1.0), np.float32(1.0), np.float32(0.0), np.float32(1.0), np.float32(0.0), np.float32(1.0), np.float32(1.0), np.float32(1.0), np.float32(0.0)]",0.0,100010.0,17
2025-08-14_08-18-36,253,"[np.float32(1.0), np.float32(0.0), np.float32(0.0), np.float32(1.0), np.float32(1.0), np.float32(1.0), np.float32(0.0), np.float32(1.0), np.float32(1.0), np.float32(1.0), np.float32(0.0), np.float32(1.0), np.float32(0.0), np.float32(0.0), np.float32(1.0), np.float32(1.0)]",-2.0,100008.0,10
2025-08-14_08-18-36,254,"[np.float32(1.0), np.float32(0.0), np.float32(0.0), np.float32(1.0), np.float32(0.0), np.float32(0.0), np.float32(0.0), np.float32(0.0), np.float32(1.0), np.float32(1.0), np.float32(1.0), np.float32(0.0), np.float32(0.0), np.float32(1.0), np.float32(1.0), np.float32(0.0)]",3.0,100011.0,5
2025-08-14_08-18-36,255,"[np.float32(0.0), np.float32(1.0), np.float32(1.0), np.float32(0.0), np.float32(0.0), np.float32(1.0), np.float32(0.0), np.float32(1.0), np.float32(1.0), np.float32(1.0), np.float32(0.0), np.float32(1.0), np.float32(1.0), np.float32(1.0), np.float32(1.0), np.float32(0.0)]",5.0,100016.0,28
2025-08-14_08-18-36,256,"[np.float32(1.0), np.float32(0.0), np.float32(0.0), np.float32(1.0), np.float32(0.0), np.float32(0.0), np.float32(1.0), np.float32(1.0), np.float32(0.0), np.float32(1.0), np.float32(1.0), np.float32(1.0), np.float32(1.0), np.float32(1.0), np.float32(0.0), np.float32(0.0)]",-4.0,100012.0,31
2025-08-14_08-18-36,257,"[np.float32(1.0), np.float32(0.0), np.float32(0.0), np.float32(1.0), np.float32(1.0), np.float32(1.0), np.float32(1.0), np.float32(0.0), np.float32(0.0), np.float32(1.0), np.float32(0.0), np.float32(0.0), np.float32(1.0), np.float32(0.0), np.float32(0.0), np.float32(0.0)]",-3.0,100009.0,36
2025-08-14_08-18-36,258,"[np.float32(0.0), np.float32(0.0), np.float32(1.0), np.float32(0.0), np.float32(0.0), np.float32(0.0), np.float32(0.0), np.float32(1.0), np.float32(1.0), np.float32(0.0), np.float32(0.0), np.float32(0.0), np.float32(0.0), np.float32(0.0), np.float32(1.0), np.float32(0.0)]",-1.0,100008.0,5
2025-08-14_08-18-36,259,"[np.float32(1.0), np.float32(0.0), np.float32(1.0), np.float32(0.0), np.float32(1.0), np.float32(1.0), np.float32(1.0), np.float32(1.0), np.float32(0.0), np.float32(0.0), np.float32(0.0), np.float32(1.0), np.float32(1.0), np.float32(1.0), np.float32(0.0), np.float32(1.0)]",-3.0,100005.0,10
2025-08-14_08-18-36,260,"[np.float32(0.0), np.float32(1.0), np.float32(1.0), np.float32(0.0), np.float32(0.0), np.float32(1.0), np.float32(0.0), np.float32(0.0), np.float32(1.0), np.float32(1.0), np.float32(0.0), np.float32(1.0), np.float32(1.0), np.float32(1.0), np.float32(0.0), np.float32(0.0)]",0.0,100005.0,15
2025-08-14_08-18-36,261,"[np.float32(0.0), np.float32(1.0), np.float32(1.0), np.float32(1.0), np.float32(0.0), np.float32(0.0), np.float32(0.0), np.float32(0.0), np.float32(0.0), np.float32(0.0), np.float32(1.0), np.float32(1.0), np.float32(1.0), np.float32(1.0), np.float32(1.0), np.float32(1.0)]",1.0,100006.0,6
2025-08-14_08-18-36,262,"[np.float32(0.0), np.float32(1.0), np.float32(0.0), np.float32(0.0), np.float32(0.0), np.float32(0.0), np.float32(1.0), np.float32(0.0), np.float32(0.0), np.float32(0.0), np.float32(1.0), np.float32(0.0), np.float32(0.0), np.float32(0.0), np.float32(1.0), np.float32(0.0)]",2.0,100008.0,23
2025-08-14_08-18-36,263,"[np.float32(0.0), np.float32(0.0), np.float32(1.0), np.float32(0.0), np.float32(1.0), np.float32(1.0), np.float32(1.0), np.float32(1.0), np.float32(0.0), np.float32(0.0), np.float32(1.0), np.float32(0.0), np.float32(1.0), np.float32(0.0), np.float32(1.0), np.float32(1.0)]",1.0,100009.0,16
2025-08-14_08-18-36,264,"[np.float32(1.0), np.float32(0.0), np.float32(0.0), np.float32(1.0), np.float32(1.0), np.float32(0.0), np.float32(1.0), np.float32(0.0), np.float32(1.0), np.float32(0.0), np.float32(0.0), np.float32(1.0), np.float32(1.0), np.float32(1.0), np.float32(1.0), np.float32(0.0)]",-1.0,100008.0,4
2025-08-14_08-18-36,265,"[np.float32(1.0), np.float32(0.0), np.float32(1.0), np.float32(0.0), np.float32(0.0), np.float32(1.0), np.float32(1.0), np.float32(0.0), np.float32(1.0), np.float32(1.0), np.float32(1.0), np.float32(0.0), np.float32(0.0), np.float32(0.0), np.float32(1.0), np.float32(0.0)]",4.0,100012.0,30
2025-08-14_08-18-36,266,"[np.float32(1.0), np.float32(1.0), np.float32(0.0), np.float32(1.0), np.float32(0.0), np.float32(0.0), np.float32(0.0), np.float32(1.0), np.float32(1.0), np.float32(0.0), np.float32(1.0), np.float32(0.0), np.float32(0.0), np.float32(1.0), np.float32(0.0), np.float32(1.0)]",-1.0,100011.0,3
2025-08-14_08-18-36,267,"[np.float32(0.0), np.float32(1.0), np.float32(1.0), np.float32(0.0), np.float32(1.0), np.float32(0.0), np.float32(1.0), np.float32(0.0), np.float32(0.0), np.float32(0.0), np.float32(0.0), np.float32(1.0), np.float32(0.0), np.float32(0.0), np.float32(1.0), np.float32(1.0)]",3.0,100014.0,24
2025-08-14_08-18-36,268,"[np.float32(1.0), np.float32(1.0), np.float32(1.0), np.float32(0.0), np.float32(0.0), np.float32(0.0), np.float32(1.0), np.float32(0.0), np.float32(0.0), np.float32(1.0), np.float32(0.0), np.float32(0.0), np.float32(1.0), np.float32(1.0), np.float32(0.0), np.float32(1.0)]",-1.0,100013.0,18
2025-08-14_08-18-36,269,"[np.float32(1.0), np.float32(0.0), np.float32(1.0), np.float32(0.0), np.float32(0.0), np.float32(0.0), np.float32(1.0), np.float32(1.0), np.float32(0.0), np.float32(0.0), np.float32(1.0), np.float32(1.0), np.float32(1.0), np.float32(0.0), np.float32(0.0), np.float32(1.0)]",-6.0,100007.0,0
2025-08-14_08-18-36,270,"[np.float32(0.0), np.float32(0.0), np.float32(0.0), np.float32(1.0), np.float32(0.0), np.float32(1.0), np.float32(1.0), np.float32(1.0), np.float32(0.0), np.float32(0.0), np.float32(0.0), np.float32(0.0), np.float32(0.0), np.float32(1.0), np.float32(0.0), np.float32(1.0)]",-1.0,100006.0,26
2025-08-14_08-18-36,271,"[np.float32(1.0), np.float32(0.0), np.float32(0.0), np.float32(1.0), np.float32(1.0), np.float32(1.0), np.float32(1.0), np.float32(1.0), np.float32(1.0), np.float32(0.0), np.float32(0.0), np.float32(1.0), np.float32(1.0), np.float32(0.0), np.float32(1.0), np.float32(1.0)]",-4.0,100002.0,32
2025-08-14_08-18-36,272,"[np.float32(1.0), np.float32(0.0), np.float32(0.0), np.float32(0.0), np.float32(1.0), np.float32(0.0), np.float32(0.0), np.float32(0.0), np.float32(0.0), np.float32(0.0), np.float32(0.0), np.float32(1.0), np.float32(1.0), np.float32(1.0), np.float32(0.0), np.float32(0.0)]",-2.0,100000.0,26
2025-08-14_08-18-36,273,"[np.float32(0.0), np.float32(1.0), np.float32(0.0), np.float32(1.0), np.float32(0.0), np.float32(1.0), np.float32(0.0), np.float32(1.0), np.float32(1.0), np.float32(0.0), np.float32(1.0), np.float32(1.0), np.float32(0.0), np.float32(1.0), np.float32(1.0), np.float32(0.0)]",4.0,100004.0,21
2025-08-14_08-18-36,274,"[np.float32(0.0), np.float32(1.0), np.float32(0.0), np.float32(1.0), np.float32(0.0), np.float32(0.0), np.float32(0.0), np.float32(1.0), np.float32(0.0), np.float32(0.0), np.float32(1.0), np.float32(0.0), np.float32(1.0), np.float32(1.0), np.float32(1.0), np.float32(0.0)]",4.0,100008.0,23
2025-08-14_08-18-36,275,"[np.float32(0.0), np.float32(1.0), np.float32(1.0), np.float32(1.0), np.float32(0.0), np.float32(0.0), np.float32(0.0), np.float32(1.0), np.float32(1.0), np.float32(0.0), np.float32(1.0), np.float32(1.0), np.float32(0.0), np.float32(0.0), np.float32(1.0), np.float32(1.0)]",-1.0,100007.0,9
2025-08-14_08-18-36,276,"[np.float32(0.0), np.float32(0.0), np.float32(0.0), np.float32(0.0), np.float32(1.0), np.float32(1.0), np.float32(1.0), np.float32(1.0), np.float32(1.0), np.float32(1.0), np.float32(1.0), np.float32(1.0), np.float32(1.0), np.float32(1.0), np.float32(0.0), np.float32(0.0)]",-2.0,100005.0,5
2025-08-14_08-18-36,277,"[np.float32(0.0), np.float32(0.0), np.float32(1.0), np.float32(1.0), np.float32(0.0), np.float32(0.0), np.float32(1.0), np.float32(1.0), np.float32(0.0), np.float32(1.0), np.float32(1.0), np.float32(1.0), np.float32(1.0), np.float32(0.0), np.float32(1.0), np.float32(0.0)]",-1.0,100004.0,19
2025-08-14_08-18-36,278,"[np.float32(0.0), np.float32(1.0), np.float32(0.0), np.float32(1.0), np.float32(1.0), np.float32(1.0), np.float32(1.0), np.float32(1.0), np.float32(1.0), np.float32(0.0), np.float32(0.0), np.float32(1.0), np.float32(0.0), np.float32(0.0), np.float32(1.0), np.float32(0.0)]",3.0,100007.0,11
2025-08-14_08-18-36,279,"[np.float32(1.0), np.float32(1.0), np.float32(1.0), np.float32(1.0), np.float32(0.0), np.float32(0.0), np.float32(1.0), np.float32(1.0), np.float32(0.0), np.float32(1.0), np.float32(1.0), np.float32(0.0), np.float32(1.0), np.float32(0.0), np.float32(0.0), np.float32(1.0)]",0.0,100007.0,8
2025-08-14_08-18-36,280,"[np.float32(1.0), np.float32(1.0), np.float32(1.0), np.float32(0.0), np.float32(0.0), np.float32(1.0), np.float32(1.0), np.float32(0.0), np.float32(0.0), np.float32(1.0), np.float32(0.0), np.float32(0.0), np.float32(0.0), np.float32(1.0), np.float32(1.0), np.float32(1.0)]",-1.0,100006.0,13
2025-08-14_08-18-36,281,"[np.float32(0.0), np.float32(0.0), np.float32(0.0), np.float32(0.0), np.float32(0.0), np.float32(1.0), np.float32(1.0), np.float32(1.0), np.float32(1.0), np.float32(0.0), np.float32(1.0), np.float32(0.0), np.float32(0.0), np.float32(0.0), np.float32(0.0), np.float32(1.0)]",2.0,100008.0,35
2025-08-14_08-18-36,282,"[np.float32(1.0), np.float32(1.0), np.float32(0.0), np.float32(0.0), np.float32(0.0), np.float32(1.0), np.float32(1.0), np.float32(0.0), np.float32(0.0), np.float32(0.0), np.float32(0.0), np.float32(0.0), np.float32(0.0), np.float32(0.0), np.float32(0.0), np.float32(0.0)]",0.0,100008.0,32
2025-08-14_08-18-36,283,"[np.float32(1.0), np.float32(0.0), np.float32(1.0), np.float32(1.0), np.float32(1.0), np.float32(0.0), np.float32(1.0), np.float32(0.0), np.float32(1.0), np.float32(0.0), np.float32(1.0), np.float32(0.0), np.float32(1.0), np.float32(0.0), np.float32(0.0), np.float32(0.0)]",-1.0,100007.0,17
2025-08-14_08-18-36,284,"[np.float32(0.0), np.float32(0.0), np.float32(1.0), np.float32(1.0), np.float32(0.0), np.float32(1.0), np.float32(1.0), np.float32(0.0), np.float32(1.0), np.float32(1.0), np.float32(0.0), np.float32(0.0), np.float32(1.0), np.float32(0.0), np.float32(1.0), np.float32(0.0)]",-1.0,100006.0,26
2025-08-14_08-18-36,285,"[np.float32(0.0), np.float32(1.0), np.float32(0.0), np.float32(1.0), np.float32(0.0), np.float32(1.0), np.float32(1.0), np.float32(0.0), np.float32(1.0), np.float32(0.0), np.float32(0.0), np.float32(0.0), np.float32(1.0), np.float32(1.0), np.float32(0.0), np.float32(0.0)]",0.0,100006.0,21
2025-08-14_08-18-36,286,"[np.float32(1.0), np.float32(0.0), np.float32(1.0), np.float32(1.0), np.float32(0.0), np.float32(1.0), np.float32(0.0), np.float32(0.0), np.float32(1.0), np.float32(0.0), np.float32(0.0), np.float32(0.0), np.float32(0.0), np.float32(1.0), np.float32(1.0), np.float32(1.0)]",1.0,100007.0,23
2025-08-14_08-18-36,287,"[np.float32(0.0), np.float32(0.0), np.float32(0.0), np.float32(1.0), np.float32(1.0), np.float32(0.0), np.float32(1.0), np.float32(1.0), np.float32(1.0), np.float32(1.0), np.float32(0.0), np.float32(1.0), np.float32(0.0), np.float32(1.0), np.float32(0.0), np.float32(0.0)]",-1.0,100006.0,5
2025-08-14_08-18-36,288,"[np.float32(1.0), np.float32(1.0), np.float32(0.0), np.float32(0.0), np.float32(1.0), np.float32(1.0), np.float32(0.0), np.float32(0.0), np.float32(1.0), np.float32(1.0), np.float32(0.0), np.float32(1.0), np.float32(0.0), np.float32(1.0), np.float32(0.0), np.float32(1.0)]",-2.0,100004.0,16
2025-08-14_08-18-36,289,"[np.float32(0.0), np.float32(1.0), np.float32(1.0), np.float32(0.0), np.float32(0.0), np.float32(0.0), np.float32(0.0), np.float32(1.0), np.float32(1.0), np.float32(0.0), np.float32(1.0), np.float32(0.0), np.float32(1.0), np.float32(0.0), np.float32(1.0), np.float32(0.0)]",1.0,100005.0,29
2025-08-14_08-18-36,290,"[np.float32(0.0), np.float32(0.0), np.float32(1.0), np.float32(1.0), np.float32(0.0), np.float32(1.0), np.float32(0.0), np.float32(0.0), np.float32(1.0), np.float32(1.0), np.float32(1.0), np.float32(1.0), np.float32(0.0), np.float32(0.0), np.float32(1.0), np.float32(0.0)]",2.0,100007.0,28
2025-08-14_08-18-36,291,"[np.float32(0.0), np.float32(0.0), np.float32(0.0), np.float32(1.0), np.float32(1.0), np.float32(1.0), np.float32(0.0), np.float32(1.0), np.float32(1.0), np.float32(1.0), np.float32(1.0), np.float32(1.0), np.float32(1.0), np.float32(1.0), np.float32(0.0), np.float32(1.0)]",35.0,100042.0,7
2025-08-14_08-18-36,292,"[np.float32(0.0), np.float32(0.0), np.float32(1.0), np.float32(1.0), np.float32(1.0), np.float32(1.0), np.float32(1.0), np.float32(0.0), np.float32(0.0), np.float32(1.0), np.float32(1.0), np.float32(0.0), np.float32(0.0), np.float32(1.0), np.float32(1.0), np.float32(1.0)]",3.0,100045.0,10
2025-08-14_08-18-36,293,"[np.float32(1.0), np.float32(1.0), np.float32(1.0), np.float32(1.0), np.float32(0.0), np.float32(0.0), np.float32(1.0), np.float32(0.0), np.float32(1.0), np.float32(1.0), np.float32(0.0), np.float32(1.0), np.float32(0.0), np.float32(1.0), np.float32(1.0), np.float32(0.0)]",3.0,100048.0,4
2025-08-14_08-18-36,294,"[np.float32(1.0), np.float32(0.0), np.float32(0.0), np.float32(0.0), np.float32(1.0), np.float32(0.0), np.float32(0.0), np.float32(0.0), np.float32(1.0), np.float32(1.0), np.float32(0.0), np.float32(0.0), np.float32(1.0), np.float32(1.0), np.float32(0.0), np.float32(0.0)]",1.0,100049.0,3
2025-08-14_08-18-36,295,"[np.float32(0.0), np.float32(0.0), np.float32(1.0), np.float32(0.0), np.float32(1.0), np.float32(1.0), np.float32(1.0), np.float32(1.0), np.float32(1.0), np.float32(0.0), np.float32(1.0), np.float32(0.0), np.float32(0.0), np.float32(0.0), np.float32(0.0), np.float32(0.0)]",-2.0,100047.0,21
2025-08-14_08-18-36,296,"[np.float32(1.0), np.float32(1.0), np.float32(1.0), np.float32(0.0), np.float32(0.0), np.float32(0.0), np.float32(0.0), np.float32(1.0), np.float32(1.0), np.float32(0.0), np.float32(0.0), np.float32(0.0), np.float32(0.0), np.float32(1.0), np.float32(0.0), np.float32(1.0)]",3.0,100050.0,26
2025-08-14_08-18-36,297,"[np.float32(0.0), np.float32(0.0), np.float32(1.0), np.float32(0.0), np.float32(0.0), np.float32(0.0), np.float32(0.0), np.float32(1.0), np.float32(1.0), np.float32(0.0), np.float32(0.0), np.float32(0.0), np.float32(1.0), np.float32(0.0), np.float32(0.0), np.float32(1.0)]",-3.0,100047.0,4
2025-08-14_08-18-36,298,"[np.float32(0.0), np.float32(0.0), np.float32(0.0), np.float32(0.0), np.float32(1.0), np.float32(1.0), np.float32(0.0), np.float32(1.0), np.float32(0.0), np.float32(1.0), np.float32(0.0), np.float32(0.0), np.float32(0.0), np.float32(1.0), np.float32(0.0), np.float32(1.0)]",2.0,100049.0,18
2025-08-14_08-18-36,299,"[np.float32(0.0), np.float32(0.0), np.float32(1.0), np.float32(0.0), np.float32(1.0), np.float32(1.0), np.float32(1.0), np.float32(0.0), np.float32(1.0), np.float32(1.0), np.float32(0.0), np.float32(1.0), np.float32(1.0), np.float32(0.0), np.float32(1.0), np.float32(1.0)]",-5.0,100044.0,23
2025-08-14_08-18-36,300,"[np.float32(1.0), np.float32(1.0), np.float32(0.0), np.float32(0.0), np.float32(0.0), np.float32(1.0), np.float32(0.0), np.float32(0.0), np.float32(0.0), np.float32(0.0), np.float32(0.0), np.float32(1.0), np.float32(1.0), np.float32(1.0), np.float32(1.0), np.float32(0.0)]",-2.0,100042.0,16
2025-08-14_08-18-36,301,"[np.float32(0.0), np.float32(0.0), np.float32(1.0), np.float32(1.0), np.float32(0.0), np.float32(1.0), np.float32(1.0), np.float32(1.0), np.float32(1.0), np.float32(0.0), np.float32(0.0), np.float32(1.0), np.float32(1.0), np.float32(0.0), np.float32(0.0), np.float32(0.0)]",0.0,100042.0,12
2025-08-14_08-18-36,302,"[np.float32(1.0), np.float32(0.0), np.float32(0.0), np.float32(0.0), np.float32(1.0), np.float32(1.0), np.float32(1.0), np.float32(1.0), np.float32(1.0), np.float32(1.0), np.float32(1.0), np.float32(0.0), np.float32(0.0), np.float32(0.0), np.float32(1.0), np.float32(0.0)]",-2.0,100040.0,21
2025-08-14_08-18-36,303,"[np.float32(1.0), np.float32(0.0), np.float32(1.0), np.float32(0.0), np.float32(1.0), np.float32(0.0), np.float32(0.0), np.float32(0.0), np.float32(1.0), np.float32(0.0), np.float32(1.0), np.float32(1.0), np.float32(1.0), np.float32(0.0), np.float32(0.0), np.float32(1.0)]",-6.0,100034.0,22
2025-08-14_08-18-36,304,"[np.float32(0.0), np.float32(0.0), np.float32(1.0), np.float32(0.0), np.float32(1.0), np.float32(1.0), np.float32(1.0), np.float32(0.0), np.float32(1.0), np.float32(0.0), np.float32(0.0), np.float32(1.0), np.float32(0.0), np.float32(0.0), np.float32(1.0), np.float32(0.0)]",0.0,100034.0,2
2025-08-14_08-18-36,305,"[np.float32(1.0), np.float32(1.0), np.float32(1.0), np.float32(1.0), np.float32(1.0), np.float32(0.0), np.float32(0.0), np.float32(0.0), np.float32(0.0), np.float32(1.0), np.float32(0.0), np.float32(0.0), np.float32(0.0), np.float32(1.0), np.float32(1.0), np.float32(1.0)]",0.0,100034.0,14
2025-08-14_08-18-36,306,"[np.float32(0.0), np.float32(0.0), np.float32(0.0), np.float32(0.0), np.float32(1.0), np.float32(0.0), np.float32(0.0), np.float32(0.0), np.float32(0.0), np.float32(0.0), np.float32(1.0), np.float32(0.0), np.float32(0.0), np.float32(1.0), np.float32(1.0), np.float32(0.0)]",-1.0,100033.0,22
2025-08-14_08-18-36,307,"[np.float32(0.0), np.float32(1.0), np.float32(0.0), np.float32(1.0), np.float32(1.0), np.float32(1.0), np.float32(1.0), np.float32(0.0), np.float32(0.0), np.float32(1.0), np.float32(1.0), np.float32(0.0), np.float32(1.0), np.float32(0.0), np.float32(0.0), np.float32(0.0)]",-4.0,100029.0,24
2025-08-14_08-18-36,308,"[np.float32(1.0), np.float32(1.0), np.float32(1.0), np.float32(1.0), np.float32(1.0), np.float32(1.0), np.float32(1.0), np.float32(1.0), np.float32(0.0), np.float32(0.0), np.float32(1.0), np.float32(0.0), np.float32(1.0), np.float32(1.0), np.float32(1.0), np.float32(1.0)]",-4.0,100025.0,36
2025-08-14_08-18-36,309,"[np.float32(0.0), np.float32(1.0), np.float32(0.0), np.float32(0.0), np.float32(1.0), np.float32(1.0), np.float32(1.0), np.float32(1.0), np.float32(0.0), np.float32(0.0), np.float32(1.0), np.float32(0.0), np.float32(1.0), np.float32(0.0), np.float32(1.0), np.float32(0.0)]",2.0,100027.0,10
2025-08-14_08-18-36,310,"[np.float32(1.0), np.float32(1.0), np.float32(0.0), np.float32(0.0), np.float32(1.0), np.float32(0.0), np.float32(0.0), np.float32(1.0), np.float32(0.0), np.float32(0.0), np.float32(0.0), np.float32(0.0), np.float32(1.0), np.float32(0.0), np.float32(0.0), np.float32(0.0)]",0.0,100027.0,20
2025-08-14_08-18-36,311,"[np.float32(1.0), np.float32(0.0), np.float32(1.0), np.float32(1.0), np.float32(0.0), np.float32(0.0), np.float32(0.0), np.float32(1.0), np.float32(0.0), np.float32(1.0), np.float32(0.0), np.float32(0.0), np.float32(1.0), np.float32(1.0), np.float32(0.0), np.float32(0.0)]",-2.0,100025.0,26
2025-08-14_08-18-36,312,"[np.float32(1.0), np.float32(0.0), np.float32(0.0), np.float32(0.0), np.float32(0.0), np.float32(0.0), np.float32(1.0), np.float32(1.0), np.float32(0.0), np.float32(0.0), np.float32(0.0), np.float32(1.0), np.float32(1.0), np.float32(1.0), np.float32(1.0), np.float32(1.0)]",-5.0,100020.0,26
2025-08-14_08-18-36,313,"[np.float32(0.0), np.float32(0.0), np.float32(0.0), np.float32(1.0), np.float32(1.0), np.float32(1.0), np.float32(0.0), np.float32(0.0), np.float32(0.0), np.float32(0.0), np.float32(0.0), np.float32(1.0), np.float32(0.0), np.float32(0.0), np.float32(0.0), np.float32(0.0)]",1.0,100021.0,30
2025-08-14_08-18-36,314,"[np.float32(0.0), np.float32(1.0), np.float32(1.0), np.float32(0.0), np.float32(1.0), np.float32(1.0), np.float32(0.0), np.float32(0.0), np.float32(1.0), np.float32(1.0), np.float32(0.0), np.float32(0.0), np.float32(1.0), np.float32(0.0), np.float32(0.0), np.float32(1.0)]",5.0,100026.0,31
2025-08-14_08-18-36,315,"[np.float32(1.0), np.float32(0.0), np.float32(1.0), np.float32(1.0), np.float32(1.0), np.float32(1.0), np.float32(0.0), np.float32(1.0), np.float32(0.0), np.float32(0.0), np.float32(1.0), np.float32(1.0), np.float32(1.0), np.float32(0.0), np.float32(0.0), np.float32(0.0)]",1.0,100027.0,15
2025-08-14_08-18-36,316,"[np.float32(1.0), np.float32(1.0), np.float32(0.0), np.float32(1.0), np.float32(1.0), np.float32(1.0), np.float32(0.0), np.float32(0.0), np.float32(1.0), np.float32(0.0), np.float32(0.0), np.float32(0.0), np.float32(0.0), np.float32(1.0), np.float32(0.0), np.float32(0.0)]",2.0,100029.0,3
2025-08-14_08-18-36,317,"[np.float32(1.0), np.float32(0.0), np.float32(1.0), np.float32(1.0), np.float32(0.0), np.float32(0.0), np.float32(0.0), np.float32(0.0), np.float32(0.0), np.float32(1.0), np.float32(0.0), np.float32(1.0), np.float32(1.0), np.float32(1.0), np.float32(1.0), np.float32(1.0)]",-1.0,100028.0,33
2025-08-14_08-18-36,318,"[np.float32(0.0), np.float32(1.0), np.float32(1.0), np.float32(0.0), np.float32(0.0), np.float32(0.0), np.float32(0.0), np.float32(0.0), np.float32(0.0), np.float32(1.0), np.float32(0.0), np.float32(1.0), np.float32(0.0), np.float32(0.0), np.float32(0.0), np.float32(1.0)]",-1.0,100027.0,2
2025-08-14_08-18-36,319,"[np.float32(1.0), np.float32(0.0), np.float32(0.0), np.float32(0.0), np.float32(0.0), np.float32(1.0), np.float32(0.0), np.float32(0.0), np.float32(0.0), np.float32(0.0), np.float32(0.0), np.float32(1.0), np.float32(1.0), np.float32(1.0), np.float32(0.0), np.float32(1.0)]",-4.0,100023.0,5
2025-08-14_08-18-36,320,"[np.float32(1.0), np.float32(1.0), np.float32(1.0), np.float32(1.0), np.float32(0.0), np.float32(0.0), np.float32(1.0), np.float32(1.0), np.float32(1.0), np.float32(0.0), np.float32(0.0), np.float32(0.0), np.float32(1.0), np.float32(1.0), np.float32(0.0), np.float32(1.0)]",0.0,100023.0,25
2025-08-14_08-18-36,321,"[np.float32(0.0), np.float32(0.0), np.float32(0.0), np.float32(0.0), np.float32(1.0), np.float32(1.0), np.float32(1.0), np.float32(0.0), np.float32(1.0), np.float32(1.0), np.float32(1.0), np.float32(1.0), np.float32(1.0), np.float32(1.0), np.float32(0.0), np.float32(0.0)]",-4.0,100019.0,14
2025-08-14_08-18-36,322,"[np.float32(0.0), np.float32(0.0), np.float32(0.0), np.float32(0.0), np.float32(1.0), np.float32(1.0), np.float32(0.0), np.float32(1.0), np.float32(0.0), np.float32(0.0), np.float32(0.0), np.float32(1.0), np.float32(1.0), np.float32(1.0), np.float32(1.0), np.float32(0.0)]",-2.0,100017.0,32
2025-08-14_08-18-36,323,"[np.float32(0.0), np.float32(1.0), np.float32(1.0), np.float32(1.0), np.float32(1.0), np.float32(1.0), np.float32(0.0), np.float32(1.0), np.float32(1.0), np.float32(0.0), np.float32(1.0), np.float32(0.0), np.float32(1.0), np.float32(1.0), np.float32(0.0), np.float32(0.0)]",2.0,100019.0,20
2025-08-14_08-18-36,324,"[np.float32(0.0), np.float32(0.0), np.float32(0.0), np.float32(1.0), np.float32(0.0), np.float32(1.0), np.float32(0.0), np.float32(1.0), np.float32(1.0), np.float32(0.0), np.float32(0.0), np.float32(0.0), np.float32(0.0), np.float32(0.0), np.float32(0.0), np.float32(0.0)]",1.0,100020.0,28
2025-08-14_08-18-36,325,"[np.float32(1.0), np.float32(1.0), np.float32(0.0), np.float32(0.0), np.float32(0.0), np.float32(0.0), np.float32(0.0), np.float32(1.0), np.float32(1.0), np.float32(0.0), np.float32(1.0), np.float32(1.0), np.float32(0.0), np.float32(0.0), np.float32(1.0), np.float32(1.0)]",0.0,100020.0,32
2025-08-14_08-18-36,326,"[np.float32(1.0), np.float32(0.0), np.float32(0.0), np.float32(1.0), np.float32(1.0), np.float32(1.0), np.float32(0.0), np.float32(0.0), np.float32(0.0), np.float32(0.0), np.float32(0.0), np.float32(0.0), np.float32(0.0), np.float32(0.0), np.float32(0.0), np.float32(0.0)]",2.0,100022.0,1
2025-08-14_08-18-36,327,"[np.float32(1.0), np.float32(0.0), np.float32(0.0), np.float32(0.0), np.float32(1.0), np.float32(1.0), np.float32(0.0), np.float32(1.0), np.float32(1.0), np.float32(0.0), np.float32(0.0), np.float32(1.0), np.float32(0.0), np.float32(1.0), np.float32(1.0), np.float32(1.0)]",1.0,100023.0,34
2025-08-14_08-18-36,328,"[np.float32(0.0), np.float32(1.0), np.float32(0.0), np.float32(1.0), np.float32(1.0), np.float32(1.0), np.float32(1.0), np.float32(1.0), np.float32(1.0), np.float32(0.0), np.float32(1.0), np.float32(1.0), np.float32(0.0), np.float32(0.0), np.float32(0.0), np.float32(0.0)]",1.0,100024.0,3
2025-08-14_08-18-36,329,"[np.float32(0.0), np.float32(0.0), np.float32(1.0), np.float32(0.0), np.float32(1.0), np.float32(0.0), np.float32(1.0), np.float32(0.0), np.float32(1.0), np.float32(0.0), np.float32(0.0), np.float32(1.0), np.float32(1.0), np.float32(1.0), np.float32(0.0), np.float32(1.0)]",3.0,100027.0,9
2025-08-14_08-18-36,330,"[np.float32(0.0), np.float32(0.0), np.float32(1.0), np.float32(1.0), np.float32(1.0), np.float32(1.0), np.float32(1.0), np.float32(0.0), np.float32(1.0), np.float32(1.0), np.float32(1.0), np.float32(0.0), np.float32(1.0), np.float32(0.0), np.float32(1.0), np.float32(0.0)]",0.0,100027.0,36
2025-08-14_08-18-36,331,"[np.float32(1.0), np.float32(0.0), np.float32(1.0), np.float32(1.0), np.float32(1.0), np.float32(1.0), np.float32(1.0), np.float32(0.0), np.float32(0.0), np.float32(1.0), np.float32(0.0), np.float32(1.0), np.float32(0.0), np.float32(1.0), np.float32(1.0), np.float32(0.0)]",2.0,100029.0,30
2025-08-14_08-18-36,332,"[np.float32(0.0), np.float32(0.0), np.float32(0.0), np.float32(0.0), np.float32(0.0), np.float32(0.0), np.float32(1.0), np.float32(0.0), np.float32(1.0), np.float32(1.0), np.float32(0.0), np.float32(0.0), np.float32(0.0), np.float32(1.0), np.float32(1.0), np.float32(1.0)]",3.0,100032.0,34
2025-08-14_08-18-36,333,"[np.float32(1.0), np.float32(1.0), np.float32(1.0), np.float32(1.0), np.float32(0.0), np.float32(1.0), np.float32(1.0), np.float32(1.0), np.float32(0.0), np.float32(0.0), np.float32(0.0), np.float32(0.0), np.float32(0.0), np.float32(0.0), np.float32(0.0), np.float32(0.0)]",-1.0,100031.0,33
2025-08-14_08-18-36,334,"[np.float32(1.0), np.float32(0.0), np.float32(0.0), np.float32(1.0), np.float32(0.0), np.float32(1.0), np.float32(0.0), np.float32(1.0), np.float32(1.0), np.float32(1.0), np.float32(0.0), np.float32(0.0), np.float32(1.0), np.float32(1.0), np.float32(0.0), np.float32(0.0)]",7.0,100038.0,25
2025-08-14_08-18-36,335,"[np.float32(0.0), np.float32(0.0), np.float32(1.0), np.float32(1.0), np.float32(0.0), np.float32(1.0), np.float32(0.0), np.float32(0.0), np.float32(1.0), np.float32(1.0), np.float32(0.0), np.float32(0.0), np.float32(1.0), np.float32(1.0), np.float32(1.0), np.float32(0.0)]",-3.0,100035.0,1
2025-08-14_08-18-36,336,"[np.float32(0.0), np.float32(0.0), np.float32(1.0), np.float32(0.0), np.float32(1.0), np.float32(1.0), np.float32(0.0), np.float32(0.0), np.float32(1.0), np.float32(1.0), np.float32(0.0), np.float32(1.0), np.float32(0.0), np.float32(1.0), np.float32(1.0), np.float32(1.0)]",-4.0,100031.0,11
2025-08-14_08-18-36,337,"[np.float32(1.0), np.float32(0.0), np.float32(1.0), np.float32(0.0), np.float32(1.0), np.float32(0.0), np.float32(1.0), np.float32(0.0), np.float32(1.0), np.float32(1.0), np.float32(0.0), np.float32(1.0), np.float32(1.0), np.float32(0.0), np.float32(1.0), np.float32(0.0)]",0.0,100031.0,33
2025-08-14_08-18-36,338,"[np.float32(0.0), np.float32(0.0), np.float32(1.0), np.float32(1.0), np.float32(1.0), np.float32(1.0), np.float32(0.0), np.float32(0.0), np.float32(1.0), np.float32(0.0), np.float32(0.0), np.float32(0.0), np.float32(1.0), np.float32(1.0), np.float32(1.0), np.float32(1.0)]",1.0,100032.0,35
2025-08-14_08-18-36,339,"[np.float32(1.0), np.float32(1.0), np.float32(1.0), np.float32(0.0), np.float32(0.0), np.float32(1.0), np.float32(0.0), np.float32(1.0), np.float32(1.0), np.float32(0.0), np.float32(0.0), np.float32(1.0), np.float32(1.0), np.float32(0.0), np.float32(0.0), np.float32(1.0)]",-2.0,100030.0,35
2025-08-14_08-18-36,340,"[np.float32(0.0), np.float32(1.0), np.float32(1.0), np.float32(1.0), np.float32(1.0), np.float32(0.0), np.float32(1.0), np.float32(0.0), np.float32(0.0), np.float32(1.0), np.float32(0.0), np.float32(1.0), np.float32(1.0), np.float32(1.0), np.float32(0.0), np.float32(1.0)]",5.0,100035.0,4
2025-08-14_08-18-36,341,"[np.float32(0.0), np.float32(1.0), np.float32(0.0), np.float32(1.0), np.float32(1.0), np.float32(0.0), np.float32(0.0), np.float32(1.0), np.float32(0.0), np.float32(0.0), np.float32(0.0), np.float32(1.0), np.float32(0.0), np.float32(0.0), np.float32(0.0), np.float32(0.0)]",-3.0,100032.0,26
2025-08-14_08-18-36,342,"[np.float32(1.0), np.float32(0.0), np.float32(1.0), np.float32(1.0), np.float32(0.0), np.float32(0.0), np.float32(1.0), np.float32(0.0), np.float32(0.0), np.float32(0.0), np.float32(0.0), np.float32(0.0), np.float32(1.0), np.float32(0.0), np.float32(0.0), np.float32(1.0)]",-4.0,100028.0,29
2025-08-14_08-18-36,343,"[np.float32(0.0), np.float32(0.0), np.float32(1.0), np.float32(0.0), np.float32(1.0), np.float32(1.0), np.float32(1.0), np.float32(1.0), np.float32(0.0), np.float32(1.0), np.float32(1.0), np.float32(0.0), np.float32(1.0), np.float32(1.0), np.float32(1.0), np.float32(0.0)]",3.0,100031.0,8
2025-08-14_08-18-36,344,"[np.float32(0.0), np.float32(1.0), np.float32(0.0), np.float32(0.0), np.float32(1.0), np.float32(1.0), np.float32(0.0), np.float32(0.0), np.float32(1.0), np.float32(0.0), np.float32(0.0), np.float32(1.0), np.float32(1.0), np.float32(1.0), np.float32(1.0), np.float32(1.0)]",-2.0,100029.0,11
2025-08-14_08-18-36,345,"[np.float32(1.0), np.float32(1.0), np.float32(0.0), np.float32(0.0), np.float32(1.0), np.float32(1.0), np.float32(1.0), np.float32(1.0), np.float32(1.0), np.float32(1.0), np.float32(1.0), np.float32(1.0), np.float32(0.0), np.float32(1.0), np.float32(1.0), np.float32(0.0)]",1.0,100030.0,22
2025-08-14_08-18-36,346,"[np.float32(1.0), np.float32(0.0), np.float32(1.0), np.float32(0.0), np.float32(0.0), np.float32(1.0), np.float32(0.0), np.float32(1.0), np.float32(1.0), np.float32(0.0), np.float32(1.0), np.float32(0.0), np.float32(0.0), np.float32(1.0), np.float32(0.0), np.float32(0.0)]",4.0,100034.0,29
2025-08-14_08-18-36,347,"[np.float32(1.0), np.float32(1.0), np.float32(1.0), np.float32(1.0), np.float32(0.0), np.float32(0.0), np.float32(1.0), np.float32(1.0), np.float32(0.0), np.float32(0.0), np.float32(1.0), np.float32(0.0), np.float32(0.0), np.float32(0.0), np.float32(1.0), np.float32(0.0)]",5.0,100039.0,11
2025-08-14_08-18-36,348,"[np.float32(0.0), np.float32(1.0), np.float32(1.0), np.float32(1.0), np.float32(0.0), np.float32(1.0), np.float32(0.0), np.float32(1.0), np.float32(1.0), np.float32(1.0), np.float32(1.0), np.float32(0.0), np.float32(1.0), np.float32(1.0), np.float32(0.0), np.float32(1.0)]",-2.0,100037.0,33
2025-08-14_08-18-36,349,"[np.float32(1.0), np.float32(0.0), np.float32(0.0), np.float32(0.0), np.float32(0.0), np.float32(0.0), np.float32(0.0), np.float32(1.0), np.float32(0.0), np.float32(1.0), np.float32(1.0), np.float32(0.0), np.float32(0.0), np.float32(1.0), np.float32(1.0), np.float32(0.0)]",0.0,100037.0,15
2025-08-14_08-18-36,350,"[np.float32(1.0), np.float32(0.0), np.float32(0.0), np.float32(1.0), np.float32(0.0), np.float32(0.0), np.float32(1.0), np.float32(1.0), np.float32(0.0), np.float32(1.0), np.float32(1.0), np.float32(0.0), np.float32(0.0), np.float32(1.0), np.float32(0.0), np.float32(1.0)]",1.0,100038.0,20
2025-08-14_08-18-36,351,"[np.float32(1.0), np.float32(0.0), np.float32(1.0), np.float32(1.0), np.float32(0.0), np.float32(0.0), np.float32(1.0), np.float32(1.0), np.float32(1.0), np.float32(0.0), np.float32(1.0), np.float32(0.0), np.float32(1.0), np.float32(0.0), np.float32(0.0), np.float32(0.0)]",-1.0,100037.0,12
2025-08-14_08-18-36,352,"[np.float32(1.0), np.float32(1.0), np.float32(0.0), np.float32(0.0), np.float32(1.0), np.float32(0.0), np.float32(1.0), np.float32(0.0), np.float32(0.0), np.float32(0.0), np.float32(0.0), np.float32(0.0), np.float32(1.0), np.float32(0.0), np.float32(1.0), np.float32(0.0)]",4.0,100041.0,8
2025-08-14_08-18-36,353,"[np.float32(0.0), np.float32(0.0), np.float32(0.0), np.float32(0.0), np.float32(0.0), np.float32(1.0), np.float32(0.0), np.float32(1.0), np.float32(0.0), np.float32(1.0), np.float32(1.0), np.float32(0.0), np.float32(1.0), np.float32(0.0), np.float32(1.0), np.float32(1.0)]",32.0,100073.0,7
2025-08-14_08-18-36,354,"[np.float32(0.0), np.float32(0.0), np.float32(1.0), np.float32(0.0), np.float32(0.0), np.float32(1.0), np.float32(1.0), np.float32(0.0), np.float32(0.0), np.float32(0.0), np.float32(1.0), np.float32(0.0), np.float32(1.0), np.float32(1.0), np.float32(1.0), np.float32(1.0)]",2.0,100075.0,26
2025-08-14_08-18-36,355,"[np.float32(0.0), np.float32(0.0), np.float32(0.0), np.float32(1.0), np.float32(0.0), np.float32(1.0), np.float32(0.0), np.float32(1.0), np.float32(1.0), np.float32(1.0), np.float32(1.0), np.float32(0.0), np.float32(0.0), np.float32(1.0), np.float32(0.0), np.float32(0.0)]",0.0,100075.0,33
2025-08-14_08-18-36,356,"[np.float32(1.0), np.float32(0.0), np.float32(0.0), np.float32(0.0), np.float32(0.0), np.float32(1.0), np.float32(1.0), np.float32(1.0), np.float32(0.0), np.float32(0.0), np.float32(0.0), np.float32(0.0), np.float32(0.0), np.float32(1.0), np.float32(1.0), np.float32(0.0)]",-2.0,100073.0,34
2025-08-14_08-18-36,357,"[np.float32(0.0), np.float32(0.0), np.float32(0.0), np.float32(1.0), np.float32(0.0), np.float32(0.0), np.float32(1.0), np.float32(1.0), np.float32(1.0), np.float32(0.0), np.float32(0.0), np.float32(0.0), np.float32(0.0), np.float32(1.0), np.float32(0.0), np.float32(1.0)]",-1.0,100072.0,11
2025-08-14_08-18-36,358,"[np.float32(0.0), np.float32(0.0), np.float32(1.0), np.float32(1.0), np.float32(0.0), np.float32(1.0), np.float32(0.0), np.float32(0.0), np.float32(1.0), np.float32(1.0), np.float32(1.0), np.float32(1.0), np.float32(1.0), np.float32(1.0), np.float32(0.0), np.float32(0.0)]",-4.0,100068.0,1
2025-08-14_08-18-36,359,"[np.float32(1.0), np.float32(0.0), np.float32(1.0), np.float32(0.0), np.float32(0.0), np.float32(1.0), np.float32(0.0), np.float32(0.0), np.float32(1.0), np.float32(0.0), np.float32(0.0), np.float32(0.0), np.float32(1.0), np.float32(0.0), np.float32(1.0), np.float32(0.0)]",-2.0,100066.0,22
2025-08-14_08-18-36,360,"[np.float32(1.0), np.float32(1.0), np.float32(1.0), np.float32(1.0), np.float32(0.0), np.float32(0.0), np.float32(0.0), np.float32(1.0), np.float32(1.0), np.float32(1.0), np.float32(0.0), np.float32(1.0), np.float32(1.0), np.float32(1.0), np.float32(0.0), np.float32(0.0)]",0.0,100066.0,33
2025-08-14_08-18-36,361,"[np.float32(1.0), np.float32(1.0), np.float32(0.0), np.float32(0.0), np.float32(1.0), np.float32(0.0), np.float32(1.0), np.float32(0.0), np.float32(1.0), np.float32(0.0), np.float32(1.0), np.float32(1.0), np.float32(0.0), np.float32(1.0), np.float32(1.0), np.float32(0.0)]",1.0,100067.0,18
2025-08-14_08-18-36,362,"[np.float32(1.0), np.float32(0.0), np.float32(1.0), np.float32(1.0), np.float32(1.0), np.float32(0.0), np.float32(1.0), np.float32(0.0), np.float32(1.0), np.float32(0.0), np.float32(1.0), np.float32(0.0), np.float32(1.0), np.float32(1.0), np.float32(0.0), np.float32(1.0)]",3.0,100070.0,2
2025-08-14_08-18-36,363,"[np.float32(0.0), np.float32(0.0), np.float32(0.0), np.float32(1.0), np.float32(1.0), np.float32(1.0), np.float32(0.0), np.float32(0.0), np.float32(0.0), np.float32(1.0), np.float32(1.0), np.float32(0.0), np.float32(0.0), np.float32(1.0), np.float32(1.0), np.float32(0.0)]",3.0,100073.0,29
2025-08-14_08-18-36,364,"[np.float32(1.0), np.float32(1.0), np.float32(1.0), np.float32(0.0), np.float32(0.0), np.float32(0.0), np.float32(1.0), np.float32(0.0), np.float32(1.0), np.float32(0.0), np.float32(1.0), np.float32(1.0), np.float32(0.0), np.float32(0.0), np.float32(0.0), np.float32(0.0)]",1.0,100074.0,27
2025-08-14_08-18-36,365,"[np.float32(0.0), np.float32(1.0), np.float32(1.0), np.float32(0.0), np.float32(1.0), np.float32(0.0), np.float32(1.0), np.float32(0.0), np.float32(1.0), np.float32(1.0), np.float32(0.0), np.float32(0.0), np.float32(1.0), np.float32(1.0), np.float32(0.0), np.float32(1.0)]",-5.0,100069.0,24
2025-08-14_08-18-36,366,"[np.float32(0.0), np.float32(1.0), np.float32(0.0), np.float32(0.0), np.float32(0.0), np.float32(1.0), np.float32(1.0), np.float32(1.0), np.float32(0.0), np.float32(1.0), np.float32(0.0), np.float32(0.0), np.float32(1.0), np.float32(1.0), np.float32(0.0), np.float32(0.0)]",-5.0,100064.0,27
2025-08-14_08-18-36,367,"[np.float32(0.0), np.float32(1.0), np.float32(0.0), np.float32(0.0), np.float32(0.0), np.float32(0.0), np.float32(0.0), np.float32(1.0), np.float32(1.0), np.float32(0.0), np.float32(1.0), np.float32(0.0), np.float32(0.0), np.float32(0.0), np.float32(0.0), np.float32(1.0)]",-3.0,100061.0,4
2025-08-14_08-18-36,368,"[np.float32(1.0), np.float32(1.0), np.float32(1.0), np.float32(1.0), np.float32(1.0), np.float32(1.0), np.float32(1.0), np.float32(1.0), np.float32(1.0), np.float32(0.0), np.float32(0.0), np.float32(1.0), np.float32(1.0), np.float32(0.0), np.float32(1.0), np.float32(0.0)]",-3.0,100058.0,14
2025-08-14_08-18-36,369,"[np.float32(0.0), np.float32(0.0), np.float32(1.0), np.float32(0.0), np.float32(0.0), np.float32(0.0), np.float32(1.0), np.float32(0.0), np.float32(0.0), np.float32(1.0), np.float32(1.0), np.float32(0.0), np.float32(1.0), np.float32(1.0), np.float32(1.0), np.float32(1.0)]",-5.0,100053.0,27
2025-08-14_08-18-36,370,"[np.float32(1.0), np.float32(1.0), np.float32(1.0), np.float32(1.0), np.float32(0.0), np.float32(1.0), np.float32(0.0), np.float32(1.0), np.float32(0.0), np.float32(0.0), np.float32(1.0), np.float32(1.0), np.float32(1.0), np.float32(1.0), np.float32(1.0), np.float32(1.0)]",1.0,100054.0,15
2025-08-14_08-18-36,371,"[np.float32(0.0), np.float32(1.0), np.float32(0.0), np.float32(1.0), np.float32(0.0), np.float32(0.0), np.float32(0.0), np.float32(0.0), np.float32(1.0), np.float32(1.0), np.float32(0.0), np.float32(1.0), np.float32(1.0), np.float32(1.0), np.float32(1.0), np.float32(1.0)]",-3.0,100051.0,16
2025-08-14_08-18-36,372,"[np.float32(0.0), np.float32(1.0), np.float32(0.0), np.float32(0.0), np.float32(0.0), np.float32(1.0), np.float32(1.0), np.float32(0.0), np.float32(0.0), np.float32(1.0), np.float32(0.0), np.float32(1.0), np.float32(1.0), np.float32(1.0), np.float32(0.0), np.float32(1.0)]",-2.0,100049.0,18
2025-08-14_08-18-36,373,"[np.float32(0.0), np.float32(0.0), np.float32(0.0), np.float32(1.0), np.float32(0.0), np.float32(1.0), np.float32(1.0), np.float32(1.0), np.float32(0.0), np.float32(0.0), np.float32(0.0), np.float32(0.0), np.float32(1.0), np.float32(0.0), np.float32(0.0), np.float32(1.0)]",-1.0,100048.0,13
2025-08-14_08-18-36,374,"[np.float32(1.0), np.float32(1.0), np.float32(0.0), np.float32(0.0), np.float32(0.0), np.float32(1.0), np.float32(1.0), np.float32(0.0), np.float32(1.0), np.float32(0.0), np.float32(0.0), np.float32(0.0), np.float32(0.0), np.float32(0.0), np.float32(0.0), np.float32(0.0)]",-3.0,100045.0,13
2025-08-14_08-18-36,375,"[np.float32(1.0), np.float32(1.0), np.float32(0.0), np.float32(1.0), np.float32(1.0), np.float32(1.0), np.float32(1.0), np.float32(1.0), np.float32(0.0), np.float32(0.0), np.float32(1.0), np.float32(0.0), np.float32(1.0), np.float32(0.0), np.float32(0.0), np.float32(1.0)]",-3.0,100042.0,24
2025-08-14_08-18-36,376,"[np.float32(1.0), np.float32(1.0), np.float32(1.0), np.float32(1.0), np.float32(0.0), np.float32(1.0), np.float32(0.0), np.float32(1.0), np.float32(1.0), np.float32(1.0), np.float32(1.0), np.float32(0.0), np.float32(0.0), np.float32(1.0), np.float32(0.0), np.float32(1.0)]",1.0,100043.0,23
2025-08-14_08-18-36,377,"[np.float32(1.0), np.float32(1.0), np.float32(0.0), np.float32(1.0), np.float32(0.0), np.float32(1.0), np.float32(1.0), np.float32(1.0), np.float32(1.0), np.float32(0.0), np.float32(1.0), np.float32(1.0), np.float32(1.0), np.float32(0.0), np.float32(1.0), np.float32(0.0)]",1.0,100044.0,35
2025-08-14_08-18-36,378,"[np.float32(1.0), np.float32(0.0), np.float32(1.0), np.float32(1.0), np.float32(1.0), np.float32(1.0), np.float32(0.0), np.float32(1.0), np.float32(1.0), np.float32(1.0), np.float32(1.0), np.float32(1.0), np.float32(1.0), np.float32(1.0), np.float32(0.0), np.float32(1.0)]",-3.0,100041.0,6
2025-08-14_08-18-36,379,"[np.float32(1.0), np.float32(1.0), np.float32(0.0), np.float32(1.0), np.float32(1.0), np.float32(1.0), np.float32(0.0), np.float32(1.0), np.float32(0.0), np.float32(0.0), np.float32(1.0), np.float32(1.0), np.float32(0.0), np.float32(0.0), np.float32(0.0), np.float32(0.0)]",2.0,100043.0,20
2025-08-14_08-18-36,380,"[np.float32(1.0), np.float32(0.0), np.float32(0.0), np.float32(0.0), np.float32(1.0), np.float32(0.0), np.float32(0.0), np.float32(1.0), np.float32(1.0), np.float32(1.0), np.float32(1.0), np.float32(0.0), np.float32(1.0), np.float32(0.0), np.float32(0.0), np.float32(0.0)]",-2.0,100041.0,2
2025-08-14_08-18-36,381,"[np.float32(1.0), np.float32(1.0), np.float32(1.0), np.float32(0.0), np.float32(0.0), np.float32(0.0), np.float32(0.0), np.float32(0.0), np.float32(0.0), np.float32(0.0), np.float32(0.0), np.float32(1.0), np.float32(0.0), np.float32(1.0), np.float32(1.0), np.float32(1.0)]",-2.0,100039.0,13
2025-08-14_08-18-36,382,"[np.float32(1.0), np.float32(0.0), np.float32(0.0), np.float32(0.0), np.float32(1.0), np.float32(1.0), np.float32(1.0), np.float32(1.0), np.float32(0.0), np.float32(1.0), np.float32(1.0), np.float32(1.0), np.float32(1.0), np.float32(0.0), np.float32(0.0), np.float32(0.0)]",-2.0,100037.0,27
2025-08-14_08-18-36,383,"[np.float32(1.0), np.float32(1.0), np.float32(1.0), np.float32(1.0), np.float32(1.0), np.float32(0.0), np.float32(1.0), np.float32(0.0), np.float32(1.0), np.float32(1.0), np.float32(1.0), np.float32(0.0), np.float32(1.0), np.float32(1.0), np.float32(0.0), np.float32(0.0)]",1.0,100038.0,10
2025-08-14_08-18-36,384,"[np.float32(1.0), np.float32(1.0), np.float32(1.0), np.float32(0.0), np.float32(0.0), np.float32(1.0), np.float32(0.0), np.float32(1.0), np.float32(1.0), np.float32(1.0), np.float32(0.0), np.float32(0.0), np.float32(1.0), np.float32(0.0), np.float32(0.0), np.float32(1.0)]",-3.0,100035.0,0
2025-08-14_08-18-36,385,"[np.float32(0.0), np.float32(1.0), np.float32(0.0), np.float32(1.0), np.float32(0.0), np.float32(1.0), np.float32(1.0), np.float32(0.0), np.float32(1.0), np.float32(1.0), np.float32(0.0), np.float32(1.0), np.float32(1.0), np.float32(0.0), np.float32(1.0), np.float32(0.0)]",-2.0,100033.0,26
2025-08-14_08-18-36,386,"[np.float32(0.0), np.float32(0.0), np.float32(0.0), np.float32(0.0), np.float32(1.0), np.float32(0.0), np.float32(0.0), np.float32(1.0), np.float32(1.0), np.float32(0.0), np.float32(1.0), np.float32(0.0), np.float32(0.0), np.float32(1.0), np.float32(1.0), np.float32(0.0)]",-3.0,100030.0,34
2025-08-14_08-18-36,387,"[np.float32(1.0), np.float32(0.0), np.float32(1.0), np.float32(1.0), np.float32(1.0), np.float32(0.0), np.float32(0.0), np.float32(0.0), np.float32(0.0), np.float32(0.0), np.float32(1.0), np.float32(0.0), np.float32(1.0), np.float32(1.0), np.float32(0.0), np.float32(1.0)]",1.0,100031.0,3
2025-08-14_08-18-36,388,"[np.float32(0.0), np.float32(0.0), np.float32(0.0), np.float32(0.0), np.float32(0.0), np.float32(0.0), np.float32(0.0), np.float32(0.0), np.float32(1.0), np.float32(0.0), np.float32(0.0), np.float32(0.0), np.float32(0.0), np.float32(0.0), np.float32(0.0), np.float32(1.0)]",1.0,100032.0,20
2025-08-14_08-18-36,389,"[np.float32(1.0), np.float32(1.0), np.float32(1.0), np.float32(0.0), np.float32(0.0), np.float32(0.0), np.float32(0.0), np.float32(0.0), np.float32(0.0), np.float32(0.0), np.float32(1.0), np.float32(0.0), np.float32(0.0), np.float32(1.0), np.float32(1.0), np.float32(1.0)]",1.0,100033.0,11
2025-08-14_08-18-36,390,"[np.float32(0.0), np.float32(0.0), np.float32(0.0), np.float32(1.0), np.float32(0.0), np.float32(1.0), np.float32(0.0), np.float32(1.0), np.float32(0.0), np.float32(0.0), np.float32(1.0), np.float32(0.0), np.float32(1.0), np.float32(0.0), np.float32(0.0), np.float32(0.0)]",-3.0,100030.0,1
2025-08-14_08-18-36,391,"[np.float32(1.0), np.float32(1.0), np.float32(1.0), np.float32(0.0), np.float32(0.0), np.float32(0.0), np.float32(0.0), np.float32(0.0), np.float32(1.0), np.float32(0.0), np.float32(1.0), np.float32(0.0), np.float32(0.0), np.float32(1.0), np.float32(1.0), np.float32(1.0)]",0.0,100030.0,25
2025-08-14_08-18-36,392,"[np.float32(0.0), np.float32(0.0), np.float32(0.0), np.float32(1.0), np.float32(1.0), np.float32(0.0), np.float32(0.0), np.float32(1.0), np.float32(1.0), np.float32(0.0), np.float32(0.0), np.float32(0.0), np.float32(0.0), np.float32(0.0), np.float32(0.0), np.float32(0.0)]",1.0,100031.0,21
2025-08-14_08-18-36,393,"[np.float32(1.0), np.float32(0.0), np.float32(0.0), np.float32(1.0), np.float32(1.0), np.float32(1.0), np.float32(0.0), np.float32(1.0), np.float32(1.0), np.float32(1.0), np.float32(0.0), np.float32(0.0), np.float32(1.0), np.float32(0.0), np.float32(0.0), np.float32(0.0)]",0.0,100031.0,22
2025-08-14_08-18-36,394,"[np.float32(1.0), np.float32(1.0), np.float32(0.0), np.float32(1.0), np.float32(0.0), np.float32(0.0), np.float32(1.0), np.float32(1.0), np.float32(1.0), np.float32(0.0), np.float32(1.0), np.float32(0.0), np.float32(1.0), np.float32(1.0), np.float32(0.0), np.float32(0.0)]",2.0,100033.0,32
2025-08-14_08-18-36,395,"[np.float32(1.0), np.float32(0.0), np.float32(1.0), np.float32(1.0), np.float32(1.0), np.float32(0.0), np.float32(0.0), np.float32(1.0), np.float32(1.0), np.float32(0.0), np.float32(1.0), np.float32(1.0), np.float32(1.0), np.float32(1.0), np.float32(0.0), np.float32(1.0)]",-6.0,100027.0,0
2025-08-14_08-18-36,396,"[np.float32(0.0), np.float32(1.0), np.float32(1.0), np.float32(0.0), np.float32(0.0), np.float32(1.0), np.float32(0.0), np.float32(0.0), np.float32(0.0), np.float32(0.0), np.float32(0.0), np.float32(1.0), np.float32(0.0), np.float32(0.0), np.float32(0.0), np.float32(1.0)]",0.0,100027.0,14
2025-08-14_08-18-36,397,"[np.float32(0.0), np.float32(1.0), np.float32(0.0), np.float32(0.0), np.float32(0.0), np.float32(0.0), np.float32(0.0), np.float32(1.0), np.float32(1.0), np.float32(0.0), np.float32(0.0), np.float32(1.0), np.float32(1.0), np.float32(0.0), np.float32(1.0), np.float32(1.0)]",2.0,100029.0,36
2025-08-14_08-18-36,398,"[np.float32(1.0), np.float32(0.0), np.float32(0.0), np.float32(0.0), np.float32(1.0), np.float32(0.0), np.float32(0.0), np.float32(1.0), np.float32(0.0), np.float32(1.0), np.float32(0.0), np.float32(1.0), np.float32(1.0), np.float32(1.0), np.float32(1.0), np.float32(0.0)]",2.0,100031.0,12
2025-08-14_08-18-36,399,"[np.float32(0.0), np.float32(0.0), np.float32(0.0), np.float32(1.0), np.float32(0.0), np.float32(1.0), np.float32(1.0), np.float32(0.0), np.float32(1.0), np.float32(0.0), np.float32(0.0), np.float32(0.0), np.float32(1.0), np.float32(0.0), np.float32(0.0), np.float32(0.0)]",-5.0,100026.0,14
2025-08-14_08-18-36,400,"[np.float32(0.0), np.float32(0.0), np.float32(1.0), np.float32(0.0), np.float32(0.0), np.float32(0.0), np.float32(0.0), np.float32(1.0), np.float32(0.0), np.float32(0.0), np.float32(0.0), np.float32(0.0), np.float32(0.0), np.float32(0.0), np.float32(1.0), np.float32(1.0)]",4.0,100030.0,14
2025-08-14_08-18-36,401,"[np.float32(1.0), np.float32(1.0), np.float32(0.0), np.float32(0.0), np.float32(0.0), np.float32(1.0), np.float32(1.0), np.float32(0.0), np.float32(1.0), np.float32(0.0), np.float32(0.0), np.float32(1.0), np.float32(1.0), np.float32(0.0), np.float32(0.0), np.float32(1.0)]",2.0,100032.0,33
2025-08-14_08-18-36,402,"[np.float32(1.0), np.float32(1.0), np.float32(0.0), np.float32(1.0), np.float32(1.0), np.float32(0.0), np.float32(1.0), np.float32(1.0), np.float32(0.0), np.float32(0.0), np.float32(0.0), np.float32(0.0), np.float32(0.0), np.float32(0.0), np.float32(0.0), np.float32(0.0)]",3.0,100035.0,11
2025-08-14_08-18-36,403,"[np.float32(1.0), np.float32(0.0), np.float32(0.0), np.float32(0.0), np.float32(0.0), np.float32(0.0), np.float32(1.0), np.float32(0.0), np.float32(1.0), np.float32(1.0), np.float32(1.0), np.float32(0.0), np.float32(1.0), np.float32(0.0), np.float32(0.0), np.float32(1.0)]",-1.0,100034.0,4
2025-08-14_08-18-36,404,"[np.float32(0.0), np.float32(0.0), np.float32(1.0), np.float32(0.0), np.float32(0.0), np.float32(0.0), np.float32(1.0), np.float32(1.0), np.float32(0.0), np.float32(0.0), np.float32(0.0), np.float32(0.0), np.float32(1.0), np.float32(0.0), np.float32(1.0), np.float32(0.0)]",1.0,100035.0,13
2025-08-14_08-18-36,405,"[np.float32(1.0), np.float32(1.0), np.float32(0.0), np.float32(0.0), np.float32(1.0), np.float32(0.0), np.float32(0.0), np.float32(0.0), np.float32(1.0), np.float32(0.0), np.float32(0.0), np.float32(1.0), np.float32(1.0), np.float32(0.0), np.float32(1.0), np.float32(0.0)]",0.0,100035.0,15
2025-08-14_08-18-36,406,"[np.float32(0.0), np.float32(0.0), np.float32(0.0), np.float32(0.0), np.float32(1.0), np.float32(1.0), np.float32(1.0), np.float32(1.0), np.float32(0.0), np.float32(1.0), np.float32(0.0), np.float32(1.0), np.float32(1.0), np.float32(1.0), np.float32(1.0), np.float32(0.0)]",-1.0,100034.0,23
2025-08-14_08-18-36,407,"[np.float32(1.0), np.float32(1.0), np.float32(0.0), np.float32(0.0), np.float32(1.0), np.float32(1.0), np.float32(1.0), np.float32(1.0), np.float32(1.0), np.float32(1.0), np.float32(0.0), np.float32(1.0), np.float32(0.0), np.float32(1.0), np.float32(1.0), np.float32(0.0)]",-1.0,100033.0,23
2025-08-14_08-18-36,408,"[np.float32(0.0), np.float32(0.0), np.float32(0.0), np.float32(1.0), np.float32(0.0), np.float32(0.0), np.float32(0.0), np.float32(1.0), np.float32(0.0), np.float32(0.0), np.float32(1.0), np.float32(0.0), np.float32(0.0), np.float32(0.0), np.float32(0.0), np.float32(0.0)]",2.0,100035.0,5
2025-08-14_08-18-36,409,"[np.float32(1.0), np.float32(0.0), np.float32(0.0), np.float32(1.0), np.float32(1.0), np.float32(1.0), np.float32(0.0), np.float32(0.0), np.float32(0.0), np.float32(0.0), np.float32(0.0), np.float32(0.0), np.float32(1.0), np.float32(0.0), np.float32(0.0), np.float32(0.0)]",-1.0,100034.0,35
2025-08-14_08-18-36,410,"[np.float32(0.0), np.float32(0.0), np.float32(1.0), np.float32(0.0), np.float32(0.0), np.float32(1.0), np.float32(1.0), np.float32(1.0), np.float32(0.0), np.float32(0.0), np.float32(0.0), np.float32(0.0), np.float32(1.0), np.float32(0.0), np.float32(1.0), np.float32(0.0)]",-2.0,100032.0,0
2025-08-14_08-18-36,411,"[np.float32(1.0), np.float32(0.0), np.float32(1.0), np.float32(1.0), np.float32(0.0), np.float32(1.0), np.float32(1.0), np.float32(1.0), np.float32(1.0), np.float32(0.0), np.float32(0.0), np.float32(0.0), np.float32(1.0), np.float32(0.0), np.float32(0.0), np.float32(0.0)]",-1.0,100031.0,1
2025-08-14_08-18-36,412,"[np.float32(1.0), np.float32(1.0), np.float32(1.0), np.float32(1.0), np.float32(0.0), np.float32(0.0), np.float32(0.0), np.float32(1.0), np.float32(0.0), np.float32(0.0), np.float32(0.0), np.float32(1.0), np.float32(0.0), np.float32(0.0), np.float32(0.0), np.float32(1.0)]",-3.0,100028.0,5
2025-08-14_08-18-36,413,"[np.float32(0.0), np.float32(0.0), np.float32(1.0), np.float32(0.0), np.float32(1.0), np.float32(1.0), np.float32(0.0), np.float32(1.0), np.float32(0.0), np.float32(0.0), np.float32(0.0), np.float32(0.0), np.float32(0.0), np.float32(0.0), np.float32(0.0), np.float32(0.0)]",-2.0,100026.0,31
2025-08-14_08-18-36,414,"[np.float32(1.0), np.float32(1.0), np.float32(1.0), np.float32(1.0), np.float32(0.0), np.float32(1.0), np.float32(1.0), np.float32(0.0), np.float32(0.0), np.float32(1.0), np.float32(1.0), np.float32(0.0), np.float32(0.0), np.float32(0.0), np.float32(0.0), np.float32(1.0)]",0.0,100026.0,22
2025-08-14_08-18-36,415,"[np.float32(1.0), np.float32(0.0), np.float32(1.0), np.float32(1.0), np.float32(1.0), np.float32(0.0), np.float32(0.0), np.float32(1.0), np.float32(0.0), np.float32(0.0), np.float32(1.0), np.float32(1.0), np.float32(0.0), np.float32(0.0), np.float32(0.0), np.float32(0.0)]",-1.0,100025.0,7
2025-08-14_08-18-36,416,"[np.float32(1.0), np.float32(0.0), np.float32(1.0), np.float32(0.0), np.float32(0.0), np.float32(0.0), np.float32(1.0), np.float32(0.0), np.float32(1.0), np.float32(1.0), np.float32(0.0), np.float32(1.0), np.float32(1.0), np.float32(0.0), np.float32(1.0), np.float32(1.0)]",-1.0,100024.0,5
2025-08-14_08-18-36,417,"[np.float32(1.0), np.float32(1.0), np.float32(1.0), np.float32(1.0), np.float32(1.0), np.float32(1.0), np.float32(0.0), np.float32(0.0), np.float32(1.0), np.float32(0.0), np.float32(0.0), np.float32(0.0), np.float32(0.0), np.float32(0.0), np.float32(0.0), np.float32(1.0)]",-2.0,100022.0,16
2025-08-14_08-18-36,418,"[np.float32(1.0), np.float32(1.0), np.float32(0.0), np.float32(1.0), np.float32(0.0), np.float32(1.0), np.float32(0.0), np.float32(1.0), np.float32(0.0), np.float32(0.0), np.float32(0.0), np.float32(1.0), np.float32(1.0), np.float32(0.0), np.float32(0.0), np.float32(0.0)]",3.0,100025.0,15
2025-08-14_08-18-36,419,"[np.float32(0.0), np.float32(1.0), np.float32(1.0), np.float32(0.0), np.float32(1.0), np.float32(1.0), np.float32(1.0), np.float32(0.0), np.float32(1.0), np.float32(1.0), np.float32(1.0), np.float32(1.0), np.float32(0.0), np.float32(1.0), np.float32(0.0), np.float32(1.0)]",-1.0,100024.0,18
2025-08-14_08-18-36,420,"[np.float32(1.0), np.float32(1.0), np.float32(1.0), np.float32(1.0), np.float32(0.0), np.float32(1.0), np.float32(0.0), np.float32(0.0), np.float32(1.0), np.float32(1.0), np.float32(0.0), np.float32(1.0), np.float32(1.0), np.float32(1.0), np.float32(1.0), np.float32(1.0)]",-5.0,100019.0,2
2025-08-14_08-18-36,421,"[np.float32(0.0), np.float32(1.0), np.float32(1.0), np.float32(1.0), np.float32(0.0), np.float32(0.0), np.float32(0.0), np.float32(1.0), np.float32(1.0), np.float32(1.0), np.float32(1.0), np.float32(0.0), np.float32(0.0), np.float32(0.0), np.float32(0.0), np.float32(1.0)]",-1.0,100018.0,15
2025-08-14_08-18-36,422,"[np.float32(0.0), np.float32(0.0), np.float32(1.0), np.float32(0.0), np.float32(1.0), np.float32(1.0), np.float32(1.0), np.float32(0.0), np.float32(0.0), np.float32(1.0), np.float32(0.0), np.float32(1.0), np.float32(1.0), np.float32(0.0), np.float32(0.0), np.float32(0.0)]",-2.0,100016.0,5
2025-08-14_08-18-36,423,"[np.float32(0.0), np.float32(0.0), np.float32(1.0), np.float32(0.0), np.float32(1.0), np.float32(1.0), np.float32(1.0), np.float32(0.0), np.float32(0.0), np.float32(1.0), np.float32(0.0), np.float32(1.0), np.float32(0.0), np.float32(1.0), np.float32(1.0), np.float32(1.0)]",4.0,100020.0,10
2025-08-14_08-18-36,424,"[np.float32(0.0), np.float32(0.0), np.float32(0.0), np.float32(1.0), np.float32(0.0), np.float32(0.0), np.float32(0.0), np.float32(0.0), np.float32(1.0), np.float32(1.0), np.float32(0.0), np.float32(0.0), np.float32(1.0), np.float32(1.0), np.float32(1.0), np.float32(0.0)]",-3.0,100017.0,18
2025-08-14_08-18-36,425,"[np.float32(1.0), np.float32(1.0), np.float32(0.0), np.float32(1.0), np.float32(1.0), np.float32(0.0), np.float32(0.0), np.float32(0.0), np.float32(0.0), np.float32(1.0), np.float32(0.0), np.float32(0.0), np.float32(1.0), np.float32(0.0), np.float32(1.0), np.float32(1.0)]",-4.0,100013.0,35
2025-08-14_08-18-36,426,"[np.float32(0.0), np.float32(0.0), np.float32(1.0), np.float32(0.0), np.float32(0.0), np.float32(0.0), np.float32(1.0), np.float32(1.0), np.float32(0.0), np.float32(1.0), np.float32(0.0), np.float32(0.0), np.float32(1.0), np.float32(1.0), np.float32(0.0), np.float32(0.0)]",0.0,100013.0,1
2025-08-14_08-18-36,427,"[np.float32(1.0), np.float32(0.0), np.float32(1.0), np.float32(1.0), np.float32(0.0), np.float32(1.0), np.float32(1.0), np.float32(0.0), np.float32(0.0), np.float32(1.0), np.float32(1.0), np.float32(0.0), np.float32(0.0), np.float32(0.0), np.float32(1.0), np.float32(0.0)]",1.0,100014.0,36
2025-08-14_08-18-36,428,"[np.float32(1.0), np.float32(1.0), np.float32(1.0), np.float32(1.0), np.float32(0.0), np.float32(0.0), np.float32(1.0), np.float32(0.0), np.float32(1.0), np.float32(1.0), np.float32(1.0), np.float32(0.0), np.float32(1.0), np.float32(0.0), np.float32(1.0), np.float32(1.0)]",-1.0,100013.0,33
2025-08-14_08-18-36,429,"[np.float32(0.0), np.float32(0.0), np.float32(1.0), np.float32(1.0), np.float32(0.0), np.float32(1.0), np.float32(1.0), np.float32(0.0), np.float32(0.0), np.float32(1.0), np.float32(1.0), np.float32(1.0), np.float32(0.0), np.float32(1.0), np.float32(0.0), np.float32(1.0)]",-1.0,100012.0,18
2025-08-14_08-18-36,430,"[np.float32(0.0), np.float32(1.0), np.float32(0.0), np.float32(1.0), np.float32(0.0), np.float32(0.0), np.float32(1.0), np.float32(0.0), np.float32(0.0), np.float32(1.0), np.float32(0.0), np.float32(0.0), np.float32(1.0), np.float32(1.0), np.float32(1.0), np.float32(1.0)]",0.0,100012.0,25
2025-08-14_08-18-36,431,"[np.float32(0.0), np.float32(0.0), np.float32(0.0), np.float32(0.0), np.float32(0.0), np.float32(1.0), np.float32(0.0), np.float32(1.0), np.float32(1.0), np.float32(1.0), np.float32(1.0), np.float32(0.0), np.float32(0.0), np.float32(0.0), np.float32(0.0), np.float32(1.0)]",3.0,100015.0,14
2025-08-14_08-18-36,432,"[np.float32(0.0), np.float32(0.0), np.float32(0.0), np.float32(0.0), np.float32(0.0), np.float32(1.0), np.float32(1.0), np.float32(1.0), np.float32(1.0), np.float32(0.0), np.float32(0.0), np.float32(1.0), np.float32(0.0), np.float32(0.0), np.float32(1.0), np.float32(0.0)]",-1.0,100014.0,25
2025-08-14_08-18-36,433,"[np.float32(0.0), np.float32(1.0), np.float32(0.0), np.float32(0.0), np.float32(1.0), np.float32(1.0), np.float32(0.0), np.float32(1.0), np.float32(1.0), np.float32(0.0), np.float32(1.0), np.float32(1.0), np.float32(1.0), np.float32(0.0), np.float32(0.0), np.float32(0.0)]",2.0,100016.0,17
2025-08-14_08-18-36,434,"[np.float32(0.0), np.float32(1.0), np.float32(0.0), np.float32(1.0), np.float32(1.0), np.float32(0.0), np.float32(0.0), np.float32(0.0), np.float32(1.0), np.float32(0.0), np.float32(1.0), np.float32(1.0), np.float32(1.0), np.float32(1.0), np.float32(1.0), np.float32(1.0)]",3.0,100019.0,29
2025-08-14_08-18-36,435,"[np.float32(0.0), np.float32(1.0), np.float32(1.0), np.float32(1.0), np.float32(1.0), np.float32(1.0), np.float32(1.0), np.float32(0.0), np.float32(1.0), np.float32(0.0), np.float32(1.0), np.float32(1.0), np.float32(0.0), np.float32(0.0), np.float32(1.0), np.float32(1.0)]",2.0,100021.0,9
2025-08-14_08-18-36,436,"[np.float32(0.0), np.float32(0.0), np.float32(0.0), np.float32(0.0), np.float32(0.0), np.float32(1.0), np.float32(0.0), np.float32(1.0), np.float32(1.0), np.float32(1.0), np.float32(0.0), np.float32(1.0), np.float32(0.0), np.float32(1.0), np.float32(1.0), np.float32(0.0)]",2.0,100023.0,15
2025-08-14_08-18-36,437,"[np.float32(1.0), np.float32(0.0), np.float32(0.0), np.float32(0.0), np.float32(1.0), np.float32(1.0), np.float32(1.0), np.float32(0.0), np.float32(1.0), np.float32(0.0), np.float32(0.0), np.float32(1.0), np.float32(0.0), np.float32(0.0), np.float32(0.0), np.float32(1.0)]",3.0,100026.0,30
2025-08-14_08-18-36,438,"[np.float32(0.0), np.float32(1.0), np.float32(1.0), np.float32(0.0), np.float32(0.0), np.float32(1.0), np.float32(0.0), np.float32(1.0), np.float32(1.0), np.float32(0.0), np.float32(0.0), np.float32(0.0), np.float32(0.0), np.float32(0.0), np.float32(1.0), np.float32(1.0)]",-3.0,100023.0,4
2025-08-14_08-18-36,439,"[np.float32(1.0), np.float32(1.0), np.float32(1.0), np.float32(0.0), np.float32(1.0), np.float32(1.0), np.float32(0.0), np.float32(1.0), np.float32(1.0), np.float32(1.0), np.float32(0.0), np.float32(1.0), np.float32(0.0), np.float32(1.0), np.float32(1.0), np.float32(1.0)]",1.0,100024.0,21
2025-08-14_08-18-36,440,"[np.float32(1.0), np.float32(1.0), np.float32(0.0), np.float32(1.0), np.float32(0.0), np.float32(1.0), np.float32(1.0), np.float32(0.0), np.float32(1.0), np.float32(1.0), np.float32(1.0), np.float32(1.0), np.float32(1.0), np.float32(1.0), np.float32(1.0), np.float32(0.0)]",37.0,100061.0,7
2025-08-14_08-18-36,441,"[np.float32(1.0), np.float32(0.0), np.float32(0.0), np.float32(1.0), np.float32(0.0), np.float32(1.0), np.float32(1.0), np.float32(0.0), np.float32(0.0), np.float32(0.0), np.float32(0.0), np.float32(1.0), np.float32(0.0), np.float32(1.0), np.float32(1.0), np.float32(1.0)]",-2.0,100059.0,4
2025-08-14_08-18-36,442,"[np.float32(0.0), np.float32(0.0), np.float32(1.0), np.float32(1.0), np.float32(0.0), np.float32(1.0), np.float32(1.0), np.float32(1.0), np.float32(0.0), np.float32(0.0), np.float32(0.0), np.float32(1.0), np.float32(0.0), np.float32(0.0), np.float32(0.0), np.float32(0.0)]",-2.0,100057.0,31
2025-08-14_08-18-36,443,"[np.float32(1.0), np.float32(0.0), np.float32(0.0), np.float32(0.0), np.float32(0.0), np.float32(1.0), np.float32(1.0), np.float32(1.0), np.float32(1.0), np.float32(0.0), np.float32(0.0), np.float32(0.0), np.float32(1.0), np.float32(0.0), np.float32(0.0), np.float32(0.0)]",-1.0,100056.0,35
2025-08-14_08-18-36,444,"[np.float32(1.0), np.float32(0.0), np.float32(1.0), np.float32(0.0), np.float32(0.0), np.float32(1.0), np.float32(0.0), np.float32(0.0), np.float32(1.0), np.float32(0.0), np.float32(0.0), np.float32(1.0), np.float32(1.0), np.float32(0.0), np.float32(1.0), np.float32(0.0)]",0.0,100056.0,16
2025-08-14_08-18-36,445,"[np.float32(1.0), np.float32(0.0), np.float32(0.0), np.float32(1.0), np.float32(1.0), np.float32(0.0), np.float32(0.0), np.float32(0.0), np.float32(0.0), np.float32(1.0), np.float32(1.0), np.float32(1.0), np.float32(1.0), np.float32(1.0), np.float32(1.0), np.float32(0.0)]",3.0,100059.0,3
2025-08-14_08-18-36,446,"[np.float32(0.0), np.float32(1.0), np.float32(0.0), np.float32(0.0), np.float32(0.0), np.float32(1.0), np.float32(0.0), np.float32(1.0), np.float32(0.0), np.float32(1.0), np.float32(1.0), np.float32(1.0), np.float32(0.0), np.float32(0.0), np.float32(1.0), np.float32(0.0)]",4.0,100063.0,13
2025-08-14_08-18-36,447,"[np.float32(0.0), np.float32(1.0), np.float32(1.0), np.float32(1.0), np.float32(0.0), np.float32(0.0), np.float32(1.0), np.float32(1.0), np.float32(1.0), np.float32(0.0), np.float32(0.0), np.float32(1.0), np.float32(1.0), np.float32(1.0), np.float32(1.0), np.float32(1.0)]",-3.0,100060.0,23
2025-08-14_08-18-36,448,"[np.float32(1.0), np.float32(0.0), np.float32(1.0), np.float32(0.0), np.float32(0.0), np.float32(1.0), np.float32(0.0), np.float32(1.0), np.float32(1.0), np.float32(1.0), np.float32(0.0), np.float32(1.0), np.float32(1.0), np.float32(0.0), np.float32(1.0), np.float32(0.0)]",2.0,100062.0,33
2025-08-14_08-18-36,449,"[np.float32(1.0), np.float32(0.0), np.float32(0.0), np.float32(0.0), np.float32(0.0), np.float32(0.0), np.float32(1.0), np.float32(1.0), np.float32(1.0), np.float32(1.0), np.float32(1.0), np.float32(0.0), np.float32(1.0), np.float32(1.0), np.float32(1.0), np.float32(1.0)]",1.0,100063.0,32
2025-08-14_08-18-36,450,"[np.float32(0.0), np.float32(0.0), np.float32(1.0), np.float32(1.0), np.float32(1.0), np.float32(1.0), np.float32(0.0), np.float32(1.0), np.float32(0.0), np.float32(0.0), np.float32(1.0), np.float32(0.0), np.float32(1.0), np.float32(1.0), np.float32(0.0), np.float32(0.0)]",-1.0,100062.0,25
2025-08-14_08-18-36,451,"[np.float32(1.0), np.float32(0.0), np.float32(0.0), np.float32(1.0), np.float32(0.0), np.float32(0.0), np.float32(1.0), np.float32(1.0), np.float32(0.0), np.float32(1.0), np.float32(0.0), np.float32(0.0), np.float32(1.0), np.float32(1.0), np.float32(0.0), np.float32(0.0)]",-4.0,100058.0,8
2025-08-14_08-18-36,452,"[np.float32(1.0), np.float32(0.0), np.float32(0.0), np.float32(1.0), np.float32(1.0), np.float32(1.0), np.float32(1.0), np.float32(1.0), np.float32(1.0), np.float32(0.0), np.float32(1.0), np.float32(0.0), np.float32(0.0), np.float32(1.0), np.float32(0.0), np.float32(1.0)]",-2.0,100056.0,6
2025-08-14_08-18-36,453,"[np.float32(0.0), np.float32(0.0), np.float32(1.0), np.float32(0.0), np.float32(1.0), np.float32(1.0), np.float32(1.0), np.float32(1.0), np.float32(1.0), np.float32(0.0), np.float32(1.0), np.float32(0.0), np.float32(0.0), np.float32(1.0), np.float32(1.0), np.float32(0.0)]",2.0,100058.0,11
2025-08-14_08-18-36,454,"[np.float32(1.0), np.float32(1.0), np.float32(0.0), np.float32(1.0), np.float32(0.0), np.float32(0.0), np.float32(0.0), np.float32(1.0), np.float32(0.0), np.float32(1.0), np.float32(0.0), np.float32(1.0), np.float32(0.0), np.float32(0.0), np.float32(1.0), np.float32(0.0)]",-5.0,100053.0,26
2025-08-14_08-18-36,455,"[np.float32(1.0), np.float32(0.0), np.float32(0.0), np.float32(1.0), np.float32(1.0), np.float32(1.0), np.float32(0.0), np.float32(1.0), np.float32(0.0), np.float32(0.0), np.float32(0.0), np.float32(0.0), np.float32(1.0), np.float32(0.0), np.float32(1.0), np.float32(1.0)]",-1.0,100052.0,33
2025-08-14_08-18-36,456,"[np.float32(0.0), np.float32(0.0), np.float32(1.0), np.float32(0.0), np.float32(0.0), np.float32(0.0), np.float32(1.0), np.float32(0.0), np.float32(0.0), np.float32(1.0), np.float32(0.0), np.float32(0.0), np.float32(0.0), np.float32(0.0), np.float32(1.0), np.float32(1.0)]",-5.0,100047.0,29
2025-08-14_08-18-36,457,"[np.float32(0.0), np.float32(1.0), np.float32(0.0), np.float32(1.0), np.float32(1.0), np.float32(0.0), np.float32(1.0), np.float32(0.0), np.float32(0.0), np.float32(1.0), np.float32(1.0), np.float32(1.0), np.float32(0.0), np.float32(0.0), np.float32(1.0), np.float32(1.0)]",-1.0,100046.0,16
2025-08-14_08-18-36,458,"[np.float32(0.0), np.float32(0.0), np.float32(1.0), np.float32(1.0), np.float32(0.0), np.float32(1.0), np.float32(0.0), np.float32(1.0), np.float32(0.0), np.float32(0.0), np.float32(1.0), np.float32(1.0), np.float32(1.0), np.float32(0.0), np.float32(1.0), np.float32(0.0)]",-4.0,100042.0,0
2025-08-14_08-18-36,459,"[np.float32(1.0), np.float32(1.0), np.float32(0.0), np.float32(1.0), np.float32(1.0), np.float32(0.0), np.float32(1.0), np.float32(0.0), np.float32(1.0), np.float32(0.0), np.float32(0.0), np.float32(0.0), np.float32(0.0), np.float32(1.0), np.float32(1.0), np.float32(1.0)]",-1.0,100041.0,28
2025-08-14_08-18-36,460,"[np.float32(0.0), np.float32(0.0), np.float32(1.0), np.float32(0.0), np.float32(0.0), np.float32(0.0), np.float32(1.0), np.float32(0.0), np.float32(1.0), np.float32(1.0), np.float32(1.0), np.float32(0.0), np.float32(0.0), np.float32(0.0), np.float32(0.0), np.float32(0.0)]",0.0,100041.0,30
2025-08-14_08-18-36,461,"[np.float32(0.0), np.float32(0.0), np.float32(1.0), np.float32(1.0), np.float32(1.0), np.float32(1.0), np.float32(0.0), np.float32(0.0), np.float32(0.0), np.float32(1.0), np.float32(0.0), np.float32(0.0), np.float32(1.0), np.float32(1.0), np.float32(1.0), np.float32(1.0)]",-2.0,100039.0,6
2025-08-14_08-18-36,462,"[np.float32(0.0), np.float32(0.0), np.float32(1.0), np.float32(0.0), np.float32(1.0), np.float32(1.0), np.float32(1.0), np.float32(1.0), np.float32(1.0), np.float32(0.0), np.float32(1.0), np.float32(1.0), np.float32(0.0), np.float32(1.0), np.float32(1.0), np.float32(1.0)]",-1.0,100038.0,10
2025-08-14_08-18-36,463,"[np.float32(0.0), np.float32(1.0), np.float32(1.0), np.float32(1.0), np.float32(0.0), np.float32(1.0), np.float32(1.0), np.float32(1.0), np.float32(1.0), np.float32(0.0), np.float32(0.0), np.float32(1.0), np.float32(1.0), np.float32(1.0), np.float32(0.0), np.float32(1.0)]",1.0,100039.0,20
2025-08-14_08-18-36,464,"[np.float32(0.0), np.float32(0.0), np.float32(1.0), np.float32(0.0), np.float32(0.0), np.float32(1.0), np.float32(0.0), np.float32(0.0), np.float32(0.0), np.float32(1.0), np.float32(1.0), np.float32(1.0), np.float32(0.0), np.float32(0.0), np.float32(1.0), np.float32(0.0)]",1.0,100040.0,22
2025-08-14_08-18-36,465,"[np.float32(0.0), np.float32(1.0), np.float32(0.0), np.float32(0.0), np.float32(0.0), np.float32(1.0), np.float32(1.0), np.float32(0.0), np.float32(1.0), np.float32(1.0), np.float32(0.0), np.float32(1.0), np.float32(1.0), np.float32(1.0), np.float32(0.0), np.float32(0.0)]",-2.0,100038.0,9
2025-08-14_08-18-36,466,"[np.float32(0.0), np.float32(0.0), np.float32(1.0), np.float32(0.0), np.float32(0.0), np.float32(1.0), np.float32(1.0), np.float32(0.0), np.float32(1.0), np.float32(0.0), np.float32(0.0), np.float32(1.0), np.float32(1.0), np.float32(1.0), np.float32(0.0), np.float32(1.0)]",0.0,100038.0,25
2025-08-14_08-18-36,467,"[np.float32(1.0), np.float32(0.0), np.float32(1.0), np.float32(0.0), np.float32(1.0), np.float32(1.0), np.float32(1.0), np.float32(1.0), np.float32(1.0), np.float32(0.0), np.float32(0.0), np.float32(1.0), np.float32(0.0), np.float32(1.0), np.float32(1.0), np.float32(0.0)]",5.0,100043.0,36
2025-08-14_08-18-36,468,"[np.float32(0.0), np.float32(1.0), np.float32(1.0), np.float32(1.0), np.float32(1.0), np.float32(1.0), np.float32(1.0), np.float32(1.0), np.float32(1.0), np.float32(0.0), np.float32(0.0), np.float32(0.0), np.float32(1.0), np.float32(1.0), np.float32(1.0), np.float32(0.0)]",-4.0,100039.0,9
2025-08-14_08-18-36,469,"[np.float32(0.0), np.float32(0.0), np.float32(0.0), np.float32(0.0), np.float32(1.0), np.float32(0.0), np.float32(1.0), np.float32(0.0), np.float32(0.0), np.float32(1.0), np.float32(0.0), np.float32(1.0), np.float32(1.0), np.float32(1.0), np.float32(0.0), np.float32(0.0)]",-4.0,100035.0,17
2025-08-14_08-18-36,470,"[np.float32(1.0), np.float32(0.0), np.float32(0.0), np.float32(1.0), np.float32(1.0), np.float32(1.0), np.float32(0.0), np.float32(1.0), np.float32(0.0), np.float32(0.0), np.float32(1.0), np.float32(0.0), np.float32(0.0), np.float32(1.0), np.float32(0.0), np.float32(1.0)]",-6.0,100029.0,10
2025-08-14_08-18-36,471,"[np.float32(0.0), np.float32(0.0), np.float32(1.0), np.float32(1.0), np.float32(0.0), np.float32(1.0), np.float32(0.0), np.float32(0.0), np.float32(0.0), np.float32(1.0), np.float32(0.0), np.float32(0.0), np.float32(1.0), np.float32(0.0), np.float32(1.0), np.float32(0.0)]",-4.0,100025.0,2
2025-08-14_08-18-36,472,"[np.float32(1.0), np.float32(0.0), np.float32(0.0), np.float32(0.0), np.float32(1.0), np.float32(1.0), np.float32(0.0), np.float32(1.0), np.float32(0.0), np.float32(0.0), np.float32(1.0), np.float32(1.0), np.float32(0.0), np.float32(0.0), np.float32(1.0), np.float32(1.0)]",-4.0,100021.0,7
2025-08-14_08-18-36,473,"[np.float32(0.0), np.float32(0.0), np.float32(1.0), np.float32(0.0), np.float32(1.0), np.float32(0.0), np.float32(1.0), np.float32(1.0), np.float32(0.0), np.float32(1.0), np.float32(0.0), np.float32(0.0), np.float32(0.0), np.float32(0.0), np.float32(1.0), np.float32(0.0)]",2.0,100023.0,24
2025-08-14_08-18-36,474,"[np.float32(1.0), np.float32(0.0), np.float32(1.0), np.float32(1.0), np.float32(1.0), np.float32(1.0), np.float32(1.0), np.float32(0.0), np.float32(1.0), np.float32(0.0), np.float32(0.0), np.float32(1.0), np.float32(0.0), np.float32(1.0), np.float32(0.0), np.float32(0.0)]",-2.0,100021.0,24
2025-08-14_08-18-36,475,"[np.float32(1.0), np.float32(0.0), np.float32(0.0), np.float32(1.0), np.float32(0.0), np.float32(0.0), np.float32(1.0), np.float32(0.0), np.float32(1.0), np.float32(0.0), np.float32(0.0), np.float32(0.0), np.float32(0.0), np.float32(1.0), np.float32(0.0), np.float32(0.0)]",5.0,100026.0,3
2025-08-14_08-18-36,476,"[np.float32(0.0), np.float32(1.0), np.float32(1.0), np.float32(0.0), np.float32(0.0), np.float32(1.0), np.float32(1.0), np.float32(1.0), np.float32(1.0), np.float32(1.0), np.float32(1.0), np.float32(0.0), np.float32(1.0), np.float32(0.0), np.float32(1.0), np.float32(1.0)]",-6.0,100020.0,18
2025-08-14_08-18-36,477,"[np.float32(1.0), np.float32(1.0), np.float32(0.0), np.float32(0.0), np.float32(1.0), np.float32(0.0), np.float32(0.0), np.float32(1.0), np.float32(1.0), np.float32(1.0), np.float32(0.0), np.float32(1.0), np.float32(0.0), np.float32(0.0), np.float32(0.0), np.float32(0.0)]",1.0,100021.0,36
2025-08-14_08-18-36,478,"[np.float32(1.0), np.float32(1.0), np.float32(1.0), np.float32(0.0), np.float32(0.0), np.float32(1.0), np.float32(1.0), np.float32(1.0), np.float32(0.0), np.float32(0.0), np.float32(0.0), np.float32(0.0), np.float32(0.0), np.float32(0.0), np.float32(1.0), np.float32(0.0)]",2.0,100023.0,20
2025-08-14_08-18-36,479,"[np.float32(1.0), np.float32(0.0), np.float32(1.0), np.float32(1.0), np.float32(0.0), np.float32(0.0), np.float32(0.0), np.float32(0.0), np.float32(0.0), np.float32(1.0), np.float32(0.0), np.float32(0.0), np.float32(1.0), np.float32(1.0), np.float32(0.0), np.float32(0.0)]",-2.0,100021.0,30
2025-08-14_08-18-36,480,"[np.float32(1.0), np.float32(0.0), np.float32(1.0), np.float32(1.0), np.float32(0.0), np.float32(0.0), np.float32(1.0), np.float32(0.0), np.float32(1.0), np.float32(1.0), np.float32(1.0), np.float32(1.0), np.float32(1.0), np.float32(0.0), np.float32(1.0), np.float32(0.0)]",1.0,100022.0,11
2025-08-14_08-18-36,481,"[np.float32(0.0), np.float32(1.0), np.float32(0.0), np.float32(0.0), np.float32(1.0), np.float32(0.0), np.float32(1.0), np.float32(0.0), np.float32(0.0), np.float32(0.0), np.float32(1.0), np.float32(0.0), np.float32(0.0), np.float32(1.0), np.float32(1.0), np.float32(0.0)]",-1.0,100021.0,14
2025-08-14_08-18-36,482,"[np.float32(1.0), np.float32(1.0), np.float32(1.0), np.float32(1.0), np.float32(1.0), np.float32(1.0), np.float32(1.0), np.float32(1.0), np.float32(0.0), np.float32(1.0), np.float32(1.0), np.float32(0.0), np.float32(1.0), np.float32(1.0), np.float32(0.0), np.float32(0.0)]",0.0,100021.0,16
2025-08-14_08-18-36,483,"[np.float32(0.0), np.float32(0.0), np.float32(0.0), np.float32(1.0), np.float32(0.0), np.float32(0.0), np.float32(0.0), np.float32(0.0), np.float32(1.0), np.float32(0.0), np.float32(1.0), np.float32(0.0), np.float32(1.0), np.float32(1.0), np.float32(0.0), np.float32(0.0)]",-5.0,100016.0,10
2025-08-14_08-18-36,484,"[np.float32(0.0), np.float32(1.0), np.float32(1.0), np.float32(1.0), np.float32(0.0), np.float32(1.0), np.float32(0.0), np.float32(0.0), np.float32(1.0), np.float32(0.0), np.float32(0.0), np.float32(0.0), np.float32(1.0), np.float32(0.0), np.float32(1.0), np.float32(1.0)]",30.0,100046.0,7
2025-08-14_08-18-36,485,"[np.float32(0.0), np.float32(1.0), np.float32(0.0), np.float32(0.0), np.float32(1.0), np.float32(1.0), np.float32(1.0), np.float32(1.0), np.float32(0.0), np.float32(0.0), np.float32(1.0), np.float32(1.0), np.float32(0.0), np.float32(0.0), np.float32(1.0), np.float32(0.0)]",2.0,100048.0,2
2025-08-14_08-18-36,486,"[np.float32(0.0), np.float32(0.0), np.float32(1.0), np.float32(1.0), np.float32(1.0), np.float32(1.0), np.float32(0.0), np.float32(1.0), np.float32(1.0), np.float32(1.0), np.float32(0.0), np.float32(0.0), np.float32(0.0), np.float32(1.0), np.float32(1.0), np.float32(0.0)]",1.0,100049.0,21
2025-08-14_08-18-36,487,"[np.float32(1.0), np.float32(0.0), np.float32(0.0), np.float32(1.0), np.float32(0.0), np.float32(0.0), np.float32(1.0), np.float32(1.0), np.float32(1.0), np.float32(0.0), np.float32(1.0), np.float32(1.0), np.float32(1.0), np.float32(0.0), np.float32(1.0), np.float32(1.0)]",-1.0,100048.0,8
2025-08-14_08-18-36,488,"[np.float32(1.0), np.float32(1.0), np.float32(0.0), np.float32(1.0), np.float32(1.0), np.float32(0.0), np.float32(1.0), np.float32(0.0), np.float32(1.0), np.float32(0.0), np.float32(1.0), np.float32(0.0), np.float32(1.0), np.float32(1.0), np.float32(0.0), np.float32(0.0)]",-4.0,100044.0,30
2025-08-14_08-18-36,489,"[np.float32(1.0), np.float32(1.0), np.float32(0.0), np.float32(0.0), np.float32(1.0), np.float32(1.0), np.float32(0.0), np.float32(1.0), np.float32(1.0), np.float32(0.0), np.float32(0.0), np.float32(1.0), np.float32(1.0), np.float32(0.0), np.float32(1.0), np.float32(0.0)]",-2.0,100042.0,11
2025-08-14_08-18-36,490,"[np.float32(0.0), np.float32(0.0), np.float32(0.0), np.float32(1.0), np.float32(0.0), np.float32(0.0), np.float32(0.0), np.float32(0.0), np.float32(1.0), np.float32(1.0), np.float32(0.0), np.float32(1.0), np.float32(0.0), np.float32(0.0), np.float32(0.0), np.float32(0.0)]",1.0,100043.0,29
2025-08-14_08-18-36,491,"[np.float32(1.0), np.float32(0.0), np.float32(1.0), np.float32(1.0), np.float32(0.0), np.float32(1.0), np.float32(1.0), np.float32(1.0), np.float32(1.0), np.float32(0.0), np.float32(1.0), np.float32(1.0), np.float32(1.0), np.float32(0.0), np.float32(0.0), np.float32(1.0)]",-3.0,100040.0,15
2025-08-14_08-18-36,492,"[np.float32(1.0), np.float32(1.0), np.float32(1.0), np.float32(1.0), np.float32(0.0), np.float32(1.0), np.float32(1.0), np.float32(1.0), np.float32(0.0), np.float32(0.0), np.float32(1.0), np.float32(0.0), np.float32(1.0), np.float32(0.0), np.float32(0.0), np.float32(1.0)]",33.0,100073.0,7
2025-08-14_08-18-36,493,"[np.float32(0.0), np.float32(1.0), np.float32(1.0), np.float32(0.0), np.float32(1.0), np.float32(1.0), np.float32(0.0), np.float32(0.0), np.float32(1.0), np.float32(0.0), np.float32(0.0), np.float32(0.0), np.float32(0.0), np.float32(0.0), np.float32(1.0), np.float32(0.0)]",-1.0,100072.0,5
2025-08-14_08-18-36,494,"[np.float32(1.0), np.float32(0.0), np.float32(0.0), np.float32(1.0), np.float32(0.0), np.float32(0.0), np.float32(0.0), np.float32(0.0), np.float32(1.0), np.float32(0.0), np.float32(1.0), np.float32(1.0), np.float32(0.0), np.float32(1.0), np.float32(0.0), np.float32(1.0)]",0.0,100072.0,1
2025-08-14_08-18-36,495,"[np.float32(1.0), np.float32(0.0), np.float32(0.0), np.float32(1.0), np.float32(0.0), np.float32(1.0), np.float32(0.0), np.float32(0.0), np.float32(0.0), np.float32(1.0), np.float32(1.0), np.float32(0.0), np.float32(0.0), np.float32(0.0), np.float32(1.0), np.float32(0.0)]",0.0,100072.0,10
2025-08-14_08-18-36,496,"[np.float32(0.0), np.float32(0.0), np.float32(0.0), np.float32(0.0), np.float32(0.0), np.float32(1.0), np.float32(0.0), np.float32(1.0), np.float32(0.0), np.float32(0.0), np.float32(0.0), np.float32(0.0), np.float32(0.0), np.float32(1.0), np.float32(1.0), np.float32(0.0)]",1.0,100073.0,0
2025-08-14_08-18-36,497,"[np.float32(0.0), np.float32(0.0), np.float32(1.0), np.float32(1.0), np.float32(0.0), np.float32(1.0), np.float32(1.0), np.float32(1.0), np.float32(0.0), np.float32(1.0), np.float32(1.0), np.float32(0.0), np.float32(0.0), np.float32(1.0), np.float32(0.0), np.float32(1.0)]",-1.0,100072.0,12
2025-08-14_08-18-36,498,"[np.float32(1.0), np.float32(0.0), np.float32(1.0), np.float32(0.0), np.float32(0.0), np.float32(1.0), np.float32(0.0), np.float32(1.0), np.float32(0.0), np.float32(0.0), np.float32(1.0), np.float32(1.0), np.float32(0.0), np.float32(1.0), np.float32(1.0), np.float32(0.0)]",2.0,100074.0,12
2025-08-14_08-18-36,499,"[np.float32(1.0), np.float32(1.0), np.float32(1.0), np.float32(1.0), np.float32(0.0), np.float32(1.0), np.float32(1.0), np.float32(1.0), np.float32(1.0), np.float32(0.0), np.float32(0.0), np.float32(1.0), np.float32(0.0), np.float32(0.0), np.float32(0.0), np.float32(1.0)]",0.0,100074.0,1
2025-08-14_08-18-36,500,"[np.float32(1.0), np.float32(1.0), np.float32(1.0), np.float32(1.0), np.float32(1.0), np.float32(1.0), np.float32(1.0), np.float32(1.0), np.float32(1.0), np.float32(0.0), np.float32(1.0), np.float32(0.0), np.float32(1.0), np.float32(1.0), np.float32(1.0), np.float32(0.0)]",-1.0,100073.0,24
2025-08-14_08-18-36,501,"[np.float32(0.0), np.float32(0.0), np.float32(1.0), np.float32(1.0), np.float32(1.0), np.float32(1.0), np.float32(0.0), np.float32(0.0), np.float32(1.0), np.float32(1.0), np.float32(0.0), np.float32(0.0), np.float32(1.0), np.float32(1.0), np.float32(1.0), np.float32(0.0)]",1.0,100074.0,33
2025-08-14_08-18-36,502,"[np.float32(0.0), np.float32(1.0), np.float32(0.0), np.float32(1.0), np.float32(0.0), np.float32(0.0), np.float32(0.0), np.float32(1.0), np.float32(0.0), np.float32(0.0), np.float32(1.0), np.float32(1.0), np.float32(1.0), np.float32(1.0), np.float32(1.0), np.float32(0.0)]",-2.0,100072.0,16
2025-08-14_08-18-36,503,"[np.float32(0.0), np.float32(1.0), np.float32(0.0), np.float32(0.0), np.float32(1.0), np.float32(1.0), np.float32(0.0), np.float32(0.0), np.float32(1.0), np.float32(0.0), np.float32(1.0), np.float32(0.0), np.float32(1.0), np.float32(0.0), np.float32(0.0), np.float32(1.0)]",-5.0,100067.0,21
2025-08-14_08-18-36,504,"[np.float32(1.0), np.float32(0.0), np.float32(0.0), np.float32(0.0), np.float32(1.0), np.float32(0.0), np.float32(0.0), np.float32(0.0), np.float32(0.0), np.float32(1.0), np.float32(1.0), np.float32(0.0), np.float32(0.0), np.float32(1.0), np.float32(0.0), np.float32(1.0)]",-4.0,100063.0,36
2025-08-14_08-18-36,505,"[np.float32(1.0), np.float32(0.0), np.float32(0.0), np.float32(0.0), np.float32(0.0), np.float32(1.0), np.float32(0.0), np.float32(0.0), np.float32(1.0), np.float32(1.0), np.float32(0.0), np.float32(0.0), np.float32(1.0), np.float32(1.0), np.float32(0.0), np.float32(1.0)]",-4.0,100059.0,15
2025-08-14_08-18-36,506,"[np.float32(1.0), np.float32(0.0), np.float32(1.0), np.float32(0.0), np.float32(0.0), np.float32(1.0), np.float32(0.0), np.float32(0.0), np.float32(0.0), np.float32(0.0), np.float32(0.0), np.float32(1.0), np.float32(0.0), np.float32(0.0), np.float32(0.0), np.float32(0.0)]",-2.0,100057.0,29
2025-08-14_08-18-36,507,"[np.float32(1.0), np.float32(0.0), np.float32(1.0), np.float32(0.0), np.float32(0.0), np.float32(0.0), np.float32(0.0), np.float32(1.0), np.float32(1.0), np.float32(0.0), np.float32(0.0), np.float32(0.0), np.float32(0.0), np.float32(0.0), np.float32(1.0), np.float32(0.0)]",3.0,100060.0,27
2025-08-14_08-18-36,508,"[np.float32(0.0), np.float32(0.0), np.float32(1.0), np.float32(1.0), np.float32(0.0), np.float32(0.0), np.float32(0.0), np.float32(1.0), np.float32(1.0), np.float32(1.0), np.float32(1.0), np.float32(0.0), np.float32(0.0), np.float32(1.0), np.float32(0.0), np.float32(0.0)]",-2.0,100058.0,8
2025-08-14_08-18-36,509,"[np.float32(1.0), np.float32(1.0), np.float32(1.0), np.float32(1.0), np.float32(1.0), np.float32(0.0), np.float32(0.0), np.float32(1.0), np.float32(1.0), np.float32(1.0), np.float32(1.0), np.float32(1.0), np.float32(0.0), np.float32(1.0), np.float32(1.0), np.float32(0.0)]",1.0,100059.0,30
2025-08-14_08-18-36,510,"[np.float32(0.0), np.float32(1.0), np.float32(1.0), np.float32(1.0), np.float32(1.0), np.float32(0.0), np.float32(1.0), np.float32(0.0), np.float32(1.0), np.float32(1.0), np.float32(1.0), np.float32(0.0), np.float32(1.0), np.float32(1.0), np.float32(0.0), np.float32(1.0)]",-6.0,100053.0,21
2025-08-14_08-18-36,511,"[np.float32(0.0), np.float32(1.0), np.float32(0.0), np.float32(1.0), np.float32(1.0), np.float32(0.0), np.float32(0.0), np.float32(1.0), np.float32(1.0), np.float32(0.0), np.float32(0.0), np.float32(0.0), np.float32(1.0), np.float32(0.0), np.float32(0.0), np.float32(1.0)]",-2.0,100051.0,26
2025-08-14_08-18-36,512,"[np.float32(1.0), np.float32(1.0), np.float32(1.0), np.float32(1.0), np.float32(0.0), np.float32(0.0), np.float32(0.0), np.float32(0.0), np.float32(0.0), np.float32(0.0), np.float32(0.0), np.float32(1.0), np.float32(0.0), np.float32(0.0), np.float32(0.0), np.float32(1.0)]",1.0,100052.0,31
2025-08-14_08-18-36,513,"[np.float32(1.0), np.float32(1.0), np.float32(1.0), np.float32(0.0), np.float32(1.0), np.float32(1.0), np.float32(1.0), np.float32(0.0), np.float32(1.0), np.float32(1.0), np.float32(1.0), np.float32(0.0), np.float32(1.0), np.float32(0.0), np.float32(1.0), np.float32(0.0)]",-2.0,100050.0,14
2025-08-14_08-18-36,514,"[np.float32(1.0), np.float32(1.0), np.float32(1.0), np.float32(0.0), np.float32(1.0), np.float32(0.0), np.float32(0.0), np.float32(1.0), np.float32(1.0), np.float32(0.0), np.float32(1.0), np.float32(1.0), np.float32(1.0), np.float32(0.0), np.float32(0.0), np.float32(1.0)]",0.0,100050.0,9
2025-08-14_08-18-36,515,"[np.float32(1.0), np.float32(0.0), np.float32(1.0), np.float32(1.0), np.float32(1.0), np.float32(1.0), np.float32(0.0), np.float32(1.0), np.float32(1.0), np.float32(1.0), np.float32(1.0), np.float32(0.0), np.float32(0.0), np.float32(0.0), np.float32(1.0), np.float32(0.0)]",2.0,100052.0,19
2025-08-14_08-18-36,516,"[np.float32(1.0), np.float32(0.0), np.float32(1.0), np.float32(1.0), np.float32(1.0), np.float32(1.0), np.float32(1.0), np.float32(0.0), np.float32(0.0), np.float32(1.0), np.float32(1.0), np.float32(0.0), np.float32(1.0), np.float32(1.0), np.float32(0.0), np.float32(1.0)]",1.0,100053.0,19
2025-08-14_08-18-36,517,"[np.float32(1.0), np.float32(0.0), np.float32(0.0), np.float32(0.0), np.float32(0.0), np.float32(1.0), np.float32(1.0), np.float32(1.0), np.float32(1.0), np.float32(0.0), np.float32(0.0), np.float32(0.0), np.float32(0.0), np.float32(0.0), np.float32(0.0), np.float32(0.0)]",2.0,100055.0,34
2025-08-14_08-18-36,518,"[np.float32(1.0), np.float32(1.0), np.float32(0.0), np.float32(1.0), np.float32(1.0), np.float32(1.0), np.float32(1.0), np.float32(0.0), np.float32(1.0), np.float32(1.0), np.float32(1.0), np.float32(0.0), np.float32(1.0), np.float32(1.0), np.float32(0.0), np.float32(1.0)]",-5.0,100050.0,16
2025-08-14_08-18-36,519,"[np.float32(0.0), np.float32(1.0), np.float32(1.0), np.float32(0.0), np.float32(1.0), np.float32(0.0), np.float32(0.0), np.float32(1.0), np.float32(1.0), np.float32(0.0), np.float32(1.0), np.float32(1.0), np.float32(0.0), np.float32(0.0), np.float32(1.0), np.float32(0.0)]",1.0,100051.0,10
2025-08-14_08-18-36,520,"[np.float32(1.0), np.float32(0.0), np.float32(0.0), np.float32(1.0), np.float32(0.0), np.float32(0.0), np.float32(0.0), np.float32(0.0), np.float32(1.0), np.float32(1.0), np.float32(1.0), np.float32(1.0), np.float32(1.0), np.float32(0.0), np.float32(0.0), np.float32(1.0)]",2.0,100053.0,27
2025-08-14_08-18-36,521,"[np.float32(1.0), np.float32(1.0), np.float32(0.0), np.float32(1.0), np.float32(0.0), np.float32(1.0), np.float32(0.0), np.float32(0.0), np.float32(1.0), np.float32(1.0), np.float32(0.0), np.float32(1.0), np.float32(1.0), np.float32(0.0), np.float32(1.0), np.float32(0.0)]",3.0,100056.0,25
2025-08-14_08-18-36,522,"[np.float32(0.0), np.float32(1.0), np.float32(1.0), np.float32(1.0), np.float32(0.0), np.float32(1.0), np.float32(0.0), np.float32(0.0), np.float32(0.0), np.float32(1.0), np.float32(1.0), np.float32(0.0), np.float32(0.0), np.float32(0.0), np.float32(0.0), np.float32(1.0)]",-5.0,100051.0,12
2025-08-14_08-18-36,523,"[np.float32(1.0), np.float32(0.0), np.float32(1.0), np.float32(1.0), np.float32(0.0), np.float32(1.0), np.float32(0.0), np.float32(1.0), np.float32(0.0), np.float32(1.0), np.float32(0.0), np.float32(0.0), np.float32(0.0), np.float32(1.0), np.float32(0.0), np.float32(1.0)]",4.0,100055.0,25
2025-08-14_08-18-36,524,"[np.float32(1.0), np.float32(1.0), np.float32(1.0), np.float32(1.0), np.float32(1.0), np.float32(1.0), np.float32(0.0), np.float32(0.0), np.float32(0.0), np.float32(0.0), np.float32(0.0), np.float32(0.0), np.float32(1.0), np.float32(0.0), np.float32(1.0), np.float32(0.0)]",-2.0,100053.0,22
2025-08-14_08-18-36,525,"[np.float32(0.0), np.float32(1.0), np.float32(0.0), np.float32(0.0), np.float32(1.0), np.float32(0.0), np.float32(0.0), np.float32(1.0), np.float32(1.0), np.float32(0.0), np.float32(1.0), np.float32(0.0), np.float32(1.0), np.float32(1.0), np.float32(0.0), np.float32(1.0)]",-3.0,100050.0,9
2025-08-14_08-18-36,526,"[np.float32(1.0), np.float32(1.0), np.float32(0.0), np.float32(1.0), np.float32(0.0), np.float32(0.0), np.float32(1.0), np.float32(0.0), np.float32(1.0), np.float32(1.0), np.float32(1.0), np.float32(0.0), np.float32(1.0), np.float32(1.0), np.float32(0.0), np.float32(0.0)]",2.0,100052.0,4
2025-08-14_08-18-36,527,"[np.float32(1.0), np.float32(0.0), np.float32(1.0), np.float32(0.0), np.float32(0.0), np.float32(1.0), np.float32(0.0), np.float32(1.0), np.float32(0.0), np.float32(1.0), np.float32(1.0), np.float32(0.0), np.float32(1.0), np.float32(0.0), np.float32(0.0), np.float32(0.0)]",2.0,100054.0,34
2025-08-14_08-18-36,528,"[np.float32(0.0), np.float32(0.0), np.float32(0.0), np.float32(1.0), np.float32(1.0), np.float32(1.0), np.float32(1.0), np.float32(0.0), np.float32(0.0), np.float32(0.0), np.float32(0.0), np.float32(0.0), np.float32(0.0), np.float32(0.0), np.float32(0.0), np.float32(0.0)]",1.0,100055.0,8
2025-08-14_08-18-36,529,"[np.float32(0.0), np.float32(0.0), np.float32(0.0), np.float32(1.0), np.float32(1.0), np.float32(1.0), np.float32(1.0), np.float32(1.0), np.float32(0.0), np.float32(0.0), np.float32(1.0), np.float32(0.0), np.float32(1.0), np.float32(0.0), np.float32(0.0), np.float32(1.0)]",-3.0,100052.0,16
2025-08-14_08-18-36,530,"[np.float32(1.0), np.float32(1.0), np.float32(0.0), np.float32(1.0), np.float32(0.0), np.float32(0.0), np.float32(0.0), np.float32(1.0), np.float32(0.0), np.float32(1.0), np.float32(1.0), np.float32(0.0), np.float32(0.0), np.float32(1.0), np.float32(0.0), np.float32(1.0)]",-3.0,100049.0,6
2025-08-14_08-18-36,531,"[np.float32(1.0), np.float32(0.0), np.float32(1.0), np.float32(1.0), np.float32(0.0), np.float32(1.0), np.float32(0.0), np.float32(1.0), np.float32(1.0), np.float32(1.0), np.float32(1.0), np.float32(1.0), np.float32(0.0), np.float32(1.0), np.float32(1.0), np.float32(1.0)]",3.0,100052.0,34
2025-08-14_08-18-36,532,"[np.float32(1.0), np.float32(0.0), np.float32(0.0), np.float32(0.0), np.float32(0.0), np.float32(0.0), np.float32(0.0), np.float32(1.0), np.float32(1.0), np.float32(1.0), np.float32(1.0), np.float32(1.0), np.float32(1.0), np.float32(0.0), np.float32(1.0), np.float32(0.0)]",-2.0,100050.0,35
2025-08-14_08-18-36,533,"[np.float32(1.0), np.float32(1.0), np.float32(0.0), np.float32(1.0), np.float32(0.0), np.float32(0.0), np.float32(0.0), np.float32(1.0), np.float32(1.0), np.float32(0.0), np.float32(0.0), np.float32(0.0), np.float32(0.0), np.float32(0.0), np.float32(0.0), np.float32(1.0)]",-2.0,100048.0,11
2025-08-14_08-18-36,534,"[np.float32(0.0), np.float32(0.0), np.float32(1.0), np.float32(1.0), np.float32(0.0), np.float32(0.0), np.float32(0.0), np.float32(1.0), np.float32(1.0), np.float32(1.0), np.float32(1.0), np.float32(0.0), np.float32(0.0), np.float32(0.0), np.float32(1.0), np.float32(1.0)]",3.0,100051.0,20
2025-08-14_08-18-36,535,"[np.float32(0.0), np.float32(0.0), np.float32(1.0), np.float32(1.0), np.float32(0.0), np.float32(1.0), np.float32(0.0), np.float32(0.0), np.float32(1.0), np.float32(1.0), np.float32(1.0), np.float32(1.0), np.float32(1.0), np.float32(0.0), np.float32(0.0), np.float32(0.0)]",-3.0,100048.0,13
2025-08-14_08-18-36,536,"[np.float32(0.0), np.float32(0.0), np.float32(1.0), np.float32(1.0), np.float32(1.0), np.float32(0.0), np.float32(1.0), np.float32(1.0), np.float32(1.0), np.float32(1.0), np.float32(1.0), np.float32(1.0), np.float32(0.0), np.float32(1.0), np.float32(1.0), np.float32(0.0)]",-1.0,100047.0,14
2025-08-14_08-18-36,537,"[np.float32(0.0), np.float32(1.0), np.float32(1.0), np.float32(1.0), np.float32(0.0), np.float32(1.0), np.float32(0.0), np.float32(1.0), np.float32(1.0), np.float32(1.0), np.float32(1.0), np.float32(0.0), np.float32(1.0), np.float32(0.0), np.float32(0.0), np.float32(0.0)]",3.0,100050.0,29
2025-08-14_08-18-36,538,"[np.float32(0.0), np.float32(1.0), np.float32(1.0), np.float32(1.0), np.float32(1.0), np.float32(1.0), np.float32(1.0), np.float32(1.0), np.float32(0.0), np.float32(1.0), np.float32(0.0), np.float32(0.0), np.float32(0.0), np.float32(0.0), np.float32(1.0), np.float32(0.0)]",-2.0,100048.0,14
2025-08-14_08-18-36,539,"[np.float32(1.0), np.float32(1.0), np.float32(0.0), np.float32(0.0), np.float32(1.0), np.float32(0.0), np.float32(1.0), np.float32(0.0), np.float32(0.0), np.float32(0.0), np.float32(1.0), np.float32(1.0), np.float32(0.0), np.float32(0.0), np.float32(0.0), np.float32(1.0)]",3.0,100051.0,11
2025-08-14_08-18-36,540,"[np.float32(0.0), np.float32(0.0), np.float32(1.0), np.float32(1.0), np.float32(0.0), np.float32(0.0), np.float32(1.0), np.float32(1.0), np.float32(1.0), np.float32(0.0), np.float32(0.0), np.float32(0.0), np.float32(0.0), np.float32(0.0), np.float32(1.0), np.float32(0.0)]",2.0,100053.0,30
2025-08-14_08-18-36,541,"[np.float32(0.0), np.float32(0.0), np.float32(1.0), np.float32(1.0), np.float32(0.0), np.float32(1.0), np.float32(0.0), np.float32(0.0), np.float32(0.0), np.float32(1.0), np.float32(1.0), np.float32(0.0), np.float32(1.0), np.float32(1.0), np.float32(0.0), np.float32(1.0)]",-3.0,100050.0,9
2025-08-14_08-18-36,542,"[np.float32(1.0), np.float32(1.0), np.float32(0.0), np.float32(0.0), np.float32(0.0), np.float32(1.0), np.float32(1.0), np.float32(1.0), np.float32(0.0), np.float32(0.0), np.float32(0.0), np.float32(1.0), np.float32(1.0), np.float32(0.0), np.float32(1.0), np.float32(1.0)]",-1.0,100049.0,18
2025-08-14_08-18-36,543,"[np.float32(1.0), np.float32(1.0), np.float32(1.0), np.float32(0.0), np.float32(1.0), np.float32(0.0), np.float32(1.0), np.float32(1.0), np.float32(1.0), np.float32(0.0), np.float32(0.0), np.float32(0.0), np.float32(0.0), np.float32(0.0), np.float32(1.0), np.float32(0.0)]",0.0,100049.0,33
2025-08-14_08-18-36,544,"[np.float32(1.0), np.float32(0.0), np.float32(0.0), np.float32(1.0), np.float32(1.0), np.float32(1.0), np.float32(1.0), np.float32(1.0), np.float32(0.0), np.float32(1.0), np.float32(1.0), np.float32(1.0), np.float32(1.0), np.float32(1.0), np.float32(1.0), np.float32(1.0)]",-5.0,100044.0,28
2025-08-14_08-18-36,545,"[np.float32(0.0), np.float32(1.0), np.float32(0.0), np.float32(1.0), np.float32(1.0), np.float32(0.0), np.float32(1.0), np.float32(0.0), np.float32(0.0), np.float32(1.0), np.float32(0.0), np.float32(0.0), np.float32(0.0), np.float32(0.0), np.float32(0.0), np.float32(1.0)]",4.0,100048.0,9
2025-08-14_08-18-36,546,"[np.float32(0.0), np.float32(0.0), np.float32(1.0), np.float32(1.0), np.float32(1.0), np.float32(1.0), np.float32(0.0), np.float32(1.0), np.float32(0.0), np.float32(1.0), np.float32(0.0), np.float32(0.0), np.float32(1.0), np.float32(1.0), np.float32(1.0), np.float32(1.0)]",36.0,100084.0,7
2025-08-14_08-18-36,547,"[np.float32(0.0), np.float32(1.0), np.float32(1.0), np.float32(1.0), np.float32(0.0), np.float32(1.0), np.float32(1.0), np.float32(1.0), np.float32(1.0), np.float32(1.0), np.float32(0.0), np.float32(0.0), np.float32(0.0), np.float32(0.0), np.float32(1.0), np.float32(0.0)]",1.0,100085.0,23
2025-08-14_08-18-36,548,"[np.float32(0.0), np.float32(1.0), np.float32(1.0), np.float32(1.0), np.float32(0.0), np.float32(1.0), np.float32(1.0), np.float32(0.0), np.float32(1.0), np.float32(1.0), np.float32(1.0), np.float32(0.0), np.float32(0.0), np.float32(0.0), np.float32(1.0), np.float32(0.0)]",1.0,100086.0,25
2025-08-14_08-18-36,549,"[np.float32(0.0), np.float32(0.0), np.float32(0.0), np.float32(1.0), np.float32(1.0), np.float32(1.0), np.float32(1.0), np.float32(0.0), np.float32(0.0), np.float32(1.0), np.float32(0.0), np.float32(0.0), np.float32(1.0), np.float32(1.0), np.float32(0.0), np.float32(1.0)]",-6.0,100080.0,24
2025-08-14_08-18-36,550,"[np.float32(1.0), np.float32(0.0), np.float32(1.0), np.float32(1.0), np.float32(1.0), np.float32(1.0), np.float32(0.0), np.float32(1.0), np.float32(0.0), np.float32(0.0), np.float32(0.0), np.float32(0.0), np.float32(1.0), np.float32(0.0), np.float32(0.0), np.float32(0.0)]",-1.0,100079.0,32
2025-08-14_08-18-36,551,"[np.float32(1.0), np.float32(1.0), np.float32(0.0), np.float32(1.0), np.float32(1.0), np.float32(1.0), np.float32(0.0), np.float32(1.0), np.float32(0.0), np.float32(1.0), np.float32(1.0), np.float32(1.0), np.float32(1.0), np.float32(1.0), np.float32(1.0), np.float32(1.0)]",-3.0,100076.0,6
2025-08-14_08-18-36,552,"[np.float32(1.0), np.float32(0.0), np.float32(1.0), np.float32(0.0), np.float32(1.0), np.float32(0.0), np.float32(0.0), np.float32(1.0), np.float32(0.0), np.float32(1.0), np.float32(0.0), np.float32(0.0), np.float32(1.0), np.float32(1.0), np.float32(0.0), np.float32(0.0)]",-7.0,100069.0,33
2025-08-14_08-18-36,553,"[np.float32(1.0), np.float32(1.0), np.float32(1.0), np.float32(0.0), np.float32(1.0), np.float32(0.0), np.float32(0.0), np.float32(1.0), np.float32(0.0), np.float32(1.0), np.float32(1.0), np.float32(0.0), np.float32(1.0), np.float32(1.0), np.float32(1.0), np.float32(0.0)]",1.0,100070.0,19
2025-08-14_08-18-36,554,"[np.float32(1.0), np.float32(0.0), np.float32(0.0), np.float32(0.0), np.float32(1.0), np.float32(1.0), np.float32(1.0), np.float32(1.0), np.float32(0.0), np.float32(0.0), np.float32(0.0), np.float32(0.0), np.float32(0.0), np.float32(0.0), np.float32(1.0), np.float32(0.0)]",-2.0,100068.0,25
2025-08-14_08-18-36,555,"[np.float32(0.0), np.float32(1.0), np.float32(1.0), np.float32(1.0), np.float32(1.0), np.float32(1.0), np.float32(1.0), np.float32(1.0), np.float32(0.0), np.float32(0.0), np.float32(0.0), np.float32(1.0), np.float32(0.0), np.float32(0.0), np.float32(0.0), np.float32(1.0)]",-2.0,100066.0,36
2025-08-14_08-18-36,556,"[np.float32(0.0), np.float32(1.0), np.float32(0.0), np.float32(0.0), np.float32(1.0), np.float32(1.0), np.float32(0.0), np.float32(0.0), np.float32(1.0), np.float32(1.0), np.float32(0.0), np.float32(1.0), np.float32(1.0), np.float32(0.0), np.float32(1.0), np.float32(1.0)]",-4.0,100062.0,21
2025-08-14_08-18-36,557,"[np.float32(0.0), np.float32(0.0), np.float32(1.0), np.float32(0.0), np.float32(1.0), np.float32(1.0), np.float32(1.0), np.float32(0.0), np.float32(0.0), np.float32(0.0), np.float32(1.0), np.float32(1.0), np.float32(0.0), np.float32(1.0), np.float32(0.0), np.float32(0.0)]",0.0,100062.0,0
2025-08-14_08-18-36,558,"[np.float32(1.0), np.float32(1.0), np.float32(1.0), np.float32(0.0), np.float32(1.0), np.float32(1.0), np.float32(1.0), np.float32(0.0), np.float32(0.0), np.float32(0.0), np.float32(0.0), np.float32(1.0), np.float32(0.0), np.float32(0.0), np.float32(0.0), np.float32(0.0)]",-3.0,100059.0,19
2025-08-14_08-18-36,559,"[np.float32(0.0), np.float32(1.0), np.float32(1.0), np.float32(0.0), np.float32(0.0), np.float32(0.0), np.float32(1.0), np.float32(0.0), np.float32(1.0), np.float32(0.0), np.float32(1.0), np.float32(1.0), np.float32(1.0), np.float32(1.0), np.float32(1.0), np.float32(1.0)]",3.0,100062.0,2
2025-08-14_08-18-36,560,"[np.float32(1.0), np.float32(0.0), np.float32(0.0), np.float32(1.0), np.float32(0.0), np.float32(0.0), np.float32(1.0), np.float32(0.0), np.float32(1.0), np.float32(1.0), np.float32(0.0), np.float32(1.0), np.float32(1.0), np.float32(0.0), np.float32(0.0), np.float32(0.0)]",-2.0,100060.0,18
2025-08-14_08-18-36,561,"[np.float32(0.0), np.float32(0.0), np.float32(1.0), np.float32(1.0), np.float32(0.0), np.float32(1.0), np.float32(0.0), np.float32(1.0), np.float32(0.0), np.float32(0.0), np.float32(1.0), np.float32(1.0), np.float32(0.0), np.float32(0.0), np.float32(0.0), np.float32(1.0)]",-3.0,100057.0,28
2025-08-14_08-18-36,562,"[np.float32(0.0), np.float32(0.0), np.float32(1.0), np.float32(0.0), np.float32(1.0), np.float32(1.0), np.float32(1.0), np.float32(0.0), np.float32(1.0), np.float32(0.0), np.float32(0.0), np.float32(0.0), np.float32(1.0), np.float32(1.0), np.float32(0.0), np.float32(0.0)]",-5.0,100052.0,13
2025-08-14_08-18-36,563,"[np.float32(1.0), np.float32(0.0), np.float32(1.0), np.float32(0.0), np.float32(0.0), np.float32(0.0), np.float32(1.0), np.float32(1.0), np.float32(1.0), np.float32(0.0), np.float32(0.0), np.float32(1.0), np.float32(0.0), np.float32(0.0), np.float32(0.0), np.float32(0.0)]",-1.0,100051.0,28
2025-08-14_08-18-36,564,"[np.float32(1.0), np.float32(0.0), np.float32(1.0), np.float32(1.0), np.float32(0.0), np.float32(0.0), np.float32(0.0), np.float32(0.0), np.float32(1.0), np.float32(0.0), np.float32(0.0), np.float32(0.0), np.float32(0.0), np.float32(1.0), np.float32(1.0), np.float32(1.0)]",0.0,100051.0,14
2025-08-14_08-18-36,565,"[np.float32(0.0), np.float32(1.0), np.float32(0.0), np.float32(0.0), np.float32(1.0), np.float32(0.0), np.float32(0.0), np.float32(1.0), np.float32(1.0), np.float32(0.0), np.float32(1.0), np.float32(1.0), np.float32(1.0), np.float32(0.0), np.float32(1.0), np.float32(0.0)]",2.0,100053.0,8
2025-08-14_08-18-36,566,"[np.float32(0.0), np.float32(0.0), np.float32(0.0), np.float32(0.0), np.float32(0.0), np.float32(1.0), np.float32(0.0), np.float32(0.0), np.float32(0.0), np.float32(0.0), np.float32(0.0), np.float32(0.0), np.float32(0.0), np.float32(0.0), np.float32(1.0), np.float32(0.0)]",1.0,100054.0,8
2025-08-14_08-18-36,567,"[np.float32(1.0), np.float32(0.0), np.float32(0.0), np.float32(0.0), np.float32(0.0), np.float32(0.0), np.float32(1.0), np.float32(1.0), np.float32(0.0), np.float32(0.0), np.float32(0.0), np.float32(0.0), np.float32(1.0), np.float32(0.0), np.float32(0.0), np.float32(1.0)]",-5.0,100049.0,29
2025-08-14_08-18-36,568,"[np.float32(0.0), np.float32(0.0), np.float32(0.0), np.float32(0.0), np.float32(0.0), np.float32(1.0), np.float32(1.0), np.float32(0.0), np.float32(1.0), np.float32(0.0), np.float32(1.0), np.float32(0.0), np.float32(1.0), np.float32(1.0), np.float32(1.0), np.float32(1.0)]",0.0,100049.0,33
2025-08-14_08-18-36,569,"[np.float32(0.0), np.float32(1.0), np.float32(0.0), np.float32(1.0), np.float32(1.0), np.float32(0.0), np.float32(1.0), np.float32(1.0), np.float32(1.0), np.float32(1.0), np.float32(0.0), np.float32(0.0), np.float32(1.0), np.float32(0.0), np.float32(0.0), np.float32(0.0)]",-1.0,100048.0,5
2025-08-14_08-18-36,570,"[np.float32(0.0), np.float32(1.0), np.float32(1.0), np.float32(0.0), np.float32(0.0), np.float32(0.0), np.float32(1.0), np.float32(1.0), np.float32(0.0), np.float32(0.0), np.float32(0.0), np.float32(1.0), np.float32(1.0), np.float32(0.0), np.float32(1.0), np.float32(1.0)]",-1.0,100047.0,22
2025-08-14_08-18-36,571,"[np.float32(0.0), np.float32(0.0), np.float32(1.0), np.float32(0.0), np.float32(1.0), np.float32(1.0), np.float32(1.0), np.float32(1.0), np.float32(0.0), np.float32(0.0), np.float32(1.0), np.float32(1.0), np.float32(0.0), np.float32(1.0), np.float32(1.0), np.float32(0.0)]",-4.0,100043.0,1
2025-08-14_08-18-36,572,"[np.float32(0.0), np.float32(0.0), np.float32(0.0), np.float32(0.0), np.float32(0.0), np.float32(0.0), np.float32(0.0), np.float32(1.0), np.float32(1.0), np.float32(1.0), np.float32(0.0), np.float32(0.0), np.float32(1.0), np.float32(0.0), np.float32(0.0), np.float32(0.0)]",-1.0,100042.0,18
2025-08-14_08-18-36,573,"[np.float32(0.0), np.float32(1.0), np.float32(1.0), np.float32(0.0), np.float32(0.0), np.float32(1.0), np.float32(1.0), np.float32(1.0), np.float32(0.0), np.float32(0.0), np.float32(1.0), np.float32(0.0), np.float32(0.0), np.float32(1.0), np.float32(0.0), np.float32(0.0)]",-2.0,100040.0,13
2025-08-14_08-18-36,574,"[np.float32(1.0), np.float32(0.0), np.float32(0.0), np.float32(0.0), np.float32(0.0), np.float32(0.0), np.float32(0.0), np.float32(1.0), np.float32(0.0), np.float32(0.0), np.float32(1.0), np.float32(0.0), np.float32(1.0), np.float32(0.0), np.float32(0.0), np.float32(0.0)]",1.0,100041.0,5
2025-08-14_08-18-36,575,"[np.float32(0.0), np.float32(0.0), np.float32(1.0), np.float32(1.0), np.float32(1.0), np.float32(0.0), np.float32(0.0), np.float32(0.0), np.float32(1.0), np.float32(1.0), np.float32(1.0), np.float32(0.0), np.float32(0.0), np.float32(1.0), np.float32(0.0), np.float32(0.0)]",0.0,100041.0,16
2025-08-14_08-18-36,576,"[np.float32(0.0), np.float32(0.0), np.float32(0.0), np.float32(1.0), np.float32(1.0), np.float32(0.0), np.float32(0.0), np.float32(1.0), np.float32(1.0), np.float32(1.0), np.float32(1.0), np.float32(1.0), np.float32(1.0), np.float32(0.0), np.float32(0.0), np.float32(1.0)]",2.0,100043.0,31
2025-08-14_08-18-36,577,"[np.float32(0.0), np.float32(1.0), np.float32(0.0), np.float32(1.0), np.float32(1.0), np.float32(0.0), np.float32(1.0), np.float32(0.0), np.float32(1.0), np.float32(0.0), np.float32(0.0), np.float32(1.0), np.float32(0.0), np.float32(0.0), np.float32(1.0), np.float32(0.0)]",0.0,100043.0,1
2025-08-14_08-18-36,578,"[np.float32(0.0), np.float32(0.0), np.float32(0.0), np.float32(0.0), np.float32(0.0), np.float32(1.0), np.float32(1.0), np.float32(0.0), np.float32(1.0), np.float32(1.0), np.float32(0.0), np.float32(1.0), np.float32(1.0), np.float32(1.0), np.float32(1.0), np.float32(1.0)]",0.0,100043.0,4
2025-08-14_08-18-36,579,"[np.float32(1.0), np.float32(0.0), np.float32(0.0), np.float32(1.0), np.float32(0.0), np.float32(1.0), np.float32(0.0), np.float32(0.0), np.float32(0.0), np.float32(0.0), np.float32(1.0), np.float32(0.0), np.float32(0.0), np.float32(0.0), np.float32(1.0), np.float32(1.0)]",2.0,100045.0,17
2025-08-14_08-18-36,580,"[np.float32(0.0), np.float32(1.0), np.float32(0.0), np.float32(0.0), np.float32(1.0), np.float32(0.0), np.float32(1.0), np.float32(0.0), np.float32(0.0), np.float32(0.0), np.float32(1.0), np.float32(1.0), np.float32(0.0), np.float32(1.0), np.float32(1.0), np.float32(1.0)]",-2.0,100043.0,27
2025-08-14_08-18-36,581,"[np.float32(1.0), np.float32(0.0), np.float32(1.0), np.float32(0.0), np.float32(1.0), np.float32(0.0), np.float32(1.0), np.float32(1.0), np.float32(0.0), np.float32(1.0), np.float32(1.0), np.float32(0.0), np.float32(1.0), np.float32(1.0), np.float32(0.0), np.float32(0.0)]",-1.0,100042.0,23
2025-08-14_08-18-36,582,"[np.float32(1.0), np.float32(1.0), np.float32(1.0), np.float32(0.0), np.float32(1.0), np.float32(1.0), np.float32(1.0), np.float32(0.0), np.float32(0.0), np.float32(0.0), np.float32(0.0), np.float32(0.0), np.float32(1.0), np.float32(1.0), np.float32(0.0), np.float32(0.0)]",38.0,100080.0,7
2025-08-14_08-18-36,583,"[np.float32(1.0), np.float32(0.0), np.float32(0.0), np.float32(1.0), np.float32(1.0), np.float32(0.0), np.float32(1.0), np.float32(0.0), np.float32(0.0), np.float32(1.0), np.float32(0.0), np.float32(1.0), np.float32(1.0), np.float32(1.0), np.float32(0.0), np.float32(1.0)]",-1.0,100079.0,34
2025-08-14_08-18-36,584,"[np.float32(0.0), np.float32(0.0), np.float32(1.0), np.float32(0.0), np.float32(0.0), np.float32(0.0), np.float32(0.0), np.float32(0.0), np.float32(1.0), np.float32(1.0), np.float32(0.0), np.float32(0.0), np.float32(1.0), np.float32(1.0), np.float32(1.0), np.float32(1.0)]",2.0,100081.0,25
2025-08-14_08-18-36,585,"[np.float32(0.0), np.float32(0.0), np.float32(1.0), np.float32(0.0), np.float32(0.0), np.float32(1.0), np.float32(0.0), np.float32(0.0), np.float32(1.0), np.float32(0.0), np.float32(0.0), np.float32(1.0), np.float32(0.0), np.float32(1.0), np.float32(1.0), np.float32(1.0)]",-1.0,100080.0,3
2025-08-14_08-18-36,586,"[np.float32(1.0), np.float32(1.0), np.float32(0.0), np.float32(0.0), np.float32(0.0), np.float32(0.0), np.float32(1.0), np.float32(1.0), np.float32(1.0), np.float32(1.0), np.float32(1.0), np.float32(1.0), np.float32(0.0), np.float32(1.0), np.float32(0.0), np.float32(1.0)]",-2.0,100078.0,10
2025-08-14_08-18-36,587,"[np.float32(0.0), np.float32(1.0), np.float32(0.0), np.float32(0.0), np.float32(0.0), np.float32(1.0), np.float32(0.0), np.float32(1.0), np.float32(1.0), np.float32(1.0), np.float32(1.0), np.float32(1.0), np.float32(0.0), np.float32(1.0), np.float32(0.0), np.float32(1.0)]",-6.0,100072.0,5
2025-08-14_08-18-36,588,"[np.float32(0.0), np.float32(0.0), np.float32(1.0), np.float32(1.0), np.float32(0.0), np.float32(1.0), np.float32(0.0), np.float32(0.0), np.float32(0.0), np.float32(1.0), np.float32(1.0), np.float32(1.0), np.float32(1.0), np.float32(0.0), np.float32(0.0), np.float32(0.0)]",0.0,100072.0,23
2025-08-14_08-18-36,589,"[np.float32(0.0), np.float32(0.0), np.float32(1.0), np.float32(1.0), np.float32(1.0), np.float32(1.0), np.float32(1.0), np.float32(0.0), np.float32(1.0), np.float32(1.0), np.float32(0.0), np.float32(0.0), np.float32(1.0), np.float32(0.0), np.float32(0.0), np.float32(1.0)]",-5.0,100067.0,23
2025-08-14_08-18-36,590,"[np.float32(1.0), np.float32(1.0), np.float32(1.0), np.float32(0.0), np.float32(1.0), np.float32(0.0), np.float32(1.0), np.float32(0.0), np.float32(1.0), np.float32(1.0), np.float32(1.0), np.float32(0.0), np.float32(0.0), np.float32(0.0), np.float32(1.0), np.float32(0.0)]",-5.0,100062.0,0
2025-08-14_08-18-36,591,"[np.float32(0.0), np.float32(0.0), np.float32(1.0), np.float32(0.0), np.float32(0.0), np.float32(1.0), np.float32(0.0), np.float32(0.0), np.float32(0.0), np.float32(1.0), np.float32(0.0), np.float32(0.0), np.float32(1.0), np.float32(1.0), np.float32(0.0), np.float32(0.0)]",-5.0,100057.0,9
2025-08-14_08-18-36,592,"[np.float32(1.0), np.float32(1.0), np.float32(0.0), np.float32(1.0), np.float32(0.0), np.float32(0.0), np.float32(0.0), np.float32(0.0), np.float32(0.0), np.float32(1.0), np.float32(0.0), np.float32(1.0), np.float32(0.0), np.float32(1.0), np.float32(0.0), np.float32(1.0)]",1.0,100058.0,6
2025-08-14_08-18-36,593,"[np.float32(1.0), np.float32(0.0), np.float32(0.0), np.float32(0.0), np.float32(0.0), np.float32(0.0), np.float32(1.0), np.float32(1.0), np.float32(1.0), np.float32(1.0), np.float32(0.0), np.float32(1.0), np.float32(0.0), np.float32(0.0), np.float32(1.0), np.float32(0.0)]",4.0,100062.0,16
2025-08-14_08-18-36,594,"[np.float32(0.0), np.float32(0.0), np.float32(1.0), np.float32(0.0), np.float32(1.0), np.float32(0.0), np.float32(0.0), np.float32(0.0), np.float32(0.0), np.float32(1.0), np.float32(0.0), np.float32(0.0), np.float32(1.0), np.float32(0.0), np.float32(0.0), np.float32(0.0)]",1.0,100063.0,22
2025-08-14_08-18-36,595,"[np.float32(0.0), np.float32(0.0), np.float32(0.0), np.float32(0.0), np.float32(0.0), np.float32(1.0), np.float32(0.0), np.float32(1.0), np.float32(0.0), np.float32(1.0), np.float32(0.0), np.float32(0.0), np.float32(1.0), np.float32(0.0), np.float32(1.0), np.float32(1.0)]",-6.0,100057.0,2
2025-08-14_08-18-36,596,"[np.float32(1.0), np.float32(0.0), np.float32(1.0), np.float32(1.0), np.float32(0.0), np.float32(0.0), np.float32(0.0), np.float32(0.0), np.float32(1.0), np.float32(1.0), np.float32(0.0), np.float32(0.0), np.float32(1.0), np.float32(1.0), np.float32(1.0), np.float32(1.0)]",-2.0,100055.0,12
2025-08-14_08-18-36,597,"[np.float32(1.0), np.float32(1.0), np.float32(0.0), np.float32(0.0), np.float32(0.0), np.float32(1.0), np.float32(0.0), np.float32(1.0), np.float32(1.0), np.float32(0.0), np.float32(1.0), np.float32(1.0), np.float32(1.0), np.float32(1.0), np.float32(1.0), np.float32(1.0)]",-3.0,100052.0,9
2025-08-14_08-18-36,598,"[np.float32(0.0), np.float32(0.0), np.float32(0.0), np.float32(1.0), np.float32(1.0), np.float32(1.0), np.float32(0.0), np.float32(1.0), np.float32(1.0), np.float32(1.0), np.float32(1.0), np.float32(0.0), np.float32(1.0), np.float32(1.0), np.float32(0.0), np.float32(0.0)]",-5.0,100047.0,9
2025-08-14_08-18-36,599,"[np.float32(1.0), np.float32(1.0), np.float32(0.0), np.float32(0.0), np.float32(0.0), np.float32(0.0), np.float32(0.0), np.float32(1.0), np.float32(0.0), np.float32(0.0), np.float32(0.0), np.float32(0.0), np.float32(0.0), np.float32(0.0), np.float32(1.0), np.float32(0.0)]",1.0,100048.0,36
2025-08-14_08-18-36,600,"[np.float32(0.0), np.float32(0.0), np.float32(0.0), np.float32(0.0), np.float32(1.0), np.float32(1.0), np.float32(1.0), np.float32(1.0), np.float32(0.0), np.float32(1.0), np.float32(1.0), np.float32(0.0), np.float32(0.0), np.float32(1.0), np.float32(0.0), np.float32(1.0)]",0.0,100048.0,32
2025-08-14_08-18-36,601,"[np.float32(0.0), np.float32(0.0), np.float32(1.0), np.float32(0.0), np.float32(0.0), np.float32(0.0), np.float32(0.0), np.float32(1.0), np.float32(1.0), np.float32(1.0), np.float32(1.0), np.float32(1.0), np.float32(1.0), np.float32(0.0), np.float32(0.0), np.float32(0.0)]",-4.0,100044.0,5
2025-08-14_08-18-36,602,"[np.float32(0.0), np.float32(1.0), np.float32(0.0), np.float32(1.0), np.float32(1.0), np.float32(1.0), np.float32(1.0), np.float32(0.0), np.float32(0.0), np.float32(1.0), np.float32(1.0), np.float32(0.0), np.float32(1.0), np.float32(1.0), np.float32(0.0), np.float32(1.0)]",3.0,100047.0,1
2025-08-14_08-18-36,603,"[np.float32(0.0), np.float32(1.0), np.float32(1.0), np.float32(0.0), np.float32(1.0), np.float32(1.0), np.float32(0.0), np.float32(1.0), np.float32(1.0), np.float32(1.0), np.float32(1.0), np.float32(1.0), np.float32(0.0), np.float32(0.0), np.float32(1.0), np.float32(1.0)]",2.0,100049.0,36
2025-08-14_08-18-36,604,"[np.float32(1.0), np.float32(0.0), np.float32(0.0), np.float32(1.0), np.float32(1.0), np.float32(0.0), np.float32(1.0), np.float32(0.0), np.float32(1.0), np.float32(1.0), np.float32(0.0), np.float32(0.0), np.float32(0.0), np.float32(0.0), np.float32(0.0), np.float32(1.0)]",-2.0,100047.0,35
2025-08-14_08-18-36,605,"[np.float32(1.0), np.float32(0.0), np.float32(0.0), np.float32(1.0), np.float32(1.0), np.float32(0.0), np.float32(1.0), np.float32(1.0), np.float32(1.0), np.float32(0.0), np.float32(1.0), np.float32(0.0), np.float32(1.0), np.float32(1.0), np.float32(1.0), np.float32(1.0)]",-1.0,100046.0,18
2025-08-14_08-18-36,606,"[np.float32(0.0), np.float32(0.0), np.float32(1.0), np.float32(0.0), np.float32(0.0), np.float32(0.0), np.float32(1.0), np.float32(1.0), np.float32(0.0), np.float32(0.0), np.float32(0.0), np.float32(1.0), np.float32(1.0), np.float32(1.0), np.float32(0.0), np.float32(1.0)]",1.0,100047.0,20
2025-08-14_08-18-36,607,"[np.float32(0.0), np.float32(0.0), np.float32(0.0), np.float32(1.0), np.float32(0.0), np.float32(1.0), np.float32(1.0), np.float32(0.0), np.float32(1.0), np.float32(0.0), np.float32(1.0), np.float32(0.0), np.float32(1.0), np.float32(0.0), np.float32(0.0), np.float32(1.0)]",-2.0,100045.0,36
2025-08-14_08-18-36,608,"[np.float32(1.0), np.float32(0.0), np.float32(1.0), np.float32(1.0), np.float32(1.0), np.float32(0.0), np.float32(1.0), np.float32(1.0), np.float32(0.0), np.float32(1.0), np.float32(0.0), np.float32(0.0), np.float32(0.0), np.float32(1.0), np.float32(0.0), np.float32(0.0)]",5.0,100050.0,19
2025-08-14_08-18-36,609,"[np.float32(1.0), np.float32(1.0), np.float32(1.0), np.float32(0.0), np.float32(0.0), np.float32(1.0), np.float32(0.0), np.float32(0.0), np.float32(1.0), np.float32(1.0), np.float32(0.0), np.float32(0.0), np.float32(0.0), np.float32(0.0), np.float32(1.0), np.float32(1.0)]",0.0,100050.0,1
2025-08-14_08-18-36,610,"[np.float32(0.0), np.float32(0.0), np.float32(1.0), np.float32(1.0), np.float32(1.0), np.float32(0.0), np.float32(1.0), np.float32(0.0), np.float32(1.0), np.float32(1.0), np.float32(0.0), np.float32(0.0), np.float32(0.0), np.float32(0.0), np.float32(0.0), np.float32(0.0)]",1.0,100051.0,16
2025-08-14_08-18-36,611,"[np.float32(0.0), np.float32(1.0), np.float32(1.0), np.float32(0.0), np.float32(0.0), np.float32(0.0), np.float32(1.0), np.float32(1.0), np.float32(0.0), np.float32(0.0), np.float32(0.0), np.float32(0.0), np.float32(1.0), np.float32(1.0), np.float32(1.0), np.float32(0.0)]",-5.0,100046.0,31
2025-08-14_08-18-36,612,"[np.float32(1.0), np.float32(1.0), np.float32(0.0), np.float32(0.0), np.float32(1.0), np.float32(1.0), np.float32(0.0), np.float32(1.0), np.float32(1.0), np.float32(0.0), np.float32(1.0), np.float32(1.0), np.float32(1.0), np.float32(1.0), np.float32(0.0), np.float32(0.0)]",0.0,100046.0,36
2025-08-14_08-18-36,613,"[np.float32(0.0), np.float32(0.0), np.float32(0.0), np.float32(1.0), np.float32(1.0), np.float32(0.0), np.float32(1.0), np.float32(1.0), np.float32(1.0), np.float32(1.0), np.float32(0.0), np.float32(1.0), np.float32(1.0), np.float32(1.0), np.float32(0.0), np.float32(0.0)]",-4.0,100042.0,8
2025-08-14_08-18-36,614,"[np.float32(0.0), np.float32(0.0), np.float32(0.0), np.float32(1.0), np.float32(0.0), np.float32(0.0), np.float32(0.0), np.float32(1.0), np.float32(1.0), np.float32(0.0), np.float32(0.0), np.float32(1.0), np.float32(1.0), np.float32(1.0), np.float32(0.0), np.float32(0.0)]",-3.0,100039.0,0
2025-08-14_08-18-36,615,"[np.float32(1.0), np.float32(1.0), np.float32(1.0), np.float32(0.0), np.float32(1.0), np.float32(1.0), np.float32(1.0), np.float32(1.0), np.float32(0.0), np.float32(1.0), np.float32(1.0), np.float32(0.0), np.float32(1.0), np.float32(0.0), np.float32(0.0), np.float32(0.0)]",0.0,100039.0,17
2025-08-14_08-18-36,616,"[np.float32(1.0), np.float32(0.0), np.float32(1.0), np.float32(1.0), np.float32(0.0), np.float32(1.0), np.float32(0.0), np.float32(1.0), np.float32(0.0), np.float32(1.0), np.float32(0.0), np.float32(0.0), np.float32(1.0), np.float32(1.0), np.float32(0.0), np.float32(1.0)]",-1.0,100038.0,13
2025-08-14_08-18-36,617,"[np.float32(0.0), np.float32(0.0), np.float32(0.0), np.float32(1.0), np.float32(1.0), np.float32(1.0), np.float32(1.0), np.float32(0.0), np.float32(0.0), np.float32(1.0), np.float32(1.0), np.float32(1.0), np.float32(0.0), np.float32(1.0), np.float32(0.0), np.float32(1.0)]",4.0,100042.0,7
2025-08-14_08-18-36,618,"[np.float32(0.0), np.float32(0.0), np.float32(0.0), np.float32(0.0), np.float32(1.0), np.float32(1.0), np.float32(0.0), np.float32(0.0), np.float32(1.0), np.float32(0.0), np.float32(0.0), np.float32(0.0), np.float32(0.0), np.float32(1.0), np.float32(0.0), np.float32(1.0)]",0.0,100042.0,36
2025-08-14_08-18-36,619,"[np.float32(1.0), np.float32(1.0), np.float32(0.0), np.float32(1.0), np.float32(1.0), np.float32(0.0), np.float32(0.0), np.float32(1.0), np.float32(1.0), np.float32(1.0), np.float32(0.0), np.float32(0.0), np.float32(0.0), np.float32(0.0), np.float32(1.0), np.float32(1.0)]",1.0,100043.0,23
2025-08-14_08-18-36,620,"[np.float32(1.0), np.float32(0.0), np.float32(0.0), np.float32(0.0), np.float32(0.0), np.float32(0.0), np.float32(0.0), np.float32(0.0), np.float32(1.0), np.float32(0.0), np.float32(0.0), np.float32(0.0), np.float32(1.0), np.float32(0.0), np.float32(1.0), np.float32(0.0)]",34.0,100077.0,7
2025-08-14_08-18-36,621,"[np.float32(1.0), np.float32(1.0), np.float32(0.0), np.float32(1.0), np.float32(1.0), np.float32(1.0), np.float32(0.0), np.float32(1.0), np.float32(0.0), np.float32(0.0), np.float32(0.0), np.float32(0.0), np.float32(0.0), np.float32(0.0), np.float32(0.0), np.float32(0.0)]",3.0,100080.0,23
2025-08-14_08-18-36,622,"[np.float32(1.0), np.float32(1.0), np.float32(0.0), np.float32(0.0), np.float32(0.0), np.float32(1.0), np.float32(1.0), np.float32(0.0), np.float32(1.0), np.float32(0.0), np.float32(1.0), np.float32(0.0), np.float32(0.0), np.float32(0.0), np.float32(1.0), np.float32(0.0)]",3.0,100083.0,30
2025-08-14_08-18-36,623,"[np.float32(1.0), np.float32(0.0), np.float32(1.0), np.float32(0.0), np.float32(0.0), np.float32(0.0), np.float32(1.0), np.float32(1.0), np.float32(0.0), np.float32(1.0), np.float32(0.0), np.float32(0.0), np.float32(0.0), np.float32(0.0), np.float32(0.0), np.float32(0.0)]",-2.0,100081.0,31
2025-08-14_08-18-36,624,"[np.float32(0.0), np.float32(0.0), np.float32(0.0), np.float32(0.0), np.float32(0.0), np.float32(1.0), np.float32(0.0), np.float32(0.0), np.float32(1.0), np.float32(0.0), np.float32(0.0), np.float32(1.0), np.float32(0.0), np.float32(1.0), np.float32(1.0), np.float32(1.0)]",2.0,100083.0,34
2025-08-14_08-18-36,625,"[np.float32(0.0), np.float32(1.0), np.float32(0.0), np.float32(0.0), np.float32(0.0), np.float32(1.0), np.float32(1.0), np.float32(0.0), np.float32(1.0), np.float32(1.0), np.float32(0.0), np.float32(0.0), np.float32(1.0), np.float32(0.0), np.float32(0.0), np.float32(0.0)]",-3.0,100080.0,12
2025-08-14_08-18-36,626,"[np.float32(0.0), np.float32(1.0), np.float32(0.0), np.float32(0.0), np.float32(0.0), np.float32(1.0), np.float32(0.0), np.float32(0.0), np.float32(0.0), np.float32(1.0), np.float32(0.0), np.float32(1.0), np.float32(1.0), np.float32(1.0), np.float32(1.0), np.float32(1.0)]",0.0,100080.0,36
2025-08-14_08-18-36,627,"[np.float32(1.0), np.float32(1.0), np.float32(1.0), np.float32(1.0), np.float32(1.0), np.float32(0.0), np.float32(1.0), np.float32(0.0), np.float32(0.0), np.float32(0.0), np.float32(0.0), np.float32(0.0), np.float32(1.0), np.float32(0.0), np.float32(1.0), np.float32(0.0)]",-4.0,100076.0,26
2025-08-14_08-18-36,628,"[np.float32(1.0), np.float32(1.0), np.float32(1.0), np.float32(1.0), np.float32(1.0), np.float32(1.0), np.float32(1.0), np.float32(0.0), np.float32(1.0), np.float32(0.0), np.float32(0.0), np.float32(0.0), np.float32(1.0), np.float32(0.0), np.float32(1.0), np.float32(0.0)]",-1.0,100075.0,26
2025-08-14_08-18-36,629,"[np.float32(0.0), np.float32(0.0), np.float32(1.0), np.float32(1.0), np.float32(0.0), np.float32(1.0), np.float32(1.0), np.float32(1.0), np.float32(0.0), np.float32(1.0), np.float32(0.0), np.float32(1.0), np.float32(0.0), np.float32(0.0), np.float32(0.0), np.float32(0.0)]",0.0,100075.0,20
2025-08-14_08-18-36,630,"[np.float32(1.0), np.float32(1.0), np.float32(0.0), np.float32(1.0), np.float32(0.0), np.float32(0.0), np.float32(0.0), np.float32(1.0), np.float32(1.0), np.float32(0.0), np.float32(0.0), np.float32(1.0), np.float32(1.0), np.float32(0.0), np.float32(0.0), np.float32(1.0)]",2.0,100077.0,21
2025-08-14_08-18-36,631,"[np.float32(0.0), np.float32(1.0), np.float32(0.0), np.float32(1.0), np.float32(1.0), np.float32(1.0), np.float32(1.0), np.float32(0.0), np.float32(0.0), np.float32(1.0), np.float32(0.0), np.float32(1.0), np.float32(0.0), np.float32(0.0), np.float32(1.0), np.float32(1.0)]",4.0,100081.0,6
2025-08-14_08-18-36,632,"[np.float32(1.0), np.float32(1.0), np.float32(1.0), np.float32(1.0), np.float32(0.0), np.float32(1.0), np.float32(0.0), np.float32(0.0), np.float32(1.0), np.float32(1.0), np.float32(0.0), np.float32(0.0), np.float32(1.0), np.float32(0.0), np.float32(0.0), np.float32(0.0)]",-4.0,100077.0,11
2025-08-14_08-18-36,633,"[np.float32(1.0), np.float32(0.0), np.float32(1.0), np.float32(0.0), np.float32(1.0), np.float32(1.0), np.float32(0.0), np.float32(0.0), np.float32(1.0), np.float32(1.0), np.float32(0.0), np.float32(0.0), np.float32(1.0), np.float32(0.0), np.float32(1.0), np.float32(0.0)]",-6.0,100071.0,15
2025-08-14_08-18-36,634,"[np.float32(1.0), np.float32(0.0), np.float32(1.0), np.float32(1.0), np.float32(1.0), np.float32(1.0), np.float32(0.0), np.float32(1.0), np.float32(1.0), np.float32(0.0), np.float32(1.0), np.float32(1.0), np.float32(1.0), np.float32(1.0), np.float32(0.0), np.float32(1.0)]",-5.0,100066.0,13
2025-08-14_08-18-36,635,"[np.float32(1.0), np.float32(0.0), np.float32(0.0), np.float32(1.0), np.float32(1.0), np.float32(0.0), np.float32(1.0), np.float32(1.0), np.float32(1.0), np.float32(1.0), np.float32(1.0), np.float32(0.0), np.float32(0.0), np.float32(1.0), np.float32(0.0), np.float32(0.0)]",1.0,100067.0,23
2025-08-14_08-18-36,636,"[np.float32(0.0), np.float32(0.0), np.float32(1.0), np.float32(0.0), np.float32(1.0), np.float32(0.0), np.float32(1.0), np.float32(0.0), np.float32(1.0), np.float32(1.0), np.float32(1.0), np.float32(1.0), np.float32(1.0), np.float32(0.0), np.float32(1.0), np.float32(0.0)]",-1.0,100066.0,1
2025-08-14_08-18-36,637,"[np.float32(1.0), np.float32(0.0), np.float32(0.0), np.float32(0.0), np.float32(1.0), np.float32(1.0), np.float32(1.0), np.float32(1.0), np.float32(1.0), np.float32(1.0), np.float32(0.0), np.float32(1.0), np.float32(0.0), np.float32(1.0), np.float32(0.0), np.float32(1.0)]",-2.0,100064.0,29
2025-08-14_08-18-36,638,"[np.float32(1.0), np.float32(1.0), np.float32(0.0), np.float32(0.0), np.float32(1.0), np.float32(0.0), np.float32(1.0), np.float32(1.0), np.float32(0.0), np.float32(0.0), np.float32(0.0), np.float32(0.0), np.float32(1.0), np.float32(0.0), np.float32(0.0), np.float32(0.0)]",-1.0,100063.0,24
2025-08-14_08-18-36,639,"[np.float32(0.0), np.float32(0.0), np.float32(0.0), np.float32(0.0), np.float32(0.0), np.float32(1.0), np.float32(0.0), np.float32(0.0), np.float32(1.0), np.float32(0.0), np.float32(0.0), np.float32(0.0), np.float32(1.0), np.float32(0.0), np.float32(1.0), np.float32(0.0)]",1.0,100064.0,35
2025-08-14_08-18-36,640,"[np.float32(0.0), np.float32(1.0), np.float32(0.0), np.float32(0.0), np.float32(1.0), np.float32(0.0), np.float32(0.0), np.float32(1.0), np.float32(0.0), np.float32(0.0), np.float32(1.0), np.float32(0.0), np.float32(0.0), np.float32(0.0), np.float32(0.0), np.float32(0.0)]",1.0,100065.0,29
2025-08-14_08-18-36,641,"[np.float32(0.0), np.float32(1.0), np.float32(1.0), np.float32(0.0), np.float32(0.0), np.float32(1.0), np.float32(0.0), np.float32(0.0), np.float32(0.0), np.float32(1.0), np.float32(0.0), np.float32(1.0), np.float32(1.0), np.float32(1.0), np.float32(0.0), np.float32(0.0)]",-2.0,100063.0,13
2025-08-14_08-18-36,642,"[np.float32(0.0), np.float32(0.0), np.float32(0.0), np.float32(0.0), np.float32(0.0), np.float32(1.0), np.float32(0.0), np.float32(1.0), np.float32(0.0), np.float32(0.0), np.float32(1.0), np.float32(1.0), np.float32(0.0), np.float32(0.0), np.float32(1.0), np.float32(0.0)]",3.0,100066.0,21
2025-08-14_08-18-36,643,"[np.float32(0.0), np.float32(0.0), np.float32(1.0), np.float32(0.0), np.float32(1.0), np.float32(1.0), np.float32(1.0), np.float32(1.0), np.float32(0.0), np.float32(1.0), np.float32(0.0), np.float32(1.0), np.float32(1.0), np.float32(0.0), np.float32(0.0), np.float32(1.0)]",-4.0,100062.0,27
2025-08-14_08-18-36,644,"[np.float32(0.0), np.float32(1.0), np.float32(1.0), np.float32(1.0), np.float32(1.0), np.float32(0.0), np.float32(1.0), np.float32(0.0), np.float32(0.0), np.float32(1.0), np.float32(0.0), np.float32(0.0), np.float32(1.0), np.float32(0.0), np.float32(0.0), np.float32(1.0)]",-4.0,100058.0,18
2025-08-14_08-18-36,645,"[np.float32(0.0), np.float32(1.0), np.float32(1.0), np.float32(0.0), np.float32(1.0), np.float32(1.0), np.float32(0.0), np.float32(0.0), np.float32(0.0), np.float32(1.0), np.float32(0.0), np.float32(1.0), np.float32(0.0), np.float32(0.0), np.float32(1.0), np.float32(0.0)]",-3.0,100055.0,17
2025-08-14_08-18-36,646,"[np.float32(0.0), np.float32(0.0), np.float32(0.0), np.float32(0.0), np.float32(1.0), np.float32(1.0), np.float32(0.0), np.float32(1.0), np.float32(0.0), np.float32(1.0), np.float32(1.0), np.float32(0.0), np.float32(0.0), np.float32(0.0), np.float32(1.0), np.float32(0.0)]",-1.0,100054.0,4
2025-08-14_08-18-36,647,"[np.float32(0.0), np.float32(1.0), np.float32(0.0), np.float32(0.0), np.float32(0.0), np.float32(0.0), np.float32(0.0), np.float32(0.0), np.float32(1.0), np.float32(0.0), np.float32(1.0), np.float32(0.0), np.float32(1.0), np.float32(0.0), np.float32(1.0), np.float32(0.0)]",-5.0,100049.0,3
2025-08-14_08-18-36,648,"[np.float32(0.0), np.float32(1.0), np.float32(0.0), np.float32(0.0), np.float32(0.0), np.float32(1.0), np.float32(1.0), np.float32(0.0), np.float32(1.0), np.float32(1.0), np.float32(0.0), np.float32(1.0), np.float32(1.0), np.float32(1.0), np.float32(1.0), np.float32(0.0)]",-1.0,100048.0,6
2025-08-14_08-18-36,649,"[np.float32(1.0), np.float32(1.0), np.float32(0.0), np.float32(1.0), np.float32(0.0), np.float32(1.0), np.float32(1.0), np.float32(0.0), np.float32(1.0), np.float32(1.0), np.float32(0.0), np.float32(0.0), np.float32(1.0), np.float32(0.0), np.float32(1.0), np.float32(0.0)]",-5.0,100043.0,15
2025-08-14_08-18-36,650,"[np.float32(0.0), np.float32(1.0), np.float32(1.0), np.float32(0.0), np.float32(1.0), np.float32(1.0), np.float32(1.0), np.float32(0.0), np.float32(1.0), np.float32(1.0), np.float32(1.0), np.float32(1.0), np.float32(1.0), np.float32(0.0), np.float32(1.0), np.float32(1.0)]",-2.0,100041.0,29
2025-08-14_08-18-36,651,"[np.float32(0.0), np.float32(1.0), np.float32(0.0), np.float32(1.0), np.float32(0.0), np.float32(1.0), np.float32(0.0), np.float32(0.0), np.float32(1.0), np.float32(0.0), np.float32(1.0), np.float32(0.0), np.float32(0.0), np.float32(0.0), np.float32(1.0), np.float32(1.0)]",3.0,100044.0,27
2025-08-14_08-18-36,652,"[np.float32(1.0), np.float32(1.0), np.float32(0.0), np.float32(0.0), np.float32(0.0), np.float32(1.0), np.float32(0.0), np.float32(1.0), np.float32(0.0), np.float32(0.0), np.float32(0.0), np.float32(0.0), np.float32(1.0), np.float32(0.0), np.float32(1.0), np.float32(1.0)]",31.0,100075.0,7
2025-08-14_08-18-36,653,"[np.float32(1.0), np.float32(0.0), np.float32(0.0), np.float32(0.0), np.float32(1.0), np.float32(0.0), np.float32(1.0), np.float32(0.0), np.float32(0.0), np.float32(1.0), np.float32(1.0), np.float32(1.0), np.float32(1.0), np.float32(1.0), np.float32(0.0), np.float32(0.0)]",0.0,100075.0,8
2025-08-14_08-18-36,654,"[np.float32(1.0), np.float32(1.0), np.float32(1.0), np.float32(0.0), np.float32(1.0), np.float32(1.0), np.float32(1.0), np.float32(1.0), np.float32(0.0), np.float32(0.0), np.float32(1.0), np.float32(0.0), np.float32(0.0), np.float32(0.0), np.float32(1.0), np.float32(0.0)]",-2.0,100073.0,29
2025-08-14_08-18-36,655,"[np.float32(1.0), np.float32(0.0), np.float32(1.0), np.float32(1.0), np.float32(1.0), np.float32(0.0), np.float32(1.0), np.float32(1.0), np.float32(0.0), np.float32(1.0), np.float32(1.0), np.float32(0.0), np.float32(0.0), np.float32(1.0), np.float32(0.0), np.float32(1.0)]",0.0,100073.0,10
2025-08-14_08-18-36,656,"[np.float32(1.0), np.float32(1.0), np.float32(0.0), np.float32(1.0), np.float32(1.0), np.float32(0.0), np.float32(1.0), np.float32(0.0), np.float32(0.0), np.float32(0.0), np.float32(1.0), np.float32(1.0), np.float32(0.0), np.float32(0.0), np.float32(1.0), np.float32(1.0)]",3.0,100076.0,3
2025-08-14_08-18-36,657,"[np.float32(1.0), np.float32(0.0), np.float32(0.0), np.float32(1.0), np.float32(1.0), np.float32(1.0), np.float32(1.0), np.float32(0.0), np.float32(1.0), np.float32(0.0), np.float32(0.0), np.float32(1.0), np.float32(1.0), np.float32(0.0), np.float32(0.0), np.float32(1.0)]",3.0,100079.0,27
2025-08-14_08-18-36,658,"[np.float32(0.0), np.float32(1.0), np.float32(1.0), np.float32(0.0), np.float32(0.0), np.float32(1.0), np.float32(0.0), np.float32(0.0), np.float32(0.0), np.float32(0.0), np.float32(1.0), np.float32(1.0), np.float32(0.0), np.float32(1.0), np.float32(1.0), np.float32(1.0)]",0.0,100079.0,18
2025-08-14_08-18-36,659,"[np.float32(1.0), np.float32(0.0), np.float32(0.0), np.float32(1.0), np.float32(1.0), np.float32(1.0), np.float32(1.0), np.float32(1.0), np.float32(0.0), np.float32(0.0), np.float32(1.0), np.float32(1.0), np.float32(0.0), np.float32(0.0), np.float32(0.0), np.float32(0.0)]",-4.0,100075.0,34
2025-08-14_08-18-36,660,"[np.float32(0.0), np.float32(0.0), np.float32(0.0), np.float32(1.0), np.float32(1.0), np.float32(0.0), np.float32(1.0), np.float32(0.0), np.float32(0.0), np.float32(0.0), np.float32(0.0), np.float32(0.0), np.float32(1.0), np.float32(0.0), np.float32(1.0), np.float32(1.0)]",-3.0,100072.0,24
2025-08-14_08-18-36,661,"[np.float32(0.0), np.float32(0.0), np.float32(1.0), np.float32(1.0), np.float32(0.0), np.float32(0.0), np.float32(1.0), np.float32(0.0), np.float32(1.0), np.float32(0.0), np.float32(1.0), np.float32(0.0), np.float32(0.0), np.float32(1.0), np.float32(0.0), np.float32(0.0)]",-4.0,100068.0,24
2025-08-14_08-18-36,662,"[np.float32(1.0), np.float32(0.0), np.float32(0.0), np.float32(0.0), np.float32(0.0), np.float32(0.0), np.float32(0.0), np.float32(1.0), np.float32(0.0), np.float32(1.0), np.float32(1.0), np.float32(1.0), np.float32(1.0), np.float32(0.0), np.float32(0.0), np.float32(0.0)]",0.0,100068.0,22
2025-08-14_08-18-36,663,"[np.float32(0.0), np.float32(0.0), np.float32(1.0), np.float32(1.0), np.float32(0.0), np.float32(1.0), np.float32(1.0), np.float32(1.0), np.float32(0.0), np.float32(1.0), np.float32(0.0), np.float32(0.0), np.float32(1.0), np.float32(1.0), np.float32(0.0), np.float32(1.0)]",-1.0,100067.0,13
2025-08-14_08-18-36,664,"[np.float32(0.0), np.float32(0.0), np.float32(1.0), np.float32(0.0), np.float32(1.0), np.float32(1.0), np.float32(1.0), np.float32(1.0), np.float32(1.0), np.float32(1.0), np.float32(1.0), np.float32(0.0), np.float32(1.0), np.float32(0.0), np.float32(1.0), np.float32(1.0)]",-1.0,100066.0,32
2025-08-14_08-18-36,665,"[np.float32(1.0), np.float32(0.0), np.float32(1.0), np.float32(1.0), np.float32(0.0), np.float32(0.0), np.float32(0.0), np.float32(0.0), np.float32(1.0), np.float32(0.0), np.float32(1.0), np.float32(1.0), np.float32(1.0), np.float32(0.0), np.float32(0.0), np.float32(0.0)]",33.0,100099.0,7
2025-08-14_08-18-36,666,"[np.float32(1.0), np.float32(1.0), np.float32(0.0), np.float32(0.0), np.float32(0.0), np.float32(0.0), np.float32(0.0), np.float32(1.0), np.float32(1.0), np.float32(1.0), np.float32(1.0), np.float32(0.0), np.float32(0.0), np.float32(0.0), np.float32(1.0), np.float32(0.0)]",1.0,100100.0,5
2025-08-14_08-18-36,667,"[np.float32(0.0), np.float32(1.0), np.float32(1.0), np.float32(1.0), np.float32(0.0), np.float32(0.0), np.float32(0.0), np.float32(1.0), np.float32(0.0), np.float32(0.0), np.float32(1.0), np.float32(1.0), np.float32(1.0), np.float32(0.0), np.float32(0.0), np.float32(1.0)]",-3.0,100097.0,5
2025-08-14_08-18-36,668,"[np.float32(0.0), np.float32(1.0), np.float32(1.0), np.float32(1.0), np.float32(0.0), np.float32(1.0), np.float32(0.0), np.float32(1.0), np.float32(0.0), np.float32(0.0), np.float32(0.0), np.float32(0.0), np.float32(1.0), np.float32(0.0), np.float32(0.0), np.float32(0.0)]",1.0,100098.0,15
2025-08-14_08-18-36,669,"[np.float32(0.0), np.float32(1.0), np.float32(0.0), np.float32(1.0), np.float32(0.0), np.float32(0.0), np.float32(0.0), np.float32(0.0), np.float32(0.0), np.float32(0.0), np.float32(1.0), np.float32(1.0), np.float32(0.0), np.float32(1.0), np.float32(1.0), np.float32(0.0)]",-1.0,100097.0,9
2025-08-14_08-18-36,670,"[np.float32(1.0), np.float32(1.0), np.float32(1.0), np.float32(0.0), np.float32(1.0), np.float32(1.0), np.float32(1.0), np.float32(1.0), np.float32(0.0), np.float32(0.0), np.float32(1.0), np.float32(1.0), np.float32(1.0), np.float32(0.0), np.float32(1.0), np.float32(0.0)]",-4.0,100093.0,35
2025-08-14_08-18-36,671,"[np.float32(1.0), np.float32(1.0), np.float32(1.0), np.float32(0.0), np.float32(0.0), np.float32(1.0), np.float32(1.0), np.float32(0.0), np.float32(0.0), np.float32(0.0), np.float32(0.0), np.float32(0.0), np.float32(1.0), np.float32(1.0), np.float32(1.0), np.float32(1.0)]",0.0,100093.0,36
2025-08-14_08-18-36,672,"[np.float32(0.0), np.float32(1.0), np.float32(1.0), np.float32(1.0), np.float32(0.0), np.float32(1.0), np.float32(0.0), np.float32(1.0), np.float32(1.0), np.float32(1.0), np.float32(1.0), np.float32(1.0), np.float32(0.0), np.float32(0.0), np.float32(0.0), np.float32(1.0)]",3.0,100096.0,34
2025-08-14_08-18-36,673,"[np.float32(0.0), np.float32(0.0), np.float32(0.0), np.float32(1.0), np.float32(0.0), np.float32(0.0), np.float32(0.0), np.float32(0.0), np.float32(1.0), np.float32(0.0), np.float32(0.0), np.float32(1.0), np.float32(0.0), np.float32(0.0), np.float32(0.0), np.float32(0.0)]",-1.0,100095.0,7
2025-08-14_08-18-36,674,"[np.float32(1.0), np.float32(0.0), np.float32(1.0), np.float32(1.0), np.float32(1.0), np.float32(0.0), np.float32(0.0), np.float32(0.0), np.float32(0.0), np.float32(0.0), np.float32(0.0), np.float32(0.0), np.float32(0.0), np.float32(1.0), np.float32(0.0), np.float32(0.0)]",-1.0,100094.0,34
2025-08-14_08-18-36,675,"[np.float32(1.0), np.float32(0.0), np.float32(0.0), np.float32(1.0), np.float32(0.0), np.float32(1.0), np.float32(0.0), np.float32(0.0), np.float32(1.0), np.float32(0.0), np.float32(0.0), np.float32(1.0), np.float32(0.0), np.float32(0.0), np.float32(1.0), np.float32(0.0)]",-3.0,100091.0,6
2025-08-14_08-18-36,676,"[np.float32(0.0), np.float32(0.0), np.float32(1.0), np.float32(0.0), np.float32(1.0), np.float32(1.0), np.float32(0.0), np.float32(1.0), np.float32(0.0), np.float32(0.0), np.float32(1.0), np.float32(0.0), np.float32(0.0), np.float32(1.0), np.float32(1.0), np.float32(0.0)]",1.0,100092.0,17
2025-08-14_08-18-36,677,"[np.float32(0.0), np.float32(0.0), np.float32(0.0), np.float32(0.0), np.float32(0.0), np.float32(0.0), np.float32(0.0), np.float32(1.0), np.float32(0.0), np.float32(1.0), np.float32(1.0), np.float32(1.0), np.float32(0.0), np.float32(0.0), np.float32(1.0), np.float32(1.0)]",0.0,100092.0,34
2025-08-14_08-18-36,678,"[np.float32(1.0), np.float32(0.0), np.float32(0.0), np.float32(0.0), np.float32(0.0), np.float32(1.0), np.float32(1.0), np.float32(0.0), np.float32(0.0), np.float32(1.0), np.float32(0.0), np.float32(1.0), np.float32(1.0), np.float32(1.0), np.float32(0.0), np.float32(1.0)]",3.0,100095.0,3
2025-08-14_08-18-36,679,"[np.float32(0.0), np.float32(1.0), np.float32(0.0), np.float32(1.0), np.float32(1.0), np.float32(0.0), np.float32(1.0), np.float32(0.0), np.float32(1.0), np.float32(0.0), np.float32(0.0), np.float32(0.0), np.float32(1.0), np.float32(0.0), np.float32(1.0), np.float32(0.0)]",-1.0,100094.0,30
2025-08-14_08-18-36,680,"[np.float32(1.0), np.float32(0.0), np.float32(1.0), np.float32(0.0), np.float32(0.0), np.float32(1.0), np.float32(0.0), np.float32(0.0), np.float32(0.0), np.float32(1.0), np.float32(0.0), np.float32(1.0), np.float32(1.0), np.float32(1.0), np.float32(0.0), np.float32(1.0)]",0.0,100094.0,4
2025-08-14_08-18-36,681,"[np.float32(1.0), np.float32(0.0), np.float32(0.0), np.float32(0.0), np.float32(1.0), np.float32(1.0), np.float32(0.0), np.float32(1.0), np.float32(1.0), np.float32(1.0), np.float32(1.0), np.float32(1.0), np.float32(1.0), np.float32(1.0), np.float32(1.0), np.float32(0.0)]",2.0,100096.0,32
2025-08-14_08-18-36,682,"[np.float32(0.0), np.float32(1.0), np.float32(0.0), np.float32(1.0), np.float32(1.0), np.float32(1.0), np.float32(1.0), np.float32(0.0), np.float32(0.0), np.float32(1.0), np.float32(1.0), np.float32(0.0), np.float32(0.0), np.float32(0.0), np.float32(1.0), np.float32(1.0)]",0.0,100096.0,29
2025-08-14_08-18-36,683,"[np.float32(1.0), np.float32(1.0), np.float32(0.0), np.float32(0.0), np.float32(0.0), np.float32(0.0), np.float32(0.0), np.float32(1.0), np.float32(1.0), np.float32(1.0), np.float32(1.0), np.float32(1.0), np.float32(0.0), np.float32(0.0), np.float32(1.0), np.float32(1.0)]",-1.0,100095.0,11
2025-08-14_08-18-36,684,"[np.float32(0.0), np.float32(0.0), np.float32(1.0), np.float32(0.0), np.float32(1.0), np.float32(0.0), np.float32(0.0), np.float32(1.0), np.float32(0.0), np.float32(1.0), np.float32(1.0), np.float32(0.0), np.float32(0.0), np.float32(0.0), np.float32(1.0), np.float32(0.0)]",-1.0,100094.0,7
2025-08-14_08-18-36,685,"[np.float32(0.0), np.float32(1.0), np.float32(1.0), np.float32(0.0), np.float32(0.0), np.float32(0.0), np.float32(1.0), np.float32(1.0), np.float32(1.0), np.float32(0.0), np.float32(0.0), np.float32(0.0), np.float32(0.0), np.float32(0.0), np.float32(0.0), np.float32(0.0)]",0.0,100094.0,14
2025-08-14_08-18-36,686,"[np.float32(0.0), np.float32(0.0), np.float32(0.0), np.float32(1.0), np.float32(0.0), np.float32(1.0), np.float32(1.0), np.float32(1.0), np.float32(1.0), np.float32(0.0), np.float32(1.0), np.float32(0.0), np.float32(1.0), np.float32(0.0), np.float32(0.0), np.float32(0.0)]",0.0,100094.0,27
2025-08-14_08-18-36,687,"[np.float32(0.0), np.float32(0.0), np.float32(1.0), np.float32(1.0), np.float32(1.0), np.float32(0.0), np.float32(0.0), np.float32(1.0), np.float32(0.0), np.float32(0.0), np.float32(1.0), np.float32(0.0), np.float32(0.0), np.float32(1.0), np.float32(1.0), np.float32(0.0)]",-2.0,100092.0,33
2025-08-14_08-18-36,688,"[np.float32(0.0), np.float32(0.0), np.float32(1.0), np.float32(0.0), np.float32(0.0), np.float32(1.0), np.float32(0.0), np.float32(0.0), np.float32(0.0), np.float32(1.0), np.float32(0.0), np.float32(0.0), np.float32(1.0), np.float32(1.0), np.float32(0.0), np.float32(1.0)]",-2.0,100090.0,36
2025-08-14_08-18-36,689,"[np.float32(0.0), np.float32(1.0), np.float32(0.0), np.float32(1.0), np.float32(0.0), np.float32(0.0), np.float32(1.0), np.float32(1.0), np.float32(1.0), np.float32(0.0), np.float32(0.0), np.float32(0.0), np.float32(1.0), np.float32(0.0), np.float32(1.0), np.float32(0.0)]",1.0,100091.0,5
2025-08-14_08-18-36,690,"[np.float32(0.0), np.float32(1.0), np.float32(1.0), np.float32(0.0), np.float32(1.0), np.float32(0.0), np.float32(0.0), np.float32(0.0), np.float32(1.0), np.float32(0.0), np.float32(0.0), np.float32(1.0), np.float32(1.0), np.float32(1.0), np.float32(1.0), np.float32(0.0)]",0.0,100091.0,35
2025-08-14_08-18-36,691,"[np.float32(0.0), np.float32(0.0), np.float32(0.0), np.float32(1.0), np.float32(0.0), np.float32(0.0), np.float32(1.0), np.float32(1.0), np.float32(0.0), np.float32(1.0), np.float32(1.0), np.float32(0.0), np.float32(0.0), np.float32(0.0), np.float32(1.0), np.float32(0.0)]",-1.0,100090.0,31
2025-08-14_08-18-36,692,"[np.float32(0.0), np.float32(1.0), np.float32(1.0), np.float32(0.0), np.float32(0.0), np.float32(0.0), np.float32(1.0), np.float32(0.0), np.float32(0.0), np.float32(0.0), np.float32(1.0), np.float32(0.0), np.float32(1.0), np.float32(1.0), np.float32(1.0), np.float32(0.0)]",-1.0,100089.0,3
2025-08-14_08-18-36,693,"[np.float32(0.0), np.float32(0.0), np.float32(1.0), np.float32(0.0), np.float32(1.0), np.float32(0.0), np.float32(0.0), np.float32(0.0), np.float32(0.0), np.float32(0.0), np.float32(0.0), np.float32(1.0), np.float32(0.0), np.float32(1.0), np.float32(0.0), np.float32(1.0)]",0.0,100089.0,0
2025-08-14_08-18-36,694,"[np.float32(1.0), np.float32(0.0), np.float32(0.0), np.float32(1.0), np.float32(1.0), np.float32(1.0), np.float32(0.0), np.float32(0.0), np.float32(1.0), np.float32(0.0), np.float32(0.0), np.float32(0.0), np.float32(0.0), np.float32(1.0), np.float32(1.0), np.float32(0.0)]",2.0,100091.0,5
2025-08-14_08-18-36,695,"[np.float32(0.0), np.float32(1.0), np.float32(0.0), np.float32(1.0), np.float32(0.0), np.float32(1.0), np.float32(0.0), np.float32(0.0), np.float32(0.0), np.float32(1.0), np.float32(1.0), np.float32(1.0), np.float32(0.0), np.float32(1.0), np.float32(0.0), np.float32(0.0)]",-2.0,100089.0,36
2025-08-14_08-18-36,696,"[np.float32(1.0), np.float32(1.0), np.float32(0.0), np.float32(1.0), np.float32(1.0), np.float32(1.0), np.float32(1.0), np.float32(1.0), np.float32(0.0), np.float32(0.0), np.float32(1.0), np.float32(1.0), np.float32(1.0), np.float32(1.0), np.float32(0.0), np.float32(0.0)]",-2.0,100087.0,27
2025-08-14_08-18-36,697,"[np.float32(0.0), np.float32(1.0), np.float32(1.0), np.float32(1.0), np.float32(0.0), np.float32(1.0), np.float32(1.0), np.float32(0.0), np.float32(1.0), np.float32(1.0), np.float32(1.0), np.float32(1.0), np.float32(1.0), np.float32(0.0), np.float32(1.0), np.float32(0.0)]",2.0,100089.0,10
2025-08-14_08-18-36,698,"[np.float32(1.0), np.float32(0.0), np.float32(1.0), np.float32(1.0), np.float32(0.0), np.float32(0.0), np.float32(1.0), np.float32(1.0), np.float32(1.0), np.float32(0.0), np.float32(1.0), np.float32(1.0), np.float32(1.0), np.float32(0.0), np.float32(1.0), np.float32(0.0)]",-2.0,100087.0,29
2025-08-14_08-18-36,699,"[np.float32(1.0), np.float32(1.0), np.float32(1.0), np.float32(1.0), np.float32(0.0), np.float32(1.0), np.float32(1.0), np.float32(0.0), np.float32(1.0), np.float32(0.0), np.float32(1.0), np.float32(0.0), np.float32(0.0), np.float32(1.0), np.float32(0.0), np.float32(1.0)]",0.0,100087.0,8
2025-08-14_08-18-36,700,"[np.float32(1.0), np.float32(1.0), np.float32(1.0), np.float32(0.0), np.float32(0.0), np.float32(1.0), np.float32(0.0), np.float32(1.0), np.float32(0.0), np.float32(1.0), np.float32(1.0), np.float32(0.0), np.float32(0.0), np.float32(0.0), np.float32(1.0), np.float32(0.0)]",-6.0,100081.0,9
2025-08-14_08-18-36,701,"[np.float32(0.0), np.float32(1.0), np.float32(1.0), np.float32(1.0), np.float32(1.0), np.float32(1.0), np.float32(1.0), np.float32(0.0), np.float32(0.0), np.float32(1.0), np.float32(0.0), np.float32(0.0), np.float32(1.0), np.float32(1.0), np.float32(1.0), np.float32(0.0)]",-1.0,100080.0,35
2025-08-14_08-18-36,702,"[np.float32(1.0), np.float32(1.0), np.float32(0.0), np.float32(1.0), np.float32(1.0), np.float32(0.0), np.float32(0.0), np.float32(1.0), np.float32(1.0), np.float32(0.0), np.float32(0.0), np.float32(0.0), np.float32(1.0), np.float32(1.0), np.float32(0.0), np.float32(1.0)]",1.0,100081.0,21
2025-08-14_08-18-36,703,"[np.float32(1.0), np.float32(1.0), np.float32(0.0), np.float32(0.0), np.float32(1.0), np.float32(1.0), np.float32(0.0), np.float32(1.0), np.float32(1.0), np.float32(0.0), np.float32(1.0), np.float32(1.0), np.float32(0.0), np.float32(0.0), np.float32(1.0), np.float32(0.0)]",1.0,100082.0,15
2025-08-14_08-18-36,704,"[np.float32(0.0), np.float32(0.0), np.float32(1.0), np.float32(0.0), np.float32(1.0), np.float32(0.0), np.float32(0.0), np.float32(1.0), np.float32(1.0), np.float32(1.0), np.float32(1.0), np.float32(1.0), np.float32(1.0), np.float32(1.0), np.float32(1.0), np.float32(1.0)]",2.0,100084.0,18
2025-08-14_08-18-36,705,"[np.float32(0.0), np.float32(1.0), np.float32(0.0), np.float32(1.0), np.float32(1.0), np.float32(1.0), np.float32(1.0), np.float32(0.0), np.float32(1.0), np.float32(0.0), np.float32(0.0), np.float32(0.0), np.float32(1.0), np.float32(0.0), np.float32(0.0), np.float32(0.0)]",-3.0,100081.0,24
2025-08-14_08-18-36,706,"[np.float32(0.0), np.float32(0.0), np.float32(0.0), np.float32(0.0), np.float32(1.0), np.float32(1.0), np.float32(0.0), np.float32(0.0), np.float32(1.0), np.float32(1.0), np.float32(1.0), np.float32(1.0), np.float32(1.0), np.float32(1.0), np.float32(1.0), np.float32(0.0)]",-1.0,100080.0,3
2025-08-14_08-18-36,707,"[np.float32(0.0), np.float32(0.0), np.float32(1.0), np.float32(0.0), np.float32(1.0), np.float32(0.0), np.float32(0.0), np.float32(0.0), np.float32(1.0), np.float32(0.0), np.float32(0.0), np.float32(0.0), np.float32(0.0), np.float32(0.0), np.float32(1.0), np.float32(0.0)]",0.0,100080.0,4
2025-08-14_08-18-36,708,"[np.float32(1.0), np.float32(0.0), np.float32(1.0), np.float32(1.0), np.float32(0.0), np.float32(1.0), np.float32(1.0), np.float32(0.0), np.float32(1.0), np.float32(1.0), np.float32(0.0), np.float32(1.0), np.float32(1.0), np.float32(1.0), np.float32(1.0), np.float32(0.0)]",-3.0,100077.0,15
2025-08-14_08-18-36,709,"[np.float32(1.0), np.float32(0.0), np.float32(0.0), np.float32(1.0), np.float32(0.0), np.float32(1.0), np.float32(1.0), np.float32(0.0), np.float32(1.0), np.float32(1.0), np.float32(0.0), np.float32(0.0), np.float32(0.0), np.float32(0.0), np.float32(1.0), np.float32(0.0)]",0.0,100077.0,35
2025-08-14_08-18-36,710,"[np.float32(0.0), np.float32(0.0), np.float32(0.0), np.float32(1.0), np.float32(0.0), np.float32(1.0), np.float32(0.0), np.float32(0.0), np.float32(1.0), np.float32(0.0), np.float32(0.0), np.float32(0.0), np.float32(0.0), np.float32(0.0), np.float32(1.0), np.float32(1.0)]",0.0,100077.0,9
2025-08-14_08-18-36,711,"[np.float32(1.0), np.float32(1.0), np.float32(0.0), np.float32(1.0), np.float32(1.0), np.float32(1.0), np.float32(0.0), np.float32(1.0), np.float32(1.0), np.float32(1.0), np.float32(1.0), np.float32(1.0), np.float32(0.0), np.float32(0.0), np.float32(0.0), np.float32(0.0)]",-6.0,100071.0,0
2025-08-14_08-18-36,712,"[np.float32(0.0), np.float32(1.0), np.float32(0.0), np.float32(1.0), np.float32(1.0), np.float32(0.0), np.float32(0.0), np.float32(1.0), np.float32(0.0), np.float32(1.0), np.float32(0.0), np.float32(0.0), np.float32(1.0), np.float32(1.0), np.float32(1.0), np.float32(1.0)]",3.0,100074.0,15
2025-08-14_08-18-36,713,"[np.float32(0.0), np.float32(0.0), np.float32(0.0), np.float32(1.0), np.float32(0.0), np.float32(1.0), np.float32(0.0), np.float32(1.0), np.float32(1.0), np.float32(1.0), np.float32(1.0), np.float32(1.0), np.float32(1.0), np.float32(0.0), np.float32(1.0), np.float32(0.0)]",4.0,100078.0,27
2025-08-14_08-18-36,714,"[np.float32(0.0), np.float32(0.0), np.float32(1.0), np.float32(1.0), np.float32(0.0), np.float32(0.0), np.float32(0.0), np.float32(1.0), np.float32(0.0), np.float32(0.0), np.float32(1.0), np.float32(1.0), np.float32(0.0), np.float32(1.0), np.float32(1.0), np.float32(1.0)]",-3.0,100075.0,10
2025-08-14_08-18-36,715,"[np.float32(0.0), np.float32(0.0), np.float32(0.0), np.float32(1.0), np.float32(0.0), np.float32(0.0), np.float32(1.0), np.float32(1.0), np.float32(0.0), np.float32(1.0), np.float32(0.0), np.float32(0.0), np.float32(1.0), np.float32(0.0), np.float32(0.0), np.float32(1.0)]",2.0,100077.0,9
2025-08-14_08-18-36,716,"[np.float32(1.0), np.float32(1.0), np.float32(1.0), np.float32(1.0), np.float32(1.0), np.float32(1.0), np.float32(1.0), np.float32(1.0), np.float32(1.0), np.float32(0.0), np.float32(0.0), np.float32(0.0), np.float32(0.0), np.float32(1.0), np.float32(1.0), np.float32(1.0)]",0.0,100077.0,35
2025-08-14_08-18-36,717,"[np.float32(1.0), np.float32(1.0), np.float32(0.0), np.float32(1.0), np.float32(1.0), np.float32(0.0), np.float32(0.0), np.float32(1.0), np.float32(1.0), np.float32(1.0), np.float32(1.0), np.float32(1.0), np.float32(1.0), np.float32(0.0), np.float32(0.0), np.float32(1.0)]",-2.0,100075.0,3
2025-08-14_08-18-36,718,"[np.float32(1.0), np.float32(1.0), np.float32(1.0), np.float32(0.0), np.float32(1.0), np.float32(0.0), np.float32(1.0), np.float32(1.0), np.float32(0.0), np.float32(0.0), np.float32(1.0), np.float32(1.0), np.float32(1.0), np.float32(1.0), np.float32(1.0), np.float32(1.0)]",3.0,100078.0,8
2025-08-14_08-18-36,719,"[np.float32(1.0), np.float32(0.0), np.float32(1.0), np.float32(1.0), np.float32(0.0), np.float32(1.0), np.float32(0.0), np.float32(0.0), np.float32(0.0), np.float32(0.0), np.float32(0.0), np.float32(0.0), np.float32(1.0), np.float32(1.0), np.float32(1.0), np.float32(0.0)]",-3.0,100075.0,20
2025-08-14_08-18-36,720,"[np.float32(0.0), np.float32(1.0), np.float32(1.0), np.float32(0.0), np.float32(0.0), np.float32(0.0), np.float32(0.0), np.float32(0.0), np.float32(0.0), np.float32(1.0), np.float32(1.0), np.float32(1.0), np.float32(0.0), np.float32(0.0), np.float32(0.0), np.float32(0.0)]",-2.0,100073.0,19
2025-08-14_08-18-36,721,"[np.float32(0.0), np.float32(0.0), np.float32(1.0), np.float32(1.0), np.float32(1.0), np.float32(0.0), np.float32(1.0), np.float32(1.0), np.float32(0.0), np.float32(1.0), np.float32(0.0), np.float32(1.0), np.float32(0.0), np.float32(1.0), np.float32(1.0), np.float32(1.0)]",1.0,100074.0,19
2025-08-14_08-18-36,722,"[np.float32(0.0), np.float32(1.0), np.float32(1.0), np.float32(1.0), np.float32(1.0), np.float32(1.0), np.float32(0.0), np.float32(1.0), np.float32(0.0), np.float32(0.0), np.float32(0.0), np.float32(1.0), np.float32(1.0), np.float32(0.0), np.float32(0.0), np.float32(0.0)]",-1.0,100073.0,14
2025-08-14_08-18-36,723,"[np.float32(1.0), np.float32(0.0), np.float32(0.0), np.float32(0.0), np.float32(1.0), np.float32(1.0), np.float32(1.0), np.float32(1.0), np.float32(0.0), np.float32(1.0), np.float32(0.0), np.float32(1.0), np.float32(0.0), np.float32(0.0), np.float32(1.0), np.float32(1.0)]",1.0,100074.0,7
2025-08-14_08-18-36,724,"[np.float32(0.0), np.float32(1.0), np.float32(0.0), np.float32(1.0), np.float32(0.0), np.float32(1.0), np.float32(0.0), np.float32(0.0), np.float32(1.0), np.float32(0.0), np.float32(0.0), np.float32(0.0), np.float32(1.0), np.float32(1.0), np.float32(0.0), np.float32(0.0)]",-6.0,100068.0,14
2025-08-14_08-18-36,725,"[np.float32(1.0), np.float32(1.0), np.float32(0.0), np.float32(0.0), np.float32(0.0), np.float32(1.0), np.float32(1.0), np.float32(0.0), np.float32(0.0), np.float32(0.0), np.float32(1.0), np.float32(1.0), np.float32(0.0), np.float32(0.0), np.float32(1.0), np.float32(1.0)]",2.0,100070.0,27
2025-08-14_08-18-36,726,"[np.float32(1.0), np.float32(0.0), np.float32(0.0), np.float32(0.0), np.float32(0.0), np.float32(1.0), np.float32(1.0), np.float32(1.0), np.float32(0.0), np.float32(0.0), np.float32(0.0), np.float32(1.0), np.float32(0.0), np.float32(0.0), np.float32(0.0), np.float32(0.0)]",0.0,100070.0,20
2025-08-14_08-18-36,727,"[np.float32(1.0), np.float32(0.0), np.float32(1.0), np.float32(0.0), np.float32(1.0), np.float32(0.0), np.float32(0.0), np.float32(1.0), np.float32(0.0), np.float32(0.0), np.float32(1.0), np.float32(1.0), np.float32(1.0), np.float32(1.0), np.float32(1.0), np.float32(1.0)]",1.0,100071.0,24
2025-08-14_08-18-36,728,"[np.float32(0.0), np.float32(1.0), np.float32(0.0), np.float32(1.0), np.float32(0.0), np.float32(0.0), np.float32(0.0), np.float32(1.0), np.float32(1.0), np.float32(1.0), np.float32(0.0), np.float32(1.0), np.float32(0.0), np.float32(1.0), np.float32(1.0), np.float32(0.0)]",-2.0,100069.0,34
2025-08-14_08-18-36,729,"[np.float32(0.0), np.float32(0.0), np.float32(1.0), np.float32(1.0), np.float32(0.0), np.float32(1.0), np.float32(0.0), np.float32(1.0), np.float32(1.0), np.float32(1.0), np.float32(0.0), np.float32(0.0), np.float32(1.0), np.float32(1.0), np.float32(1.0), np.float32(1.0)]",3.0,100072.0,31
2025-08-14_08-18-36,730,"[np.float32(0.0), np.float32(0.0), np.float32(1.0), np.float32(1.0), np.float32(0.0), np.float32(1.0), np.float32(1.0), np.float32(0.0), np.float32(0.0), np.float32(0.0), np.float32(1.0), np.float32(0.0), np.float32(1.0), np.float32(0.0), np.float32(1.0), np.float32(0.0)]",-2.0,100070.0,4
2025-08-14_08-18-36,731,"[np.float32(1.0), np.float32(0.0), np.float32(1.0), np.float32(0.0), np.float32(1.0), np.float32(0.0), np.float32(1.0), np.float32(1.0), np.float32(1.0), np.float32(1.0), np.float32(0.0), np.float32(0.0), np.float32(1.0), np.float32(0.0), np.float32(1.0), np.float32(0.0)]",2.0,100072.0,13
2025-08-14_08-18-36,732,"[np.float32(1.0), np.float32(1.0), np.float32(0.0), np.float32(0.0), np.float32(1.0), np.float32(0.0), np.float32(0.0), np.float32(0.0), np.float32(0.0), np.float32(0.0), np.float32(1.0), np.float32(0.0), np.float32(0.0), np.float32(1.0), np.float32(1.0), np.float32(0.0)]",4.0,100076.0,11
2025-08-14_08-18-36,733,"[np.float32(1.0), np.float32(0.0), np.float32(1.0), np.float32(0.0), np.float32(1.0), np.float32(1.0), np.float32(1.0), np.float32(0.0), np.float32(0.0), np.float32(1.0), np.float32(0.0), np.float32(0.0), np.float32(0.0), np.float32(0.0), np.float32(0.0), np.float32(0.0)]",1.0,100077.0,22
2025-08-14_08-18-36,734,"[np.float32(0.0), np.float32(0.0), np.float32(1.0), np.float32(0.0), np.float32(0.0), np.float32(0.0), np.float32(1.0), np.float32(1.0), np.float32(0.0), np.float32(0.0), np.float32(0.0), np.float32(1.0), np.float32(1.0), np.float32(1.0), np.float32(0.0), np.float32(0.0)]",-1.0,100076.0,36
2025-08-14_08-18-36,735,"[np.float32(0.0), np.float32(0.0), np.float32(0.0), np.float32(1.0), np.float32(0.0), np.float32(0.0), np.float32(1.0), np.float32(0.0), np.float32(1.0), np.float32(0.0), np.float32(0.0), np.float32(0.0), np.float32(0.0), np.float32(0.0), np.float32(1.0), np.float32(0.0)]",2.0,100078.0,8
2025-08-14_08-18-36,736,"[np.float32(1.0), np.float32(1.0), np.float32(0.0), np.float32(1.0), np.float32(0.0), np.float32(0.0), np.float32(1.0), np.float32(1.0), np.float32(1.0), np.float32(1.0), np.float32(0.0), np.float32(0.0), np.float32(1.0), np.float32(1.0), np.float32(0.0), np.float32(1.0)]",-5.0,100073.0,0
2025-08-14_08-18-36,737,"[np.float32(1.0), np.float32(0.0), np.float32(0.0), np.float32(0.0), np.float32(0.0), np.float32(1.0), np.float32(1.0), np.float32(1.0), np.float32(1.0), np.float32(0.0), np.float32(0.0), np.float32(0.0), np.float32(0.0), np.float32(0.0), np.float32(1.0), np.float32(0.0)]",4.0,100077.0,30
2025-08-14_08-18-36,738,"[np.float32(0.0), np.float32(0.0), np.float32(1.0), np.float32(1.0), np.float32(1.0), np.float32(0.0), np.float32(0.0), np.float32(0.0), np.float32(0.0), np.float32(0.0), np.float32(0.0), np.float32(1.0), np.float32(1.0), np.float32(0.0), np.float32(1.0), np.float32(1.0)]",-5.0,100072.0,32
2025-08-14_08-18-36,739,"[np.float32(1.0), np.float32(1.0), np.float32(0.0), np.float32(0.0), np.float32(1.0), np.float32(0.0), np.float32(1.0), np.float32(1.0), np.float32(1.0), np.float32(1.0), np.float32(1.0), np.float32(1.0), np.float32(0.0), np.float32(0.0), np.float32(1.0), np.float32(1.0)]",-3.0,100069.0,22
2025-08-14_08-18-36,740,"[np.float32(1.0), np.float32(1.0), np.float32(0.0), np.float32(1.0), np.float32(1.0), np.float32(1.0), np.float32(1.0), np.float32(0.0), np.float32(0.0), np.float32(0.0), np.float32(1.0), np.float32(0.0), np.float32(0.0), np.float32(1.0), np.float32(1.0), np.float32(1.0)]",-1.0,100068.0,19
2025-08-14_08-18-36,741,"[np.float32(1.0), np.float32(1.0), np.float32(0.0), np.float32(0.0), np.float32(0.0), np.float32(0.0), np.float32(1.0), np.float32(1.0), np.float32(1.0), np.float32(1.0), np.float32(0.0), np.float32(0.0), np.float32(0.0), np.float32(0.0), np.float32(0.0), np.float32(1.0)]",1.0,100069.0,25
2025-08-14_08-18-36,742,"[np.float32(1.0), np.float32(0.0), np.float32(1.0), np.float32(1.0), np.float32(0.0), np.float32(0.0), np.float32(0.0), np.float32(1.0), np.float32(0.0), np.float32(0.0), np.float32(1.0), np.float32(1.0), np.float32(1.0), np.float32(1.0), np.float32(0.0), np.float32(0.0)]",5.0,100074.0,21
2025-08-14_08-18-36,743,"[np.float32(1.0), np.float32(0.0), np.float32(1.0), np.float32(0.0), np.float32(1.0), np.float32(0.0), np.float32(0.0), np.float32(0.0), np.float32(1.0), np.float32(0.0), np.float32(0.0), np.float32(1.0), np.float32(0.0), np.float32(0.0), np.float32(1.0), np.float32(0.0)]",-4.0,100070.0,20
2025-08-14_08-18-36,744,"[np.float32(0.0), np.float32(0.0), np.float32(1.0), np.float32(1.0), np.float32(0.0), np.float32(0.0), np.float32(1.0), np.float32(1.0), np.float32(1.0), np.float32(0.0), np.float32(0.0), np.float32(0.0), np.float32(0.0), np.float32(0.0), np.float32(0.0), np.float32(1.0)]",2.0,100072.0,34
2025-08-14_08-18-36,745,"[np.float32(1.0), np.float32(1.0), np.float32(0.0), np.float32(0.0), np.float32(0.0), np.float32(1.0), np.float32(1.0), np.float32(1.0), np.float32(1.0), np.float32(1.0), np.float32(0.0), np.float32(0.0), np.float32(1.0), np.float32(0.0), np.float32(1.0), np.float32(0.0)]",1.0,100073.0,30
2025-08-14_08-18-36,746,"[np.float32(0.0), np.float32(0.0), np.float32(0.0), np.float32(1.0), np.float32(1.0), np.float32(0.0), np.float32(0.0), np.float32(1.0), np.float32(1.0), np.float32(1.0), np.float32(1.0), np.float32(1.0), np.float32(0.0), np.float32(1.0), np.float32(0.0), np.float32(0.0)]",-3.0,100070.0,6
2025-08-14_08-18-36,747,"[np.float32(0.0), np.float32(0.0), np.float32(1.0), np.float32(0.0), np.float32(1.0), np.float32(1.0), np.float32(0.0), np.float32(1.0), np.float32(1.0), np.float32(1.0), np.float32(0.0), np.float32(0.0), np.float32(0.0), np.float32(0.0), np.float32(1.0), np.float32(1.0)]",0.0,100070.0,19
2025-08-14_08-18-36,748,"[np.float32(0.0), np.float32(0.0), np.float32(1.0), np.float32(1.0), np.float32(1.0), np.float32(0.0), np.float32(1.0), np.float32(0.0), np.float32(1.0), np.float32(0.0), np.float32(0.0), np.float32(1.0), np.float32(0.0), np.float32(0.0), np.float32(0.0), np.float32(0.0)]",-1.0,100069.0,29
2025-08-14_08-18-36,749,"[np.float32(0.0), np.float32(1.0), np.float32(1.0), np.float32(0.0), np.float32(1.0), np.float32(0.0), np.float32(0.0), np.float32(0.0), np.float32(0.0), np.float32(1.0), np.float32(1.0), np.float32(0.0), np.float32(1.0), np.float32(0.0), np.float32(0.0), np.float32(1.0)]",2.0,100071.0,6
2025-08-14_08-18-36,750,"[np.float32(1.0), np.float32(1.0), np.float32(0.0), np.float32(0.0), np.float32(1.0), np.float32(0.0), np.float32(1.0), np.float32(1.0), np.float32(1.0), np.float32(0.0), np.float32(1.0), np.float32(0.0), np.float32(0.0), np.float32(1.0), np.float32(1.0), np.float32(0.0)]",1.0,100072.0,18
2025-08-14_08-18-36,751,"[np.float32(0.0), np.float32(1.0), np.float32(0.0), np.float32(1.0), np.float32(0.0), np.float32(0.0), np.float32(0.0), np.float32(1.0), np.float32(1.0), np.float32(1.0), np.float32(0.0), np.float32(0.0), np.float32(1.0), np.float32(0.0), np.float32(0.0), np.float32(0.0)]",-4.0,100068.0,8
2025-08-14_08-18-36,752,"[np.float32(1.0), np.float32(1.0), np.float32(0.0), np.float32(0.0), np.float32(1.0), np.float32(0.0), np.float32(0.0), np.float32(0.0), np.float32(0.0), np.float32(0.0), np.float32(0.0), np.float32(0.0), np.float32(0.0), np.float32(0.0), np.float32(0.0), np.float32(0.0)]",-1.0,100067.0,19
2025-08-14_08-18-36,753,"[np.float32(0.0), np.float32(0.0), np.float32(0.0), np.float32(0.0), np.float32(0.0), np.float32(0.0), np.float32(1.0), np.float32(0.0), np.float32(1.0), np.float32(1.0), np.float32(0.0), np.float32(1.0), np.float32(0.0), np.float32(1.0), np.float32(1.0), np.float32(0.0)]",3.0,100070.0,25
2025-08-14_08-18-36,754,"[np.float32(0.0), np.float32(1.0), np.float32(0.0), np.float32(1.0), np.float32(1.0), np.float32(1.0), np.float32(1.0), np.float32(0.0), np.float32(1.0), np.float32(1.0), np.float32(1.0), np.float32(1.0), np.float32(0.0), np.float32(1.0), np.float32(0.0), np.float32(1.0)]",2.0,100072.0,1
2025-08-14_08-18-36,755,"[np.float32(1.0), np.float32(1.0), np.float32(1.0), np.float32(1.0), np.float32(0.0), np.float32(0.0), np.float32(0.0), np.float32(0.0), np.float32(0.0), np.float32(0.0), np.float32(1.0), np.float32(1.0), np.float32(0.0), np.float32(0.0), np.float32(0.0), np.float32(0.0)]",1.0,100073.0,15
2025-08-14_08-18-36,756,"[np.float32(0.0), np.float32(1.0), np.float32(0.0), np.float32(1.0), np.float32(1.0), np.float32(0.0), np.float32(0.0), np.float32(0.0), np.float32(1.0), np.float32(1.0), np.float32(0.0), np.float32(1.0), np.float32(0.0), np.float32(1.0), np.float32(0.0), np.float32(0.0)]",2.0,100075.0,13
2025-08-14_08-18-36,757,"[np.float32(0.0), np.float32(1.0), np.float32(1.0), np.float32(0.0), np.float32(1.0), np.float32(1.0), np.float32(1.0), np.float32(0.0), np.float32(0.0), np.float32(1.0), np.float32(0.0), np.float32(1.0), np.float32(1.0), np.float32(0.0), np.float32(0.0), np.float32(1.0)]",-2.0,100073.0,17
2025-08-14_08-18-36,758,"[np.float32(1.0), np.float32(1.0), np.float32(0.0), np.float32(0.0), np.float32(1.0), np.float32(1.0), np.float32(1.0), np.float32(0.0), np.float32(1.0), np.float32(1.0), np.float32(1.0), np.float32(1.0), np.float32(0.0), np.float32(0.0), np.float32(0.0), np.float32(1.0)]",-3.0,100070.0,18
2025-08-14_08-18-36,759,"[np.float32(0.0), np.float32(0.0), np.float32(0.0), np.float32(1.0), np.float32(0.0), np.float32(0.0), np.float32(0.0), np.float32(1.0), np.float32(0.0), np.float32(0.0), np.float32(0.0), np.float32(0.0), np.float32(1.0), np.float32(1.0), np.float32(0.0), np.float32(0.0)]",-1.0,100069.0,0
2025-08-14_08-18-36,760,"[np.float32(0.0), np.float32(1.0), np.float32(0.0), np.float32(0.0), np.float32(0.0), np.float32(1.0), np.float32(0.0), np.float32(1.0), np.float32(1.0), np.float32(1.0), np.float32(0.0), np.float32(1.0), np.float32(0.0), np.float32(1.0), np.float32(0.0), np.float32(0.0)]",1.0,100070.0,13
2025-08-14_08-18-36,761,"[np.float32(0.0), np.float32(1.0), np.float32(1.0), np.float32(0.0), np.float32(0.0), np.float32(1.0), np.float32(1.0), np.float32(1.0), np.float32(1.0), np.float32(0.0), np.float32(1.0), np.float32(0.0), np.float32(1.0), np.float32(1.0), np.float32(1.0), np.float32(1.0)]",-3.0,100067.0,27
2025-08-14_08-18-36,762,"[np.float32(1.0), np.float32(1.0), np.float32(0.0), np.float32(0.0), np.float32(1.0), np.float32(1.0), np.float32(0.0), np.float32(1.0), np.float32(1.0), np.float32(1.0), np.float32(1.0), np.float32(0.0), np.float32(1.0), np.float32(0.0), np.float32(0.0), np.float32(0.0)]",-2.0,100065.0,18
2025-08-14_08-18-36,763,"[np.float32(0.0), np.float32(0.0), np.float32(1.0), np.float32(0.0), np.float32(0.0), np.float32(0.0), np.float32(1.0), np.float32(1.0), np.float32(0.0), np.float32(1.0), np.float32(1.0), np.float32(0.0), np.float32(1.0), np.float32(0.0), np.float32(1.0), np.float32(0.0)]",1.0,100066.0,4
2025-08-14_08-18-36,764,"[np.float32(1.0), np.float32(1.0), np.float32(0.0), np.float32(0.0), np.float32(0.0), np.float32(1.0), np.float32(1.0), np.float32(1.0), np.float32(1.0), np.float32(1.0), np.float32(0.0), np.float32(1.0), np.float32(1.0), np.float32(0.0), np.float32(0.0), np.float32(1.0)]",-3.0,100063.0,35
2025-08-14_08-18-36,765,"[np.float32(1.0), np.float32(0.0), np.float32(0.0), np.float32(1.0), np.float32(1.0), np.float32(1.0), np.float32(1.0), np.float32(0.0), np.float32(1.0), np.float32(0.0), np.float32(0.0), np.float32(0.0), np.float32(0.0), np.float32(1.0), np.float32(1.0), np.float32(1.0)]",1.0,100064.0,31
2025-08-14_08-18-36,766,"[np.float32(0.0), np.float32(1.0), np.float32(0.0), np.float32(1.0), np.float32(0.0), np.float32(0.0), np.float32(0.0), np.float32(1.0), np.float32(0.0), np.float32(1.0), np.float32(1.0), np.float32(0.0), np.float32(1.0), np.float32(0.0), np.float32(1.0), np.float32(1.0)]",1.0,100065.0,14
2025-08-14_08-18-36,767,"[np.float32(1.0), np.float32(0.0), np.float32(1.0), np.float32(0.0), np.float32(0.0), np.float32(1.0), np.float32(1.0), np.float32(1.0), np.float32(1.0), np.float32(1.0), np.float32(1.0), np.float32(1.0), np.float32(1.0), np.float32(1.0), np.float32(0.0), np.float32(0.0)]",0.0,100065.0,4
2025-08-14_08-18-36,768,"[np.float32(0.0), np.float32(0.0), np.float32(1.0), np.float32(0.0), np.float32(0.0), np.float32(1.0), np.float32(1.0), np.float32(0.0), np.float32(1.0), np.float32(0.0), np.float32(1.0), np.float32(1.0), np.float32(1.0), np.float32(1.0), np.float32(0.0), np.float32(1.0)]",4.0,100069.0,32
2025-08-14_08-18-36,769,"[np.float32(0.0), np.float32(0.0), np.float32(0.0), np.float32(0.0), np.float32(1.0), np.float32(0.0), np.float32(1.0), np.float32(1.0), np.float32(1.0), np.float32(0.0), np.float32(0.0), np.float32(0.0), np.float32(1.0), np.float32(1.0), np.float32(1.0), np.float32(1.0)]",-2.0,100067.0,22
2025-08-14_08-18-36,770,"[np.float32(0.0), np.float32(0.0), np.float32(1.0), np.float32(1.0), np.float32(0.0), np.float32(1.0), np.float32(0.0), np.float32(0.0), np.float32(0.0), np.float32(1.0), np.float32(0.0), np.float32(0.0), np.float32(1.0), np.float32(1.0), np.float32(0.0), np.float32(1.0)]",0.0,100067.0,20
2025-08-14_08-18-36,771,"[np.float32(0.0), np.float32(1.0), np.float32(0.0), np.float32(0.0), np.float32(1.0), np.float32(0.0), np.float32(0.0), np.float32(1.0), np.float32(0.0), np.float32(1.0), np.float32(0.0), np.float32(1.0), np.float32(1.0), np.float32(0.0), np.float32(0.0), np.float32(0.0)]",2.0,100069.0,16
2025-08-14_08-18-36,772,"[np.float32(1.0), np.float32(0.0), np.float32(1.0), np.float32(1.0), np.float32(0.0), np.float32(1.0), np.float32(0.0), np.float32(0.0), np.float32(0.0), np.float32(1.0), np.float32(1.0), np.float32(1.0), np.float32(0.0), np.float32(0.0), np.float32(1.0), np.float32(1.0)]",3.0,100072.0,30
2025-08-14_08-18-36,773,"[np.float32(0.0), np.float32(0.0), np.float32(1.0), np.float32(1.0), np.float32(1.0), np.float32(0.0), np.float32(0.0), np.float32(0.0), np.float32(1.0), np.float32(1.0), np.float32(0.0), np.float32(0.0), np.float32(0.0), np.float32(1.0), np.float32(0.0), np.float32(0.0)]",-2.0,100070.0,5
2025-08-14_08-18-36,774,"[np.float32(0.0), np.float32(0.0), np.float32(1.0), np.float32(0.0), np.float32(1.0), np.float32(1.0), np.float32(1.0), np.float32(1.0), np.float32(1.0), np.float32(0.0), np.float32(1.0), np.float32(0.0), np.float32(1.0), np.float32(1.0), np.float32(0.0), np.float32(1.0)]",1.0,100071.0,35
2025-08-14_08-18-36,775,"[np.float32(1.0), np.float32(1.0), np.float32(0.0), np.float32(1.0), np.float32(1.0), np.float32(0.0), np.float32(1.0), np.float32(1.0), np.float32(1.0), np.float32(0.0), np.float32(1.0), np.float32(0.0), np.float32(0.0), np.float32(1.0), np.float32(1.0), np.float32(0.0)]",0.0,100071.0,27
2025-08-14_08-18-36,776,"[np.float32(1.0), np.float32(0.0), np.float32(1.0), np.float32(0.0), np.float32(1.0), np.float32(1.0), np.float32(0.0), np.float32(0.0), np.float32(1.0), np.float32(1.0), np.float32(0.0), np.float32(1.0), np.float32(0.0), np.float32(0.0), np.float32(1.0), np.float32(1.0)]",1.0,100072.0,25
2025-08-14_08-18-36,777,"[np.float32(1.0), np.float32(1.0), np.float32(0.0), np.float32(1.0), np.float32(1.0), np.float32(0.0), np.float32(1.0), np.float32(0.0), np.float32(0.0), np.float32(0.0), np.float32(1.0), np.float32(1.0), np.float32(1.0), np.float32(1.0), np.float32(0.0), np.float32(1.0)]",-4.0,100068.0,13
2025-08-14_08-18-36,778,"[np.float32(0.0), np.float32(0.0), np.float32(1.0), np.float32(1.0), np.float32(0.0), np.float32(0.0), np.float32(1.0), np.float32(1.0), np.float32(1.0), np.float32(1.0), np.float32(0.0), np.float32(0.0), np.float32(1.0), np.float32(0.0), np.float32(1.0), np.float32(0.0)]",-3.0,100065.0,35
2025-08-14_08-18-36,779,"[np.float32(0.0), np.float32(0.0), np.float32(1.0), np.float32(1.0), np.float32(0.0), np.float32(1.0), np.float32(0.0), np.float32(0.0), np.float32(1.0), np.float32(1.0), np.float32(1.0), np.float32(0.0), np.float32(1.0), np.float32(1.0), np.float32(0.0), np.float32(0.0)]",-4.0,100061.0,24
2025-08-14_08-18-36,780,"[np.float32(1.0), np.float32(1.0), np.float32(1.0), np.float32(0.0), np.float32(0.0), np.float32(0.0), np.float32(1.0), np.float32(1.0), np.float32(0.0), np.float32(0.0), np.float32(1.0), np.float32(0.0), np.float32(1.0), np.float32(0.0), np.float32(1.0), np.float32(0.0)]",2.0,100063.0,10
2025-08-14_08-18-36,781,"[np.float32(1.0), np.float32(0.0), np.float32(0.0), np.float32(0.0), np.float32(0.0), np.float32(0.0), np.float32(1.0), np.float32(1.0), np.float32(0.0), np.float32(0.0), np.float32(1.0), np.float32(0.0), np.float32(1.0), np.float32(1.0), np.float32(1.0), np.float32(1.0)]",0.0,100063.0,12
2025-08-14_08-18-36,782,"[np.float32(0.0), np.float32(1.0), np.float32(1.0), np.float32(1.0), np.float32(0.0), np.float32(0.0), np.float32(1.0), np.float32(0.0), np.float32(1.0), np.float32(1.0), np.float32(0.0), np.float32(1.0), np.float32(0.0), np.float32(1.0), np.float32(1.0), np.float32(0.0)]",1.0,100064.0,6
2025-08-14_08-18-36,783,"[np.float32(1.0), np.float32(1.0), np.float32(1.0), np.float32(1.0), np.float32(0.0), np.float32(1.0), np.float32(1.0), np.float32(1.0), np.float32(1.0), np.float32(0.0), np.float32(0.0), np.float32(1.0), np.float32(1.0), np.float32(0.0), np.float32(1.0), np.float32(0.0)]",-2.0,100062.0,34
2025-08-14_08-18-36,784,"[np.float32(1.0), np.float32(1.0), np.float32(0.0), np.float32(1.0), np.float32(1.0), np.float32(1.0), np.float32(0.0), np.float32(1.0), np.float32(0.0), np.float32(0.0), np.float32(1.0), np.float32(0.0), np.float32(1.0), np.float32(1.0), np.float32(1.0), np.float32(1.0)]",-4.0,100058.0,36
2025-08-14_08-18-36,785,"[np.float32(0.0), np.float32(0.0), np.float32(1.0), np.float32(0.0), np.float32(0.0), np.float32(0.0), np.float32(0.0), np.float32(0.0), np.float32(0.0), np.float32(1.0), np.float32(1.0), np.float32(0.0), np.float32(1.0), np.float32(1.0), np.float32(1.0), np.float32(0.0)]",-1.0,100057.0,30
2025-08-14_08-18-36,786,"[np.float32(0.0), np.float32(1.0), np.float32(0.0), np.float32(0.0), np.float32(0.0), np.float32(1.0), np.float32(1.0), np.float32(0.0), np.float32(1.0), np.float32(1.0), np.float32(0.0), np.float32(1.0), np.float32(1.0), np.float32(1.0), np.float32(0.0), np.float32(0.0)]",-6.0,100051.0,23
2025-08-14_08-18-36,787,"[np.float32(1.0), np.float32(1.0), np.float32(1.0), np.float32(0.0), np.float32(1.0), np.float32(1.0), np.float32(0.0), np.float32(1.0), np.float32(0.0), np.float32(1.0), np.float32(0.0), np.float32(1.0), np.float32(0.0), np.float32(1.0), np.float32(1.0), np.float32(0.0)]",0.0,100051.0,25
2025-08-14_08-18-36,788,"[np.float32(1.0), np.float32(1.0), np.float32(1.0), np.float32(0.0), np.float32(0.0), np.float32(0.0), np.float32(0.0), np.float32(1.0), np.float32(1.0), np.float32(0.0), np.float32(0.0), np.float32(0.0), np.float32(0.0), np.float32(0.0), np.float32(0.0), np.float32(0.0)]",-3.0,100048.0,11
2025-08-14_08-18-36,789,"[np.float32(0.0), np.float32(0.0), np.float32(0.0), np.float32(0.0), np.float32(1.0), np.float32(0.0), np.float32(1.0), np.float32(1.0), np.float32(1.0), np.float32(0.0), np.float32(0.0), np.float32(1.0), np.float32(1.0), np.float32(0.0), np.float32(0.0), np.float32(1.0)]",-1.0,100047.0,36
2025-08-14_08-18-36,790,"[np.float32(1.0), np.float32(1.0), np.float32(1.0), np.float32(1.0), np.float32(0.0), np.float32(1.0), np.float32(0.0), np.float32(0.0), np.float32(1.0), np.float32(0.0), np.float32(0.0), np.float32(1.0), np.float32(1.0), np.float32(1.0), np.float32(0.0), np.float32(0.0)]",-2.0,100045.0,9
2025-08-14_08-18-36,791,"[np.float32(1.0), np.float32(1.0), np.float32(0.0), np.float32(0.0), np.float32(0.0), np.float32(1.0), np.float32(0.0), np.float32(0.0), np.float32(0.0), np.float32(1.0), np.float32(1.0), np.float32(0.0), np.float32(1.0), np.float32(1.0), np.float32(1.0), np.float32(0.0)]",-3.0,100042.0,3
2025-08-14_08-18-36,792,"[np.float32(1.0), np.float32(0.0), np.float32(0.0), np.float32(1.0), np.float32(1.0), np.float32(1.0), np.float32(0.0), np.float32(0.0), np.float32(1.0), np.float32(0.0), np.float32(0.0), np.float32(0.0), np.float32(1.0), np.float32(1.0), np.float32(1.0), np.float32(0.0)]",-1.0,100041.0,31
2025-08-14_08-18-36,793,"[np.float32(1.0), np.float32(1.0), np.float32(1.0), np.float32(0.0), np.float32(1.0), np.float32(1.0), np.float32(0.0), np.float32(0.0), np.float32(0.0), np.float32(1.0), np.float32(0.0), np.float32(0.0), np.float32(1.0), np.float32(0.0), np.float32(0.0), np.float32(1.0)]",-2.0,100039.0,30
2025-08-14_08-18-36,794,"[np.float32(0.0), np.float32(0.0), np.float32(1.0), np.float32(0.0), np.float32(0.0), np.float32(1.0), np.float32(0.0), np.float32(0.0), np.float32(0.0), np.float32(0.0), np.float32(1.0), np.float32(0.0), np.float32(1.0), np.float32(0.0), np.float32(0.0), np.float32(0.0)]",-2.0,100037.0,31
2025-08-14_08-18-36,795,"[np.float32(1.0), np.float32(0.0), np.float32(0.0), np.float32(1.0), np.float32(0.0), np.float32(1.0), np.float32(1.0), np.float32(0.0), np.float32(1.0), np.float32(0.0), np.float32(1.0), np.float32(1.0), np.float32(1.0), np.float32(0.0), np.float32(1.0), np.float32(0.0)]",-6.0,100031.0,4
2025-08-14_08-18-36,796,"[np.float32(0.0), np.float32(1.0), np.float32(0.0), np.float32(0.0), np.float32(0.0), np.float32(0.0), np.float32(0.0), np.float32(0.0), np.float32(1.0), np.float32(0.0), np.float32(0.0), np.float32(1.0), np.float32(0.0), np.float32(1.0), np.float32(1.0), np.float32(1.0)]",-1.0,100030.0,22
2025-08-14_08-18-36,797,"[np.float32(1.0), np.float32(1.0), np.float32(0.0), np.float32(1.0), np.float32(1.0), np.float32(1.0), np.float32(1.0), np.float32(0.0), np.float32(0.0), np.float32(0.0), np.float32(0.0), np.float32(1.0), np.float32(1.0), np.float32(1.0), np.float32(1.0), np.float32(0.0)]",0.0,100030.0,8
2025-08-14_08-18-36,798,"[np.float32(0.0), np.float32(1.0), np.float32(1.0), np.float32(1.0), np.float32(1.0), np.float32(0.0), np.float32(0.0), np.float32(1.0), np.float32(0.0), np.float32(0.0), np.float32(1.0), np.float32(0.0), np.float32(0.0), np.float32(1.0), np.float32(0.0), np.float32(0.0)]",0.0,100030.0,5
2025-08-14_08-18-36,799,"[np.float32(1.0), np.float32(1.0), np.float32(1.0), np.float32(0.0), np.float32(1.0), np.float32(0.0), np.float32(0.0), np.float32(0.0), np.float32(1.0), np.float32(1.0), np.float32(0.0), np.float32(1.0), np.float32(1.0), np.float32(1.0), np.float32(0.0), np.float32(1.0)]",-1.0,100029.0,16
2025-08-14_08-18-36,800,"[np.float32(0.0), np.float32(0.0), np.float32(1.0), np.float32(1.0), np.float32(1.0), np.float32(0.0), np.float32(1.0), np.float32(0.0), np.float32(0.0), np.float32(1.0), np.float32(1.0), np.float32(1.0), np.float32(0.0), np.float32(1.0), np.float32(1.0), np.float32(0.0)]",4.0,100033.0,4
2025-08-14_08-18-36,801,"[np.float32(1.0), np.float32(0.0), np.float32(1.0), np.float32(0.0), np.float32(1.0), np.float32(0.0), np.float32(1.0), np.float32(0.0), np.float32(0.0), np.float32(1.0), np.float32(1.0), np.float32(0.0), np.float32(0.0), np.float32(0.0), np.float32(1.0), np.float32(0.0)]",-5.0,100028.0,0
2025-08-14_08-18-36,802,"[np.float32(0.0), np.float32(0.0), np.float32(1.0), np.float32(0.0), np.float32(0.0), np.float32(1.0), np.float32(1.0), np.float32(1.0), np.float32(1.0), np.float32(1.0), np.float32(0.0), np.float32(1.0), np.float32(1.0), np.float32(0.0), np.float32(1.0), np.float32(1.0)]",-4.0,100024.0,17
2025-08-14_08-18-36,803,"[np.float32(0.0), np.float32(0.0), np.float32(1.0), np.float32(1.0), np.float32(1.0), np.float32(1.0), np.float32(0.0), np.float32(1.0), np.float32(1.0), np.float32(1.0), np.float32(0.0), np.float32(1.0), np.float32(1.0), np.float32(0.0), np.float32(0.0), np.float32(1.0)]",0.0,100024.0,19
2025-08-14_08-18-36,804,"[np.float32(1.0), np.float32(0.0), np.float32(0.0), np.float32(0.0), np.float32(0.0), np.float32(0.0), np.float32(0.0), np.float32(0.0), np.float32(0.0), np.float32(0.0), np.float32(0.0), np.float32(1.0), np.float32(1.0), np.float32(1.0), np.float32(1.0), np.float32(0.0)]",-2.0,100022.0,4
2025-08-14_08-18-36,805,"[np.float32(1.0), np.float32(0.0), np.float32(1.0), np.float32(1.0), np.float32(1.0), np.float32(1.0), np.float32(0.0), np.float32(1.0), np.float32(0.0), np.float32(0.0), np.float32(0.0), np.float32(1.0), np.float32(0.0), np.float32(0.0), np.float32(1.0), np.float32(0.0)]",-4.0,100018.0,35
2025-08-14_08-18-36,806,"[np.float32(1.0), np.float32(0.0), np.float32(0.0), np.float32(0.0), np.float32(0.0), np.float32(1.0), np.float32(0.0), np.float32(0.0), np.float32(1.0), np.float32(1.0), np.float32(1.0), np.float32(1.0), np.float32(1.0), np.float32(0.0), np.float32(1.0), np.float32(0.0)]",-5.0,100013.0,17
2025-08-14_08-18-36,807,"[np.float32(0.0), np.float32(1.0), np.float32(1.0), np.float32(0.0), np.float32(1.0), np.float32(0.0), np.float32(1.0), np.float32(1.0), np.float32(0.0), np.float32(1.0), np.float32(1.0), np.float32(0.0), np.float32(0.0), np.float32(0.0), np.float32(0.0), np.float32(0.0)]",-7.0,100006.0,27
2025-08-14_08-18-36,808,"[np.float32(0.0), np.float32(0.0), np.float32(1.0), np.float32(0.0), np.float32(0.0), np.float32(0.0), np.float32(1.0), np.float32(1.0), np.float32(1.0), np.float32(1.0), np.float32(0.0), np.float32(1.0), np.float32(1.0), np.float32(0.0), np.float32(0.0), np.float32(1.0)]",-3.0,100003.0,32
2025-08-14_08-18-36,809,"[np.float32(1.0), np.float32(0.0), np.float32(1.0), np.float32(1.0), np.float32(1.0), np.float32(1.0), np.float32(1.0), np.float32(0.0), np.float32(1.0), np.float32(0.0), np.float32(1.0), np.float32(0.0), np.float32(0.0), np.float32(0.0), np.float32(0.0), np.float32(0.0)]",1.0,100004.0,30
2025-08-14_08-18-36,810,"[np.float32(0.0), np.float32(0.0), np.float32(1.0), np.float32(1.0), np.float32(0.0), np.float32(0.0), np.float32(0.0), np.float32(0.0), np.float32(1.0), np.float32(1.0), np.float32(0.0), np.float32(1.0), np.float32(0.0), np.float32(1.0), np.float32(1.0), np.float32(0.0)]",1.0,100005.0,10
2025-08-14_08-18-36,811,"[np.float32(0.0), np.float32(0.0), np.float32(1.0), np.float32(1.0), np.float32(1.0), np.float32(1.0), np.float32(0.0), np.float32(1.0), np.float32(1.0), np.float32(0.0), np.float32(1.0), np.float32(1.0), np.float32(1.0), np.float32(0.0), np.float32(0.0), np.float32(0.0)]",1.0,100006.0,30
2025-08-14_08-18-36,812,"[np.float32(0.0), np.float32(1.0), np.float32(0.0), np.float32(0.0), np.float32(0.0), np.float32(0.0), np.float32(0.0), np.float32(0.0), np.float32(1.0), np.float32(0.0), np.float32(1.0), np.float32(0.0), np.float32(1.0), np.float32(1.0), np.float32(0.0), np.float32(1.0)]",2.0,100008.0,2
2025-08-14_08-18-36,813,"[np.float32(1.0), np.float32(0.0), np.float32(1.0), np.float32(0.0), np.float32(0.0), np.float32(0.0), np.float32(0.0), np.float32(0.0), np.float32(0.0), np.float32(1.0), np.float32(1.0), np.float32(0.0), np.float32(0.0), np.float32(0.0), np.float32(0.0), np.float32(1.0)]",0.0,100008.0,22
2025-08-14_08-18-36,814,"[np.float32(1.0), np.float32(1.0), np.float32(1.0), np.float32(0.0), np.float32(1.0), np.float32(1.0), np.float32(1.0), np.float32(1.0), np.float32(1.0), np.float32(0.0), np.float32(1.0), np.float32(0.0), np.float32(1.0), np.float32(0.0), np.float32(1.0), np.float32(0.0)]",1.0,100009.0,30
2025-08-14_08-18-36,815,"[np.float32(0.0), np.float32(0.0), np.float32(1.0), np.float32(1.0), np.float32(1.0), np.float32(1.0), np.float32(0.0), np.float32(1.0), np.float32(0.0), np.float32(1.0), np.float32(1.0), np.float32(1.0), np.float32(0.0), np.float32(0.0), np.float32(1.0), np.float32(0.0)]",-2.0,100007.0,31
2025-08-14_08-18-36,816,"[np.float32(1.0), np.float32(1.0), np.float32(0.0), np.float32(0.0), np.float32(0.0), np.float32(0.0), np.float32(1.0), np.float32(0.0), np.float32(0.0), np.float32(1.0), np.float32(0.0), np.float32(0.0), np.float32(0.0), np.float32(0.0), np.float32(0.0), np.float32(1.0)]",-3.0,100004.0,15
2025-08-14_08-18-36,817,"[np.float32(0.0), np.float32(0.0), np.float32(1.0), np.float32(1.0), np.float32(0.0), np.float32(1.0), np.float32(1.0), np.float32(0.0), np.float32(0.0), np.float32(0.0), np.float32(1.0), np.float32(0.0), np.float32(0.0), np.float32(1.0), np.float32(1.0), np.float32(0.0)]",3.0,100007.0,23
2025-08-14_08-18-36,818,"[np.float32(0.0), np.float32(0.0), np.float32(1.0), np.float32(1.0), np.float32(0.0), np.float32(0.0), np.float32(1.0), np.float32(0.0), np.float32(0.0), np.float32(0.0), np.float32(0.0), np.float32(1.0), np.float32(1.0), np.float32(0.0), np.float32(0.0), np.float32(0.0)]",-3.0,100004.0,25
2025-08-14_08-18-36,819,"[np.float32(1.0), np.float32(1.0), np.float32(1.0), np.float32(0.0), np.float32(1.0), np.float32(1.0), np.float32(1.0), np.float32(0.0), np.float32(0.0), np.float32(0.0), np.float32(1.0), np.float32(1.0), np.float32(1.0), np.float32(0.0), np.float32(1.0), np.float32(0.0)]",-4.0,100000.0,28
2025-08-14_08-18-36,820,"[np.float32(0.0), np.float32(1.0), np.float32(1.0), np.float32(0.0), np.float32(1.0), np.float32(0.0), np.float32(0.0), np.float32(1.0), np.float32(1.0), np.float32(1.0), np.float32(0.0), np.float32(0.0), np.float32(1.0), np.float32(0.0), np.float32(1.0), np.float32(0.0)]",-2.0,99998.0,23
2025-08-14_08-18-36,821,"[np.float32(1.0), np.float32(1.0), np.float32(1.0), np.float32(1.0), np.float32(0.0), np.float32(0.0), np.float32(0.0), np.float32(0.0), np.float32(0.0), np.float32(1.0), np.float32(1.0), np.float32(1.0), np.float32(0.0), np.float32(1.0), np.float32(0.0), np.float32(1.0)]",1.0,99999.0,34
2025-08-14_08-18-36,822,"[np.float32(0.0), np.float32(1.0), np.float32(1.0), np.float32(0.0), np.float32(0.0), np.float32(1.0), np.float32(0.0), np.float32(0.0), np.float32(1.0), np.float32(0.0), np.float32(0.0), np.float32(1.0), np.float32(1.0), np.float32(0.0), np.float32(1.0), np.float32(0.0)]",-2.0,99997.0,23
2025-08-14_08-18-36,823,"[np.float32(0.0), np.float32(0.0), np.float32(0.0), np.float32(0.0), np.float32(1.0), np.float32(1.0), np.float32(1.0), np.float32(1.0), np.float32(1.0), np.float32(0.0), np.float32(0.0), np.float32(1.0), np.float32(1.0), np.float32(0.0), np.float32(1.0), np.float32(0.0)]",0.0,99997.0,5
2025-08-14_08-18-36,824,"[np.float32(1.0), np.float32(0.0), np.float32(0.0), np.float32(1.0), np.float32(1.0), np.float32(1.0), np.float32(1.0), np.float32(1.0), np.float32(0.0), np.float32(1.0), np.float32(0.0), np.float32(0.0), np.float32(0.0), np.float32(0.0), np.float32(1.0), np.float32(0.0)]",-1.0,99996.0,15
2025-08-14_08-18-36,825,"[np.float32(0.0), np.float32(0.0), np.float32(1.0), np.float32(0.0), np.float32(1.0), np.float32(1.0), np.float32(0.0), np.float32(0.0), np.float32(0.0), np.float32(1.0), np.float32(1.0), np.float32(0.0), np.float32(0.0), np.float32(1.0), np.float32(1.0), np.float32(0.0)]",0.0,99996.0,20
2025-08-14_08-18-36,826,"[np.float32(0.0), np.float32(0.0), np.float32(1.0), np.float32(0.0), np.float32(0.0), np.float32(1.0), np.float32(0.0), np.float32(1.0), np.float32(0.0), np.float32(1.0), np.float32(0.0), np.float32(1.0), np.float32(1.0), np.float32(1.0), np.float32(1.0), np.float32(0.0)]",2.0,99998.0,30
2025-08-14_08-18-36,827,"[np.float32(0.0), np.float32(0.0), np.float32(1.0), np.float32(0.0), np.float32(1.0), np.float32(1.0), np.float32(1.0), np.float32(1.0), np.float32(1.0), np.float32(0.0), np.float32(0.0), np.float32(1.0), np.float32(1.0), np.float32(0.0), np.float32(0.0), np.float32(1.0)]",-2.0,99996.0,26
2025-08-14_08-18-36,828,"[np.float32(0.0), np.float32(0.0), np.float32(1.0), np.float32(1.0), np.float32(1.0), np.float32(0.0), np.float32(0.0), np.float32(0.0), np.float32(0.0), np.float32(0.0), np.float32(1.0), np.float32(1.0), np.float32(1.0), np.float32(1.0), np.float32(1.0), np.float32(0.0)]",0.0,99996.0,21
2025-08-14_08-18-36,829,"[np.float32(0.0), np.float32(1.0), np.float32(1.0), np.float32(0.0), np.float32(1.0), np.float32(0.0), np.float32(0.0), np.float32(1.0), np.float32(1.0), np.float32(1.0), np.float32(0.0), np.float32(0.0), np.float32(0.0), np.float32(1.0), np.float32(1.0), np.float32(1.0)]",2.0,99998.0,31
2025-08-14_08-18-36,830,"[np.float32(0.0), np.float32(1.0), np.float32(1.0), np.float32(0.0), np.float32(1.0), np.float32(1.0), np.float32(1.0), np.float32(1.0), np.float32(0.0), np.float32(1.0), np.float32(1.0), np.float32(0.0), np.float32(1.0), np.float32(1.0), np.float32(1.0), np.float32(0.0)]",-1.0,99997.0,17
2025-08-14_08-18-36,831,"[np.float32(0.0), np.float32(0.0), np.float32(1.0), np.float32(0.0), np.float32(0.0), np.float32(1.0), np.float32(1.0), np.float32(1.0), np.float32(0.0), np.float32(0.0), np.float32(1.0), np.float32(0.0), np.float32(0.0), np.float32(0.0), np.float32(1.0), np.float32(0.0)]",-1.0,99996.0,21
2025-08-14_08-18-36,832,"[np.float32(0.0), np.float32(0.0), np.float32(1.0), np.float32(1.0), np.float32(0.0), np.float32(0.0), np.float32(0.0), np.float32(0.0), np.float32(0.0), np.float32(0.0), np.float32(1.0), np.float32(1.0), np.float32(0.0), np.float32(0.0), np.float32(0.0), np.float32(0.0)]",-2.0,99994.0,31
2025-08-14_08-18-36,833,"[np.float32(0.0), np.float32(1.0), np.float32(1.0), np.float32(1.0), np.float32(0.0), np.float32(1.0), np.float32(0.0), np.float32(0.0), np.float32(0.0), np.float32(0.0), np.float32(0.0), np.float32(0.0), np.float32(0.0), np.float32(0.0), np.float32(1.0), np.float32(0.0)]",2.0,99996.0,23
2025-08-14_08-18-36,834,"[np.float32(1.0), np.float32(0.0), np.float32(1.0), np.float32(1.0), np.float32(1.0), np.float32(0.0), np.float32(0.0), np.float32(1.0), np.float32(0.0), np.float32(1.0), np.float32(0.0), np.float32(1.0), np.float32(1.0), np.float32(1.0), np.float32(0.0), np.float32(1.0)]",-3.0,99993.0,23
2025-08-14_08-18-36,835,"[np.float32(0.0), np.float32(1.0), np.float32(0.0), np.float32(0.0), np.float32(1.0), np.float32(1.0), np.float32(1.0), np.float32(0.0), np.float32(1.0), np.float32(1.0), np.float32(0.0), np.float32(1.0), np.float32(1.0), np.float32(1.0), np.float32(1.0), np.float32(1.0)]",-4.0,99989.0,0
2025-08-14_08-18-36,836,"[np.float32(1.0), np.float32(0.0), np.float32(0.0), np.float32(0.0), np.float32(0.0), np.float32(1.0), np.float32(1.0), np.float32(1.0), np.float32(0.0), np.float32(0.0), np.float32(1.0), np.float32(1.0), np.float32(0.0), np.float32(0.0), np.float32(0.0), np.float32(0.0)]",-1.0,99988.0,26
2025-08-14_08-18-36,837,"[np.float32(1.0), np.float32(1.0), np.float32(1.0), np.float32(1.0), np.float32(0.0), np.float32(0.0), np.float32(1.0), np.float32(0.0), np.float32(1.0), np.float32(1.0), np.float32(1.0), np.float32(0.0), np.float32(0.0), np.float32(0.0), np.float32(1.0), np.float32(1.0)]",0.0,99988.0,14
2025-08-14_08-18-36,838,"[np.float32(0.0), np.float32(1.0), np.float32(1.0), np.float32(0.0), np.float32(0.0), np.float32(0.0), np.float32(1.0), np.float32(0.0), np.float32(1.0), np.float32(1.0), np.float32(0.0), np.float32(1.0), np.float32(1.0), np.float32(0.0), np.float32(1.0), np.float32(1.0)]",2.0,99990.0,33
2025-08-14_08-18-36,839,"[np.float32(0.0), np.float32(0.0), np.float32(1.0), np.float32(0.0), np.float32(0.0), np.float32(1.0), np.float32(0.0), np.float32(1.0), np.float32(1.0), np.float32(0.0), np.float32(0.0), np.float32(0.0), np.float32(1.0), np.float32(0.0), np.float32(1.0), np.float32(0.0)]",-1.0,99989.0,14
2025-08-14_08-18-36,840,"[np.float32(0.0), np.float32(0.0), np.float32(1.0), np.float32(0.0), np.float32(1.0), np.float32(1.0), np.float32(0.0), np.float32(0.0), np.float32(0.0), np.float32(0.0), np.float32(1.0), np.float32(0.0), np.float32(0.0), np.float32(1.0), np.float32(0.0), np.float32(0.0)]",2.0,99991.0,18
2025-08-14_08-18-36,841,"[np.float32(1.0), np.float32(0.0), np.float32(1.0), np.float32(0.0), np.float32(0.0), np.float32(0.0), np.float32(0.0), np.float32(0.0), np.float32(1.0), np.float32(0.0), np.float32(0.0), np.float32(1.0), np.float32(0.0), np.float32(1.0), np.float32(0.0), np.float32(1.0)]",-4.0,99987.0,5
2025-08-14_08-18-36,842,"[np.float32(1.0), np.float32(0.0), np.float32(1.0), np.float32(0.0), np.float32(1.0), np.float32(0.0), np.float32(0.0), np.float32(1.0), np.float32(1.0), np.float32(1.0), np.float32(0.0), np.float32(1.0), np.float32(1.0), np.float32(0.0), np.float32(0.0), np.float32(1.0)]",-1.0,99986.0,13
2025-08-14_08-18-36,843,"[np.float32(0.0), np.float32(0.0), np.float32(0.0), np.float32(0.0), np.float32(0.0), np.float32(1.0), np.float32(0.0), np.float32(1.0), np.float32(1.0), np.float32(0.0), np.float32(0.0), np.float32(0.0), np.float32(1.0), np.float32(1.0), np.float32(0.0), np.float32(0.0)]",3.0,99989.0,21
2025-08-14_08-18-36,844,"[np.float32(1.0), np.float32(0.0), np.float32(1.0), np.float32(0.0), np.float32(0.0), np.float32(0.0), np.float32(0.0), np.float32(1.0), np.float32(1.0), np.float32(0.0), np.float32(1.0), np.float32(1.0), np.float32(0.0), np.float32(0.0), np.float32(0.0), np.float32(1.0)]",-1.0,99988.0,15
2025-08-14_08-18-36,845,"[np.float32(0.0), np.float32(1.0), np.float32(0.0), np.float32(1.0), np.float32(1.0), np.float32(1.0), np.float32(0.0), np.float32(1.0), np.float32(1.0), np.float32(0.0), np.float32(1.0), np.float32(1.0), np.float32(0.0), np.float32(1.0), np.float32(0.0), np.float32(0.0)]",6.0,99994.0,15
2025-08-14_08-18-36,846,"[np.float32(0.0), np.float32(1.0), np.float32(1.0), np.float32(1.0), np.float32(1.0), np.float32(0.0), np.float32(1.0), np.float32(1.0), np.float32(0.0), np.float32(1.0), np.float32(1.0), np.float32(1.0), np.float32(0.0), np.float32(0.0), np.float32(0.0), np.float32(1.0)]",-6.0,99988.0,0
2025-08-14_08-18-36,847,"[np.float32(1.0), np.float32(0.0), np.float32(1.0), np.float32(1.0), np.float32(0.0), np.float32(1.0), np.float32(1.0), np.float32(0.0), np.float32(1.0), np.float32(0.0), np.float32(1.0), np.float32(0.0), np.float32(1.0), np.float32(1.0), np.float32(0.0), np.float32(1.0)]",0.0,99988.0,1
2025-08-14_08-18-36,848,"[np.float32(1.0), np.float32(1.0), np.float32(1.0), np.float32(0.0), np.float32(0.0), np.float32(1.0), np.float32(0.0), np.float32(0.0), np.float32(0.0), np.float32(1.0), np.float32(0.0), np.float32(1.0), np.float32(1.0), np.float32(0.0), np.float32(1.0), np.float32(0.0)]",-4.0,99984.0,2
2025-08-14_08-18-36,849,"[np.float32(0.0), np.float32(0.0), np.float32(1.0), np.float32(0.0), np.float32(1.0), np.float32(1.0), np.float32(0.0), np.float32(1.0), np.float32(1.0), np.float32(0.0), np.float32(0.0), np.float32(1.0), np.float32(1.0), np.float32(1.0), np.float32(1.0), np.float32(1.0)]",-2.0,99982.0,23
2025-08-14_08-18-36,850,"[np.float32(1.0), np.float32(0.0), np.float32(0.0), np.float32(1.0), np.float32(0.0), np.float32(0.0), np.float32(1.0), np.float32(1.0), np.float32(0.0), np.float32(1.0), np.float32(1.0), np.float32(0.0), np.float32(0.0), np.float32(1.0), np.float32(0.0), np.float32(1.0)]",0.0,99982.0,34
2025-08-14_08-18-36,851,"[np.float32(0.0), np.float32(0.0), np.float32(1.0), np.float32(0.0), np.float32(0.0), np.float32(0.0), np.float32(1.0), np.float32(1.0), np.float32(0.0), np.float32(0.0), np.float32(0.0), np.float32(0.0), np.float32(1.0), np.float32(0.0), np.float32(0.0), np.float32(1.0)]",-2.0,99980.0,11
2025-08-14_08-18-36,852,"[np.float32(1.0), np.float32(0.0), np.float32(1.0), np.float32(0.0), np.float32(0.0), np.float32(0.0), np.float32(0.0), np.float32(1.0), np.float32(0.0), np.float32(0.0), np.float32(1.0), np.float32(0.0), np.float32(1.0), np.float32(1.0), np.float32(1.0), np.float32(0.0)]",3.0,99983.0,14
2025-08-14_08-18-36,853,"[np.float32(1.0), np.float32(0.0), np.float32(0.0), np.float32(1.0), np.float32(0.0), np.float32(0.0), np.float32(0.0), np.float32(1.0), np.float32(1.0), np.float32(1.0), np.float32(0.0), np.float32(0.0), np.float32(1.0), np.float32(1.0), np.float32(0.0), np.float32(0.0)]",1.0,99984.0,15
2025-08-14_08-18-36,854,"[np.float32(0.0), np.float32(0.0), np.float32(0.0), np.float32(0.0), np.float32(1.0), np.float32(0.0), np.float32(0.0), np.float32(0.0), np.float32(1.0), np.float32(1.0), np.float32(1.0), np.float32(0.0), np.float32(1.0), np.float32(1.0), np.float32(0.0), np.float32(0.0)]",3.0,99987.0,29
2025-08-14_08-18-36,855,"[np.float32(0.0), np.float32(0.0), np.float32(1.0), np.float32(1.0), np.float32(0.0), np.float32(1.0), np.float32(1.0), np.float32(0.0), np.float32(1.0), np.float32(0.0), np.float32(0.0), np.float32(0.0), np.float32(0.0), np.float32(1.0), np.float32(0.0), np.float32(1.0)]",-2.0,99985.0,10
2025-08-14_08-18-36,856,"[np.float32(0.0), np.float32(1.0), np.float32(1.0), np.float32(1.0), np.float32(0.0), np.float32(1.0), np.float32(0.0), np.float32(1.0), np.float32(0.0), np.float32(0.0), np.float32(0.0), np.float32(0.0), np.float32(1.0), np.float32(1.0), np.float32(0.0), np.float32(0.0)]",-1.0,99984.0,31
2025-08-14_08-18-36,857,"[np.float32(0.0), np.float32(0.0), np.float32(1.0), np.float32(0.0), np.float32(1.0), np.float32(0.0), np.float32(1.0), np.float32(0.0), np.float32(1.0), np.float32(1.0), np.float32(0.0), np.float32(0.0), np.float32(0.0), np.float32(0.0), np.float32(1.0), np.float32(1.0)]",1.0,99985.0,7
2025-08-14_08-18-36,858,"[np.float32(0.0), np.float32(0.0), np.float32(0.0), np.float32(1.0), np.float32(1.0), np.float32(1.0), np.float32(0.0), np.float32(1.0), np.float32(1.0), np.float32(0.0), np.float32(1.0), np.float32(0.0), np.float32(0.0), np.float32(1.0), np.float32(0.0), np.float32(0.0)]",0.0,99985.0,5
2025-08-14_08-18-36,859,"[np.float32(0.0), np.float32(0.0), np.float32(0.0), np.float32(1.0), np.float32(0.0), np.float32(0.0), np.float32(0.0), np.float32(0.0), np.float32(0.0), np.float32(1.0), np.float32(0.0), np.float32(1.0), np.float32(1.0), np.float32(1.0), np.float32(1.0), np.float32(1.0)]",-1.0,99984.0,6
2025-08-14_08-18-36,860,"[np.float32(1.0), np.float32(1.0), np.float32(1.0), np.float32(0.0), np.float32(1.0), np.float32(0.0), np.float32(1.0), np.float32(1.0), np.float32(0.0), np.float32(0.0), np.float32(1.0), np.float32(1.0), np.float32(0.0), np.float32(0.0), np.float32(1.0), np.float32(1.0)]",3.0,99987.0,24
2025-08-14_08-18-36,861,"[np.float32(1.0), np.float32(0.0), np.float32(0.0), np.float32(1.0), np.float32(1.0), np.float32(1.0), np.float32(0.0), np.float32(0.0), np.float32(1.0), np.float32(1.0), np.float32(0.0), np.float32(1.0), np.float32(0.0), np.float32(1.0), np.float32(0.0), np.float32(1.0)]",-1.0,99986.0,22
2025-08-14_08-18-36,862,"[np.float32(0.0), np.float32(0.0), np.float32(1.0), np.float32(0.0), np.float32(1.0), np.float32(0.0), np.float32(1.0), np.float32(0.0), np.float32(1.0), np.float32(1.0), np.float32(0.0), np.float32(1.0), np.float32(0.0), np.float32(0.0), np.float32(0.0), np.float32(1.0)]",-2.0,99984.0,24
2025-08-14_08-18-36,863,"[np.float32(0.0), np.float32(1.0), np.float32(1.0), np.float32(1.0), np.float32(0.0), np.float32(0.0), np.float32(1.0), np.float32(0.0), np.float32(1.0), np.float32(0.0), np.float32(0.0), np.float32(1.0), np.float32(0.0), np.float32(1.0), np.float32(0.0), np.float32(1.0)]",-1.0,99983.0,8
2025-08-14_08-18-36,864,"[np.float32(1.0), np.float32(0.0), np.float32(1.0), np.float32(0.0), np.float32(0.0), np.float32(0.0), np.float32(0.0), np.float32(0.0), np.float32(0.0), np.float32(1.0), np.float32(1.0), np.float32(1.0), np.float32(0.0), np.float32(0.0), np.float32(0.0), np.float32(0.0)]",-2.0,99981.0,33
2025-08-14_08-18-36,865,"[np.float32(1.0), np.float32(0.0), np.float32(0.0), np.float32(0.0), np.float32(0.0), np.float32(1.0), np.float32(0.0), np.float32(0.0), np.float32(1.0), np.float32(0.0), np.float32(0.0), np.float32(0.0), np.float32(1.0), np.float32(1.0), np.float32(0.0), np.float32(0.0)]",-2.0,99979.0,4
2025-08-14_08-18-36,866,"[np.float32(0.0), np.float32(1.0), np.float32(1.0), np.float32(0.0), np.float32(0.0), np.float32(1.0), np.float32(1.0), np.float32(0.0), np.float32(0.0), np.float32(0.0), np.float32(0.0), np.float32(0.0), np.float32(1.0), np.float32(1.0), np.float32(0.0), np.float32(0.0)]",-4.0,99975.0,17
2025-08-14_08-18-36,867,"[np.float32(1.0), np.float32(0.0), np.float32(1.0), np.float32(0.0), np.float32(0.0), np.float32(0.0), np.float32(1.0), np.float32(1.0), np.float32(1.0), np.float32(1.0), np.float32(0.0), np.float32(0.0), np.float32(0.0), np.float32(1.0), np.float32(1.0), np.float32(0.0)]",0.0,99975.0,1
2025-08-14_08-18-36,868,"[np.float32(1.0), np.float32(0.0), np.float32(0.0), np.float32(0.0), np.float32(1.0), np.float32(1.0), np.float32(1.0), np.float32(1.0), np.float32(0.0), np.float32(1.0), np.float32(0.0), np.float32(0.0), np.float32(1.0), np.float32(1.0), np.float32(0.0), np.float32(0.0)]",0.0,99975.0,15
2025-08-14_08-18-36,869,"[np.float32(1.0), np.float32(0.0), np.float32(0.0), np.float32(1.0), np.float32(0.0), np.float32(0.0), np.float32(1.0), np.float32(1.0), np.float32(1.0), np.float32(0.0), np.float32(1.0), np.float32(1.0), np.float32(1.0), np.float32(0.0), np.float32(1.0), np.float32(0.0)]",-1.0,99974.0,35
2025-08-14_08-18-36,870,"[np.float32(1.0), np.float32(1.0), np.float32(1.0), np.float32(1.0), np.float32(1.0), np.float32(1.0), np.float32(1.0), np.float32(0.0), np.float32(1.0), np.float32(1.0), np.float32(1.0), np.float32(1.0), np.float32(0.0), np.float32(0.0), np.float32(0.0), np.float32(1.0)]",0.0,99974.0,27
2025-08-14_08-18-36,871,"[np.float32(1.0), np.float32(0.0), np.float32(0.0), np.float32(0.0), np.float32(1.0), np.float32(0.0), np.float32(0.0), np.float32(0.0), np.float32(0.0), np.float32(1.0), np.float32(1.0), np.float32(1.0), np.float32(1.0), np.float32(1.0), np.float32(0.0), np.float32(1.0)]",2.0,99976.0,1
2025-08-14_08-18-36,872,"[np.float32(1.0), np.float32(0.0), np.float32(0.0), np.float32(1.0), np.float32(0.0), np.float32(0.0), np.float32(0.0), np.float32(0.0), np.float32(0.0), np.float32(0.0), np.float32(1.0), np.float32(0.0), np.float32(1.0), np.float32(1.0), np.float32(1.0), np.float32(0.0)]",-4.0,99972.0,31
2025-08-14_08-18-36,873,"[np.float32(0.0), np.float32(0.0), np.float32(0.0), np.float32(0.0), np.float32(0.0), np.float32(1.0), np.float32(1.0), np.float32(1.0), np.float32(1.0), np.float32(0.0), np.float32(1.0), np.float32(0.0), np.float32(0.0), np.float32(1.0), np.float32(1.0), np.float32(0.0)]",1.0,99973.0,36
2025-08-14_08-18-36,874,"[np.float32(0.0), np.float32(0.0), np.float32(0.0), np.float32(0.0), np.float32(0.0), np.float32(0.0), np.float32(0.0), np.float32(0.0), np.float32(1.0), np.float32(0.0), np.float32(0.0), np.float32(1.0), np.float32(1.0), np.float32(1.0), np.float32(0.0), np.float32(1.0)]",-2.0,99971.0,17
2025-08-14_08-18-36,875,"[np.float32(0.0), np.float32(0.0), np.float32(1.0), np.float32(1.0), np.float32(0.0), np.float32(0.0), np.float32(1.0), np.float32(0.0), np.float32(0.0), np.float32(1.0), np.float32(0.0), np.float32(0.0), np.float32(1.0), np.float32(1.0), np.float32(1.0), np.float32(0.0)]",-2.0,99969.0,18
2025-08-14_08-18-36,876,"[np.float32(0.0), np.float32(1.0), np.float32(0.0), np.float32(1.0), np.float32(1.0), np.float32(0.0), np.float32(1.0), np.float32(0.0), np.float32(0.0), np.float32(1.0), np.float32(1.0), np.float32(1.0), np.float32(0.0), np.float32(1.0), np.float32(0.0), np.float32(0.0)]",-5.0,99964.0,30
2025-08-14_08-18-36,877,"[np.float32(0.0), np.float32(0.0), np.float32(1.0), np.float32(1.0), np.float32(0.0), np.float32(0.0), np.float32(1.0), np.float32(0.0), np.float32(1.0), np.float32(0.0), np.float32(1.0), np.float32(1.0), np.float32(1.0), np.float32(0.0), np.float32(0.0), np.float32(0.0)]",-2.0,99962.0,25
2025-08-14_08-18-36,878,"[np.float32(0.0), np.float32(1.0), np.float32(1.0), np.float32(1.0), np.float32(1.0), np.float32(1.0), np.float32(1.0), np.float32(1.0), np.float32(1.0), np.float32(0.0), np.float32(0.0), np.float32(0.0), np.float32(0.0), np.float32(0.0), np.float32(0.0), np.float32(0.0)]",1.0,99963.0,8
2025-08-14_08-18-36,879,"[np.float32(1.0), np.float32(1.0), np.float32(1.0), np.float32(0.0), np.float32(0.0), np.float32(0.0), np.float32(0.0), np.float32(1.0), np.float32(1.0), np.float32(0.0), np.float32(0.0), np.float32(1.0), np.float32(0.0), np.float32(0.0), np.float32(0.0), np.float32(0.0)]",-1.0,99962.0,17
2025-08-14_08-18-36,880,"[np.float32(1.0), np.float32(0.0), np.float32(0.0), np.float32(1.0), np.float32(1.0), np.float32(0.0), np.float32(0.0), np.float32(1.0), np.float32(1.0), np.float32(0.0), np.float32(0.0), np.float32(1.0), np.float32(0.0), np.float32(0.0), np.float32(1.0), np.float32(1.0)]",-3.0,99959.0,8
2025-08-14_08-18-36,881,"[np.float32(1.0), np.float32(1.0), np.float32(0.0), np.float32(1.0), np.float32(0.0), np.float32(0.0), np.float32(0.0), np.float32(0.0), np.float32(0.0), np.float32(0.0), np.float32(0.0), np.float32(0.0), np.float32(1.0), np.float32(1.0), np.float32(0.0), np.float32(0.0)]",-3.0,99956.0,8
2025-08-14_08-18-36,882,"[np.float32(1.0), np.float32(0.0), np.float32(0.0), np.float32(0.0), np.float32(1.0), np.float32(1.0), np.float32(0.0), np.float32(0.0), np.float32(1.0), np.float32(0.0), np.float32(0.0), np.float32(1.0), np.float32(0.0), np.float32(0.0), np.float32(1.0), np.float32(0.0)]",-1.0,99955.0,35
2025-08-14_08-18-36,883,"[np.float32(0.0), np.float32(1.0), np.float32(0.0), np.float32(1.0), np.float32(0.0), np.float32(1.0), np.float32(0.0), np.float32(0.0), np.float32(1.0), np.float32(1.0), np.float32(0.0), np.float32(1.0), np.float32(1.0), np.float32(1.0), np.float32(1.0), np.float32(0.0)]",-4.0,99951.0,6
2025-08-14_08-18-36,884,"[np.float32(0.0), np.float32(1.0), np.float32(1.0), np.float32(0.0), np.float32(0.0), np.float32(1.0), np.float32(1.0), np.float32(0.0), np.float32(1.0), np.float32(0.0), np.float32(0.0), np.float32(1.0), np.float32(0.0), np.float32(0.0), np.float32(1.0), np.float32(0.0)]",2.0,99953.0,26
2025-08-14_08-18-36,885,"[np.float32(0.0), np.float32(1.0), np.float32(1.0), np.float32(0.0), np.float32(0.0), np.float32(1.0), np.float32(1.0), np.float32(1.0), np.float32(1.0), np.float32(0.0), np.float32(0.0), np.float32(1.0), np.float32(0.0), np.float32(0.0), np.float32(1.0), np.float32(0.0)]",0.0,99953.0,21
2025-08-14_08-18-36,886,"[np.float32(0.0), np.float32(1.0), np.float32(1.0), np.float32(0.0), np.float32(1.0), np.float32(0.0), np.float32(0.0), np.float32(1.0), np.float32(0.0), np.float32(1.0), np.float32(0.0), np.float32(1.0), np.float32(1.0), np.float32(0.0), np.float32(0.0), np.float32(1.0)]",-3.0,99950.0,36
2025-08-14_08-18-36,887,"[np.float32(0.0), np.float32(1.0), np.float32(0.0), np.float32(1.0), np.float32(1.0), np.float32(1.0), np.float32(1.0), np.float32(0.0), np.float32(1.0), np.float32(0.0), np.float32(1.0), np.float32(1.0), np.float32(0.0), np.float32(0.0), np.float32(0.0), np.float32(1.0)]",-2.0,99948.0,7
2025-08-14_08-18-36,888,"[np.float32(0.0), np.float32(1.0), np.float32(0.0), np.float32(0.0), np.float32(1.0), np.float32(1.0), np.float32(1.0), np.float32(1.0), np.float32(0.0), np.float32(1.0), np.float32(1.0), np.float32(1.0), np.float32(0.0), np.float32(0.0), np.float32(0.0), np.float32(0.0)]",0.0,99948.0,19
2025-08-14_08-18-36,889,"[np.float32(0.0), np.float32(0.0), np.float32(0.0), np.float32(0.0), np.float32(1.0), np.float32(0.0), np.float32(0.0), np.float32(0.0), np.float32(0.0), np.float32(1.0), np.float32(0.0), np.float32(0.0), np.float32(1.0), np.float32(1.0), np.float32(1.0), np.float32(1.0)]",2.0,99950.0,4
2025-08-14_08-18-36,890,"[np.float32(0.0), np.float32(0.0), np.float32(1.0), np.float32(1.0), np.float32(1.0), np.float32(1.0), np.float32(1.0), np.float32(0.0), np.float32(1.0), np.float32(1.0), np.float32(1.0), np.float32(0.0), np.float32(0.0), np.float32(0.0), np.float32(1.0), np.float32(0.0)]",4.0,99954.0,5
2025-08-14_08-18-36,891,"[np.float32(0.0), np.float32(0.0), np.float32(1.0), np.float32(1.0), np.float32(0.0), np.float32(1.0), np.float32(1.0), np.float32(1.0), np.float32(0.0), np.float32(0.0), np.float32(0.0), np.float32(1.0), np.float32(1.0), np.float32(0.0), np.float32(1.0), np.float32(1.0)]",1.0,99955.0,23
2025-08-14_08-18-36,892,"[np.float32(1.0), np.float32(1.0), np.float32(0.0), np.float32(1.0), np.float32(0.0), np.float32(0.0), np.float32(0.0), np.float32(1.0), np.float32(0.0), np.float32(0.0), np.float32(1.0), np.float32(1.0), np.float32(0.0), np.float32(1.0), np.float32(0.0), np.float32(0.0)]",-2.0,99953.0,8
2025-08-14_08-18-36,893,"[np.float32(1.0), np.float32(0.0), np.float32(0.0), np.float32(1.0), np.float32(0.0), np.float32(1.0), np.float32(1.0), np.float32(1.0), np.float32(0.0), np.float32(0.0), np.float32(0.0), np.float32(1.0), np.float32(0.0), np.float32(0.0), np.float32(0.0), np.float32(1.0)]",-5.0,99948.0,26
2025-08-14_08-18-36,894,"[np.float32(0.0), np.float32(0.0), np.float32(0.0), np.float32(0.0), np.float32(0.0), np.float32(0.0), np.float32(0.0), np.float32(1.0), np.float32(1.0), np.float32(1.0), np.float32(0.0), np.float32(1.0), np.float32(0.0), np.float32(1.0), np.float32(0.0), np.float32(0.0)]",-2.0,99946.0,17
2025-08-14_08-18-36,895,"[np.float32(0.0), np.float32(1.0), np.float32(1.0), np.float32(1.0), np.float32(0.0), np.float32(0.0), np.float32(1.0), np.float32(0.0), np.float32(1.0), np.float32(1.0), np.float32(0.0), np.float32(1.0), np.float32(0.0), np.float32(1.0), np.float32(1.0), np.float32(0.0)]",1.0,99947.0,11
2025-08-14_08-18-36,896,"[np.float32(1.0), np.float32(1.0), np.float32(0.0), np.float32(1.0), np.float32(1.0), np.float32(1.0), np.float32(1.0), np.float32(1.0), np.float32(1.0), np.float32(1.0), np.float32(0.0), np.float32(1.0), np.float32(0.0), np.float32(0.0), np.float32(0.0), np.float32(1.0)]",-4.0,99943.0,8
2025-08-14_08-18-36,897,"[np.float32(0.0), np.float32(1.0), np.float32(0.0), np.float32(0.0), np.float32(0.0), np.float32(1.0), np.float32(1.0), np.float32(0.0), np.float32(1.0), np.float32(0.0), np.float32(1.0), np.float32(1.0), np.float32(1.0), np.float32(0.0), np.float32(1.0), np.float32(1.0)]",2.0,99945.0,30
2025-08-14_08-18-36,898,"[np.float32(1.0), np.float32(1.0), np.float32(1.0), np.float32(1.0), np.float32(0.0), np.float32(0.0), np.float32(0.0), np.float32(1.0), np.float32(1.0), np.float32(1.0), np.float32(1.0), np.float32(1.0), np.float32(1.0), np.float32(0.0), np.float32(1.0), np.float32(1.0)]",1.0,99946.0,23
2025-08-14_08-18-36,899,"[np.float32(0.0), np.float32(1.0), np.float32(1.0), np.float32(0.0), np.float32(0.0), np.float32(0.0), np.float32(0.0), np.float32(1.0), np.float32(1.0), np.float32(0.0), np.float32(0.0), np.float32(0.0), np.float32(0.0), np.float32(0.0), np.float32(0.0), np.float32(1.0)]",-2.0,99944.0,9
2025-08-14_08-18-36,900,"[np.float32(1.0), np.float32(1.0), np.float32(1.0), np.float32(0.0), np.float32(0.0), np.float32(0.0), np.float32(0.0), np.float32(1.0), np.float32(1.0), np.float32(0.0), np.float32(1.0), np.float32(0.0), np.float32(1.0), np.float32(1.0), np.float32(1.0), np.float32(0.0)]",-1.0,99943.0,11
2025-08-14_08-18-36,901,"[np.float32(0.0), np.float32(1.0), np.float32(1.0), np.float32(0.0), np.float32(1.0), np.float32(1.0), np.float32(0.0), np.float32(1.0), np.float32(0.0), np.float32(0.0), np.float32(0.0), np.float32(1.0), np.float32(0.0), np.float32(1.0), np.float32(1.0), np.float32(0.0)]",-1.0,99942.0,29
2025-08-14_08-18-36,902,"[np.float32(0.0), np.float32(0.0), np.float32(1.0), np.float32(1.0), np.float32(0.0), np.float32(0.0), np.float32(1.0), np.float32(0.0), np.float32(0.0), np.float32(1.0), np.float32(0.0), np.float32(1.0), np.float32(0.0), np.float32(1.0), np.float32(1.0), np.float32(0.0)]",4.0,99946.0,4
2025-08-14_08-18-36,903,"[np.float32(1.0), np.float32(0.0), np.float32(0.0), np.float32(1.0), np.float32(0.0), np.float32(1.0), np.float32(1.0), np.float32(0.0), np.float32(1.0), np.float32(0.0), np.float32(0.0), np.float32(1.0), np.float32(1.0), np.float32(0.0), np.float32(1.0), np.float32(1.0)]",0.0,99946.0,25
2025-08-14_08-18-36,904,"[np.float32(1.0), np.float32(0.0), np.float32(1.0), np.float32(1.0), np.float32(1.0), np.float32(1.0), np.float32(1.0), np.float32(1.0), np.float32(1.0), np.float32(1.0), np.float32(1.0), np.float32(1.0), np.float32(1.0), np.float32(1.0), np.float32(0.0), np.float32(0.0)]",-3.0,99943.0,13
2025-08-14_08-18-36,905,"[np.float32(0.0), np.float32(1.0), np.float32(0.0), np.float32(1.0), np.float32(0.0), np.float32(1.0), np.float32(0.0), np.float32(0.0), np.float32(1.0), np.float32(1.0), np.float32(0.0), np.float32(0.0), np.float32(0.0), np.float32(1.0), np.float32(0.0), np.float32(0.0)]",-2.0,99941.0,17
2025-08-14_08-18-36,906,"[np.float32(0.0), np.float32(1.0), np.float32(0.0), np.float32(1.0), np.float32(1.0), np.float32(0.0), np.float32(1.0), np.float32(1.0), np.float32(1.0), np.float32(0.0), np.float32(0.0), np.float32(1.0), np.float32(1.0), np.float32(0.0), np.float32(1.0), np.float32(1.0)]",-3.0,99938.0,4
2025-08-14_08-18-36,907,"[np.float32(0.0), np.float32(1.0), np.float32(0.0), np.float32(1.0), np.float32(1.0), np.float32(0.0), np.float32(0.0), np.float32(1.0), np.float32(0.0), np.float32(0.0), np.float32(0.0), np.float32(1.0), np.float32(1.0), np.float32(1.0), np.float32(1.0), np.float32(0.0)]",-8.0,99930.0,34
2025-08-14_08-18-36,908,"[np.float32(0.0), np.float32(1.0), np.float32(0.0), np.float32(0.0), np.float32(0.0), np.float32(1.0), np.float32(0.0), np.float32(0.0), np.float32(1.0), np.float32(0.0), np.float32(1.0), np.float32(0.0), np.float32(1.0), np.float32(0.0), np.float32(0.0), np.float32(0.0)]",2.0,99932.0,33
2025-08-14_08-18-36,909,"[np.float32(1.0), np.float32(0.0), np.float32(0.0), np.float32(1.0), np.float32(0.0), np.float32(0.0), np.float32(0.0), np.float32(0.0), np.float32(0.0), np.float32(0.0), np.float32(1.0), np.float32(1.0), np.float32(1.0), np.float32(1.0), np.float32(0.0), np.float32(1.0)]",-4.0,99928.0,28
2025-08-14_08-18-36,910,"[np.float32(1.0), np.float32(0.0), np.float32(1.0), np.float32(1.0), np.float32(1.0), np.float32(0.0), np.float32(1.0), np.float32(1.0), np.float32(1.0), np.float32(1.0), np.float32(0.0), np.float32(0.0), np.float32(1.0), np.float32(0.0), np.float32(1.0), np.float32(0.0)]",-1.0,99927.0,14
2025-08-14_08-18-36,911,"[np.float32(1.0), np.float32(0.0), np.float32(0.0), np.float32(1.0), np.float32(1.0), np.float32(1.0), np.float32(1.0), np.float32(0.0), np.float32(0.0), np.float32(0.0), np.float32(1.0), np.float32(0.0), np.float32(1.0), np.float32(0.0), np.float32(0.0), np.float32(1.0)]",0.0,99927.0,6
2025-08-14_08-18-36,912,"[np.float32(1.0), np.float32(1.0), np.float32(1.0), np.float32(1.0), np.float32(0.0), np.float32(1.0), np.float32(1.0), np.float32(0.0), np.float32(0.0), np.float32(1.0), np.float32(0.0), np.float32(1.0), np.float32(0.0), np.float32(1.0), np.float32(1.0), np.float32(0.0)]",-1.0,99926.0,26
2025-08-14_08-18-36,913,"[np.float32(1.0), np.float32(1.0), np.float32(1.0), np.float32(1.0), np.float32(1.0), np.float32(0.0), np.float32(1.0), np.float32(0.0), np.float32(1.0), np.float32(0.0), np.float32(1.0), np.float32(1.0), np.float32(1.0), np.float32(0.0), np.float32(0.0), np.float32(0.0)]",-6.0,99920.0,0
2025-08-14_08-18-36,914,"[np.float32(1.0), np.float32(1.0), np.float32(1.0), np.float32(1.0), np.float32(0.0), np.float32(1.0), np.float32(0.0), np.float32(1.0), np.float32(1.0), np.float32(1.0), np.float32(1.0), np.float32(1.0), np.float32(1.0), np.float32(1.0), np.float32(0.0), np.float32(1.0)]",0.0,99920.0,18
2025-08-14_08-18-36,915,"[np.float32(0.0), np.float32(1.0), np.float32(0.0), np.float32(1.0), np.float32(0.0), np.float32(1.0), np.float32(0.0), np.float32(0.0), np.float32(0.0), np.float32(1.0), np.float32(0.0), np.float32(1.0), np.float32(0.0), np.float32(1.0), np.float32(0.0), np.float32(0.0)]",3.0,99923.0,35
2025-08-14_08-18-36,916,"[np.float32(1.0), np.float32(0.0), np.float32(0.0), np.float32(0.0), np.float32(1.0), np.float32(1.0), np.float32(0.0), np.float32(1.0), np.float32(1.0), np.float32(0.0), np.float32(0.0), np.float32(1.0), np.float32(0.0), np.float32(1.0), np.float32(0.0), np.float32(0.0)]",0.0,99923.0,34
2025-08-14_08-18-36,917,"[np.float32(1.0), np.float32(0.0), np.float32(1.0), np.float32(1.0), np.float32(1.0), np.float32(1.0), np.float32(0.0), np.float32(0.0), np.float32(0.0), np.float32(0.0), np.float32(1.0), np.float32(1.0), np.float32(1.0), np.float32(1.0), np.float32(1.0), np.float32(1.0)]",-4.0,99919.0,22
2025-08-14_08-18-36,918,"[np.float32(1.0), np.float32(1.0), np.float32(0.0), np.float32(0.0), np.float32(1.0), np.float32(1.0), np.float32(0.0), np.float32(1.0), np.float32(1.0), np.float32(1.0), np.float32(0.0), np.float32(0.0), np.float32(1.0), np.float32(1.0), np.float32(0.0), np.float32(1.0)]",-3.0,99916.0,27
2025-08-14_08-18-36,919,"[np.float32(1.0), np.float32(0.0), np.float32(0.0), np.float32(1.0), np.float32(0.0), np.float32(0.0), np.float32(1.0), np.float32(0.0), np.float32(0.0), np.float32(1.0), np.float32(1.0), np.float32(0.0), np.float32(1.0), np.float32(0.0), np.float32(1.0), np.float32(0.0)]",0.0,99916.0,9
2025-08-14_08-18-36,920,"[np.float32(1.0), np.float32(1.0), np.float32(1.0), np.float32(1.0), np.float32(0.0), np.float32(0.0), np.float32(1.0), np.float32(1.0), np.float32(1.0), np.float32(0.0), np.float32(1.0), np.float32(0.0), np.float32(1.0), np.float32(0.0), np.float32(0.0), np.float32(0.0)]",1.0,99917.0,32
2025-08-14_08-18-36,921,"[np.float32(0.0), np.float32(0.0), np.float32(1.0), np.float32(1.0), np.float32(0.0), np.float32(1.0), np.float32(0.0), np.float32(0.0), np.float32(1.0), np.float32(0.0), np.float32(0.0), np.float32(1.0), np.float32(1.0), np.float32(0.0), np.float32(0.0), np.float32(0.0)]",-4.0,99913.0,8
2025-08-14_08-18-36,922,"[np.float32(0.0), np.float32(0.0), np.float32(1.0), np.float32(0.0), np.float32(0.0), np.float32(0.0), np.float32(1.0), np.float32(0.0), np.float32(1.0), np.float32(1.0), np.float32(0.0), np.float32(1.0), np.float32(1.0), np.float32(1.0), np.float32(0.0), np.float32(1.0)]",-2.0,99911.0,35
2025-08-14_08-18-36,923,"[np.float32(0.0), np.float32(1.0), np.float32(1.0), np.float32(1.0), np.float32(0.0), np.float32(1.0), np.float32(1.0), np.float32(1.0), np.float32(1.0), np.float32(1.0), np.float32(1.0), np.float32(0.0), np.float32(1.0), np.float32(0.0), np.float32(0.0), np.float32(1.0)]",-1.0,99910.0,6
2025-08-14_08-18-36,924,"[np.float32(0.0), np.float32(1.0), np.float32(0.0), np.float32(1.0), np.float32(1.0), np.float32(1.0), np.float32(1.0), np.float32(1.0), np.float32(1.0), np.float32(1.0), np.float32(0.0), np.float32(1.0), np.float32(1.0), np.float32(0.0), np.float32(0.0), np.float32(1.0)]",-2.0,99908.0,11
2025-08-14_08-18-36,925,"[np.float32(0.0), np.float32(0.0), np.float32(0.0), np.float32(0.0), np.float32(0.0), np.float32(0.0), np.float32(1.0), np.float32(1.0), np.float32(0.0), np.float32(0.0), np.float32(1.0), np.float32(0.0), np.float32(1.0), np.float32(1.0), np.float32(0.0), np.float32(0.0)]",1.0,99909.0,23
2025-08-14_08-18-36,926,"[np.float32(0.0), np.float32(1.0), np.float32(1.0), np.float32(1.0), np.float32(0.0), np.float32(0.0), np.float32(0.0), np.float32(1.0), np.float32(1.0), np.float32(1.0), np.float32(0.0), np.float32(1.0), np.float32(1.0), np.float32(1.0), np.float32(0.0), np.float32(1.0)]",-2.0,99907.0,1
2025-08-14_08-18-36,927,"[np.float32(1.0), np.float32(1.0), np.float32(0.0), np.float32(1.0), np.float32(1.0), np.float32(0.0), np.float32(1.0), np.float32(1.0), np.float32(1.0), np.float32(1.0), np.float32(0.0), np.float32(0.0), np.float32(0.0), np.float32(1.0), np.float32(0.0), np.float32(0.0)]",1.0,99908.0,16
2025-08-14_08-18-36,928,"[np.float32(1.0), np.float32(0.0), np.float32(1.0), np.float32(1.0), np.float32(0.0), np.float32(0.0), np.float32(1.0), np.float32(0.0), np.float32(0.0), np.float32(1.0), np.float32(0.0), np.float32(0.0), np.float32(1.0), np.float32(0.0), np.float32(1.0), np.float32(0.0)]",-5.0,99903.0,35
2025-08-14_08-18-36,929,"[np.float32(0.0), np.float32(1.0), np.float32(0.0), np.float32(1.0), np.float32(1.0), np.float32(0.0), np.float32(1.0), np.float32(0.0), np.float32(0.0), np.float32(1.0), np.float32(0.0), np.float32(1.0), np.float32(0.0), np.float32(1.0), np.float32(0.0), np.float32(0.0)]",-4.0,99899.0,32
2025-08-14_08-18-36,930,"[np.float32(1.0), np.float32(1.0), np.float32(1.0), np.float32(1.0), np.float32(1.0), np.float32(0.0), np.float32(1.0), np.float32(1.0), np.float32(0.0), np.float32(0.0), np.float32(1.0), np.float32(0.0), np.float32(1.0), np.float32(0.0), np.float32(1.0), np.float32(0.0)]",-3.0,99896.0,33
2025-08-14_08-18-36,931,"[np.float32(1.0), np.float32(1.0), np.float32(1.0), np.float32(1.0), np.float32(0.0), np.float32(0.0), np.float32(1.0), np.float32(0.0), np.float32(1.0), np.float32(0.0), np.float32(1.0), np.float32(0.0), np.float32(0.0), np.float32(0.0), np.float32(0.0), np.float32(0.0)]",0.0,99896.0,33
2025-08-14_08-18-36,932,"[np.float32(1.0), np.float32(0.0), np.float32(0.0), np.float32(1.0), np.float32(0.0), np.float32(0.0), np.float32(0.0), np.float32(0.0), np.float32(0.0), np.float32(1.0), np.float32(1.0), np.float32(0.0), np.float32(0.0), np.float32(0.0), np.float32(0.0), np.float32(1.0)]",-3.0,99893.0,18
2025-08-14_08-18-36,933,"[np.float32(0.0), np.float32(0.0), np.float32(1.0), np.float32(0.0), np.float32(1.0), np.float32(0.0), np.float32(1.0), np.float32(1.0), np.float32(0.0), np.float32(0.0), np.float32(1.0), np.float32(1.0), np.float32(0.0), np.float32(1.0), np.float32(0.0), np.float32(1.0)]",3.0,99896.0,15
2025-08-14_08-18-36,934,"[np.float32(0.0), np.float32(1.0), np.float32(0.0), np.float32(0.0), np.float32(0.0), np.float32(0.0), np.float32(0.0), np.float32(0.0), np.float32(0.0), np.float32(1.0), np.float32(0.0), np.float32(0.0), np.float32(0.0), np.float32(1.0), np.float32(0.0), np.float32(0.0)]",3.0,99899.0,7
2025-08-14_08-18-36,935,"[np.float32(0.0), np.float32(1.0), np.float32(0.0), np.float32(0.0), np.float32(1.0), np.float32(0.0), np.float32(1.0), np.float32(0.0), np.float32(1.0), np.float32(1.0), np.float32(0.0), np.float32(1.0), np.float32(1.0), np.float32(1.0), np.float32(0.0), np.float32(1.0)]",2.0,99901.0,3
2025-08-14_08-18-36,936,"[np.float32(1.0), np.float32(0.0), np.float32(1.0), np.float32(0.0), np.float32(0.0), np.float32(0.0), np.float32(0.0), np.float32(1.0), np.float32(0.0), np.float32(1.0), np.float32(1.0), np.float32(1.0), np.float32(0.0), np.float32(1.0), np.float32(1.0), np.float32(1.0)]",-3.0,99898.0,31
2025-08-14_08-18-36,937,"[np.float32(1.0), np.float32(0.0), np.float32(0.0), np.float32(1.0), np.float32(1.0), np.float32(0.0), np.float32(1.0), np.float32(0.0), np.float32(1.0), np.float32(0.0), np.float32(1.0), np.float32(1.0), np.float32(0.0), np.float32(0.0), np.float32(1.0), np.float32(0.0)]",2.0,99900.0,23
2025-08-14_08-18-36,938,"[np.float32(1.0), np.float32(0.0), np.float32(1.0), np.float32(0.0), np.float32(1.0), np.float32(1.0), np.float32(1.0), np.float32(1.0), np.float32(1.0), np.float32(0.0), np.float32(1.0), np.float32(0.0), np.float32(1.0), np.float32(0.0), np.float32(0.0), np.float32(0.0)]",-2.0,99898.0,22
2025-08-14_08-18-36,939,"[np.float32(0.0), np.float32(0.0), np.float32(0.0), np.float32(1.0), np.float32(0.0), np.float32(1.0), np.float32(1.0), np.float32(0.0), np.float32(1.0), np.float32(0.0), np.float32(0.0), np.float32(0.0), np.float32(0.0), np.float32(1.0), np.float32(1.0), np.float32(1.0)]",1.0,99899.0,7
2025-08-14_08-18-36,940,"[np.float32(1.0), np.float32(1.0), np.float32(1.0), np.float32(1.0), np.float32(1.0), np.float32(0.0), np.float32(0.0), np.float32(0.0), np.float32(0.0), np.float32(0.0), np.float32(0.0), np.float32(0.0), np.float32(0.0), np.float32(0.0), np.float32(1.0), np.float32(1.0)]",0.0,99899.0,30
2025-08-14_08-18-36,941,"[np.float32(1.0), np.float32(1.0), np.float32(1.0), np.float32(0.0), np.float32(0.0), np.float32(1.0), np.float32(0.0), np.float32(1.0), np.float32(1.0), np.float32(1.0), np.float32(1.0), np.float32(0.0), np.float32(0.0), np.float32(0.0), np.float32(1.0), np.float32(0.0)]",1.0,99900.0,10
2025-08-14_08-18-36,942,"[np.float32(1.0), np.float32(0.0), np.float32(0.0), np.float32(1.0), np.float32(1.0), np.float32(0.0), np.float32(1.0), np.float32(1.0), np.float32(1.0), np.float32(1.0), np.float32(1.0), np.float32(0.0), np.float32(1.0), np.float32(1.0), np.float32(0.0), np.float32(0.0)]",0.0,99900.0,14
2025-08-14_08-18-36,943,"[np.float32(0.0), np.float32(0.0), np.float32(1.0), np.float32(1.0), np.float32(0.0), np.float32(1.0), np.float32(0.0), np.float32(0.0), np.float32(1.0), np.float32(1.0), np.float32(0.0), np.float32(1.0), np.float32(0.0), np.float32(0.0), np.float32(1.0), np.float32(1.0)]",0.0,99900.0,10
2025-08-14_08-18-36,944,"[np.float32(1.0), np.float32(1.0), np.float32(0.0), np.float32(0.0), np.float32(1.0), np.float32(0.0), np.float32(1.0), np.float32(0.0), np.float32(1.0), np.float32(1.0), np.float32(0.0), np.float32(0.0), np.float32(1.0), np.float32(0.0), np.float32(1.0), np.float32(1.0)]",1.0,99901.0,16
2025-08-14_08-18-36,945,"[np.float32(1.0), np.float32(0.0), np.float32(1.0), np.float32(1.0), np.float32(0.0), np.float32(0.0), np.float32(0.0), np.float32(0.0), np.float32(0.0), np.float32(1.0), np.float32(0.0), np.float32(0.0), np.float32(1.0), np.float32(0.0), np.float32(0.0), np.float32(0.0)]",-1.0,99900.0,21
2025-08-14_08-18-36,946,"[np.float32(0.0), np.float32(1.0), np.float32(0.0), np.float32(1.0), np.float32(0.0), np.float32(1.0), np.float32(0.0), np.float32(0.0), np.float32(1.0), np.float32(1.0), np.float32(0.0), np.float32(0.0), np.float32(0.0), np.float32(1.0), np.float32(0.0), np.float32(1.0)]",-4.0,99896.0,18
2025-08-14_08-18-36,947,"[np.float32(0.0), np.float32(1.0), np.float32(1.0), np.float32(0.0), np.float32(1.0), np.float32(1.0), np.float32(1.0), np.float32(1.0), np.float32(1.0), np.float32(1.0), np.float32(0.0), np.float32(1.0), np.float32(1.0), np.float32(1.0), np.float32(1.0), np.float32(0.0)]",3.0,99899.0,28
2025-08-14_08-18-36,948,"[np.float32(1.0), np.float32(0.0), np.float32(0.0), np.float32(0.0), np.float32(1.0), np.float32(0.0), np.float32(1.0), np.float32(1.0), np.float32(0.0), np.float32(1.0), np.float32(0.0), np.float32(0.0), np.float32(1.0), np.float32(0.0), np.float32(0.0), np.float32(1.0)]",-2.0,99897.0,2
2025-08-14_08-18-36,949,"[np.float32(0.0), np.float32(1.0), np.float32(0.0), np.float32(0.0), np.float32(1.0), np.float32(1.0), np.float32(0.0), np.float32(1.0), np.float32(0.0), np.float32(0.0), np.float32(0.0), np.float32(1.0), np.float32(1.0), np.float32(0.0), np.float32(1.0), np.float32(1.0)]",2.0,99899.0,13
2025-08-14_08-18-36,950,"[np.float32(0.0), np.float32(1.0), np.float32(0.0), np.float32(0.0), np.float32(1.0), np.float32(0.0), np.float32(0.0), np.float32(1.0), np.float32(0.0), np.float32(1.0), np.float32(0.0), np.float32(1.0), np.float32(1.0), np.float32(0.0), np.float32(1.0), np.float32(0.0)]",0.0,99899.0,11
2025-08-14_08-18-36,951,"[np.float32(1.0), np.float32(0.0), np.float32(1.0), np.float32(0.0), np.float32(1.0), np.float32(0.0), np.float32(0.0), np.float32(0.0), np.float32(0.0), np.float32(0.0), np.float32(1.0), np.float32(0.0), np.float32(1.0), np.float32(1.0), np.float32(1.0), np.float32(0.0)]",-4.0,99895.0,33
2025-08-14_08-18-36,952,"[np.float32(1.0), np.float32(0.0), np.float32(1.0), np.float32(0.0), np.float32(1.0), np.float32(0.0), np.float32(1.0), np.float32(0.0), np.float32(0.0), np.float32(0.0), np.float32(0.0), np.float32(1.0), np.float32(1.0), np.float32(1.0), np.float32(1.0), np.float32(1.0)]",-4.0,99891.0,28
2025-08-14_08-18-36,953,"[np.float32(0.0), np.float32(0.0), np.float32(1.0), np.float32(0.0), np.float32(1.0), np.float32(0.0), np.float32(1.0), np.float32(1.0), np.float32(1.0), np.float32(0.0), np.float32(0.0), np.float32(1.0), np.float32(0.0), np.float32(0.0), np.float32(1.0), np.float32(0.0)]",3.0,99894.0,12
2025-08-14_08-18-36,954,"[np.float32(0.0), np.float32(0.0), np.float32(1.0), np.float32(1.0), np.float32(1.0), np.float32(1.0), np.float32(0.0), np.float32(0.0), np.float32(0.0), np.float32(1.0), np.float32(0.0), np.float32(0.0), np.float32(1.0), np.float32(0.0), np.float32(0.0), np.float32(1.0)]",0.0,99894.0,20
2025-08-14_08-18-36,955,"[np.float32(1.0), np.float32(1.0), np.float32(1.0), np.float32(0.0), np.float32(1.0), np.float32(0.0), np.float32(0.0), np.float32(1.0), np.float32(1.0), np.float32(1.0), np.float32(1.0), np.float32(1.0), np.float32(1.0), np.float32(0.0), np.float32(0.0), np.float32(0.0)]",-3.0,99891.0,3
2025-08-14_08-18-36,956,"[np.float32(0.0), np.float32(1.0), np.float32(0.0), np.float32(0.0), np.float32(0.0), np.float32(0.0), np.float32(1.0), np.float32(0.0), np.float32(1.0), np.float32(0.0), np.float32(0.0), np.float32(0.0), np.float32(0.0), np.float32(0.0), np.float32(1.0), np.float32(0.0)]",-2.0,99889.0,15
2025-08-14_08-18-36,957,"[np.float32(1.0), np.float32(0.0), np.float32(1.0), np.float32(0.0), np.float32(1.0), np.float32(1.0), np.float32(0.0), np.float32(1.0), np.float32(1.0), np.float32(0.0), np.float32(0.0), np.float32(1.0), np.float32(0.0), np.float32(1.0), np.float32(0.0), np.float32(0.0)]",-1.0,99888.0,0
2025-08-14_08-18-36,958,"[np.float32(1.0), np.float32(1.0), np.float32(0.0), np.float32(1.0), np.float32(0.0), np.float32(1.0), np.float32(1.0), np.float32(1.0), np.float32(1.0), np.float32(0.0), np.float32(1.0), np.float32(1.0), np.float32(0.0), np.float32(1.0), np.float32(1.0), np.float32(0.0)]",-3.0,99885.0,16
2025-08-14_08-18-36,959,"[np.float32(1.0), np.float32(0.0), np.float32(1.0), np.float32(1.0), np.float32(0.0), np.float32(1.0), np.float32(1.0), np.float32(0.0), np.float32(0.0), np.float32(1.0), np.float32(1.0), np.float32(0.0), np.float32(0.0), np.float32(1.0), np.float32(0.0), np.float32(0.0)]",-2.0,99883.0,27
2025-08-14_08-18-36,960,"[np.float32(0.0), np.float32(1.0), np.float32(1.0), np.float32(1.0), np.float32(1.0), np.float32(0.0), np.float32(1.0), np.float32(1.0), np.float32(0.0), np.float32(1.0), np.float32(1.0), np.float32(1.0), np.float32(0.0), np.float32(1.0), np.float32(0.0), np.float32(1.0)]",1.0,99884.0,13
2025-08-14_08-18-36,961,"[np.float32(0.0), np.float32(1.0), np.float32(1.0), np.float32(1.0), np.float32(0.0), np.float32(0.0), np.float32(1.0), np.float32(0.0), np.float32(1.0), np.float32(1.0), np.float32(1.0), np.float32(0.0), np.float32(1.0), np.float32(1.0), np.float32(0.0), np.float32(1.0)]",3.0,99887.0,28
2025-08-14_08-18-36,962,"[np.float32(1.0), np.float32(1.0), np.float32(1.0), np.float32(1.0), np.float32(1.0), np.float32(1.0), np.float32(1.0), np.float32(0.0), np.float32(1.0), np.float32(0.0), np.float32(0.0), np.float32(1.0), np.float32(0.0), np.float32(1.0), np.float32(0.0), np.float32(1.0)]",-2.0,99885.0,8
2025-08-14_08-18-36,963,"[np.float32(0.0), np.float32(1.0), np.float32(0.0), np.float32(1.0), np.float32(0.0), np.float32(0.0), np.float32(0.0), np.float32(1.0), np.float32(0.0), np.float32(0.0), np.float32(0.0), np.float32(1.0), np.float32(1.0), np.float32(0.0), np.float32(0.0), np.float32(1.0)]",0.0,99885.0,14
2025-08-14_08-18-36,964,"[np.float32(0.0), np.float32(1.0), np.float32(1.0), np.float32(1.0), np.float32(0.0), np.float32(0.0), np.float32(0.0), np.float32(0.0), np.float32(1.0), np.float32(0.0), np.float32(0.0), np.float32(0.0), np.float32(1.0), np.float32(0.0), np.float32(1.0), np.float32(0.0)]",-4.0,99881.0,3
2025-08-14_08-18-36,965,"[np.float32(0.0), np.float32(1.0), np.float32(0.0), np.float32(0.0), np.float32(0.0), np.float32(0.0), np.float32(0.0), np.float32(1.0), np.float32(0.0), np.float32(0.0), np.float32(0.0), np.float32(0.0), np.float32(0.0), np.float32(0.0), np.float32(0.0), np.float32(1.0)]",-3.0,99878.0,25
2025-08-14_08-18-36,966,"[np.float32(0.0), np.float32(1.0), np.float32(0.0), np.float32(0.0), np.float32(1.0), np.float32(0.0), np.float32(0.0), np.float32(1.0), np.float32(0.0), np.float32(1.0), np.float32(0.0), np.float32(0.0), np.float32(1.0), np.float32(0.0), np.float32(0.0), np.float32(0.0)]",-3.0,99875.0,0
2025-08-14_08-18-36,967,"[np.float32(0.0), np.float32(1.0), np.float32(1.0), np.float32(0.0), np.float32(1.0), np.float32(1.0), np.float32(0.0), np.float32(0.0), np.float32(1.0), np.float32(1.0), np.float32(0.0), np.float32(1.0), np.float32(1.0), np.float32(0.0), np.float32(0.0), np.float32(0.0)]",-1.0,99874.0,18
2025-08-14_08-18-36,968,"[np.float32(1.0), np.float32(1.0), np.float32(0.0), np.float32(1.0), np.float32(1.0), np.float32(0.0), np.float32(0.0), np.float32(0.0), np.float32(0.0), np.float32(1.0), np.float32(1.0), np.float32(1.0), np.float32(1.0), np.float32(0.0), np.float32(1.0), np.float32(1.0)]",0.0,99874.0,10
2025-08-14_08-18-36,969,"[np.float32(0.0), np.float32(1.0), np.float32(0.0), np.float32(1.0), np.float32(0.0), np.float32(0.0), np.float32(1.0), np.float32(0.0), np.float32(1.0), np.float32(0.0), np.float32(0.0), np.float32(1.0), np.float32(1.0), np.float32(1.0), np.float32(0.0), np.float32(0.0)]",-7.0,99867.0,14
2025-08-14_08-18-36,970,"[np.float32(0.0), np.float32(0.0), np.float32(0.0), np.float32(0.0), np.float32(0.0), np.float32(1.0), np.float32(1.0), np.float32(0.0), np.float32(1.0), np.float32(0.0), np.float32(0.0), np.float32(1.0), np.float32(1.0), np.float32(0.0), np.float32(0.0), np.float32(0.0)]",-2.0,99865.0,1
2025-08-14_08-18-36,971,"[np.float32(1.0), np.float32(0.0), np.float32(0.0), np.float32(0.0), np.float32(0.0), np.float32(1.0), np.float32(0.0), np.float32(1.0), np.float32(1.0), np.float32(0.0), np.float32(0.0), np.float32(0.0), np.float32(0.0), np.float32(1.0), np.float32(0.0), np.float32(0.0)]",0.0,99865.0,33
2025-08-14_08-18-36,972,"[np.float32(1.0), np.float32(1.0), np.float32(0.0), np.float32(1.0), np.float32(1.0), np.float32(1.0), np.float32(0.0), np.float32(0.0), np.float32(1.0), np.float32(1.0), np.float32(0.0), np.float32(0.0), np.float32(0.0), np.float32(0.0), np.float32(0.0), np.float32(0.0)]",-3.0,99862.0,24
2025-08-14_08-18-36,973,"[np.float32(1.0), np.float32(1.0), np.float32(1.0), np.float32(1.0), np.float32(0.0), np.float32(1.0), np.float32(0.0), np.float32(1.0), np.float32(0.0), np.float32(1.0), np.float32(0.0), np.float32(0.0), np.float32(0.0), np.float32(0.0), np.float32(0.0), np.float32(1.0)]",-1.0,99861.0,4
2025-08-14_08-18-36,974,"[np.float32(0.0), np.float32(0.0), np.float32(1.0), np.float32(0.0), np.float32(0.0), np.float32(0.0), np.float32(0.0), np.float32(1.0), np.float32(1.0), np.float32(1.0), np.float32(1.0), np.float32(0.0), np.float32(1.0), np.float32(0.0), np.float32(1.0), np.float32(0.0)]",-2.0,99859.0,4
2025-08-14_08-18-36,975,"[np.float32(0.0), np.float32(0.0), np.float32(1.0), np.float32(1.0), np.float32(0.0), np.float32(1.0), np.float32(1.0), np.float32(0.0), np.float32(1.0), np.float32(1.0), np.float32(0.0), np.float32(1.0), np.float32(0.0), np.float32(0.0), np.float32(1.0), np.float32(0.0)]",-3.0,99856.0,15
2025-08-14_08-18-36,976,"[np.float32(1.0), np.float32(0.0), np.float32(1.0), np.float32(1.0), np.float32(1.0), np.float32(1.0), np.float32(0.0), np.float32(1.0), np.float32(0.0), np.float32(0.0), np.float32(0.0), np.float32(1.0), np.float32(0.0), np.float32(1.0), np.float32(0.0), np.float32(1.0)]",6.0,99862.0,21
2025-08-14_08-18-36,977,"[np.float32(0.0), np.float32(0.0), np.float32(0.0), np.float32(0.0), np.float32(1.0), np.float32(1.0), np.float32(0.0), np.float32(1.0), np.float32(1.0), np.float32(0.0), np.float32(0.0), np.float32(0.0), np.float32(1.0), np.float32(1.0), np.float32(0.0), np.float32(1.0)]",1.0,99863.0,14
2025-08-14_08-18-36,978,"[np.float32(0.0), np.float32(1.0), np.float32(1.0), np.float32(1.0), np.float32(0.0), np.float32(1.0), np.float32(0.0), np.float32(1.0), np.float32(1.0), np.float32(1.0), np.float32(0.0), np.float32(1.0), np.float32(0.0), np.float32(1.0), np.float32(0.0), np.float32(0.0)]",4.0,99867.0,15
2025-08-14_08-18-36,979,"[np.float32(1.0), np.float32(0.0), np.float32(1.0), np.float32(0.0), np.float32(1.0), np.float32(0.0), np.float32(0.0), np.float32(0.0), np.float32(1.0), np.float32(1.0), np.float32(0.0), np.float32(0.0), np.float32(1.0), np.float32(1.0), np.float32(1.0), np.float32(1.0)]",-4.0,99863.0,20
2025-08-14_08-18-36,980,"[np.float32(0.0), np.float32(1.0), np.float32(0.0), np.float32(1.0), np.float32(1.0), np.float32(1.0), np.float32(0.0), np.float32(1.0), np.float32(1.0), np.float32(1.0), np.float32(1.0), np.float32(0.0), np.float32(1.0), np.float32(0.0), np.float32(0.0), np.float32(1.0)]",-2.0,99861.0,32
2025-08-14_08-18-36,981,"[np.float32(0.0), np.float32(1.0), np.float32(0.0), np.float32(0.0), np.float32(0.0), np.float32(1.0), np.float32(1.0), np.float32(0.0), np.float32(0.0), np.float32(1.0), np.float32(0.0), np.float32(1.0), np.float32(0.0), np.float32(0.0), np.float32(1.0), np.float32(0.0)]",-1.0,99860.0,23
2025-08-14_08-18-36,982,"[np.float32(0.0), np.float32(0.0), np.float32(1.0), np.float32(0.0), np.float32(0.0), np.float32(1.0), np.float32(1.0), np.float32(1.0), np.float32(0.0), np.float32(0.0), np.float32(1.0), np.float32(1.0), np.float32(0.0), np.float32(0.0), np.float32(1.0), np.float32(1.0)]",3.0,99863.0,23
2025-08-14_08-18-36,983,"[np.float32(0.0), np.float32(0.0), np.float32(1.0), np.float32(0.0), np.float32(0.0), np.float32(0.0), np.float32(1.0), np.float32(0.0), np.float32(1.0), np.float32(0.0), np.float32(0.0), np.float32(1.0), np.float32(0.0), np.float32(0.0), np.float32(1.0), np.float32(0.0)]",6.0,99869.0,30
2025-08-14_08-18-36,984,"[np.float32(1.0), np.float32(0.0), np.float32(1.0), np.float32(1.0), np.float32(0.0), np.float32(1.0), np.float32(1.0), np.float32(0.0), np.float32(0.0), np.float32(0.0), np.float32(0.0), np.float32(0.0), np.float32(1.0), np.float32(0.0), np.float32(0.0), np.float32(1.0)]",-3.0,99866.0,0
2025-08-14_08-18-36,985,"[np.float32(1.0), np.float32(1.0), np.float32(0.0), np.float32(1.0), np.float32(0.0), np.float32(1.0), np.float32(1.0), np.float32(1.0), np.float32(1.0), np.float32(1.0), np.float32(0.0), np.float32(1.0), np.float32(1.0), np.float32(0.0), np.float32(0.0), np.float32(0.0)]",-3.0,99863.0,5
2025-08-14_08-18-36,986,"[np.float32(0.0), np.float32(0.0), np.float32(1.0), np.float32(0.0), np.float32(0.0), np.float32(1.0), np.float32(0.0), np.float32(1.0), np.float32(1.0), np.float32(0.0), np.float32(0.0), np.float32(0.0), np.float32(0.0), np.float32(1.0), np.float32(0.0), np.float32(1.0)]",1.0,99864.0,24
2025-08-14_08-18-36,987,"[np.float32(0.0), np.float32(0.0), np.float32(0.0), np.float32(1.0), np.float32(0.0), np.float32(1.0), np.float32(0.0), np.float32(1.0), np.float32(0.0), np.float32(0.0), np.float32(0.0), np.float32(0.0), np.float32(0.0), np.float32(1.0), np.float32(1.0), np.float32(1.0)]",-1.0,99863.0,28
2025-08-14_08-18-36,988,"[np.float32(0.0), np.float32(0.0), np.float32(0.0), np.float32(1.0), np.float32(0.0), np.float32(1.0), np.float32(0.0), np.float32(1.0), np.float32(1.0), np.float32(1.0), np.float32(1.0), np.float32(1.0), np.float32(0.0), np.float32(0.0), np.float32(0.0), np.float32(0.0)]",-5.0,99858.0,0
2025-08-14_08-18-36,989,"[np.float32(0.0), np.float32(0.0), np.float32(0.0), np.float32(1.0), np.float32(0.0), np.float32(1.0), np.float32(1.0), np.float32(0.0), np.float32(0.0), np.float32(0.0), np.float32(0.0), np.float32(0.0), np.float32(1.0), np.float32(1.0), np.float32(0.0), np.float32(0.0)]",1.0,99859.0,2
2025-08-14_08-18-36,990,"[np.float32(0.0), np.float32(0.0), np.float32(1.0), np.float32(0.0), np.float32(0.0), np.float32(1.0), np.float32(0.0), np.float32(0.0), np.float32(1.0), np.float32(0.0), np.float32(0.0), np.float32(0.0), np.float32(0.0), np.float32(0.0), np.float32(0.0), np.float32(0.0)]",-3.0,99856.0,1
2025-08-14_08-18-36,991,"[np.float32(1.0), np.float32(0.0), np.float32(0.0), np.float32(1.0), np.float32(0.0), np.float32(0.0), np.float32(0.0), np.float32(1.0), np.float32(0.0), np.float32(1.0), np.float32(1.0), np.float32(0.0), np.float32(1.0), np.float32(0.0), np.float32(1.0), np.float32(0.0)]",-4.0,99852.0,28
2025-08-14_08-18-36,992,"[np.float32(1.0), np.float32(1.0), np.float32(1.0), np.float32(0.0), np.float32(0.0), np.float32(0.0), np.float32(1.0), np.float32(0.0), np.float32(1.0), np.float32(1.0), np.float32(0.0), np.float32(0.0), np.float32(1.0), np.float32(0.0), np.float32(1.0), np.float32(0.0)]",-1.0,99851.0,32
2025-08-14_08-18-36,993,"[np.float32(0.0), np.float32(1.0), np.float32(0.0), np.float32(1.0), np.float32(0.0), np.float32(1.0), np.float32(0.0), np.float32(0.0), np.float32(0.0), np.float32(1.0), np.float32(0.0), np.float32(0.0), np.float32(0.0), np.float32(1.0), np.float32(1.0), np.float32(0.0)]",3.0,99854.0,29
2025-08-14_08-18-36,994,"[np.float32(1.0), np.float32(0.0), np.float32(0.0), np.float32(1.0), np.float32(0.0), np.float32(0.0), np.float32(0.0), np.float32(0.0), np.float32(1.0), np.float32(1.0), np.float32(1.0), np.float32(0.0), np.float32(0.0), np.float32(0.0), np.float32(1.0), np.float32(0.0)]",4.0,99858.0,25
2025-08-14_08-18-36,995,"[np.float32(0.0), np.float32(0.0), np.float32(1.0), np.float32(1.0), np.float32(1.0), np.float32(0.0), np.float32(1.0), np.float32(0.0), np.float32(0.0), np.float32(0.0), np.float32(0.0), np.float32(0.0), np.float32(1.0), np.float32(1.0), np.float32(1.0), np.float32(1.0)]",-3.0,99855.0,33
2025-08-14_08-18-36,996,"[np.float32(0.0), np.float32(0.0), np.float32(0.0), np.float32(1.0), np.float32(1.0), np.float32(1.0), np.float32(0.0), np.float32(0.0), np.float32(0.0), np.float32(1.0), np.float32(1.0), np.float32(1.0), np.float32(0.0), np.float32(1.0), np.float32(0.0), np.float32(0.0)]",0.0,99855.0,31
2025-08-14_08-18-36,997,"[np.float32(1.0), np.float32(1.0), np.float32(0.0), np.float32(1.0), np.float32(0.0), np.float32(1.0), np.float32(0.0), np.float32(0.0), np.float32(0.0), np.float32(0.0), np.float32(0.0), np.float32(0.0), np.float32(0.0), np.float32(1.0), np.float32(0.0), np.float32(0.0)]",-1.0,99854.0,20
2025-08-14_08-18-36,998,"[np.float32(0.0), np.float32(1.0), np.float32(1.0), np.float32(1.0), np.float32(1.0), np.float32(1.0), np.float32(1.0), np.float32(0.0), np.float32(0.0), np.float32(1.0), np.float32(0.0), np.float32(1.0), np.float32(0.0), np.float32(1.0), np.float32(0.0), np.float32(0.0)]",-2.0,99852.0,32
2025-08-14_08-18-36,999,"[np.float32(0.0), np.float32(1.0), np.float32(0.0), np.float32(1.0), np.float32(0.0), np.float32(1.0), np.float32(0.0), np.float32(0.0), np.float32(1.0), np.float32(1.0), np.float32(1.0), np.float32(1.0), np.float32(1.0), np.float32(0.0), np.float32(0.0), np.float32(1.0)]",-2.0,99850.0,24
2025-08-14_08-18-36,1000,"[np.float32(1.0), np.float32(1.0), np.float32(0.0), np.float32(0.0), np.float32(0.0), np.float32(0.0), np.float32(0.0), np.float32(1.0), np.float32(1.0), np.float32(0.0), np.float32(1.0), np.float32(1.0), np.float32(1.0), np.float32(1.0), np.float32(0.0), np.float32(1.0)]",2.0,99852.0,15
2025-08-14_08-18-36,1001,"[np.float32(0.0), np.float32(1.0), np.float32(1.0), np.float32(1.0), np.float32(0.0), np.float32(0.0), np.float32(0.0), np.float32(0.0), np.float32(0.0), np.float32(0.0), np.float32(1.0), np.float32(1.0), np.float32(0.0), np.float32(1.0), np.float32(0.0), np.float32(1.0)]",-5.0,99920.0,16
2025-08-14_08-18-36,1002,"[np.float32(0.0), np.float32(1.0), np.float32(1.0), np.float32(0.0), np.float32(1.0), np.float32(1.0), np.float32(1.0), np.float32(1.0), np.float32(1.0), np.float32(1.0), np.float32(0.0), np.float32(0.0), np.float32(0.0), np.float32(0.0), np.float32(1.0), np.float32(0.0)]",1.0,99921.0,36
2025-08-14_08-18-36,1003,"[np.float32(0.0), np.float32(1.0), np.float32(0.0), np.float32(1.0), np.float32(1.0), np.float32(0.0), np.float32(1.0), np.float32(0.0), np.float32(1.0), np.float32(0.0), np.float32(1.0), np.float32(0.0), np.float32(1.0), np.float32(1.0), np.float32(0.0), np.float32(0.0)]",-1.0,99920.0,9
2025-08-14_08-18-36,1004,"[np.float32(1.0), np.float32(0.0), np.float32(0.0), np.float32(0.0), np.float32(0.0), np.float32(1.0), np.float32(0.0), np.float32(1.0), np.float32(1.0), np.float32(1.0), np.float32(0.0), np.float32(1.0), np.float32(1.0), np.float32(1.0), np.float32(0.0), np.float32(1.0)]",1.0,99921.0,32
2025-08-14_08-18-36,1005,"[np.float32(0.0), np.float32(1.0), np.float32(0.0), np.float32(1.0), np.float32(1.0), np.float32(0.0), np.float32(0.0), np.float32(0.0), np.float32(0.0), np.float32(0.0), np.float32(0.0), np.float32(0.0), np.float32(0.0), np.float32(0.0), np.float32(1.0), np.float32(1.0)]",0.0,99921.0,23
2025-08-14_08-18-36,1006,"[np.float32(0.0), np.float32(1.0), np.float32(1.0), np.float32(1.0), np.float32(0.0), np.float32(1.0), np.float32(0.0), np.float32(1.0), np.float32(1.0), np.float32(0.0), np.float32(0.0), np.float32(1.0), np.float32(0.0), np.float32(1.0), np.float32(0.0), np.float32(0.0)]",-1.0,99920.0,4
2025-08-14_08-18-36,1007,"[np.float32(0.0), np.float32(0.0), np.float32(0.0), np.float32(1.0), np.float32(0.0), np.float32(1.0), np.float32(1.0), np.float32(0.0), np.float32(1.0), np.float32(0.0), np.float32(1.0), np.float32(1.0), np.float32(0.0), np.float32(1.0), np.float32(1.0), np.float32(1.0)]",0.0,99920.0,6
2025-08-14_08-18-36,1008,"[np.float32(1.0), np.float32(1.0), np.float32(1.0), np.float32(0.0), np.float32(1.0), np.float32(0.0), np.float32(0.0), np.float32(1.0), np.float32(0.0), np.float32(1.0), np.float32(0.0), np.float32(0.0), np.float32(0.0), np.float32(0.0), np.float32(1.0), np.float32(0.0)]",-3.0,99917.0,26
2025-08-14_08-18-36,1009,"[np.float32(0.0), np.float32(0.0), np.float32(0.0), np.float32(0.0), np.float32(1.0), np.float32(1.0), np.float32(0.0), np.float32(1.0), np.float32(1.0), np.float32(1.0), np.float32(1.0), np.float32(0.0), np.float32(0.0), np.float32(0.0), np.float32(0.0), np.float32(0.0)]",2.0,99919.0,31
2025-08-14_08-18-36,1010,"[np.float32(1.0), np.float32(1.0), np.float32(0.0), np.float32(1.0), np.float32(1.0), np.float32(1.0), np.float32(0.0), np.float32(1.0), np.float32(0.0), np.float32(0.0), np.float32(1.0), np.float32(1.0), np.float32(0.0), np.float32(1.0), np.float32(1.0), np.float32(0.0)]",0.0,99919.0,2
2025-08-14_08-18-36,1011,"[np.float32(1.0), np.float32(1.0), np.float32(0.0), np.float32(1.0), np.float32(0.0), np.float32(1.0), np.float32(0.0), np.float32(1.0), np.float32(0.0), np.float32(0.0), np.float32(1.0), np.float32(1.0), np.float32(1.0), np.float32(0.0), np.float32(0.0), np.float32(1.0)]",-2.0,99917.0,13
2025-08-14_08-18-36,1012,"[np.float32(1.0), np.float32(0.0), np.float32(0.0), np.float32(0.0), np.float32(1.0), np.float32(1.0), np.float32(0.0), np.float32(0.0), np.float32(1.0), np.float32(1.0), np.float32(1.0), np.float32(1.0), np.float32(1.0), np.float32(0.0), np.float32(1.0), np.float32(0.0)]",-1.0,99916.0,10
2025-08-14_08-18-36,1013,"[np.float32(1.0), np.float32(0.0), np.float32(1.0), np.float32(1.0), np.float32(0.0), np.float32(1.0), np.float32(1.0), np.float32(0.0), np.float32(0.0), np.float32(0.0), np.float32(1.0), np.float32(0.0), np.float32(1.0), np.float32(0.0), np.float32(0.0), np.float32(0.0)]",0.0,99916.0,29
2025-08-14_08-18-36,1014,"[np.float32(1.0), np.float32(0.0), np.float32(1.0), np.float32(1.0), np.float32(1.0), np.float32(0.0), np.float32(0.0), np.float32(0.0), np.float32(1.0), np.float32(1.0), np.float32(0.0), np.float32(0.0), np.float32(0.0), np.float32(0.0), np.float32(1.0), np.float32(1.0)]",1.0,99917.0,14
2025-08-14_08-18-36,1015,"[np.float32(1.0), np.float32(1.0), np.float32(1.0), np.float32(1.0), np.float32(0.0), np.float32(0.0), np.float32(0.0), np.float32(0.0), np.float32(0.0), np.float32(0.0), np.float32(1.0), np.float32(0.0), np.float32(1.0), np.float32(1.0), np.float32(0.0), np.float32(1.0)]",-1.0,99916.0,31
2025-08-14_08-18-36,1016,"[np.float32(0.0), np.float32(1.0), np.float32(1.0), np.float32(1.0), np.float32(0.0), np.float32(0.0), np.float32(1.0), np.float32(0.0), np.float32(1.0), np.float32(1.0), np.float32(1.0), np.float32(1.0), np.float32(0.0), np.float32(1.0), np.float32(0.0), np.float32(1.0)]",1.0,99917.0,7
2025-08-14_08-18-36,1017,"[np.float32(1.0), np.float32(1.0), np.float32(0.0), np.float32(0.0), np.float32(1.0), np.float32(1.0), np.float32(1.0), np.float32(1.0), np.float32(0.0), np.float32(1.0), np.float32(1.0), np.float32(1.0), np.float32(0.0), np.float32(1.0), np.float32(0.0), np.float32(1.0)]",2.0,99919.0,4
2025-08-14_08-18-36,1018,"[np.float32(0.0), np.float32(0.0), np.float32(0.0), np.float32(1.0), np.float32(0.0), np.float32(0.0), np.float32(0.0), np.float32(0.0), np.float32(1.0), np.float32(0.0), np.float32(1.0), np.float32(1.0), np.float32(1.0), np.float32(1.0), np.float32(0.0), np.float32(0.0)]",0.0,99919.0,18
2025-08-14_08-18-36,1019,"[np.float32(1.0), np.float32(1.0), np.float32(0.0), np.float32(1.0), np.float32(1.0), np.float32(0.0), np.float32(0.0), np.float32(1.0), np.float32(0.0), np.float32(1.0), np.float32(1.0), np.float32(1.0), np.float32(0.0), np.float32(1.0), np.float32(0.0), np.float32(0.0)]",1.0,99920.0,12
2025-08-14_08-18-36,1020,"[np.float32(0.0), np.float32(1.0), np.float32(1.0), np.float32(0.0), np.float32(1.0), np.float32(1.0), np.float32(0.0), np.float32(1.0), np.float32(0.0), np.float32(0.0), np.float32(0.0), np.float32(1.0), np.float32(0.0), np.float32(0.0), np.float32(1.0), np.float32(0.0)]",-5.0,99915.0,1
2025-08-14_08-18-36,1021,"[np.float32(1.0), np.float32(1.0), np.float32(1.0), np.float32(0.0), np.float32(0.0), np.float32(0.0), np.float32(1.0), np.float32(0.0), np.float32(1.0), np.float32(1.0), np.float32(0.0), np.float32(1.0), np.float32(0.0), np.float32(0.0), np.float32(1.0), np.float32(1.0)]",1.0,99916.0,8
2025-08-14_08-18-36,1022,"[np.float32(1.0), np.float32(0.0), np.float32(0.0), np.float32(1.0), np.float32(0.0), np.float32(0.0), np.float32(1.0), np.float32(0.0), np.float32(0.0), np.float32(0.0), np.float32(0.0), np.float32(0.0), np.float32(1.0), np.float32(0.0), np.float32(0.0), np.float32(0.0)]",-2.0,99914.0,14
2025-08-14_08-18-36,1023,"[np.float32(1.0), np.float32(0.0), np.float32(0.0), np.float32(0.0), np.float32(1.0), np.float32(1.0), np.float32(0.0), np.float32(1.0), np.float32(1.0), np.float32(0.0), np.float32(0.0), np.float32(0.0), np.float32(0.0), np.float32(0.0), np.float32(1.0), np.float32(1.0)]",1.0,99915.0,24
2025-08-14_08-18-36,1024,"[np.float32(1.0), np.float32(1.0), np.float32(0.0), np.float32(1.0), np.float32(0.0), np.float32(0.0), np.float32(0.0), np.float32(0.0), np.float32(0.0), np.float32(1.0), np.float32(1.0), np.float32(0.0), np.float32(0.0), np.float32(1.0), np.float32(0.0), np.float32(1.0)]",1.0,99916.0,28
2025-08-14_08-18-36,1025,"[np.float32(1.0), np.float32(0.0), np.float32(0.0), np.float32(0.0), np.float32(1.0), np.float32(0.0), np.float32(1.0), np.float32(1.0), np.float32(1.0), np.float32(0.0), np.float32(0.0), np.float32(1.0), np.float32(0.0), np.float32(0.0), np.float32(1.0), np.float32(0.0)]",1.0,99917.0,21
2025-08-14_08-18-36,1026,"[np.float32(0.0), np.float32(0.0), np.float32(0.0), np.float32(1.0), np.float32(0.0), np.float32(0.0), np.float32(0.0), np.float32(0.0), np.float32(1.0), np.float32(0.0), np.float32(0.0), np.float32(1.0), np.float32(1.0), np.float32(1.0), np.float32(0.0), np.float32(1.0)]",2.0,99919.0,15
2025-08-14_08-18-36,1027,"[np.float32(0.0), np.float32(0.0), np.float32(1.0), np.float32(0.0), np.float32(1.0), np.float32(1.0), np.float32(1.0), np.float32(1.0), np.float32(1.0), np.float32(0.0), np.float32(1.0), np.float32(0.0), np.float32(0.0), np.float32(0.0), np.float32(0.0), np.float32(1.0)]",-1.0,99918.0,28
2025-08-14_08-18-36,1028,"[np.float32(1.0), np.float32(0.0), np.float32(0.0), np.float32(0.0), np.float32(0.0), np.float32(0.0), np.float32(1.0), np.float32(0.0), np.float32(1.0), np.float32(0.0), np.float32(0.0), np.float32(1.0), np.float32(0.0), np.float32(0.0), np.float32(1.0), np.float32(0.0)]",6.0,99924.0,30
2025-08-14_08-18-36,1029,"[np.float32(0.0), np.float32(1.0), np.float32(0.0), np.float32(1.0), np.float32(1.0), np.float32(1.0), np.float32(1.0), np.float32(1.0), np.float32(1.0), np.float32(0.0), np.float32(1.0), np.float32(1.0), np.float32(0.0), np.float32(0.0), np.float32(1.0), np.float32(1.0)]",-4.0,99920.0,4
2025-08-14_08-18-36,1030,"[np.float32(1.0), np.float32(1.0), np.float32(1.0), np.float32(1.0), np.float32(0.0), np.float32(1.0), np.float32(1.0), np.float32(0.0), np.float32(1.0), np.float32(0.0), np.float32(1.0), np.float32(0.0), np.float32(1.0), np.float32(0.0), np.float32(1.0), np.float32(1.0)]",-2.0,99918.0,28
2025-08-14_08-18-36,1031,"[np.float32(1.0), np.float32(1.0), np.float32(0.0), np.float32(1.0), np.float32(0.0), np.float32(0.0), np.float32(1.0), np.float32(1.0), np.float32(1.0), np.float32(1.0), np.float32(0.0), np.float32(0.0), np.float32(1.0), np.float32(1.0), np.float32(0.0), np.float32(1.0)]",-2.0,99916.0,10
2025-08-14_08-18-36,1032,"[np.float32(1.0), np.float32(0.0), np.float32(0.0), np.float32(1.0), np.float32(0.0), np.float32(1.0), np.float32(0.0), np.float32(0.0), np.float32(1.0), np.float32(1.0), np.float32(1.0), np.float32(1.0), np.float32(0.0), np.float32(1.0), np.float32(1.0), np.float32(0.0)]",-6.0,99910.0,6
2025-08-14_08-18-36,1033,"[np.float32(1.0), np.float32(1.0), np.float32(1.0), np.float32(0.0), np.float32(0.0), np.float32(1.0), np.float32(0.0), np.float32(1.0), np.float32(0.0), np.float32(0.0), np.float32(1.0), np.float32(1.0), np.float32(0.0), np.float32(0.0), np.float32(0.0), np.float32(1.0)]",-3.0,99907.0,3
2025-08-14_08-18-36,1034,"[np.float32(0.0), np.float32(1.0), np.float32(0.0), np.float32(0.0), np.float32(1.0), np.float32(1.0), np.float32(0.0), np.float32(0.0), np.float32(0.0), np.float32(0.0), np.float32(1.0), np.float32(0.0), np.float32(0.0), np.float32(1.0), np.float32(1.0), np.float32(1.0)]",-2.0,99905.0,36
2025-08-14_08-18-36,1035,"[np.float32(0.0), np.float32(0.0), np.float32(1.0), np.float32(1.0), np.float32(1.0), np.float32(1.0), np.float32(0.0), np.float32(0.0), np.float32(1.0), np.float32(1.0), np.float32(1.0), np.float32(1.0), np.float32(1.0), np.float32(1.0), np.float32(1.0), np.float32(1.0)]",1.0,99906.0,26
2025-08-14_08-18-36,1036,"[np.float32(0.0), np.float32(1.0), np.float32(1.0), np.float32(0.0), np.float32(0.0), np.float32(0.0), np.float32(0.0), np.float32(1.0), np.float32(0.0), np.float32(0.0), np.float32(0.0), np.float32(1.0), np.float32(1.0), np.float32(1.0), np.float32(1.0), np.float32(1.0)]",-3.0,99903.0,32
2025-08-14_08-18-36,1037,"[np.float32(0.0), np.float32(0.0), np.float32(0.0), np.float32(1.0), np.float32(0.0), np.float32(0.0), np.float32(0.0), np.float32(0.0), np.float32(0.0), np.float32(0.0), np.float32(1.0), np.float32(0.0), np.float32(0.0), np.float32(1.0), np.float32(0.0), np.float32(1.0)]",1.0,99904.0,11
2025-08-14_08-18-36,1038,"[np.float32(0.0), np.float32(0.0), np.float32(1.0), np.float32(1.0), np.float32(0.0), np.float32(0.0), np.float32(1.0), np.float32(0.0), np.float32(1.0), np.float32(1.0), np.float32(1.0), np.float32(1.0), np.float32(1.0), np.float32(1.0), np.float32(1.0), np.float32(0.0)]",1.0,99905.0,32
2025-08-14_08-18-36,1039,"[np.float32(1.0), np.float32(0.0), np.float32(0.0), np.float32(0.0), np.float32(1.0), np.float32(1.0), np.float32(1.0), np.float32(1.0), np.float32(0.0), np.float32(1.0), np.float32(0.0), np.float32(1.0), np.float32(0.0), np.float32(0.0), np.float32(1.0), np.float32(1.0)]",-1.0,99904.0,20
2025-08-14_08-18-36,1040,"[np.float32(1.0), np.float32(0.0), np.float32(0.0), np.float32(1.0), np.float32(1.0), np.float32(1.0), np.float32(0.0), np.float32(1.0), np.float32(0.0), np.float32(0.0), np.float32(1.0), np.float32(1.0), np.float32(0.0), np.float32(0.0), np.float32(0.0), np.float32(1.0)]",4.0,99908.0,21
2025-08-14_08-18-36,1041,"[np.float32(0.0), np.float32(0.0), np.float32(0.0), np.float32(1.0), np.float32(0.0), np.float32(1.0), np.float32(1.0), np.float32(1.0), np.float32(0.0), np.float32(0.0), np.float32(0.0), np.float32(0.0), np.float32(0.0), np.float32(1.0), np.float32(1.0), np.float32(0.0)]",0.0,99908.0,18
2025-08-14_08-18-36,1042,"[np.float32(1.0), np.float32(0.0), np.float32(0.0), np.float32(1.0), np.float32(0.0), np.float32(0.0), np.float32(0.0), np.float32(1.0), np.float32(1.0), np.float32(1.0), np.float32(0.0), np.float32(0.0), np.float32(0.0), np.float32(1.0), np.float32(1.0), np.float32(0.0)]",3.0,99911.0,23
2025-08-14_08-18-36,1043,"[np.float32(1.0), np.float32(0.0), np.float32(1.0), np.float32(1.0), np.float32(0.0), np.float32(1.0), np.float32(0.0), np.float32(0.0), np.float32(0.0), np.float32(0.0), np.float32(1.0), np.float32(1.0), np.float32(1.0), np.float32(1.0), np.float32(1.0), np.float32(1.0)]",-3.0,99908.0,0
2025-08-14_08-18-36,1044,"[np.float32(1.0), np.float32(0.0), np.float32(0.0), np.float32(1.0), np.float32(1.0), np.float32(0.0), np.float32(1.0), np.float32(0.0), np.float32(0.0), np.float32(0.0), np.float32(0.0), np.float32(1.0), np.float32(0.0), np.float32(1.0), np.float32(0.0), np.float32(1.0)]",0.0,99908.0,25
2025-08-14_08-18-36,1045,"[np.float32(1.0), np.float32(0.0), np.float32(0.0), np.float32(0.0), np.float32(1.0), np.float32(1.0), np.float32(1.0), np.float32(1.0), np.float32(1.0), np.float32(1.0), np.float32(0.0), np.float32(1.0), np.float32(0.0), np.float32(0.0), np.float32(1.0), np.float32(0.0)]",-4.0,99904.0,35
2025-08-14_08-18-36,1046,"[np.float32(1.0), np.float32(0.0), np.float32(0.0), np.float32(1.0), np.float32(0.0), np.float32(1.0), np.float32(1.0), np.float32(1.0), np.float32(1.0), np.float32(1.0), np.float32(0.0), np.float32(1.0), np.float32(0.0), np.float32(0.0), np.float32(1.0), np.float32(1.0)]",2.0,99906.0,23
2025-08-14_08-18-36,1047,"[np.float32(0.0), np.float32(1.0), np.float32(1.0), np.float32(0.0), np.float32(0.0), np.float32(0.0), np.float32(0.0), np.float32(1.0), np.float32(1.0), np.float32(1.0), np.float32(0.0), np.float32(0.0), np.float32(1.0), np.float32(1.0), np.float32(0.0), np.float32(0.0)]",6.0,99912.0,22
2025-08-14_08-18-36,1048,"[np.float32(1.0), np.float32(0.0), np.float32(0.0), np.float32(0.0), np.float32(0.0), np.float32(1.0), np.float32(1.0), np.float32(1.0), np.float32(0.0), np.float32(0.0), np.float32(0.0), np.float32(1.0), np.float32(0.0), np.float32(0.0), np.float32(1.0), np.float32(1.0)]",1.0,99913.0,14
2025-08-14_08-18-36,1049,"[np.float32(0.0), np.float32(1.0), np.float32(0.0), np.float32(1.0), np.float32(0.0), np.float32(1.0), np.float32(1.0), np.float32(1.0), np.float32(1.0), np.float32(1.0), np.float32(0.0), np.float32(0.0), np.float32(1.0), np.float32(1.0), np.float32(0.0), np.float32(0.0)]",-3.0,99910.0,16
2025-08-14_08-18-36,1050,"[np.float32(0.0), np.float32(1.0), np.float32(1.0), np.float32(1.0), np.float32(0.0), np.float32(1.0), np.float32(0.0), np.float32(0.0), np.float32(1.0), np.float32(0.0), np.float32(1.0), np.float32(0.0), np.float32(1.0), np.float32(0.0), np.float32(0.0), np.float32(0.0)]",-3.0,99907.0,19
2025-08-14_08-18-36,1051,"[np.float32(1.0), np.float32(0.0), np.float32(1.0), np.float32(0.0), np.float32(0.0), np.float32(1.0), np.float32(1.0), np.float32(0.0), np.float32(0.0), np.float32(1.0), np.float32(0.0), np.float32(1.0), np.float32(0.0), np.float32(0.0), np.float32(0.0), np.float32(0.0)]",1.0,99908.0,24
2025-08-14_08-18-36,1052,"[np.float32(0.0), np.float32(0.0), np.float32(1.0), np.float32(1.0), np.float32(1.0), np.float32(0.0), np.float32(0.0), np.float32(1.0), np.float32(1.0), np.float32(1.0), np.float32(0.0), np.float32(1.0), np.float32(1.0), np.float32(0.0), np.float32(1.0), np.float32(0.0)]",-2.0,99906.0,3
2025-08-14_08-18-36,1053,"[np.float32(0.0), np.float32(1.0), np.float32(1.0), np.float32(0.0), np.float32(0.0), np.float32(0.0), np.float32(0.0), np.float32(0.0), np.float32(0.0), np.float32(0.0), np.float32(1.0), np.float32(0.0), np.float32(0.0), np.float32(1.0), np.float32(1.0), np.float32(0.0)]",-5.0,99901.0,1
2025-08-14_08-18-36,1054,"[np.float32(0.0), np.float32(0.0), np.float32(0.0), np.float32(0.0), np.float32(0.0), np.float32(0.0), np.float32(1.0), np.float32(1.0), np.float32(0.0), np.float32(1.0), np.float32(0.0), np.float32(1.0), np.float32(0.0), np.float32(1.0), np.float32(1.0), np.float32(1.0)]",2.0,99903.0,22
2025-08-14_08-18-36,1055,"[np.float32(1.0), np.float32(1.0), np.float32(0.0), np.float32(1.0), np.float32(1.0), np.float32(1.0), np.float32(1.0), np.float32(0.0), np.float32(0.0), np.float32(1.0), np.float32(1.0), np.float32(1.0), np.float32(0.0), np.float32(0.0), np.float32(1.0), np.float32(1.0)]",-4.0,99899.0,32
2025-08-14_08-18-36,1056,"[np.float32(1.0), np.float32(1.0), np.float32(1.0), np.float32(0.0), np.float32(1.0), np.float32(0.0), np.float32(0.0), np.float32(1.0), np.float32(1.0), np.float32(0.0), np.float32(1.0), np.float32(1.0), np.float32(1.0), np.float32(1.0), np.float32(0.0), np.float32(0.0)]",-3.0,99896.0,0
2025-08-14_08-18-36,1057,"[np.float32(0.0), np.float32(0.0), np.float32(0.0), np.float32(0.0), np.float32(1.0), np.float32(1.0), np.float32(1.0), np.float32(1.0), np.float32(1.0), np.float32(1.0), np.float32(0.0), np.float32(0.0), np.float32(1.0), np.float32(0.0), np.float32(0.0), np.float32(0.0)]",-2.0,99894.0,32
2025-08-14_08-18-36,1058,"[np.float32(1.0), np.float32(0.0), np.float32(0.0), np.float32(0.0), np.float32(1.0), np.float32(0.0), np.float32(0.0), np.float32(1.0), np.float32(0.0), np.float32(1.0), np.float32(0.0), np.float32(0.0), np.float32(1.0), np.float32(0.0), np.float32(1.0), np.float32(0.0)]",-1.0,99893.0,36
2025-08-14_08-18-36,1059,"[np.float32(0.0), np.float32(0.0), np.float32(1.0), np.float32(0.0), np.float32(1.0), np.float32(0.0), np.float32(0.0), np.float32(0.0), np.float32(0.0), np.float32(1.0), np.float32(0.0), np.float32(0.0), np.float32(0.0), np.float32(1.0), np.float32(0.0), np.float32(1.0)]",0.0,99893.0,20
2025-08-14_08-18-36,1060,"[np.float32(1.0), np.float32(0.0), np.float32(0.0), np.float32(0.0), np.float32(0.0), np.float32(0.0), np.float32(0.0), np.float32(0.0), np.float32(1.0), np.float32(0.0), np.float32(0.0), np.float32(1.0), np.float32(1.0), np.float32(0.0), np.float32(0.0), np.float32(1.0)]",33.0,99926.0,7
2025-08-14_08-18-36,1061,"[np.float32(0.0), np.float32(0.0), np.float32(1.0), np.float32(0.0), np.float32(1.0), np.float32(1.0), np.float32(0.0), np.float32(0.0), np.float32(1.0), np.float32(0.0), np.float32(1.0), np.float32(0.0), np.float32(1.0), np.float32(1.0), np.float32(1.0), np.float32(1.0)]",1.0,99927.0,34
2025-08-14_08-18-36,1062,"[np.float32(1.0), np.float32(1.0), np.float32(0.0), np.float32(0.0), np.float32(0.0), np.float32(0.0), np.float32(0.0), np.float32(0.0), np.float32(1.0), np.float32(0.0), np.float32(1.0), np.float32(0.0), np.float32(0.0), np.float32(0.0), np.float32(1.0), np.float32(1.0)]",2.0,99929.0,32
2025-08-14_08-18-36,1063,"[np.float32(0.0), np.float32(0.0), np.float32(0.0), np.float32(1.0), np.float32(1.0), np.float32(0.0), np.float32(0.0), np.float32(0.0), np.float32(0.0), np.float32(1.0), np.float32(1.0), np.float32(0.0), np.float32(0.0), np.float32(1.0), np.float32(1.0), np.float32(1.0)]",0.0,99929.0,15
2025-08-14_08-18-36,1064,"[np.float32(0.0), np.float32(1.0), np.float32(0.0), np.float32(1.0), np.float32(0.0), np.float32(0.0), np.float32(1.0), np.float32(1.0), np.float32(1.0), np.float32(1.0), np.float32(1.0), np.float32(1.0), np.float32(1.0), np.float32(1.0), np.float32(0.0), np.float32(0.0)]",0.0,99929.0,11
2025-08-14_08-18-36,1065,"[np.float32(0.0), np.float32(1.0), np.float32(1.0), np.float32(0.0), np.float32(1.0), np.float32(1.0), np.float32(0.0), np.float32(1.0), np.float32(0.0), np.float32(0.0), np.float32(0.0), np.float32(0.0), np.float32(1.0), np.float32(0.0), np.float32(1.0), np.float32(1.0)]",-2.0,99927.0,2
2025-08-14_08-18-36,1066,"[np.float32(0.0), np.float32(1.0), np.float32(0.0), np.float32(1.0), np.float32(0.0), np.float32(0.0), np.float32(0.0), np.float32(1.0), np.float32(1.0), np.float32(0.0), np.float32(1.0), np.float32(0.0), np.float32(1.0), np.float32(1.0), np.float32(0.0), np.float32(1.0)]",2.0,99929.0,15
2025-08-14_08-18-36,1067,"[np.float32(1.0), np.float32(0.0), np.float32(0.0), np.float32(0.0), np.float32(1.0), np.float32(1.0), np.float32(1.0), np.float32(0.0), np.float32(0.0), np.float32(0.0), np.float32(1.0), np.float32(0.0), np.float32(0.0), np.float32(1.0), np.float32(1.0), np.float32(0.0)]",3.0,99932.0,32
2025-08-14_08-18-36,1068,"[np.float32(0.0), np.float32(1.0), np.float32(0.0), np.float32(0.0), np.float32(0.0), np.float32(0.0), np.float32(0.0), np.float32(0.0), np.float32(1.0), np.float32(0.0), np.float32(0.0), np.float32(1.0), np.float32(0.0), np.float32(1.0), np.float32(0.0), np.float32(0.0)]",1.0,99933.0,2
2025-08-14_08-18-36,1069,"[np.float32(1.0), np.float32(1.0), np.float32(1.0), np.float32(1.0), np.float32(0.0), np.float32(0.0), np.float32(1.0), np.float32(0.0), np.float32(0.0), np.float32(1.0), np.float32(0.0), np.float32(0.0), np.float32(0.0), np.float32(1.0), np.float32(0.0), np.float32(0.0)]",0.0,99933.0,15
2025-08-14_08-18-36,1070,"[np.float32(0.0), np.float32(1.0), np.float32(1.0), np.float32(1.0), np.float32(1.0), np.float32(0.0), np.float32(0.0), np.float32(1.0), np.float32(1.0), np.float32(0.0), np.float32(0.0), np.float32(0.0), np.float32(0.0), np.float32(1.0), np.float32(1.0), np.float32(1.0)]",-1.0,99932.0,23
2025-08-14_08-18-36,1071,"[np.float32(0.0), np.float32(1.0), np.float32(0.0), np.float32(1.0), np.float32(0.0), np.float32(0.0), np.float32(0.0), np.float32(0.0), np.float32(0.0), np.float32(0.0), np.float32(0.0), np.float32(0.0), np.float32(0.0), np.float32(1.0), np.float32(1.0), np.float32(1.0)]",-2.0,99930.0,14
2025-08-14_08-18-36,1072,"[np.float32(1.0), np.float32(0.0), np.float32(1.0), np.float32(1.0), np.float32(1.0), np.float32(0.0), np.float32(0.0), np.float32(0.0), np.float32(1.0), np.float32(0.0), np.float32(1.0), np.float32(0.0), np.float32(1.0), np.float32(0.0), np.float32(1.0), np.float32(0.0)]",2.0,99932.0,11
2025-08-14_08-18-36,1073,"[np.float32(0.0), np.float32(1.0), np.float32(1.0), np.float32(0.0), np.float32(1.0), np.float32(0.0), np.float32(0.0), np.float32(1.0), np.float32(0.0), np.float32(0.0), np.float32(0.0), np.float32(0.0), np.float32(0.0), np.float32(1.0), np.float32(0.0), np.float32(0.0)]",2.0,99934.0,14
2025-08-14_08-18-36,1074,"[np.float32(0.0), np.float32(1.0), np.float32(0.0), np.float32(1.0), np.float32(0.0), np.float32(0.0), np.float32(0.0), np.float32(0.0), np.float32(1.0), np.float32(0.0), np.float32(0.0), np.float32(1.0), np.float32(1.0), np.float32(1.0), np.float32(1.0), np.float32(1.0)]",-1.0,99933.0,13
2025-08-14_08-18-36,1075,"[np.float32(1.0), np.float32(0.0), np.float32(1.0), np.float32(1.0), np.float32(0.0), np.float32(0.0), np.float32(1.0), np.float32(1.0), np.float32(0.0), np.float32(1.0), np.float32(0.0), np.float32(0.0), np.float32(1.0), np.float32(1.0), np.float32(1.0), np.float32(1.0)]",1.0,99934.0,4
2025-08-14_08-18-36,1076,"[np.float32(0.0), np.float32(1.0), np.float32(1.0), np.float32(1.0), np.float32(1.0), np.float32(1.0), np.float32(0.0), np.float32(0.0), np.float32(1.0), np.float32(0.0), np.float32(0.0), np.float32(1.0), np.float32(0.0), np.float32(1.0), np.float32(1.0), np.float32(1.0)]",-3.0,99931.0,1
2025-08-14_08-18-36,1077,"[np.float32(1.0), np.float32(0.0), np.float32(1.0), np.float32(1.0), np.float32(0.0), np.float32(0.0), np.float32(1.0), np.float32(0.0), np.float32(0.0), np.float32(1.0), np.float32(1.0), np.float32(0.0), np.float32(1.0), np.float32(0.0), np.float32(0.0), np.float32(1.0)]",0.0,99931.0,20
2025-08-14_08-18-36,1078,"[np.float32(0.0), np.float32(0.0), np.float32(0.0), np.float32(1.0), np.float32(1.0), np.float32(0.0), np.float32(1.0), np.float32(1.0), np.float32(0.0), np.float32(1.0), np.float32(1.0), np.float32(1.0), np.float32(1.0), np.float32(1.0), np.float32(1.0), np.float32(1.0)]",0.0,99931.0,2
2025-08-14_08-18-36,1079,"[np.float32(1.0), np.float32(1.0), np.float32(0.0), np.float32(0.0), np.float32(1.0), np.float32(0.0), np.float32(0.0), np.float32(0.0), np.float32(0.0), np.float32(0.0), np.float32(0.0), np.float32(1.0), np.float32(1.0), np.float32(1.0), np.float32(0.0), np.float32(0.0)]",1.0,99932.0,9
2025-08-14_08-18-36,1080,"[np.float32(1.0), np.float32(0.0), np.float32(0.0), np.float32(0.0), np.float32(1.0), np.float32(1.0), np.float32(0.0), np.float32(0.0), np.float32(0.0), np.float32(1.0), np.float32(1.0), np.float32(1.0), np.float32(1.0), np.float32(1.0), np.float32(0.0), np.float32(0.0)]",-1.0,99931.0,1
2025-08-14_08-18-36,1081,"[np.float32(1.0), np.float32(0.0), np.float32(1.0), np.float32(1.0), np.float32(0.0), np.float32(1.0), np.float32(0.0), np.float32(0.0), np.float32(1.0), np.float32(1.0), np.float32(0.0), np.float32(1.0), np.float32(0.0), np.float32(1.0), np.float32(1.0), np.float32(0.0)]",-5.0,99926.0,20
2025-08-14_08-18-36,1082,"[np.float32(1.0), np.float32(1.0), np.float32(1.0), np.float32(1.0), np.float32(1.0), np.float32(1.0), np.float32(1.0), np.float32(1.0), np.float32(1.0), np.float32(0.0), np.float32(1.0), np.float32(0.0), np.float32(1.0), np.float32(0.0), np.float32(1.0), np.float32(1.0)]",-1.0,99925.0,1
2025-08-14_08-18-36,1083,"[np.float32(1.0), np.float32(1.0), np.float32(0.0), np.float32(1.0), np.float32(1.0), np.float32(0.0), np.float32(1.0), np.float32(0.0), np.float32(1.0), np.float32(1.0), np.float32(1.0), np.float32(0.0), np.float32(0.0), np.float32(1.0), np.float32(0.0), np.float32(1.0)]",1.0,99926.0,32
2025-08-14_08-18-36,1084,"[np.float32(0.0), np.float32(0.0), np.float32(1.0), np.float32(0.0), np.float32(1.0), np.float32(0.0), np.float32(0.0), np.float32(0.0), np.float32(0.0), np.float32(1.0), np.float32(0.0), np.float32(0.0), np.float32(0.0), np.float32(1.0), np.float32(1.0), np.float32(1.0)]",0.0,99926.0,25
2025-08-14_08-18-36,1085,"[np.float32(1.0), np.float32(0.0), np.float32(0.0), np.float32(1.0), np.float32(0.0), np.float32(1.0), np.float32(1.0), np.float32(1.0), np.float32(1.0), np.float32(1.0), np.float32(1.0), np.float32(1.0), np.float32(0.0), np.float32(0.0), np.float32(0.0), np.float32(1.0)]",-2.0,99924.0,24
2025-08-14_08-18-36,1086,"[np.float32(1.0), np.float32(1.0), np.float32(0.0), np.float32(1.0), np.float32(0.0), np.float32(1.0), np.float32(0.0), np.float32(1.0), np.float32(1.0), np.float32(0.0), np.float32(0.0), np.float32(0.0), np.float32(1.0), np.float32(1.0), np.float32(1.0), np.float32(0.0)]",-7.0,99917.0,6
2025-08-14_08-18-36,1087,"[np.float32(0.0), np.float32(1.0), np.float32(0.0), np.float32(1.0), np.float32(0.0), np.float32(1.0), np.float32(0.0), np.float32(1.0), np.float32(0.0), np.float32(1.0), np.float32(1.0), np.float32(1.0), np.float32(1.0), np.float32(0.0), np.float32(1.0), np.float32(0.0)]",-2.0,99915.0,26
2025-08-14_08-18-36,1088,"[np.float32(0.0), np.float32(0.0), np.float32(1.0), np.float32(1.0), np.float32(1.0), np.float32(1.0), np.float32(0.0), np.float32(0.0), np.float32(0.0), np.float32(0.0), np.float32(0.0), np.float32(0.0), np.float32(0.0), np.float32(1.0), np.float32(0.0), np.float32(0.0)]",2.0,99917.0,0
2025-08-14_08-18-36,1089,"[np.float32(1.0), np.float32(1.0), np.float32(1.0), np.float32(0.0), np.float32(0.0), np.float32(1.0), np.float32(0.0), np.float32(1.0), np.float32(0.0), np.float32(1.0), np.float32(1.0), np.float32(1.0), np.float32(0.0), np.float32(1.0), np.float32(1.0), np.float32(0.0)]",0.0,99917.0,25
2025-08-14_08-18-36,1090,"[np.float32(1.0), np.float32(0.0), np.float32(1.0), np.float32(1.0), np.float32(0.0), np.float32(1.0), np.float32(0.0), np.float32(0.0), np.float32(1.0), np.float32(0.0), np.float32(1.0), np.float32(0.0), np.float32(1.0), np.float32(0.0), np.float32(1.0), np.float32(1.0)]",-4.0,99913.0,2
2025-08-14_08-18-36,1091,"[np.float32(1.0), np.float32(1.0), np.float32(1.0), np.float32(1.0), np.float32(0.0), np.float32(0.0), np.float32(0.0), np.float32(1.0), np.float32(0.0), np.float32(1.0), np.float32(1.0), np.float32(1.0), np.float32(1.0), np.float32(1.0), np.float32(0.0), np.float32(1.0)]",-1.0,99912.0,32
2025-08-14_08-18-36,1092,"[np.float32(1.0), np.float32(0.0), np.float32(0.0), np.float32(1.0), np.float32(1.0), np.float32(0.0), np.float32(1.0), np.float32(0.0), np.float32(0.0), np.float32(0.0), np.float32(1.0), np.float32(1.0), np.float32(0.0), np.float32(1.0), np.float32(1.0), np.float32(0.0)]",-6.0,99906.0,31
2025-08-14_08-18-36,1093,"[np.float32(1.0), np.float32(0.0), np.float32(0.0), np.float32(0.0), np.float32(1.0), np.float32(0.0), np.float32(1.0), np.float32(1.0), np.float32(0.0), np.float32(1.0), np.float32(0.0), np.float32(1.0), np.float32(1.0), np.float32(0.0), np.float32(1.0), np.float32(1.0)]",1.0,99907.0,14
2025-08-14_08-18-36,1094,"[np.float32(1.0), np.float32(1.0), np.float32(1.0), np.float32(0.0), np.float32(0.0), np.float32(0.0), np.float32(1.0), np.float32(1.0), np.float32(0.0), np.float32(0.0), np.float32(0.0), np.float32(1.0), np.float32(1.0), np.float32(0.0), np.float32(0.0), np.float32(1.0)]",-1.0,99906.0,34
2025-08-14_08-18-36,1095,"[np.float32(0.0), np.float32(1.0), np.float32(1.0), np.float32(0.0), np.float32(1.0), np.float32(1.0), np.float32(1.0), np.float32(1.0), np.float32(0.0), np.float32(0.0), np.float32(1.0), np.float32(1.0), np.float32(0.0), np.float32(0.0), np.float32(0.0), np.float32(0.0)]",-2.0,99904.0,0
2025-08-14_08-18-36,1096,"[np.float32(0.0), np.float32(0.0), np.float32(1.0), np.float32(1.0), np.float32(1.0), np.float32(0.0), np.float32(1.0), np.float32(1.0), np.float32(0.0), np.float32(0.0), np.float32(0.0), np.float32(0.0), np.float32(0.0), np.float32(0.0), np.float32(0.0), np.float32(1.0)]",-4.0,99900.0,0
2025-08-14_08-18-36,1097,"[np.float32(1.0), np.float32(0.0), np.float32(0.0), np.float32(0.0), np.float32(1.0), np.float32(0.0), np.float32(1.0), np.float32(0.0), np.float32(0.0), np.float32(0.0), np.float32(1.0), np.float32(1.0), np.float32(1.0), np.float32(0.0), np.float32(0.0), np.float32(1.0)]",4.0,99904.0,6
2025-08-14_08-18-36,1098,"[np.float32(1.0), np.float32(0.0), np.float32(0.0), np.float32(1.0), np.float32(0.0), np.float32(1.0), np.float32(1.0), np.float32(0.0), np.float32(0.0), np.float32(0.0), np.float32(0.0), np.float32(0.0), np.float32(0.0), np.float32(0.0), np.float32(0.0), np.float32(1.0)]",1.0,99905.0,23
2025-08-14_08-18-36,1099,"[np.float32(0.0), np.float32(1.0), np.float32(1.0), np.float32(1.0), np.float32(1.0), np.float32(1.0), np.float32(0.0), np.float32(0.0), np.float32(1.0), np.float32(1.0), np.float32(0.0), np.float32(1.0), np.float32(1.0), np.float32(0.0), np.float32(0.0), np.float32(1.0)]",-3.0,99902.0,14
2025-08-14_08-18-36,1100,"[np.float32(1.0), np.float32(1.0), np.float32(0.0), np.float32(0.0), np.float32(1.0), np.float32(0.0), np.float32(1.0), np.float32(0.0), np.float32(0.0), np.float32(1.0), np.float32(1.0), np.float32(1.0), np.float32(1.0), np.float32(1.0), np.float32(0.0), np.float32(1.0)]",-5.0,99897.0,27
2025-08-14_08-18-36,1101,"[np.float32(0.0), np.float32(0.0), np.float32(1.0), np.float32(0.0), np.float32(0.0), np.float32(0.0), np.float32(1.0), np.float32(1.0), np.float32(0.0), np.float32(0.0), np.float32(1.0), np.float32(0.0), np.float32(0.0), np.float32(1.0), np.float32(0.0), np.float32(1.0)]",-1.0,99896.0,10
2025-08-14_08-18-36,1102,"[np.float32(1.0), np.float32(0.0), np.float32(0.0), np.float32(0.0), np.float32(0.0), np.float32(1.0), np.float32(0.0), np.float32(1.0), np.float32(1.0), np.float32(1.0), np.float32(1.0), np.float32(0.0), np.float32(1.0), np.float32(0.0), np.float32(0.0), np.float32(0.0)]",-4.0,99892.0,2
2025-08-14_08-18-36,1103,"[np.float32(1.0), np.float32(0.0), np.float32(0.0), np.float32(0.0), np.float32(1.0), np.float32(1.0), np.float32(0.0), np.float32(1.0), np.float32(0.0), np.float32(0.0), np.float32(1.0), np.float32(1.0), np.float32(1.0), np.float32(0.0), np.float32(1.0), np.float32(0.0)]",32.0,99924.0,7
2025-08-14_08-18-36,1104,"[np.float32(0.0), np.float32(0.0), np.float32(0.0), np.float32(0.0), np.float32(0.0), np.float32(1.0), np.float32(0.0), np.float32(1.0), np.float32(1.0), np.float32(1.0), np.float32(0.0), np.float32(1.0), np.float32(1.0), np.float32(1.0), np.float32(0.0), np.float32(0.0)]",1.0,99925.0,24
2025-08-14_08-18-36,1105,"[np.float32(1.0), np.float32(0.0), np.float32(1.0), np.float32(1.0), np.float32(0.0), np.float32(1.0), np.float32(0.0), np.float32(1.0), np.float32(0.0), np.float32(1.0), np.float32(1.0), np.float32(0.0), np.float32(1.0), np.float32(1.0), np.float32(0.0), np.float32(1.0)]",-3.0,99922.0,0
2025-08-14_08-18-36,1106,"[np.float32(1.0), np.float32(0.0), np.float32(0.0), np.float32(0.0), np.float32(1.0), np.float32(0.0), np.float32(0.0), np.float32(0.0), np.float32(1.0), np.float32(1.0), np.float32(0.0), np.float32(0.0), np.float32(1.0), np.float32(0.0), np.float32(1.0), np.float32(0.0)]",-2.0,99920.0,18
2025-08-14_08-18-36,1107,"[np.float32(1.0), np.float32(0.0), np.float32(1.0), np.float32(1.0), np.float32(1.0), np.float32(1.0), np.float32(0.0), np.float32(1.0), np.float32(1.0), np.float32(0.0), np.float32(0.0), np.float32(1.0), np.float32(1.0), np.float32(0.0), np.float32(0.0), np.float32(0.0)]",-2.0,99918.0,22
2025-08-14_08-18-36,1108,"[np.float32(1.0), np.float32(1.0), np.float32(1.0), np.float32(1.0), np.float32(0.0), np.float32(1.0), np.float32(1.0), np.float32(0.0), np.float32(0.0), np.float32(0.0), np.float32(0.0), np.float32(1.0), np.float32(1.0), np.float32(1.0), np.float32(1.0), np.float32(1.0)]",-2.0,99916.0,31
2025-08-14_08-18-36,1109,"[np.float32(1.0), np.float32(1.0), np.float32(1.0), np.float32(1.0), np.float32(1.0), np.float32(1.0), np.float32(0.0), np.float32(1.0), np.float32(1.0), np.float32(1.0), np.float32(0.0), np.float32(1.0), np.float32(1.0), np.float32(0.0), np.float32(0.0), np.float32(0.0)]",-2.0,99914.0,10
2025-08-14_08-18-36,1110,"[np.float32(0.0), np.float32(1.0), np.float32(1.0), np.float32(0.0), np.float32(0.0), np.float32(0.0), np.float32(0.0), np.float32(0.0), np.float32(0.0), np.float32(0.0), np.float32(1.0), np.float32(1.0), np.float32(1.0), np.float32(0.0), np.float32(0.0), np.float32(0.0)]",0.0,99914.0,14
2025-08-14_08-18-36,1111,"[np.float32(1.0), np.float32(0.0), np.float32(0.0), np.float32(0.0), np.float32(1.0), np.float32(1.0), np.float32(1.0), np.float32(0.0), np.float32(0.0), np.float32(1.0), np.float32(0.0), np.float32(0.0), np.float32(1.0), np.float32(0.0), np.float32(1.0), np.float32(0.0)]",-2.0,99912.0,24
2025-08-14_08-18-36,1112,"[np.float32(1.0), np.float32(1.0), np.float32(0.0), np.float32(0.0), np.float32(0.0), np.float32(1.0), np.float32(0.0), np.float32(1.0), np.float32(0.0), np.float32(1.0), np.float32(1.0), np.float32(0.0), np.float32(1.0), np.float32(1.0), np.float32(1.0), np.float32(0.0)]",-1.0,99911.0,14
2025-08-14_08-18-36,1113,"[np.float32(1.0), np.float32(0.0), np.float32(1.0), np.float32(1.0), np.float32(1.0), np.float32(1.0), np.float32(0.0), np.float32(0.0), np.float32(0.0), np.float32(1.0), np.float32(0.0), np.float32(0.0), np.float32(0.0), np.float32(1.0), np.float32(1.0), np.float32(1.0)]",1.0,99912.0,4
2025-08-14_08-18-36,1114,"[np.float32(0.0), np.float32(0.0), np.float32(0.0), np.float32(1.0), np.float32(0.0), np.float32(1.0), np.float32(1.0), np.float32(0.0), np.float32(0.0), np.float32(0.0), np.float32(0.0), np.float32(1.0), np.float32(0.0), np.float32(1.0), np.float32(1.0), np.float32(0.0)]",1.0,99913.0,23
2025-08-14_08-18-36,1115,"[np.float32(0.0), np.float32(0.0), np.float32(1.0), np.float32(0.0), np.float32(1.0), np.float32(1.0), np.float32(0.0), np.float32(1.0), np.float32(0.0), np.float32(0.0), np.float32(1.0), np.float32(1.0), np.float32(1.0), np.float32(1.0), np.float32(0.0), np.float32(0.0)]",-4.0,99909.0,34
2025-08-14_08-18-36,1116,"[np.float32(1.0), np.float32(0.0), np.float32(0.0), np.float32(1.0), np.float32(1.0), np.float32(0.0), np.float32(1.0), np.float32(1.0), np.float32(0.0), np.float32(0.0), np.float32(1.0), np.float32(1.0), np.float32(0.0), np.float32(0.0), np.float32(0.0), np.float32(1.0)]",2.0,99911.0,18
2025-08-14_08-18-36,1117,"[np.float32(1.0), np.float32(0.0), np.float32(0.0), np.float32(1.0), np.float32(1.0), np.float32(1.0), np.float32(0.0), np.float32(0.0), np.float32(1.0), np.float32(0.0), np.float32(0.0), np.float32(1.0), np.float32(0.0), np.float32(1.0), np.float32(0.0), np.float32(1.0)]",2.0,99913.0,29
2025-08-14_08-18-36,1118,"[np.float32(1.0), np.float32(0.0), np.float32(1.0), np.float32(0.0), np.float32(0.0), np.float32(0.0), np.float32(0.0), np.float32(0.0), np.float32(0.0), np.float32(0.0), np.float32(0.0), np.float32(1.0), np.float32(0.0), np.float32(1.0), np.float32(0.0), np.float32(0.0)]",-2.0,99911.0,8
2025-08-14_08-18-36,1119,"[np.float32(0.0), np.float32(0.0), np.float32(1.0), np.float32(1.0), np.float32(0.0), np.float32(1.0), np.float32(1.0), np.float32(0.0), np.float32(1.0), np.float32(0.0), np.float32(0.0), np.float32(1.0), np.float32(1.0), np.float32(1.0), np.float32(0.0), np.float32(1.0)]",1.0,99912.0,31
2025-08-14_08-18-36,1120,"[np.float32(0.0), np.float32(0.0), np.float32(1.0), np.float32(0.0), np.float32(0.0), np.float32(1.0), np.float32(1.0), np.float32(0.0), np.float32(0.0), np.float32(0.0), np.float32(1.0), np.float32(0.0), np.float32(0.0), np.float32(0.0), np.float32(0.0), np.float32(0.0)]",-4.0,99908.0,13
2025-08-14_08-18-36,1121,"[np.float32(0.0), np.float32(0.0), np.float32(1.0), np.float32(1.0), np.float32(0.0), np.float32(0.0), np.float32(1.0), np.float32(1.0), np.float32(0.0), np.float32(1.0), np.float32(0.0), np.float32(0.0), np.float32(0.0), np.float32(1.0), np.float32(1.0), np.float32(0.0)]",1.0,99909.0,24
2025-08-14_08-18-36,1122,"[np.float32(1.0), np.float32(1.0), np.float32(0.0), np.float32(0.0), np.float32(1.0), np.float32(0.0), np.float32(1.0), np.float32(0.0), np.float32(1.0), np.float32(0.0), np.float32(0.0), np.float32(0.0), np.float32(0.0), np.float32(1.0), np.float32(0.0), np.float32(0.0)]",-1.0,99908.0,21
2025-08-14_08-18-36,1123,"[np.float32(1.0), np.float32(1.0), np.float32(0.0), np.float32(1.0), np.float32(1.0), np.float32(0.0), np.float32(1.0), np.float32(0.0), np.float32(0.0), np.float32(1.0), np.float32(1.0), np.float32(0.0), np.float32(0.0), np.float32(1.0), np.float32(1.0), np.float32(0.0)]",-2.0,99906.0,31
2025-08-14_08-18-36,1124,"[np.float32(0.0), np.float32(1.0), np.float32(0.0), np.float32(1.0), np.float32(0.0), np.float32(0.0), np.float32(0.0), np.float32(1.0), np.float32(1.0), np.float32(0.0), np.float32(1.0), np.float32(0.0), np.float32(0.0), np.float32(1.0), np.float32(1.0), np.float32(1.0)]",0.0,99906.0,28
2025-08-14_08-18-36,1125,"[np.float32(0.0), np.float32(0.0), np.float32(0.0), np.float32(0.0), np.float32(1.0), np.float32(0.0), np.float32(1.0), np.float32(1.0), np.float32(1.0), np.float32(1.0), np.float32(1.0), np.float32(0.0), np.float32(1.0), np.float32(1.0), np.float32(1.0), np.float32(1.0)]",-1.0,99905.0,35
2025-08-14_08-18-36,1126,"[np.float32(0.0), np.float32(0.0), np.float32(0.0), np.float32(1.0), np.float32(0.0), np.float32(0.0), np.float32(0.0), np.float32(0.0), np.float32(1.0), np.float32(0.0), np.float32(1.0), np.float32(0.0), np.float32(1.0), np.float32(0.0), np.float32(1.0), np.float32(0.0)]",0.0,99905.0,31
2025-08-14_08-18-36,1127,"[np.float32(1.0), np.float32(1.0), np.float32(1.0), np.float32(1.0), np.float32(0.0), np.float32(1.0), np.float32(1.0), np.float32(1.0), np.float32(0.0), np.float32(0.0), np.float32(0.0), np.float32(0.0), np.float32(1.0), np.float32(1.0), np.float32(0.0), np.float32(0.0)]",1.0,99906.0,2
2025-08-14_08-18-36,1128,"[np.float32(0.0), np.float32(1.0), np.float32(1.0), np.float32(1.0), np.float32(0.0), np.float32(1.0), np.float32(1.0), np.float32(1.0), np.float32(1.0), np.float32(1.0), np.float32(1.0), np.float32(1.0), np.float32(1.0), np.float32(0.0), np.float32(1.0), np.float32(0.0)]",-2.0,99904.0,2
2025-08-14_08-18-36,1129,"[np.float32(0.0), np.float32(0.0), np.float32(1.0), np.float32(0.0), np.float32(0.0), np.float32(1.0), np.float32(1.0), np.float32(0.0), np.float32(1.0), np.float32(1.0), np.float32(0.0), np.float32(0.0), np.float32(0.0), np.float32(1.0), np.float32(1.0), np.float32(1.0)]",5.0,99909.0,34
2025-08-14_08-18-36,1130,"[np.float32(1.0), np.float32(0.0), np.float32(1.0), np.float32(1.0), np.float32(0.0), np.float32(0.0), np.float32(1.0), np.float32(0.0), np.float32(0.0), np.float32(1.0), np.float32(1.0), np.float32(1.0), np.float32(1.0), np.float32(0.0), np.float32(0.0), np.float32(0.0)]",0.0,99909.0,11
2025-08-14_08-18-36,1131,"[np.float32(0.0), np.float32(0.0), np.float32(1.0), np.float32(0.0), np.float32(0.0), np.float32(1.0), np.float32(0.0), np.float32(0.0), np.float32(0.0), np.float32(0.0), np.float32(0.0), np.float32(1.0), np.float32(1.0), np.float32(0.0), np.float32(0.0), np.float32(0.0)]",0.0,99909.0,22
2025-08-14_08-18-36,1132,"[np.float32(0.0), np.float32(1.0), np.float32(0.0), np.float32(1.0), np.float32(0.0), np.float32(1.0), np.float32(1.0), np.float32(0.0), np.float32(0.0), np.float32(1.0), np.float32(1.0), np.float32(1.0), np.float32(1.0), np.float32(0.0), np.float32(1.0), np.float32(0.0)]",-1.0,99908.0,2
2025-08-14_08-18-36,1133,"[np.float32(0.0), np.float32(0.0), np.float32(0.0), np.float32(1.0), np.float32(1.0), np.float32(1.0), np.float32(0.0), np.float32(1.0), np.float32(0.0), np.float32(1.0), np.float32(0.0), np.float32(0.0), np.float32(1.0), np.float32(0.0), np.float32(0.0), np.float32(0.0)]",37.0,99945.0,7
2025-08-14_08-18-36,1134,"[np.float32(0.0), np.float32(1.0), np.float32(0.0), np.float32(1.0), np.float32(1.0), np.float32(1.0), np.float32(1.0), np.float32(0.0), np.float32(1.0), np.float32(1.0), np.float32(1.0), np.float32(1.0), np.float32(0.0), np.float32(0.0), np.float32(0.0), np.float32(1.0)]",-5.0,99940.0,18
2025-08-14_08-18-36,1135,"[np.float32(0.0), np.float32(0.0), np.float32(0.0), np.float32(1.0), np.float32(0.0), np.float32(0.0), np.float32(0.0), np.float32(0.0), np.float32(0.0), np.float32(1.0), np.float32(0.0), np.float32(0.0), np.float32(0.0), np.float32(0.0), np.float32(0.0), np.float32(0.0)]",1.0,99941.0,22
2025-08-14_08-18-36,1136,"[np.float32(1.0), np.float32(1.0), np.float32(0.0), np.float32(0.0), np.float32(0.0), np.float32(0.0), np.float32(1.0), np.float32(0.0), np.float32(0.0), np.float32(0.0), np.float32(1.0), np.float32(1.0), np.float32(0.0), np.float32(0.0), np.float32(0.0), np.float32(0.0)]",-3.0,99938.0,0
2025-08-14_08-18-36,1137,"[np.float32(0.0), np.float32(0.0), np.float32(0.0), np.float32(0.0), np.float32(0.0), np.float32(0.0), np.float32(1.0), np.float32(0.0), np.float32(0.0), np.float32(1.0), np.float32(1.0), np.float32(1.0), np.float32(1.0), np.float32(0.0), np.float32(0.0), np.float32(0.0)]",-2.0,99936.0,25
2025-08-14_08-18-36,1138,"[np.float32(1.0), np.float32(1.0), np.float32(0.0), np.float32(1.0), np.float32(1.0), np.float32(1.0), np.float32(0.0), np.float32(1.0), np.float32(0.0), np.float32(1.0), np.float32(0.0), np.float32(1.0), np.float32(1.0), np.float32(0.0), np.float32(1.0), np.float32(1.0)]",1.0,99937.0,1
2025-08-14_08-18-36,1139,"[np.float32(1.0), np.float32(0.0), np.float32(1.0), np.float32(1.0), np.float32(0.0), np.float32(1.0), np.float32(0.0), np.float32(0.0), np.float32(0.0), np.float32(1.0), np.float32(1.0), np.float32(1.0), np.float32(1.0), np.float32(1.0), np.float32(1.0), np.float32(0.0)]",2.0,99939.0,25
2025-08-14_08-18-36,1140,"[np.float32(0.0), np.float32(0.0), np.float32(0.0), np.float32(1.0), np.float32(0.0), np.float32(1.0), np.float32(0.0), np.float32(0.0), np.float32(1.0), np.float32(0.0), np.float32(1.0), np.float32(1.0), np.float32(1.0), np.float32(0.0), np.float32(1.0), np.float32(1.0)]",0.0,99939.0,24
2025-08-14_08-18-36,1141,"[np.float32(1.0), np.float32(1.0), np.float32(0.0), np.float32(1.0), np.float32(1.0), np.float32(0.0), np.float32(0.0), np.float32(1.0), np.float32(1.0), np.float32(0.0), np.float32(0.0), np.float32(1.0), np.float32(0.0), np.float32(1.0), np.float32(1.0), np.float32(0.0)]",4.0,99943.0,21
2025-08-14_08-18-36,1142,"[np.float32(0.0), np.float32(1.0), np.float32(1.0), np.float32(0.0), np.float32(0.0), np.float32(1.0), np.float32(1.0), np.float32(1.0), np.float32(0.0), np.float32(0.0), np.float32(0.0), np.float32(1.0), np.float32(1.0), np.float32(0.0), np.float32(1.0), np.float32(0.0)]",-4.0,99939.0,31
2025-08-14_08-18-36,1143,"[np.float32(0.0), np.float32(0.0), np.float32(1.0), np.float32(1.0), np.float32(1.0), np.float32(0.0), np.float32(1.0), np.float32(0.0), np.float32(1.0), np.float32(1.0), np.float32(0.0), np.float32(1.0), np.float32(1.0), np.float32(1.0), np.float32(1.0), np.float32(0.0)]",0.0,99939.0,2
2025-08-14_08-18-36,1144,"[np.float32(0.0), np.float32(1.0), np.float32(0.0), np.float32(1.0), np.float32(0.0), np.float32(1.0), np.float32(0.0), np.float32(1.0), np.float32(1.0), np.float32(0.0), np.float32(0.0), np.float32(1.0), np.float32(0.0), np.float32(1.0), np.float32(1.0), np.float32(0.0)]",5.0,99944.0,27
2025-08-14_08-18-36,1145,"[np.float32(0.0), np.float32(0.0), np.float32(0.0), np.float32(1.0), np.float32(1.0), np.float32(0.0), np.float32(0.0), np.float32(0.0), np.float32(1.0), np.float32(0.0), np.float32(0.0), np.float32(0.0), np.float32(0.0), np.float32(0.0), np.float32(0.0), np.float32(0.0)]",0.0,99944.0,30
2025-08-14_08-18-36,1146,"[np.float32(1.0), np.float32(1.0), np.float32(1.0), np.float32(1.0), np.float32(0.0), np.float32(0.0), np.float32(0.0), np.float32(0.0), np.float32(1.0), np.float32(1.0), np.float32(0.0), np.float32(0.0), np.float32(0.0), np.float32(1.0), np.float32(1.0), np.float32(0.0)]",2.0,99946.0,29
2025-08-14_08-18-36,1147,"[np.float32(0.0), np.float32(0.0), np.float32(0.0), np.float32(1.0), np.float32(0.0), np.float32(1.0), np.float32(0.0), np.float32(0.0), np.float32(1.0), np.float32(1.0), np.float32(1.0), np.float32(1.0), np.float32(0.0), np.float32(0.0), np.float32(1.0), np.float32(1.0)]",-2.0,99944.0,16
2025-08-14_08-18-36,1148,"[np.float32(0.0), np.float32(0.0), np.float32(0.0), np.float32(0.0), np.float32(1.0), np.float32(1.0), np.float32(0.0), np.float32(1.0), np.float32(0.0), np.float32(0.0), np.float32(1.0), np.float32(1.0), np.float32(0.0), np.float32(1.0), np.float32(0.0), np.float32(0.0)]",2.0,99946.0,24
2025-08-14_08-18-36,1149,"[np.float32(1.0), np.float32(0.0), np.float32(0.0), np.float32(1.0), np.float32(1.0), np.float32(0.0), np.float32(0.0), np.float32(0.0), np.float32(0.0), np.float32(0.0), np.float32(0.0), np.float32(1.0), np.float32(1.0), np.float32(0.0), np.float32(1.0), np.float32(1.0)]",2.0,99948.0,1
2025-08-14_08-18-36,1150,"[np.float32(1.0), np.float32(0.0), np.float32(1.0), np.float32(1.0), np.float32(0.0), np.float32(1.0), np.float32(1.0), np.float32(0.0), np.float32(0.0), np.float32(1.0), np.float32(1.0), np.float32(0.0), np.float32(0.0), np.float32(0.0), np.float32(0.0), np.float32(0.0)]",2.0,99950.0,34
2025-08-14_08-18-36,1151,"[np.float32(0.0), np.float32(1.0), np.float32(1.0), np.float32(1.0), np.float32(0.0), np.float32(0.0), np.float32(0.0), np.float32(1.0), np.float32(1.0), np.float32(0.0), np.float32(1.0), np.float32(1.0), np.float32(1.0), np.float32(1.0), np.float32(1.0), np.float32(0.0)]",1.0,99951.0,32
2025-08-14_08-18-36,1152,"[np.float32(1.0), np.float32(1.0), np.float32(0.0), np.float32(1.0), np.float32(1.0), np.float32(1.0), np.float32(0.0), np.float32(1.0), np.float32(0.0), np.float32(1.0), np.float32(0.0), np.float32(1.0), np.float32(1.0), np.float32(0.0), np.float32(0.0), np.float32(0.0)]",36.0,99987.0,7
2025-08-14_08-18-36,1153,"[np.float32(0.0), np.float32(1.0), np.float32(1.0), np.float32(1.0), np.float32(0.0), np.float32(1.0), np.float32(1.0), np.float32(0.0), np.float32(1.0), np.float32(1.0), np.float32(0.0), np.float32(1.0), np.float32(0.0), np.float32(1.0), np.float32(0.0), np.float32(0.0)]",3.0,99990.0,35
2025-08-14_08-18-36,1154,"[np.float32(0.0), np.float32(1.0), np.float32(1.0), np.float32(0.0), np.float32(0.0), np.float32(0.0), np.float32(0.0), np.float32(0.0), np.float32(1.0), np.float32(1.0), np.float32(0.0), np.float32(0.0), np.float32(1.0), np.float32(1.0), np.float32(0.0), np.float32(0.0)]",3.0,99993.0,25
2025-08-14_08-18-36,1155,"[np.float32(0.0), np.float32(0.0), np.float32(0.0), np.float32(0.0), np.float32(1.0), np.float32(1.0), np.float32(0.0), np.float32(0.0), np.float32(1.0), np.float32(0.0), np.float32(0.0), np.float32(0.0), np.float32(0.0), np.float32(0.0), np.float32(1.0), np.float32(0.0)]",1.0,99994.0,31
2025-08-14_08-18-36,1156,"[np.float32(1.0), np.float32(0.0), np.float32(1.0), np.float32(0.0), np.float32(0.0), np.float32(1.0), np.float32(0.0), np.float32(0.0), np.float32(0.0), np.float32(0.0), np.float32(1.0), np.float32(1.0), np.float32(0.0), np.float32(1.0), np.float32(0.0), np.float32(0.0)]",-4.0,99990.0,31
2025-08-14_08-18-36,1157,"[np.float32(1.0), np.float32(0.0), np.float32(0.0), np.float32(0.0), np.float32(0.0), np.float32(1.0), np.float32(0.0), np.float32(1.0), np.float32(0.0), np.float32(1.0), np.float32(0.0), np.float32(0.0), np.float32(0.0), np.float32(1.0), np.float32(1.0), np.float32(0.0)]",-3.0,99987.0,8
2025-08-14_08-18-36,1158,"[np.float32(0.0), np.float32(0.0), np.float32(1.0), np.float32(1.0), np.float32(0.0), np.float32(0.0), np.float32(1.0), np.float32(1.0), np.float32(0.0), np.float32(0.0), np.float32(1.0), np.float32(0.0), np.float32(0.0), np.float32(0.0), np.float32(0.0), np.float32(1.0)]",-1.0,99986.0,18
2025-08-14_08-18-36,1159,"[np.float32(0.0), np.float32(1.0), np.float32(1.0), np.float32(0.0), np.float32(1.0), np.float32(1.0), np.float32(1.0), np.float32(1.0), np.float32(0.0), np.float32(0.0), np.float32(1.0), np.float32(0.0), np.float32(1.0), np.float32(0.0), np.float32(1.0), np.float32(0.0)]",-2.0,99984.0,15
2025-08-14_08-18-36,1160,"[np.float32(0.0), np.float32(0.0), np.float32(0.0), np.float32(0.0), np.float32(0.0), np.float32(1.0), np.float32(0.0), np.float32(1.0), np.float32(1.0), np.float32(1.0), np.float32(0.0), np.float32(1.0), np.float32(1.0), np.float32(0.0), np.float32(0.0), np.float32(1.0)]",1.0,99985.0,22
2025-08-14_08-18-36,1161,"[np.float32(1.0), np.float32(0.0), np.float32(0.0), np.float32(0.0), np.float32(0.0), np.float32(1.0), np.float32(0.0), np.float32(0.0), np.float32(1.0), np.float32(1.0), np.float32(0.0), np.float32(0.0), np.float32(1.0), np.float32(1.0), np.float32(0.0), np.float32(1.0)]",-4.0,99981.0,2
2025-08-14_08-18-36,1162,"[np.float32(1.0), np.float32(1.0), np.float32(0.0), np.float32(1.0), np.float32(0.0), np.float32(1.0), np.float32(0.0), np.float32(1.0), np.float32(0.0), np.float32(1.0), np.float32(1.0), np.float32(1.0), np.float32(0.0), np.float32(1.0), np.float32(1.0), np.float32(1.0)]",2.0,99983.0,20
2025-08-14_08-18-36,1163,"[np.float32(1.0), np.float32(0.0), np.float32(0.0), np.float32(0.0), np.float32(0.0), np.float32(1.0), np.float32(0.0), np.float32(1.0), np.float32(0.0), np.float32(0.0), np.float32(0.0), np.float32(1.0), np.float32(1.0), np.float32(0.0), np.float32(0.0), np.float32(0.0)]",5.0,99988.0,21
2025-08-14_08-18-36,1164,"[np.float32(0.0), np.float32(0.0), np.float32(1.0), np.float32(0.0), np.float32(0.0), np.float32(0.0), np.float32(1.0), np.float32(1.0), np.float32(0.0), np.float32(1.0), np.float32(0.0), np.float32(1.0), np.float32(0.0), np.float32(0.0), np.float32(0.0), np.float32(1.0)]",-6.0,99982.0,35
2025-08-14_08-18-36,1165,"[np.float32(0.0), np.float32(0.0), np.float32(1.0), np.float32(1.0), np.float32(0.0), np.float32(1.0), np.float32(0.0), np.float32(0.0), np.float32(1.0), np.float32(0.0), np.float32(0.0), np.float32(1.0), np.float32(1.0), np.float32(0.0), np.float32(1.0), np.float32(1.0)]",-3.0,99979.0,11
2025-08-14_08-18-36,1166,"[np.float32(0.0), np.float32(0.0), np.float32(1.0), np.float32(1.0), np.float32(0.0), np.float32(0.0), np.float32(1.0), np.float32(1.0), np.float32(1.0), np.float32(0.0), np.float32(0.0), np.float32(0.0), np.float32(0.0), np.float32(0.0), np.float32(1.0), np.float32(0.0)]",2.0,99981.0,8
2025-08-14_08-18-36,1167,"[np.float32(0.0), np.float32(0.0), np.float32(0.0), np.float32(1.0), np.float32(1.0), np.float32(1.0), np.float32(1.0), np.float32(1.0), np.float32(0.0), np.float32(1.0), np.float32(0.0), np.float32(1.0), np.float32(0.0), np.float32(1.0), np.float32(0.0), np.float32(1.0)]",-4.0,99977.0,32
2025-08-14_08-18-36,1168,"[np.float32(0.0), np.float32(1.0), np.float32(0.0), np.float32(0.0), np.float32(0.0), np.float32(1.0), np.float32(0.0), np.float32(1.0), np.float32(0.0), np.float32(0.0), np.float32(0.0), np.float32(0.0), np.float32(1.0), np.float32(0.0), np.float32(1.0), np.float32(1.0)]",-2.0,99975.0,28
2025-08-14_08-18-36,1169,"[np.float32(1.0), np.float32(0.0), np.float32(0.0), np.float32(1.0), np.float32(0.0), np.float32(0.0), np.float32(0.0), np.float32(1.0), np.float32(0.0), np.float32(1.0), np.float32(1.0), np.float32(0.0), np.float32(0.0), np.float32(1.0), np.float32(0.0), np.float32(0.0)]",3.0,99978.0,22
2025-08-14_08-18-36,1170,"[np.float32(0.0), np.float32(0.0), np.float32(0.0), np.float32(1.0), np.float32(0.0), np.float32(0.0), np.float32(0.0), np.float32(1.0), np.float32(0.0), np.float32(1.0), np.float32(0.0), np.float32(1.0), np.float32(1.0), np.float32(0.0), np.float32(1.0), np.float32(0.0)]",-3.0,99975.0,28
2025-08-14_08-18-36,1171,"[np.float32(0.0), np.float32(1.0), np.float32(0.0), np.float32(0.0), np.float32(1.0), np.float32(0.0), np.float32(0.0), np.float32(1.0), np.float32(0.0), np.float32(0.0), np.float32(0.0), np.float32(0.0), np.float32(1.0), np.float32(1.0), np.float32(0.0), np.float32(0.0)]",-2.0,99973.0,32
2025-08-14_08-18-36,1172,"[np.float32(1.0), np.float32(1.0), np.float32(0.0), np.float32(1.0), np.float32(1.0), np.float32(1.0), np.float32(0.0), np.float32(1.0), np.float32(1.0), np.float32(1.0), np.float32(1.0), np.float32(0.0), np.float32(1.0), np.float32(0.0), np.float32(1.0), np.float32(1.0)]",-5.0,99968.0,18
2025-08-14_08-18-36,1173,"[np.float32(0.0), np.float32(0.0), np.float32(0.0), np.float32(1.0), np.float32(1.0), np.float32(1.0), np.float32(1.0), np.float32(0.0), np.float32(1.0), np.float32(1.0), np.float32(1.0), np.float32(1.0), np.float32(1.0), np.float32(1.0), np.float32(0.0), np.float32(1.0)]",-1.0,99967.0,21
2025-08-14_08-18-36,1174,"[np.float32(1.0), np.float32(0.0), np.float32(1.0), np.float32(0.0), np.float32(1.0), np.float32(1.0), np.float32(1.0), np.float32(1.0), np.float32(1.0), np.float32(1.0), np.float32(0.0), np.float32(1.0), np.float32(1.0), np.float32(0.0), np.float32(0.0), np.float32(0.0)]",2.0,99969.0,16
2025-08-14_08-18-36,1175,"[np.float32(1.0), np.float32(0.0), np.float32(0.0), np.float32(1.0), np.float32(0.0), np.float32(0.0), np.float32(1.0), np.float32(1.0), np.float32(1.0), np.float32(0.0), np.float32(1.0), np.float32(0.0), np.float32(1.0), np.float32(1.0), np.float32(1.0), np.float32(1.0)]",-4.0,99965.0,10
2025-08-14_08-18-36,1176,"[np.float32(0.0), np.float32(0.0), np.float32(1.0), np.float32(1.0), np.float32(1.0), np.float32(0.0), np.float32(0.0), np.float32(1.0), np.float32(0.0), np.float32(0.0), np.float32(0.0), np.float32(1.0), np.float32(1.0), np.float32(0.0), np.float32(1.0), np.float32(1.0)]",-1.0,99964.0,8
2025-08-14_08-18-36,1177,"[np.float32(1.0), np.float32(0.0), np.float32(1.0), np.float32(0.0), np.float32(0.0), np.float32(0.0), np.float32(0.0), np.float32(1.0), np.float32(0.0), np.float32(1.0), np.float32(1.0), np.float32(1.0), np.float32(0.0), np.float32(1.0), np.float32(1.0), np.float32(1.0)]",2.0,99966.0,19
2025-08-14_08-18-36,1178,"[np.float32(1.0), np.float32(1.0), np.float32(1.0), np.float32(0.0), np.float32(0.0), np.float32(1.0), np.float32(0.0), np.float32(1.0), np.float32(0.0), np.float32(0.0), np.float32(1.0), np.float32(1.0), np.float32(0.0), np.float32(0.0), np.float32(1.0), np.float32(0.0)]",-1.0,99965.0,2
2025-08-14_08-18-36,1179,"[np.float32(0.0), np.float32(1.0), np.float32(0.0), np.float32(0.0), np.float32(0.0), np.float32(0.0), np.float32(0.0), np.float32(0.0), np.float32(1.0), np.float32(0.0), np.float32(1.0), np.float32(1.0), np.float32(1.0), np.float32(1.0), np.float32(0.0), np.float32(0.0)]",0.0,99965.0,3
2025-08-14_08-18-36,1180,"[np.float32(1.0), np.float32(0.0), np.float32(1.0), np.float32(1.0), np.float32(0.0), np.float32(1.0), np.float32(0.0), np.float32(0.0), np.float32(0.0), np.float32(1.0), np.float32(1.0), np.float32(1.0), np.float32(0.0), np.float32(1.0), np.float32(0.0), np.float32(0.0)]",-1.0,99964.0,31
2025-08-14_08-18-36,1181,"[np.float32(0.0), np.float32(0.0), np.float32(1.0), np.float32(1.0), np.float32(0.0), np.float32(0.0), np.float32(0.0), np.float32(0.0), np.float32(0.0), np.float32(0.0), np.float32(1.0), np.float32(1.0), np.float32(0.0), np.float32(0.0), np.float32(0.0), np.float32(0.0)]",1.0,99965.0,21
2025-08-14_08-18-36,1182,"[np.float32(1.0), np.float32(0.0), np.float32(0.0), np.float32(0.0), np.float32(0.0), np.float32(0.0), np.float32(0.0), np.float32(0.0), np.float32(0.0), np.float32(0.0), np.float32(1.0), np.float32(0.0), np.float32(0.0), np.float32(0.0), np.float32(0.0), np.float32(0.0)]",0.0,99965.0,3
2025-08-14_08-18-36,1183,"[np.float32(1.0), np.float32(1.0), np.float32(1.0), np.float32(1.0), np.float32(0.0), np.float32(1.0), np.float32(1.0), np.float32(0.0), np.float32(1.0), np.float32(1.0), np.float32(1.0), np.float32(0.0), np.float32(1.0), np.float32(1.0), np.float32(0.0), np.float32(1.0)]",3.0,99968.0,35
2025-08-14_08-18-36,1184,"[np.float32(0.0), np.float32(1.0), np.float32(1.0), np.float32(1.0), np.float32(0.0), np.float32(1.0), np.float32(0.0), np.float32(1.0), np.float32(1.0), np.float32(1.0), np.float32(0.0), np.float32(0.0), np.float32(1.0), np.float32(0.0), np.float32(1.0), np.float32(1.0)]",-3.0,99965.0,8
2025-08-14_08-18-36,1185,"[np.float32(1.0), np.float32(1.0), np.float32(0.0), np.float32(1.0), np.float32(0.0), np.float32(1.0), np.float32(1.0), np.float32(0.0), np.float32(1.0), np.float32(0.0), np.float32(0.0), np.float32(1.0), np.float32(1.0), np.float32(1.0), np.float32(0.0), np.float32(0.0)]",-1.0,99964.0,2
2025-08-14_08-18-36,1186,"[np.float32(0.0), np.float32(1.0), np.float32(0.0), np.float32(1.0), np.float32(0.0), np.float32(0.0), np.float32(1.0), np.float32(1.0), np.float32(0.0), np.float32(0.0), np.float32(1.0), np.float32(0.0), np.float32(1.0), np.float32(0.0), np.float32(0.0), np.float32(1.0)]",-3.0,99961.0,33
2025-08-14_08-18-36,1187,"[np.float32(0.0), np.float32(1.0), np.float32(1.0), np.float32(1.0), np.float32(0.0), np.float32(1.0), np.float32(0.0), np.float32(0.0), np.float32(1.0), np.float32(1.0), np.float32(1.0), np.float32(0.0), np.float32(1.0), np.float32(0.0), np.float32(1.0), np.float32(1.0)]",-3.0,99958.0,6
2025-08-14_08-18-36,1188,"[np.float32(0.0), np.float32(1.0), np.float32(1.0), np.float32(0.0), np.float32(1.0), np.float32(1.0), np.float32(1.0), np.float32(1.0), np.float32(0.0), np.float32(0.0), np.float32(0.0), np.float32(0.0), np.float32(0.0), np.float32(1.0), np.float32(0.0), np.float32(1.0)]",4.0,99962.0,4
2025-08-14_08-18-36,1189,"[np.float32(0.0), np.float32(0.0), np.float32(1.0), np.float32(0.0), np.float32(1.0), np.float32(0.0), np.float32(0.0), np.float32(1.0), np.float32(0.0), np.float32(0.0), np.float32(0.0), np.float32(0.0), np.float32(1.0), np.float32(1.0), np.float32(1.0), np.float32(0.0)]",-3.0,99959.0,27
2025-08-14_08-18-36,1190,"[np.float32(0.0), np.float32(0.0), np.float32(0.0), np.float32(1.0), np.float32(0.0), np.float32(0.0), np.float32(0.0), np.float32(0.0), np.float32(0.0), np.float32(0.0), np.float32(0.0), np.float32(1.0), np.float32(1.0), np.float32(1.0), np.float32(1.0), np.float32(1.0)]",-3.0,99956.0,0
2025-08-14_08-18-36,1191,"[np.float32(1.0), np.float32(0.0), np.float32(1.0), np.float32(1.0), np.float32(0.0), np.float32(1.0), np.float32(1.0), np.float32(1.0), np.float32(0.0), np.float32(1.0), np.float32(0.0), np.float32(1.0), np.float32(1.0), np.float32(0.0), np.float32(0.0), np.float32(0.0)]",-1.0,99955.0,4
2025-08-14_08-18-36,1192,"[np.float32(1.0), np.float32(0.0), np.float32(1.0), np.float32(0.0), np.float32(0.0), np.float32(1.0), np.float32(1.0), np.float32(1.0), np.float32(1.0), np.float32(0.0), np.float32(1.0), np.float32(1.0), np.float32(0.0), np.float32(1.0), np.float32(0.0), np.float32(0.0)]",2.0,99957.0,35
2025-08-14_08-18-36,1193,"[np.float32(1.0), np.float32(0.0), np.float32(0.0), np.float32(1.0), np.float32(0.0), np.float32(0.0), np.float32(1.0), np.float32(1.0), np.float32(0.0), np.float32(0.0), np.float32(1.0), np.float32(1.0), np.float32(0.0), np.float32(0.0), np.float32(0.0), np.float32(1.0)]",3.0,99960.0,23
2025-08-14_08-18-36,1194,"[np.float32(1.0), np.float32(0.0), np.float32(0.0), np.float32(1.0), np.float32(1.0), np.float32(1.0), np.float32(1.0), np.float32(1.0), np.float32(1.0), np.float32(1.0), np.float32(1.0), np.float32(1.0), np.float32(1.0), np.float32(0.0), np.float32(0.0), np.float32(1.0)]",-4.0,99956.0,8
2025-08-14_08-18-36,1195,"[np.float32(0.0), np.float32(1.0), np.float32(0.0), np.float32(1.0), np.float32(1.0), np.float32(1.0), np.float32(1.0), np.float32(0.0), np.float32(1.0), np.float32(1.0), np.float32(1.0), np.float32(1.0), np.float32(1.0), np.float32(1.0), np.float32(0.0), np.float32(0.0)]",-3.0,99953.0,30
2025-08-14_08-18-36,1196,"[np.float32(0.0), np.float32(1.0), np.float32(1.0), np.float32(1.0), np.float32(1.0), np.float32(1.0), np.float32(1.0), np.float32(0.0), np.float32(1.0), np.float32(0.0), np.float32(0.0), np.float32(0.0), np.float32(1.0), np.float32(0.0), np.float32(1.0), np.float32(0.0)]",-3.0,99950.0,15
2025-08-14_08-18-36,1197,"[np.float32(0.0), np.float32(1.0), np.float32(1.0), np.float32(1.0), np.float32(0.0), np.float32(1.0), np.float32(1.0), np.float32(1.0), np.float32(0.0), np.float32(0.0), np.float32(0.0), np.float32(0.0), np.float32(1.0), np.float32(0.0), np.float32(1.0), np.float32(1.0)]",-4.0,99946.0,12
2025-08-14_08-18-36,1198,"[np.float32(1.0), np.float32(1.0), np.float32(0.0), np.float32(0.0), np.float32(0.0), np.float32(1.0), np.float32(0.0), np.float32(0.0), np.float32(0.0), np.float32(0.0), np.float32(0.0), np.float32(0.0), np.float32(1.0), np.float32(0.0), np.float32(0.0), np.float32(0.0)]",-2.0,99944.0,9
2025-08-14_08-18-36,1199,"[np.float32(0.0), np.float32(0.0), np.float32(1.0), np.float32(1.0), np.float32(0.0), np.float32(0.0), np.float32(0.0), np.float32(0.0), np.float32(0.0), np.float32(0.0), np.float32(0.0), np.float32(1.0), np.float32(0.0), np.float32(0.0), np.float32(1.0), np.float32(0.0)]",1.0,99945.0,5
2025-08-14_08-18-36,1200,"[np.float32(0.0), np.float32(0.0), np.float32(0.0), np.float32(1.0), np.float32(1.0), np.float32(0.0), np.float32(1.0), np.float32(1.0), np.float32(0.0), np.float32(1.0), np.float32(0.0), np.float32(1.0), np.float32(0.0), np.float32(0.0), np.float32(1.0), np.float32(0.0)]",1.0,99946.0,8
2025-08-14_08-18-36,1201,"[np.float32(1.0), np.float32(0.0), np.float32(1.0), np.float32(0.0), np.float32(0.0), np.float32(1.0), np.float32(0.0), np.float32(1.0), np.float32(0.0), np.float32(0.0), np.float32(0.0), np.float32(1.0), np.float32(0.0), np.float32(0.0), np.float32(1.0), np.float32(0.0)]",0.0,99946.0,34
2025-08-14_08-18-36,1202,"[np.float32(0.0), np.float32(0.0), np.float32(0.0), np.float32(1.0), np.float32(1.0), np.float32(0.0), np.float32(1.0), np.float32(1.0), np.float32(0.0), np.float32(1.0), np.float32(0.0), np.float32(0.0), np.float32(0.0), np.float32(0.0), np.float32(0.0), np.float32(0.0)]",2.0,99948.0,9
2025-08-14_08-18-36,1203,"[np.float32(1.0), np.float32(1.0), np.float32(1.0), np.float32(0.0), np.float32(1.0), np.float32(0.0), np.float32(0.0), np.float32(1.0), np.float32(1.0), np.float32(0.0), np.float32(1.0), np.float32(0.0), np.float32(1.0), np.float32(0.0), np.float32(1.0), np.float32(0.0)]",-4.0,99944.0,31
2025-08-14_08-18-36,1204,"[np.float32(0.0), np.float32(0.0), np.float32(0.0), np.float32(1.0), np.float32(1.0), np.float32(1.0), np.float32(0.0), np.float32(1.0), np.float32(1.0), np.float32(0.0), np.float32(0.0), np.float32(1.0), np.float32(1.0), np.float32(0.0), np.float32(1.0), np.float32(1.0)]",1.0,99945.0,31
2025-08-14_08-18-36,1205,"[np.float32(0.0), np.float32(0.0), np.float32(0.0), np.float32(1.0), np.float32(0.0), np.float32(0.0), np.float32(0.0), np.float32(1.0), np.float32(1.0), np.float32(0.0), np.float32(1.0), np.float32(0.0), np.float32(1.0), np.float32(1.0), np.float32(1.0), np.float32(1.0)]",0.0,99945.0,19
2025-08-14_08-18-36,1206,"[np.float32(1.0), np.float32(1.0), np.float32(0.0), np.float32(0.0), np.float32(0.0), np.float32(0.0), np.float32(1.0), np.float32(1.0), np.float32(1.0), np.float32(0.0), np.float32(1.0), np.float32(1.0), np.float32(0.0), np.float32(1.0), np.float32(1.0), np.float32(0.0)]",-1.0,99944.0,22
2025-08-14_08-18-36,1207,"[np.float32(1.0), np.float32(0.0), np.float32(1.0), np.float32(0.0), np.float32(1.0), np.float32(0.0), np.float32(0.0), np.float32(1.0), np.float32(1.0), np.float32(0.0), np.float32(0.0), np.float32(1.0), np.float32(1.0), np.float32(0.0), np.float32(0.0), np.float32(1.0)]",0.0,99944.0,24
2025-08-14_08-18-36,1208,"[np.float32(1.0), np.float32(0.0), np.float32(0.0), np.float32(0.0), np.float32(1.0), np.float32(0.0), np.float32(0.0), np.float32(1.0), np.float32(1.0), np.float32(1.0), np.float32(1.0), np.float32(0.0), np.float32(0.0), np.float32(1.0), np.float32(0.0), np.float32(1.0)]",-3.0,99941.0,8
2025-08-14_08-18-36,1209,"[np.float32(1.0), np.float32(1.0), np.float32(0.0), np.float32(1.0), np.float32(0.0), np.float32(0.0), np.float32(0.0), np.float32(1.0), np.float32(0.0), np.float32(1.0), np.float32(0.0), np.float32(1.0), np.float32(0.0), np.float32(0.0), np.float32(1.0), np.float32(1.0)]",2.0,99943.0,17
2025-08-14_08-18-36,1210,"[np.float32(1.0), np.float32(0.0), np.float32(0.0), np.float32(0.0), np.float32(0.0), np.float32(0.0), np.float32(1.0), np.float32(0.0), np.float32(1.0), np.float32(1.0), np.float32(1.0), np.float32(1.0), np.float32(0.0), np.float32(1.0), np.float32(1.0), np.float32(1.0)]",2.0,99945.0,25
2025-08-14_08-18-36,1211,"[np.float32(0.0), np.float32(0.0), np.float32(0.0), np.float32(1.0), np.float32(0.0), np.float32(1.0), np.float32(0.0), np.float32(0.0), np.float32(0.0), np.float32(1.0), np.float32(1.0), np.float32(0.0), np.float32(0.0), np.float32(0.0), np.float32(0.0), np.float32(1.0)]",-3.0,99942.0,30
2025-08-14_08-18-36,1212,"[np.float32(1.0), np.float32(0.0), np.float32(1.0), np.float32(1.0), np.float32(0.0), np.float32(0.0), np.float32(0.0), np.float32(1.0), np.float32(0.0), np.float32(1.0), np.float32(0.0), np.float32(1.0), np.float32(1.0), np.float32(0.0), np.float32(1.0), np.float32(0.0)]",-6.0,99936.0,2
2025-08-14_08-18-36,1213,"[np.float32(0.0), np.float32(0.0), np.float32(0.0), np.float32(1.0), np.float32(0.0), np.float32(1.0), np.float32(1.0), np.float32(1.0), np.float32(1.0), np.float32(0.0), np.float32(0.0), np.float32(1.0), np.float32(1.0), np.float32(1.0), np.float32(1.0), np.float32(1.0)]",-4.0,99932.0,16
2025-08-14_08-18-36,1214,"[np.float32(1.0), np.float32(1.0), np.float32(0.0), np.float32(0.0), np.float32(0.0), np.float32(1.0), np.float32(1.0), np.float32(0.0), np.float32(0.0), np.float32(0.0), np.float32(1.0), np.float32(1.0), np.float32(1.0), np.float32(1.0), np.float32(1.0), np.float32(0.0)]",-4.0,99928.0,13
2025-08-14_08-18-36,1215,"[np.float32(0.0), np.float32(0.0), np.float32(0.0), np.float32(0.0), np.float32(1.0), np.float32(1.0), np.float32(1.0), np.float32(1.0), np.float32(1.0), np.float32(0.0), np.float32(1.0), np.float32(1.0), np.float32(1.0), np.float32(1.0), np.float32(1.0), np.float32(0.0)]",1.0,99929.0,11
2025-08-14_08-18-36,1216,"[np.float32(0.0), np.float32(0.0), np.float32(0.0), np.float32(0.0), np.float32(1.0), np.float32(0.0), np.float32(0.0), np.float32(1.0), np.float32(0.0), np.float32(0.0), np.float32(0.0), np.float32(1.0), np.float32(0.0), np.float32(0.0), np.float32(1.0), np.float32(1.0)]",0.0,99929.0,10
2025-08-14_08-18-36,1217,"[np.float32(0.0), np.float32(1.0), np.float32(1.0), np.float32(1.0), np.float32(1.0), np.float32(0.0), np.float32(0.0), np.float32(1.0), np.float32(0.0), np.float32(0.0), np.float32(0.0), np.float32(1.0), np.float32(1.0), np.float32(0.0), np.float32(0.0), np.float32(1.0)]",-6.0,99923.0,25
2025-08-14_08-18-36,1218,"[np.float32(1.0), np.float32(1.0), np.float32(1.0), np.float32(0.0), np.float32(1.0), np.float32(1.0), np.float32(0.0), np.float32(0.0), np.float32(1.0), np.float32(1.0), np.float32(0.0), np.float32(1.0), np.float32(0.0), np.float32(0.0), np.float32(1.0), np.float32(0.0)]",3.0,99926.0,10
2025-08-14_08-18-36,1219,"[np.float32(0.0), np.float32(1.0), np.float32(0.0), np.float32(1.0), np.float32(0.0), np.float32(1.0), np.float32(1.0), np.float32(1.0), np.float32(0.0), np.float32(1.0), np.float32(1.0), np.float32(0.0), np.float32(1.0), np.float32(1.0), np.float32(1.0), np.float32(0.0)]",-5.0,99921.0,30
2025-08-14_08-18-36,1220,"[np.float32(0.0), np.float32(1.0), np.float32(1.0), np.float32(1.0), np.float32(1.0), np.float32(0.0), np.float32(0.0), np.float32(1.0), np.float32(1.0), np.float32(0.0), np.float32(0.0), np.float32(0.0), np.float32(1.0), np.float32(1.0), np.float32(0.0), np.float32(1.0)]",-2.0,99919.0,9
2025-08-14_08-18-36,1221,"[np.float32(0.0), np.float32(0.0), np.float32(0.0), np.float32(0.0), np.float32(1.0), np.float32(1.0), np.float32(1.0), np.float32(1.0), np.float32(0.0), np.float32(1.0), np.float32(0.0), np.float32(0.0), np.float32(0.0), np.float32(0.0), np.float32(0.0), np.float32(0.0)]",3.0,99922.0,7
2025-08-14_08-18-36,1222,"[np.float32(1.0), np.float32(1.0), np.float32(1.0), np.float32(1.0), np.float32(0.0), np.float32(0.0), np.float32(0.0), np.float32(1.0), np.float32(0.0), np.float32(1.0), np.float32(1.0), np.float32(1.0), np.float32(1.0), np.float32(1.0), np.float32(0.0), np.float32(0.0)]",3.0,99925.0,18
2025-08-14_08-18-36,1223,"[np.float32(0.0), np.float32(1.0), np.float32(0.0), np.float32(1.0), np.float32(0.0), np.float32(0.0), np.float32(0.0), np.float32(1.0), np.float32(0.0), np.float32(0.0), np.float32(1.0), np.float32(1.0), np.float32(0.0), np.float32(1.0), np.float32(1.0), np.float32(1.0)]",0.0,99925.0,8
2025-08-14_08-18-36,1224,"[np.float32(1.0), np.float32(1.0), np.float32(1.0), np.float32(1.0), np.float32(1.0), np.float32(0.0), np.float32(1.0), np.float32(1.0), np.float32(0.0), np.float32(0.0), np.float32(0.0), np.float32(1.0), np.float32(0.0), np.float32(1.0), np.float32(1.0), np.float32(0.0)]",-3.0,99922.0,32
2025-08-14_08-18-36,1225,"[np.float32(1.0), np.float32(0.0), np.float32(1.0), np.float32(0.0), np.float32(1.0), np.float32(0.0), np.float32(1.0), np.float32(0.0), np.float32(1.0), np.float32(1.0), np.float32(1.0), np.float32(1.0), np.float32(0.0), np.float32(1.0), np.float32(1.0), np.float32(0.0)]",-1.0,99921.0,35
2025-08-14_08-18-36,1226,"[np.float32(0.0), np.float32(1.0), np.float32(0.0), np.float32(0.0), np.float32(1.0), np.float32(0.0), np.float32(0.0), np.float32(0.0), np.float32(0.0), np.float32(0.0), np.float32(1.0), np.float32(1.0), np.float32(1.0), np.float32(1.0), np.float32(0.0), np.float32(0.0)]",-3.0,99918.0,36
2025-08-14_08-18-36,1227,"[np.float32(1.0), np.float32(0.0), np.float32(0.0), np.float32(1.0), np.float32(1.0), np.float32(0.0), np.float32(0.0), np.float32(1.0), np.float32(1.0), np.float32(0.0), np.float32(1.0), np.float32(1.0), np.float32(1.0), np.float32(0.0), np.float32(0.0), np.float32(1.0)]",1.0,99919.0,27
2025-08-14_08-18-36,1228,"[np.float32(1.0), np.float32(0.0), np.float32(1.0), np.float32(1.0), np.float32(1.0), np.float32(0.0), np.float32(0.0), np.float32(0.0), np.float32(0.0), np.float32(1.0), np.float32(1.0), np.float32(1.0), np.float32(0.0), np.float32(1.0), np.float32(0.0), np.float32(0.0)]",-3.0,99916.0,24
2025-08-14_08-18-36,1229,"[np.float32(0.0), np.float32(1.0), np.float32(0.0), np.float32(1.0), np.float32(1.0), np.float32(1.0), np.float32(0.0), np.float32(1.0), np.float32(0.0), np.float32(1.0), np.float32(1.0), np.float32(1.0), np.float32(1.0), np.float32(0.0), np.float32(0.0), np.float32(1.0)]",-1.0,99915.0,35
2025-08-14_08-18-36,1230,"[np.float32(1.0), np.float32(1.0), np.float32(0.0), np.float32(1.0), np.float32(0.0), np.float32(0.0), np.float32(0.0), np.float32(1.0), np.float32(0.0), np.float32(1.0), np.float32(0.0), np.float32(1.0), np.float32(1.0), np.float32(1.0), np.float32(0.0), np.float32(0.0)]",0.0,99915.0,4
2025-08-14_08-18-36,1231,"[np.float32(1.0), np.float32(1.0), np.float32(0.0), np.float32(1.0), np.float32(1.0), np.float32(1.0), np.float32(1.0), np.float32(1.0), np.float32(0.0), np.float32(0.0), np.float32(0.0), np.float32(0.0), np.float32(1.0), np.float32(1.0), np.float32(1.0), np.float32(1.0)]",1.0,99916.0,3
2025-08-14_08-18-36,1232,"[np.float32(0.0), np.float32(1.0), np.float32(1.0), np.float32(0.0), np.float32(1.0), np.float32(0.0), np.float32(0.0), np.float32(0.0), np.float32(1.0), np.float32(0.0), np.float32(0.0), np.float32(1.0), np.float32(0.0), np.float32(0.0), np.float32(1.0), np.float32(1.0)]",-3.0,99913.0,22
2025-08-14_08-18-36,1233,"[np.float32(1.0), np.float32(1.0), np.float32(1.0), np.float32(1.0), np.float32(0.0), np.float32(1.0), np.float32(1.0), np.float32(1.0), np.float32(0.0), np.float32(0.0), np.float32(0.0), np.float32(0.0), np.float32(1.0), np.float32(0.0), np.float32(0.0), np.float32(0.0)]",-2.0,99911.0,36
2025-08-14_08-18-36,1234,"[np.float32(1.0), np.float32(1.0), np.float32(0.0), np.float32(0.0), np.float32(0.0), np.float32(0.0), np.float32(0.0), np.float32(1.0), np.float32(0.0), np.float32(1.0), np.float32(0.0), np.float32(1.0), np.float32(0.0), np.float32(1.0), np.float32(1.0), np.float32(1.0)]",0.0,99911.0,30
2025-08-14_08-18-36,1235,"[np.float32(0.0), np.float32(1.0), np.float32(1.0), np.float32(0.0), np.float32(0.0), np.float32(0.0), np.float32(0.0), np.float32(0.0), np.float32(0.0), np.float32(1.0), np.float32(0.0), np.float32(1.0), np.float32(1.0), np.float32(0.0), np.float32(0.0), np.float32(0.0)]",0.0,99911.0,31
2025-08-14_08-18-36,1236,"[np.float32(0.0), np.float32(1.0), np.float32(0.0), np.float32(1.0), np.float32(0.0), np.float32(0.0), np.float32(0.0), np.float32(0.0), np.float32(0.0), np.float32(0.0), np.float32(0.0), np.float32(0.0), np.float32(1.0), np.float32(1.0), np.float32(0.0), np.float32(1.0)]",-3.0,99908.0,23
2025-08-14_08-18-36,1237,"[np.float32(0.0), np.float32(0.0), np.float32(0.0), np.float32(0.0), np.float32(1.0), np.float32(1.0), np.float32(0.0), np.float32(1.0), np.float32(1.0), np.float32(0.0), np.float32(1.0), np.float32(0.0), np.float32(1.0), np.float32(1.0), np.float32(1.0), np.float32(0.0)]",-3.0,99905.0,31
2025-08-14_08-18-36,1238,"[np.float32(0.0), np.float32(1.0), np.float32(1.0), np.float32(0.0), np.float32(1.0), np.float32(0.0), np.float32(0.0), np.float32(0.0), np.float32(1.0), np.float32(1.0), np.float32(1.0), np.float32(1.0), np.float32(0.0), np.float32(1.0), np.float32(1.0), np.float32(0.0)]",1.0,99906.0,16
2025-08-14_08-18-36,1239,"[np.float32(1.0), np.float32(1.0), np.float32(1.0), np.float32(1.0), np.float32(0.0), np.float32(1.0), np.float32(0.0), np.float32(1.0), np.float32(1.0), np.float32(0.0), np.float32(1.0), np.float32(1.0), np.float32(0.0), np.float32(1.0), np.float32(0.0), np.float32(0.0)]",-3.0,99903.0,13
2025-08-14_08-18-36,1240,"[np.float32(0.0), np.float32(1.0), np.float32(0.0), np.float32(0.0), np.float32(1.0), np.float32(0.0), np.float32(0.0), np.float32(1.0), np.float32(1.0), np.float32(1.0), np.float32(1.0), np.float32(1.0), np.float32(0.0), np.float32(0.0), np.float32(0.0), np.float32(0.0)]",1.0,99904.0,24
2025-08-14_08-18-36,1241,"[np.float32(0.0), np.float32(1.0), np.float32(0.0), np.float32(1.0), np.float32(0.0), np.float32(0.0), np.float32(0.0), np.float32(0.0), np.float32(1.0), np.float32(0.0), np.float32(1.0), np.float32(1.0), np.float32(1.0), np.float32(0.0), np.float32(1.0), np.float32(1.0)]",1.0,99905.0,30
2025-08-14_08-18-36,1242,"[np.float32(0.0), np.float32(1.0), np.float32(1.0), np.float32(1.0), np.float32(1.0), np.float32(0.0), np.float32(0.0), np.float32(0.0), np.float32(1.0), np.float32(1.0), np.float32(0.0), np.float32(0.0), np.float32(1.0), np.float32(0.0), np.float32(1.0), np.float32(0.0)]",2.0,99907.0,31
2025-08-14_08-18-36,1243,"[np.float32(0.0), np.float32(0.0), np.float32(1.0), np.float32(1.0), np.float32(0.0), np.float32(1.0), np.float32(1.0), np.float32(0.0), np.float32(0.0), np.float32(0.0), np.float32(0.0), np.float32(1.0), np.float32(0.0), np.float32(0.0), np.float32(1.0), np.float32(0.0)]",4.0,99911.0,33
2025-08-14_08-18-36,1244,"[np.float32(1.0), np.float32(1.0), np.float32(1.0), np.float32(0.0), np.float32(0.0), np.float32(1.0), np.float32(1.0), np.float32(0.0), np.float32(1.0), np.float32(1.0), np.float32(0.0), np.float32(0.0), np.float32(0.0), np.float32(0.0), np.float32(0.0), np.float32(0.0)]",5.0,99916.0,28
2025-08-14_08-18-36,1245,"[np.float32(0.0), np.float32(1.0), np.float32(1.0), np.float32(0.0), np.float32(0.0), np.float32(1.0), np.float32(0.0), np.float32(1.0), np.float32(0.0), np.float32(1.0), np.float32(0.0), np.float32(1.0), np.float32(1.0), np.float32(1.0), np.float32(0.0), np.float32(0.0)]",-3.0,99913.0,14
2025-08-14_08-18-36,1246,"[np.float32(1.0), np.float32(1.0), np.float32(1.0), np.float32(1.0), np.float32(0.0), np.float32(1.0), np.float32(1.0), np.float32(0.0), np.float32(1.0), np.float32(0.0), np.float32(0.0), np.float32(1.0), np.float32(1.0), np.float32(0.0), np.float32(1.0), np.float32(1.0)]",-1.0,99912.0,8
2025-08-14_08-18-36,1247,"[np.float32(1.0), np.float32(0.0), np.float32(0.0), np.float32(0.0), np.float32(1.0), np.float32(1.0), np.float32(0.0), np.float32(0.0), np.float32(1.0), np.float32(0.0), np.float32(0.0), np.float32(0.0), np.float32(0.0), np.float32(0.0), np.float32(1.0), np.float32(1.0)]",4.0,99916.0,30
2025-08-14_08-18-36,1248,"[np.float32(0.0), np.float32(0.0), np.float32(0.0), np.float32(0.0), np.float32(1.0), np.float32(1.0), np.float32(0.0), np.float32(0.0), np.float32(0.0), np.float32(1.0), np.float32(1.0), np.float32(1.0), np.float32(0.0), np.float32(1.0), np.float32(0.0), np.float32(1.0)]",1.0,99917.0,18
2025-08-14_08-18-36,1249,"[np.float32(0.0), np.float32(1.0), np.float32(0.0), np.float32(0.0), np.float32(0.0), np.float32(1.0), np.float32(1.0), np.float32(1.0), np.float32(0.0), np.float32(1.0), np.float32(1.0), np.float32(1.0), np.float32(1.0), np.float32(0.0), np.float32(1.0), np.float32(0.0)]",2.0,99919.0,8
2025-08-14_08-18-36,1250,"[np.float32(0.0), np.float32(1.0), np.float32(1.0), np.float32(1.0), np.float32(0.0), np.float32(1.0), np.float32(0.0), np.float32(0.0), np.float32(0.0), np.float32(1.0), np.float32(1.0), np.float32(0.0), np.float32(0.0), np.float32(1.0), np.float32(0.0), np.float32(1.0)]",4.0,99923.0,26
2025-08-14_08-18-36,1251,"[np.float32(0.0), np.float32(1.0), np.float32(1.0), np.float32(1.0), np.float32(0.0), np.float32(0.0), np.float32(0.0), np.float32(1.0), np.float32(0.0), np.float32(1.0), np.float32(0.0), np.float32(0.0), np.float32(0.0), np.float32(1.0), np.float32(0.0), np.float32(1.0)]",-2.0,99921.0,23
2025-08-14_08-18-36,1252,"[np.float32(1.0), np.float32(0.0), np.float32(1.0), np.float32(0.0), np.float32(0.0), np.float32(1.0), np.float32(1.0), np.float32(1.0), np.float32(0.0), np.float32(0.0), np.float32(0.0), np.float32(1.0), np.float32(1.0), np.float32(0.0), np.float32(1.0), np.float32(0.0)]",2.0,99923.0,12
2025-08-14_08-18-36,1253,"[np.float32(1.0), np.float32(0.0), np.float32(0.0), np.float32(1.0), np.float32(1.0), np.float32(1.0), np.float32(0.0), np.float32(1.0), np.float32(0.0), np.float32(1.0), np.float32(1.0), np.float32(1.0), np.float32(0.0), np.float32(1.0), np.float32(1.0), np.float32(0.0)]",2.0,99925.0,7
2025-08-14_08-18-36,1254,"[np.float32(1.0), np.float32(1.0), np.float32(1.0), np.float32(1.0), np.float32(1.0), np.float32(0.0), np.float32(1.0), np.float32(0.0), np.float32(0.0), np.float32(0.0), np.float32(0.0), np.float32(1.0), np.float32(0.0), np.float32(0.0), np.float32(1.0), np.float32(1.0)]",0.0,99925.0,15
2025-08-14_08-18-36,1255,"[np.float32(1.0), np.float32(0.0), np.float32(0.0), np.float32(1.0), np.float32(1.0), np.float32(1.0), np.float32(0.0), np.float32(1.0), np.float32(0.0), np.float32(0.0), np.float32(0.0), np.float32(1.0), np.float32(1.0), np.float32(0.0), np.float32(0.0), np.float32(0.0)]",-1.0,99924.0,25
2025-08-14_08-18-36,1256,"[np.float32(0.0), np.float32(0.0), np.float32(1.0), np.float32(1.0), np.float32(0.0), np.float32(1.0), np.float32(0.0), np.float32(1.0), np.float32(1.0), np.float32(0.0), np.float32(1.0), np.float32(1.0), np.float32(1.0), np.float32(1.0), np.float32(1.0), np.float32(1.0)]",-1.0,99923.0,25
2025-08-14_08-18-36,1257,"[np.float32(0.0), np.float32(1.0), np.float32(0.0), np.float32(0.0), np.float32(0.0), np.float32(1.0), np.float32(0.0), np.float32(0.0), np.float32(0.0), np.float32(1.0), np.float32(0.0), np.float32(0.0), np.float32(1.0), np.float32(1.0), np.float32(1.0), np.float32(0.0)]",1.0,99924.0,24
2025-08-14_08-18-36,1258,"[np.float32(0.0), np.float32(0.0), np.float32(0.0), np.float32(1.0), np.float32(1.0), np.float32(0.0), np.float32(0.0), np.float32(0.0), np.float32(0.0), np.float32(0.0), np.float32(1.0), np.float32(0.0), np.float32(0.0), np.float32(1.0), np.float32(0.0), np.float32(0.0)]",4.0,99928.0,2
2025-08-14_08-18-36,1259,"[np.float32(0.0), np.float32(1.0), np.float32(0.0), np.float32(1.0), np.float32(0.0), np.float32(0.0), np.float32(1.0), np.float32(1.0), np.float32(1.0), np.float32(0.0), np.float32(1.0), np.float32(1.0), np.float32(1.0), np.float32(0.0), np.float32(1.0), np.float32(0.0)]",2.0,99930.0,27
2025-08-14_08-18-36,1260,"[np.float32(0.0), np.float32(1.0), np.float32(1.0), np.float32(1.0), np.float32(0.0), np.float32(1.0), np.float32(0.0), np.float32(0.0), np.float32(0.0), np.float32(0.0), np.float32(0.0), np.float32(1.0), np.float32(1.0), np.float32(1.0), np.float32(0.0), np.float32(1.0)]",-1.0,99929.0,34
2025-08-14_08-18-36,1261,"[np.float32(0.0), np.float32(0.0), np.float32(0.0), np.float32(1.0), np.float32(1.0), np.float32(1.0), np.float32(0.0), np.float32(0.0), np.float32(1.0), np.float32(0.0), np.float32(0.0), np.float32(1.0), np.float32(0.0), np.float32(0.0), np.float32(1.0), np.float32(0.0)]",-1.0,99928.0,28
2025-08-14_08-18-36,1262,"[np.float32(0.0), np.float32(0.0), np.float32(0.0), np.float32(0.0), np.float32(1.0), np.float32(0.0), np.float32(0.0), np.float32(1.0), np.float32(0.0), np.float32(0.0), np.float32(1.0), np.float32(0.0), np.float32(1.0), np.float32(1.0), np.float32(1.0), np.float32(1.0)]",-4.0,99924.0,27
2025-08-14_08-18-36,1263,"[np.float32(1.0), np.float32(0.0), np.float32(0.0), np.float32(0.0), np.float32(1.0), np.float32(1.0), np.float32(1.0), np.float32(0.0), np.float32(1.0), np.float32(1.0), np.float32(1.0), np.float32(0.0), np.float32(0.0), np.float32(0.0), np.float32(1.0), np.float32(0.0)]",5.0,99929.0,5
2025-08-14_08-18-36,1264,"[np.float32(1.0), np.float32(0.0), np.float32(1.0), np.float32(1.0), np.float32(1.0), np.float32(1.0), np.float32(0.0), np.float32(0.0), np.float32(1.0), np.float32(1.0), np.float32(0.0), np.float32(0.0), np.float32(0.0), np.float32(0.0), np.float32(1.0), np.float32(0.0)]",2.0,99931.0,31
2025-08-14_08-18-36,1265,"[np.float32(1.0), np.float32(1.0), np.float32(1.0), np.float32(0.0), np.float32(1.0), np.float32(1.0), np.float32(0.0), np.float32(0.0), np.float32(1.0), np.float32(0.0), np.float32(1.0), np.float32(1.0), np.float32(1.0), np.float32(0.0), np.float32(0.0), np.float32(0.0)]",-2.0,99929.0,23
2025-08-14_08-18-36,1266,"[np.float32(1.0), np.float32(1.0), np.float32(1.0), np.float32(1.0), np.float32(0.0), np.float32(0.0), np.float32(0.0), np.float32(0.0), np.float32(0.0), np.float32(0.0), np.float32(1.0), np.float32(1.0), np.float32(0.0), np.float32(0.0), np.float32(1.0), np.float32(0.0)]",0.0,99929.0,13
2025-08-14_08-18-36,1267,"[np.float32(0.0), np.float32(0.0), np.float32(1.0), np.float32(1.0), np.float32(1.0), np.float32(1.0), np.float32(1.0), np.float32(1.0), np.float32(0.0), np.float32(0.0), np.float32(0.0), np.float32(1.0), np.float32(0.0), np.float32(1.0), np.float32(1.0), np.float32(1.0)]",0.0,99929.0,1
2025-08-14_08-18-36,1268,"[np.float32(0.0), np.float32(0.0), np.float32(0.0), np.float32(1.0), np.float32(1.0), np.float32(0.0), np.float32(0.0), np.float32(1.0), np.float32(1.0), np.float32(0.0), np.float32(1.0), np.float32(0.0), np.float32(0.0), np.float32(0.0), np.float32(1.0), np.float32(0.0)]",4.0,99933.0,13
2025-08-14_08-18-36,1269,"[np.float32(0.0), np.float32(0.0), np.float32(1.0), np.float32(0.0), np.float32(0.0), np.float32(1.0), np.float32(0.0), np.float32(1.0), np.float32(1.0), np.float32(1.0), np.float32(0.0), np.float32(0.0), np.float32(0.0), np.float32(1.0), np.float32(1.0), np.float32(0.0)]",-1.0,99932.0,7
2025-08-14_08-18-36,1270,"[np.float32(1.0), np.float32(1.0), np.float32(0.0), np.float32(1.0), np.float32(0.0), np.float32(1.0), np.float32(0.0), np.float32(0.0), np.float32(1.0), np.float32(0.0), np.float32(0.0), np.float32(0.0), np.float32(0.0), np.float32(1.0), np.float32(0.0), np.float32(1.0)]",-3.0,99929.0,13
2025-08-14_08-18-36,1271,"[np.float32(1.0), np.float32(1.0), np.float32(1.0), np.float32(1.0), np.float32(1.0), np.float32(1.0), np.float32(1.0), np.float32(1.0), np.float32(1.0), np.float32(0.0), np.float32(1.0), np.float32(0.0), np.float32(0.0), np.float32(1.0), np.float32(0.0), np.float32(0.0)]",-2.0,99927.0,36
2025-08-14_08-18-36,1272,"[np.float32(1.0), np.float32(1.0), np.float32(1.0), np.float32(0.0), np.float32(1.0), np.float32(1.0), np.float32(0.0), np.float32(1.0), np.float32(0.0), np.float32(1.0), np.float32(0.0), np.float32(1.0), np.float32(1.0), np.float32(1.0), np.float32(0.0), np.float32(1.0)]",1.0,99928.0,16
2025-08-14_08-18-36,1273,"[np.float32(1.0), np.float32(1.0), np.float32(0.0), np.float32(1.0), np.float32(0.0), np.float32(1.0), np.float32(0.0), np.float32(1.0), np.float32(1.0), np.float32(0.0), np.float32(1.0), np.float32(0.0), np.float32(0.0), np.float32(1.0), np.float32(0.0), np.float32(0.0)]",0.0,99928.0,2
2025-08-14_08-18-36,1274,"[np.float32(1.0), np.float32(0.0), np.float32(1.0), np.float32(0.0), np.float32(1.0), np.float32(0.0), np.float32(0.0), np.float32(1.0), np.float32(0.0), np.float32(1.0), np.float32(0.0), np.float32(0.0), np.float32(1.0), np.float32(0.0), np.float32(0.0), np.float32(0.0)]",-6.0,99922.0,29
2025-08-14_08-18-36,1275,"[np.float32(1.0), np.float32(0.0), np.float32(0.0), np.float32(0.0), np.float32(0.0), np.float32(0.0), np.float32(0.0), np.float32(0.0), np.float32(1.0), np.float32(0.0), np.float32(0.0), np.float32(1.0), np.float32(1.0), np.float32(1.0), np.float32(1.0), np.float32(1.0)]",-1.0,99921.0,15
2025-08-14_08-18-36,1276,"[np.float32(0.0), np.float32(0.0), np.float32(0.0), np.float32(1.0), np.float32(0.0), np.float32(1.0), np.float32(0.0), np.float32(1.0), np.float32(1.0), np.float32(1.0), np.float32(1.0), np.float32(0.0), np.float32(0.0), np.float32(1.0), np.float32(1.0), np.float32(1.0)]",-3.0,99918.0,18
2025-08-14_08-18-36,1277,"[np.float32(1.0), np.float32(0.0), np.float32(1.0), np.float32(0.0), np.float32(1.0), np.float32(0.0), np.float32(1.0), np.float32(1.0), np.float32(0.0), np.float32(1.0), np.float32(1.0), np.float32(0.0), np.float32(0.0), np.float32(0.0), np.float32(1.0), np.float32(1.0)]",-3.0,99915.0,31
2025-08-14_08-18-36,1278,"[np.float32(1.0), np.float32(0.0), np.float32(1.0), np.float32(0.0), np.float32(1.0), np.float32(1.0), np.float32(1.0), np.float32(1.0), np.float32(1.0), np.float32(0.0), np.float32(1.0), np.float32(1.0), np.float32(1.0), np.float32(1.0), np.float32(0.0), np.float32(1.0)]",-2.0,99913.0,19
2025-08-14_08-18-36,1279,"[np.float32(1.0), np.float32(0.0), np.float32(0.0), np.float32(1.0), np.float32(1.0), np.float32(1.0), np.float32(1.0), np.float32(0.0), np.float32(1.0), np.float32(0.0), np.float32(0.0), np.float32(0.0), np.float32(1.0), np.float32(1.0), np.float32(1.0), np.float32(0.0)]",3.0,99916.0,25
2025-08-14_08-18-36,1280,"[np.float32(1.0), np.float32(1.0), np.float32(1.0), np.float32(0.0), np.float32(0.0), np.float32(0.0), np.float32(1.0), np.float32(1.0), np.float32(0.0), np.float32(1.0), np.float32(1.0), np.float32(1.0), np.float32(0.0), np.float32(0.0), np.float32(0.0), np.float32(0.0)]",2.0,99918.0,16
2025-08-14_08-18-36,1281,"[np.float32(1.0), np.float32(1.0), np.float32(1.0), np.float32(0.0), np.float32(0.0), np.float32(1.0), np.float32(0.0), np.float32(1.0), np.float32(0.0), np.float32(0.0), np.float32(1.0), np.float32(1.0), np.float32(1.0), np.float32(0.0), np.float32(0.0), np.float32(0.0)]",-3.0,99915.0,9
2025-08-14_08-18-36,1282,"[np.float32(1.0), np.float32(0.0), np.float32(1.0), np.float32(0.0), np.float32(0.0), np.float32(0.0), np.float32(0.0), np.float32(1.0), np.float32(1.0), np.float32(1.0), np.float32(0.0), np.float32(0.0), np.float32(1.0), np.float32(0.0), np.float32(1.0), np.float32(1.0)]",-2.0,99913.0,33
2025-08-14_08-18-36,1283,"[np.float32(1.0), np.float32(1.0), np.float32(0.0), np.float32(1.0), np.float32(0.0), np.float32(0.0), np.float32(0.0), np.float32(1.0), np.float32(0.0), np.float32(1.0), np.float32(0.0), np.float32(0.0), np.float32(0.0), np.float32(0.0), np.float32(0.0), np.float32(0.0)]",3.0,99916.0,22
2025-08-14_08-18-36,1284,"[np.float32(1.0), np.float32(1.0), np.float32(0.0), np.float32(1.0), np.float32(0.0), np.float32(0.0), np.float32(1.0), np.float32(0.0), np.float32(1.0), np.float32(0.0), np.float32(0.0), np.float32(0.0), np.float32(0.0), np.float32(1.0), np.float32(1.0), np.float32(1.0)]",-3.0,99913.0,22
2025-08-14_08-18-36,1285,"[np.float32(1.0), np.float32(1.0), np.float32(1.0), np.float32(1.0), np.float32(0.0), np.float32(0.0), np.float32(1.0), np.float32(1.0), np.float32(1.0), np.float32(0.0), np.float32(0.0), np.float32(0.0), np.float32(1.0), np.float32(0.0), np.float32(0.0), np.float32(0.0)]",-1.0,99912.0,17
2025-08-14_08-18-36,1286,"[np.float32(0.0), np.float32(0.0), np.float32(1.0), np.float32(1.0), np.float32(0.0), np.float32(1.0), np.float32(1.0), np.float32(0.0), np.float32(0.0), np.float32(1.0), np.float32(0.0), np.float32(1.0), np.float32(0.0), np.float32(0.0), np.float32(0.0), np.float32(0.0)]",2.0,99914.0,10
2025-08-14_08-18-36,1287,"[np.float32(0.0), np.float32(1.0), np.float32(1.0), np.float32(0.0), np.float32(1.0), np.float32(1.0), np.float32(1.0), np.float32(1.0), np.float32(0.0), np.float32(0.0), np.float32(0.0), np.float32(0.0), np.float32(0.0), np.float32(1.0), np.float32(0.0), np.float32(1.0)]",2.0,99916.0,12
2025-08-14_08-18-36,1288,"[np.float32(1.0), np.float32(1.0), np.float32(0.0), np.float32(1.0), np.float32(0.0), np.float32(1.0), np.float32(0.0), np.float32(1.0), np.float32(1.0), np.float32(0.0), np.float32(1.0), np.float32(1.0), np.float32(1.0), np.float32(0.0), np.float32(1.0), np.float32(1.0)]",29.0,99945.0,7
2025-08-14_08-18-36,1289,"[np.float32(0.0), np.float32(0.0), np.float32(0.0), np.float32(0.0), np.float32(1.0), np.float32(0.0), np.float32(1.0), np.float32(0.0), np.float32(1.0), np.float32(1.0), np.float32(1.0), np.float32(0.0), np.float32(1.0), np.float32(0.0), np.float32(1.0), np.float32(0.0)]",-1.0,99944.0,23
2025-08-14_08-18-36,1290,"[np.float32(0.0), np.float32(0.0), np.float32(1.0), np.float32(1.0), np.float32(0.0), np.float32(1.0), np.float32(0.0), np.float32(0.0), np.float32(0.0), np.float32(1.0), np.float32(0.0), np.float32(0.0), np.float32(0.0), np.float32(0.0), np.float32(1.0), np.float32(1.0)]",1.0,99945.0,25
2025-08-14_08-18-36,1291,"[np.float32(1.0), np.float32(0.0), np.float32(0.0), np.float32(0.0), np.float32(1.0), np.float32(0.0), np.float32(1.0), np.float32(0.0), np.float32(0.0), np.float32(0.0), np.float32(1.0), np.float32(0.0), np.float32(1.0), np.float32(0.0), np.float32(0.0), np.float32(0.0)]",-3.0,99942.0,36
2025-08-14_08-18-36,1292,"[np.float32(0.0), np.float32(1.0), np.float32(0.0), np.float32(1.0), np.float32(0.0), np.float32(1.0), np.float32(1.0), np.float32(1.0), np.float32(0.0), np.float32(1.0), np.float32(1.0), np.float32(1.0), np.float32(1.0), np.float32(1.0), np.float32(1.0), np.float32(0.0)]",0.0,99942.0,3
2025-08-14_08-18-36,1293,"[np.float32(0.0), np.float32(1.0), np.float32(1.0), np.float32(1.0), np.float32(0.0), np.float32(1.0), np.float32(1.0), np.float32(1.0), np.float32(0.0), np.float32(0.0), np.float32(0.0), np.float32(0.0), np.float32(1.0), np.float32(0.0), np.float32(0.0), np.float32(0.0)]",0.0,99942.0,23
2025-08-14_08-18-36,1294,"[np.float32(1.0), np.float32(1.0), np.float32(1.0), np.float32(0.0), np.float32(0.0), np.float32(1.0), np.float32(0.0), np.float32(0.0), np.float32(0.0), np.float32(1.0), np.float32(1.0), np.float32(1.0), np.float32(1.0), np.float32(1.0), np.float32(1.0), np.float32(1.0)]",-1.0,99941.0,31
2025-08-14_08-18-36,1295,"[np.float32(0.0), np.float32(1.0), np.float32(0.0), np.float32(0.0), np.float32(0.0), np.float32(0.0), np.float32(0.0), np.float32(0.0), np.float32(0.0), np.float32(1.0), np.float32(1.0), np.float32(1.0), np.float32(0.0), np.float32(0.0), np.float32(1.0), np.float32(0.0)]",-2.0,99939.0,3
2025-08-14_08-18-36,1296,"[np.float32(0.0), np.float32(0.0), np.float32(0.0), np.float32(1.0), np.float32(1.0), np.float32(1.0), np.float32(0.0), np.float32(1.0), np.float32(1.0), np.float32(0.0), np.float32(0.0), np.float32(1.0), np.float32(1.0), np.float32(1.0), np.float32(0.0), np.float32(1.0)]",-1.0,99938.0,32
2025-08-14_08-18-36,1297,"[np.float32(1.0), np.float32(0.0), np.float32(1.0), np.float32(0.0), np.float32(1.0), np.float32(0.0), np.float32(0.0), np.float32(0.0), np.float32(0.0), np.float32(1.0), np.float32(0.0), np.float32(0.0), np.float32(0.0), np.float32(1.0), np.float32(1.0), np.float32(1.0)]",1.0,99939.0,19
2025-08-14_08-18-36,1298,"[np.float32(1.0), np.float32(0.0), np.float32(0.0), np.float32(1.0), np.float32(1.0), np.float32(0.0), np.float32(0.0), np.float32(0.0), np.float32(1.0), np.float32(1.0), np.float32(0.0), np.float32(1.0), np.float32(1.0), np.float32(0.0), np.float32(0.0), np.float32(1.0)]",-4.0,99935.0,23
2025-08-14_08-18-36,1299,"[np.float32(1.0), np.float32(0.0), np.float32(0.0), np.float32(1.0), np.float32(0.0), np.float32(1.0), np.float32(1.0), np.float32(0.0), np.float32(1.0), np.float32(1.0), np.float32(0.0), np.float32(0.0), np.float32(0.0), np.float32(0.0), np.float32(0.0), np.float32(0.0)]",4.0,99939.0,31
2025-08-14_08-18-36,1300,"[np.float32(1.0), np.float32(1.0), np.float32(1.0), np.float32(0.0), np.float32(0.0), np.float32(1.0), np.float32(1.0), np.float32(1.0), np.float32(1.0), np.float32(1.0), np.float32(0.0), np.float32(0.0), np.float32(1.0), np.float32(0.0), np.float32(0.0), np.float32(0.0)]",-1.0,99938.0,13
2025-08-14_08-18-36,1301,"[np.float32(0.0), np.float32(1.0), np.float32(1.0), np.float32(1.0), np.float32(0.0), np.float32(0.0), np.float32(1.0), np.float32(1.0), np.float32(0.0), np.float32(0.0), np.float32(0.0), np.float32(0.0), np.float32(0.0), np.float32(1.0), np.float32(1.0), np.float32(0.0)]",3.0,99941.0,15
2025-08-14_08-18-36,1302,"[np.float32(0.0), np.float32(1.0), np.float32(1.0), np.float32(0.0), np.float32(1.0), np.float32(1.0), np.float32(1.0), np.float32(0.0), np.float32(1.0), np.float32(1.0), np.float32(1.0), np.float32(1.0), np.float32(1.0), np.float32(0.0), np.float32(1.0), np.float32(0.0)]",1.0,99942.0,2
2025-08-14_08-18-36,1303,"[np.float32(1.0), np.float32(0.0), np.float32(0.0), np.float32(1.0), np.float32(0.0), np.float32(1.0), np.float32(0.0), np.float32(1.0), np.float32(1.0), np.float32(1.0), np.float32(0.0), np.float32(1.0), np.float32(1.0), np.float32(1.0), np.float32(0.0), np.float32(1.0)]",-7.0,99935.0,10
2025-08-14_08-18-36,1304,"[np.float32(0.0), np.float32(1.0), np.float32(1.0), np.float32(1.0), np.float32(1.0), np.float32(0.0), np.float32(1.0), np.float32(0.0), np.float32(1.0), np.float32(1.0), np.float32(1.0), np.float32(0.0), np.float32(1.0), np.float32(0.0), np.float32(1.0), np.float32(0.0)]",2.0,99937.0,4
2025-08-14_08-18-36,1305,"[np.float32(0.0), np.float32(0.0), np.float32(0.0), np.float32(1.0), np.float32(1.0), np.float32(0.0), np.float32(0.0), np.float32(1.0), np.float32(1.0), np.float32(1.0), np.float32(0.0), np.float32(1.0), np.float32(0.0), np.float32(1.0), np.float32(1.0), np.float32(0.0)]",1.0,99938.0,36
2025-08-14_08-18-36,1306,"[np.float32(0.0), np.float32(1.0), np.float32(0.0), np.float32(0.0), np.float32(1.0), np.float32(0.0), np.float32(1.0), np.float32(1.0), np.float32(1.0), np.float32(0.0), np.float32(0.0), np.float32(0.0), np.float32(0.0), np.float32(1.0), np.float32(1.0), np.float32(1.0)]",2.0,99940.0,4
2025-08-14_08-18-36,1307,"[np.float32(1.0), np.float32(0.0), np.float32(1.0), np.float32(0.0), np.float32(1.0), np.float32(0.0), np.float32(0.0), np.float32(1.0), np.float32(0.0), np.float32(1.0), np.float32(1.0), np.float32(0.0), np.float32(1.0), np.float32(1.0), np.float32(1.0), np.float32(0.0)]",-6.0,99934.0,33
2025-08-14_08-18-36,1308,"[np.float32(0.0), np.float32(1.0), np.float32(1.0), np.float32(1.0), np.float32(1.0), np.float32(1.0), np.float32(1.0), np.float32(0.0), np.float32(1.0), np.float32(1.0), np.float32(0.0), np.float32(0.0), np.float32(1.0), np.float32(0.0), np.float32(0.0), np.float32(0.0)]",37.0,99971.0,7
2025-08-14_08-18-36,1309,"[np.float32(0.0), np.float32(0.0), np.float32(0.0), np.float32(1.0), np.float32(0.0), np.float32(1.0), np.float32(1.0), np.float32(1.0), np.float32(0.0), np.float32(0.0), np.float32(1.0), np.float32(1.0), np.float32(0.0), np.float32(0.0), np.float32(0.0), np.float32(0.0)]",2.0,99973.0,20
2025-08-14_08-18-36,1310,"[np.float32(0.0), np.float32(0.0), np.float32(1.0), np.float32(1.0), np.float32(0.0), np.float32(0.0), np.float32(1.0), np.float32(1.0), np.float32(1.0), np.float32(1.0), np.float32(0.0), np.float32(0.0), np.float32(1.0), np.float32(1.0), np.float32(0.0), np.float32(1.0)]",-1.0,99972.0,16
2025-08-14_08-18-36,1311,"[np.float32(0.0), np.float32(1.0), np.float32(1.0), np.float32(0.0), np.float32(0.0), np.float32(0.0), np.float32(0.0), np.float32(0.0), np.float32(1.0), np.float32(0.0), np.float32(1.0), np.float32(1.0), np.float32(1.0), np.float32(0.0), np.float32(0.0), np.float32(0.0)]",-3.0,99969.0,25
2025-08-14_08-18-36,1312,"[np.float32(0.0), np.float32(0.0), np.float32(0.0), np.float32(0.0), np.float32(1.0), np.float32(0.0), np.float32(1.0), np.float32(1.0), np.float32(1.0), np.float32(0.0), np.float32(0.0), np.float32(0.0), np.float32(1.0), np.float32(0.0), np.float32(1.0), np.float32(0.0)]",-3.0,99966.0,35
2025-08-14_08-18-36,1313,"[np.float32(0.0), np.float32(0.0), np.float32(0.0), np.float32(1.0), np.float32(0.0), np.float32(1.0), np.float32(0.0), np.float32(1.0), np.float32(1.0), np.float32(1.0), np.float32(1.0), np.float32(1.0), np.float32(0.0), np.float32(0.0), np.float32(0.0), np.float32(0.0)]",1.0,99967.0,22
2025-08-14_08-18-36,1314,"[np.float32(1.0), np.float32(1.0), np.float32(0.0), np.float32(1.0), np.float32(0.0), np.float32(0.0), np.float32(1.0), np.float32(1.0), np.float32(0.0), np.float32(0.0), np.float32(0.0), np.float32(1.0), np.float32(1.0), np.float32(1.0), np.float32(0.0), np.float32(0.0)]",0.0,99967.0,24
2025-08-14_08-18-36,1315,"[np.float32(1.0), np.float32(0.0), np.float32(1.0), np.float32(1.0), np.float32(1.0), np.float32(1.0), np.float32(0.0), np.float32(0.0), np.float32(0.0), np.float32(0.0), np.float32(1.0), np.float32(0.0), np.float32(1.0), np.float32(1.0), np.float32(1.0), np.float32(0.0)]",0.0,99967.0,18
2025-08-14_08-18-36,1316,"[np.float32(1.0), np.float32(1.0), np.float32(0.0), np.float32(0.0), np.float32(0.0), np.float32(0.0), np.float32(0.0), np.float32(0.0), np.float32(1.0), np.float32(0.0), np.float32(1.0), np.float32(0.0), np.float32(1.0), np.float32(0.0), np.float32(0.0), np.float32(1.0)]",-1.0,99966.0,9
2025-08-14_08-18-36,1317,"[np.float32(1.0), np.float32(0.0), np.float32(0.0), np.float32(1.0), np.float32(1.0), np.float32(0.0), np.float32(0.0), np.float32(0.0), np.float32(0.0), np.float32(1.0), np.float32(0.0), np.float32(0.0), np.float32(0.0), np.float32(0.0), np.float32(1.0), np.float32(0.0)]",1.0,99967.0,3
2025-08-14_08-18-36,1318,"[np.float32(1.0), np.float32(0.0), np.float32(0.0), np.float32(0.0), np.float32(0.0), np.float32(0.0), np.float32(0.0), np.float32(0.0), np.float32(1.0), np.float32(1.0), np.float32(0.0), np.float32(0.0), np.float32(1.0), np.float32(0.0), np.float32(0.0), np.float32(1.0)]",-3.0,99964.0,3
2025-08-14_08-18-36,1319,"[np.float32(0.0), np.float32(0.0), np.float32(1.0), np.float32(1.0), np.float32(1.0), np.float32(0.0), np.float32(0.0), np.float32(1.0), np.float32(0.0), np.float32(1.0), np.float32(1.0), np.float32(1.0), np.float32(0.0), np.float32(0.0), np.float32(0.0), np.float32(0.0)]",-2.0,99962.0,30
2025-08-14_08-18-36,1320,"[np.float32(0.0), np.float32(1.0), np.float32(0.0), np.float32(0.0), np.float32(0.0), np.float32(0.0), np.float32(1.0), np.float32(0.0), np.float32(1.0), np.float32(0.0), np.float32(0.0), np.float32(1.0), np.float32(1.0), np.float32(1.0), np.float32(0.0), np.float32(1.0)]",2.0,99964.0,3
2025-08-14_08-18-36,1321,"[np.float32(1.0), np.float32(0.0), np.float32(1.0), np.float32(0.0), np.float32(1.0), np.float32(1.0), np.float32(0.0), np.float32(1.0), np.float32(1.0), np.float32(0.0), np.float32(0.0), np.float32(1.0), np.float32(0.0), np.float32(0.0), np.float32(0.0), np.float32(0.0)]",-2.0,99962.0,29
2025-08-14_08-18-36,1322,"[np.float32(1.0), np.float32(0.0), np.float32(0.0), np.float32(0.0), np.float32(0.0), np.float32(0.0), np.float32(0.0), np.float32(0.0), np.float32(0.0), np.float32(1.0), np.float32(0.0), np.float32(0.0), np.float32(1.0), np.float32(1.0), np.float32(1.0), np.float32(1.0)]",-3.0,99959.0,6
2025-08-14_08-18-36,1323,"[np.float32(1.0), np.float32(1.0), np.float32(0.0), np.float32(0.0), np.float32(1.0), np.float32(1.0), np.float32(1.0), np.float32(1.0), np.float32(1.0), np.float32(0.0), np.float32(0.0), np.float32(0.0), np.float32(0.0), np.float32(1.0), np.float32(0.0), np.float32(0.0)]",2.0,99961.0,19
2025-08-14_08-18-36,1324,"[np.float32(1.0), np.float32(1.0), np.float32(1.0), np.float32(1.0), np.float32(0.0), np.float32(1.0), np.float32(1.0), np.float32(0.0), np.float32(1.0), np.float32(0.0), np.float32(1.0), np.float32(1.0), np.float32(1.0), np.float32(0.0), np.float32(1.0), np.float32(1.0)]",-2.0,99959.0,2
2025-08-14_08-18-36,1325,"[np.float32(0.0), np.float32(1.0), np.float32(0.0), np.float32(1.0), np.float32(0.0), np.float32(1.0), np.float32(0.0), np.float32(0.0), np.float32(0.0), np.float32(0.0), np.float32(1.0), np.float32(1.0), np.float32(0.0), np.float32(0.0), np.float32(1.0), np.float32(0.0)]",1.0,99960.0,13
2025-08-14_08-18-36,1326,"[np.float32(1.0), np.float32(0.0), np.float32(1.0), np.float32(0.0), np.float32(1.0), np.float32(1.0), np.float32(1.0), np.float32(1.0), np.float32(0.0), np.float32(1.0), np.float32(0.0), np.float32(1.0), np.float32(0.0), np.float32(1.0), np.float32(1.0), np.float32(1.0)]",-2.0,99958.0,32
2025-08-14_08-18-36,1327,"[np.float32(0.0), np.float32(0.0), np.float32(1.0), np.float32(0.0), np.float32(0.0), np.float32(1.0), np.float32(0.0), np.float32(0.0), np.float32(0.0), np.float32(1.0), np.float32(0.0), np.float32(1.0), np.float32(0.0), np.float32(0.0), np.float32(0.0), np.float32(0.0)]",1.0,99959.0,4
2025-08-14_08-18-36,1328,"[np.float32(0.0), np.float32(1.0), np.float32(1.0), np.float32(1.0), np.float32(0.0), np.float32(1.0), np.float32(1.0), np.float32(1.0), np.float32(0.0), np.float32(0.0), np.float32(1.0), np.float32(1.0), np.float32(0.0), np.float32(0.0), np.float32(1.0), np.float32(0.0)]",6.0,99965.0,24
2025-08-14_08-18-36,1329,"[np.float32(1.0), np.float32(0.0), np.float32(1.0), np.float32(0.0), np.float32(1.0), np.float32(0.0), np.float32(0.0), np.float32(0.0), np.float32(0.0), np.float32(1.0), np.float32(0.0), np.float32(0.0), np.float32(1.0), np.float32(1.0), np.float32(0.0), np.float32(0.0)]",-4.0,99961.0,17
2025-08-14_08-18-36,1330,"[np.float32(0.0), np.float32(0.0), np.float32(0.0), np.float32(1.0), np.float32(0.0), np.float32(1.0), np.float32(0.0), np.float32(0.0), np.float32(0.0), np.float32(1.0), np.float32(1.0), np.float32(0.0), np.float32(1.0), np.float32(0.0), np.float32(1.0), np.float32(0.0)]",-4.0,99957.0,0
2025-08-14_08-18-36,1331,"[np.float32(1.0), np.float32(0.0), np.float32(1.0), np.float32(1.0), np.float32(0.0), np.float32(1.0), np.float32(0.0), np.float32(1.0), np.float32(0.0), np.float32(0.0), np.float32(0.0), np.float32(0.0), np.float32(1.0), np.float32(0.0), np.float32(1.0), np.float32(1.0)]",-1.0,99956.0,22
2025-08-14_08-18-36,1332,"[np.float32(0.0), np.float32(1.0), np.float32(0.0), np.float32(0.0), np.float32(0.0), np.float32(0.0), np.float32(0.0), np.float32(1.0), np.float32(1.0), np.float32(1.0), np.float32(0.0), np.float32(1.0), np.float32(1.0), np.float32(1.0), np.float32(0.0), np.float32(0.0)]",35.0,99991.0,7
2025-08-14_08-18-36,1333,"[np.float32(1.0), np.float32(0.0), np.float32(1.0), np.float32(0.0), np.float32(0.0), np.float32(1.0), np.float32(0.0), np.float32(1.0), np.float32(1.0), np.float32(1.0), np.float32(1.0), np.float32(1.0), np.float32(1.0), np.float32(0.0), np.float32(1.0), np.float32(1.0)]",-7.0,99984.0,0
2025-08-14_08-18-36,1334,"[np.float32(0.0), np.float32(1.0), np.float32(0.0), np.float32(1.0), np.float32(0.0), np.float32(0.0), np.float32(0.0), np.float32(0.0), np.float32(1.0), np.float32(1.0), np.float32(0.0), np.float32(0.0), np.float32(0.0), np.float32(0.0), np.float32(1.0), np.float32(0.0)]",-5.0,99979.0,18
2025-08-14_08-18-36,1335,"[np.float32(1.0), np.float32(1.0), np.float32(1.0), np.float32(0.0), np.float32(1.0), np.float32(0.0), np.float32(1.0), np.float32(0.0), np.float32(0.0), np.float32(0.0), np.float32(0.0), np.float32(1.0), np.float32(1.0), np.float32(0.0), np.float32(1.0), np.float32(0.0)]",-1.0,99978.0,15
2025-08-14_08-18-36,1336,"[np.float32(0.0), np.float32(1.0), np.float32(1.0), np.float32(0.0), np.float32(1.0), np.float32(0.0), np.float32(1.0), np.float32(1.0), np.float32(0.0), np.float32(1.0), np.float32(0.0), np.float32(0.0), np.float32(0.0), np.float32(0.0), np.float32(1.0), np.float32(1.0)]",2.0,99980.0,14
2025-08-14_08-18-36,1337,"[np.float32(1.0), np.float32(0.0), np.float32(0.0), np.float32(0.0), np.float32(1.0), np.float32(1.0), np.float32(0.0), np.float32(0.0), np.float32(0.0), np.float32(0.0), np.float32(0.0), np.float32(0.0), np.float32(1.0), np.float32(1.0), np.float32(1.0), np.float32(1.0)]",0.0,99980.0,25
2025-08-14_08-18-36,1338,"[np.float32(0.0), np.float32(1.0), np.float32(0.0), np.float32(0.0), np.float32(0.0), np.float32(0.0), np.float32(1.0), np.float32(1.0), np.float32(1.0), np.float32(0.0), np.float32(0.0), np.float32(1.0), np.float32(1.0), np.float32(1.0), np.float32(1.0), np.float32(1.0)]",-1.0,99979.0,11
2025-08-14_08-18-36,1339,"[np.float32(0.0), np.float32(1.0), np.float32(1.0), np.float32(1.0), np.float32(1.0), np.float32(1.0), np.float32(0.0), np.float32(0.0), np.float32(1.0), np.float32(0.0), np.float32(1.0), np.float32(0.0), np.float32(0.0), np.float32(1.0), np.float32(0.0), np.float32(1.0)]",3.0,99982.0,20
2025-08-14_08-18-36,1340,"[np.float32(1.0), np.float32(0.0), np.float32(1.0), np.float32(0.0), np.float32(0.0), np.float32(0.0), np.float32(0.0), np.float32(0.0), np.float32(0.0), np.float32(1.0), np.float32(0.0), np.float32(0.0), np.float32(1.0), np.float32(0.0), np.float32(0.0), np.float32(0.0)]",-4.0,99978.0,11
2025-08-14_08-18-36,1341,"[np.float32(1.0), np.float32(0.0), np.float32(0.0), np.float32(0.0), np.float32(0.0), np.float32(0.0), np.float32(0.0), np.float32(0.0), np.float32(0.0), np.float32(0.0), np.float32(1.0), np.float32(0.0), np.float32(1.0), np.float32(1.0), np.float32(0.0), np.float32(1.0)]",36.0,100014.0,7
2025-08-14_08-18-36,1342,"[np.float32(0.0), np.float32(1.0), np.float32(0.0), np.float32(1.0), np.float32(1.0), np.float32(0.0), np.float32(0.0), np.float32(0.0), np.float32(1.0), np.float32(0.0), np.float32(1.0), np.float32(0.0), np.float32(0.0), np.float32(0.0), np.float32(1.0), np.float32(1.0)]",-3.0,100011.0,7
2025-08-14_08-18-36,1343,"[np.float32(1.0), np.float32(0.0), np.float32(0.0), np.float32(1.0), np.float32(1.0), np.float32(0.0), np.float32(1.0), np.float32(0.0), np.float32(0.0), np.float32(0.0), np.float32(1.0), np.float32(0.0), np.float32(0.0), np.float32(1.0), np.float32(0.0), np.float32(1.0)]",-4.0,100007.0,28
2025-08-14_08-18-36,1344,"[np.float32(1.0), np.float32(1.0), np.float32(0.0), np.float32(1.0), np.float32(1.0), np.float32(1.0), np.float32(1.0), np.float32(1.0), np.float32(0.0), np.float32(0.0), np.float32(1.0), np.float32(1.0), np.float32(0.0), np.float32(1.0), np.float32(1.0), np.float32(0.0)]",1.0,100008.0,13
2025-08-14_08-18-36,1345,"[np.float32(0.0), np.float32(0.0), np.float32(0.0), np.float32(1.0), np.float32(0.0), np.float32(1.0), np.float32(0.0), np.float32(1.0), np.float32(1.0), np.float32(0.0), np.float32(1.0), np.float32(0.0), np.float32(1.0), np.float32(0.0), np.float32(0.0), np.float32(0.0)]",1.0,100009.0,19
2025-08-14_08-18-36,1346,"[np.float32(1.0), np.float32(0.0), np.float32(0.0), np.float32(1.0), np.float32(0.0), np.float32(0.0), np.float32(0.0), np.float32(0.0), np.float32(0.0), np.float32(0.0), np.float32(1.0), np.float32(0.0), np.float32(0.0), np.float32(0.0), np.float32(1.0), np.float32(0.0)]",4.0,100013.0,11
2025-08-14_08-18-36,1347,"[np.float32(1.0), np.float32(0.0), np.float32(1.0), np.float32(1.0), np.float32(0.0), np.float32(0.0), np.float32(1.0), np.float32(1.0), np.float32(1.0), np.float32(0.0), np.float32(1.0), np.float32(1.0), np.float32(1.0), np.float32(1.0), np.float32(1.0), np.float32(0.0)]",-4.0,100009.0,1
2025-08-14_08-18-36,1348,"[np.float32(0.0), np.float32(1.0), np.float32(1.0), np.float32(1.0), np.float32(0.0), np.float32(1.0), np.float32(0.0), np.float32(1.0), np.float32(0.0), np.float32(0.0), np.float32(1.0), np.float32(0.0), np.float32(1.0), np.float32(1.0), np.float32(0.0), np.float32(1.0)]",4.0,100013.0,17
2025-08-14_08-18-36,1349,"[np.float32(1.0), np.float32(1.0), np.float32(1.0), np.float32(1.0), np.float32(0.0), np.float32(1.0), np.float32(0.0), np.float32(1.0), np.float32(0.0), np.float32(1.0), np.float32(1.0), np.float32(0.0), np.float32(0.0), np.float32(1.0), np.float32(0.0), np.float32(0.0)]",1.0,100014.0,17
2025-08-14_08-18-36,1350,"[np.float32(0.0), np.float32(1.0), np.float32(0.0), np.float32(1.0), np.float32(1.0), np.float32(0.0), np.float32(0.0), np.float32(1.0), np.float32(1.0), np.float32(1.0), np.float32(1.0), np.float32(0.0), np.float32(0.0), np.float32(1.0), np.float32(0.0), np.float32(1.0)]",2.0,100016.0,19
2025-08-14_08-18-36,1351,"[np.float32(0.0), np.float32(1.0), np.float32(1.0), np.float32(1.0), np.float32(0.0), np.float32(1.0), np.float32(1.0), np.float32(0.0), np.float32(1.0), np.float32(0.0), np.float32(0.0), np.float32(1.0), np.float32(0.0), np.float32(0.0), np.float32(1.0), np.float32(0.0)]",1.0,100017.0,26
2025-08-14_08-18-36,1352,"[np.float32(1.0), np.float32(1.0), np.float32(1.0), np.float32(0.0), np.float32(1.0), np.float32(0.0), np.float32(1.0), np.float32(1.0), np.float32(0.0), np.float32(1.0), np.float32(1.0), np.float32(0.0), np.float32(0.0), np.float32(0.0), np.float32(0.0), np.float32(1.0)]",-4.0,100013.0,35
2025-08-14_08-18-36,1353,"[np.float32(0.0), np.float32(1.0), np.float32(0.0), np.float32(1.0), np.float32(0.0), np.float32(1.0), np.float32(1.0), np.float32(0.0), np.float32(0.0), np.float32(1.0), np.float32(1.0), np.float32(1.0), np.float32(0.0), np.float32(1.0), np.float32(0.0), np.float32(1.0)]",-1.0,100012.0,34
2025-08-14_08-18-36,1354,"[np.float32(1.0), np.float32(0.0), np.float32(0.0), np.float32(1.0), np.float32(0.0), np.float32(0.0), np.float32(0.0), np.float32(0.0), np.float32(0.0), np.float32(0.0), np.float32(1.0), np.float32(1.0), np.float32(1.0), np.float32(1.0), np.float32(0.0), np.float32(1.0)]",1.0,100013.0,32
2025-08-14_08-18-36,1355,"[np.float32(0.0), np.float32(0.0), np.float32(1.0), np.float32(0.0), np.float32(0.0), np.float32(0.0), np.float32(1.0), np.float32(0.0), np.float32(0.0), np.float32(0.0), np.float32(1.0), np.float32(0.0), np.float32(1.0), np.float32(1.0), np.float32(0.0), np.float32(1.0)]",2.0,100015.0,26
2025-08-14_08-18-36,1356,"[np.float32(1.0), np.float32(1.0), np.float32(1.0), np.float32(0.0), np.float32(1.0), np.float32(0.0), np.float32(0.0), np.float32(0.0), np.float32(0.0), np.float32(0.0), np.float32(1.0), np.float32(0.0), np.float32(1.0), np.float32(0.0), np.float32(0.0), np.float32(0.0)]",1.0,100016.0,32
2025-08-14_08-18-36,1357,"[np.float32(1.0), np.float32(1.0), np.float32(0.0), np.float32(0.0), np.float32(1.0), np.float32(0.0), np.float32(0.0), np.float32(0.0), np.float32(0.0), np.float32(1.0), np.float32(1.0), np.float32(1.0), np.float32(1.0), np.float32(0.0), np.float32(0.0), np.float32(1.0)]",-1.0,100015.0,11
2025-08-14_08-18-36,1358,"[np.float32(0.0), np.float32(0.0), np.float32(0.0), np.float32(0.0), np.float32(0.0), np.float32(0.0), np.float32(1.0), np.float32(0.0), np.float32(1.0), np.float32(1.0), np.float32(0.0), np.float32(1.0), np.float32(0.0), np.float32(0.0), np.float32(0.0), np.float32(1.0)]",-2.0,100013.0,26
2025-08-14_08-18-36,1359,"[np.float32(0.0), np.float32(0.0), np.float32(0.0), np.float32(1.0), np.float32(0.0), np.float32(1.0), np.float32(1.0), np.float32(1.0), np.float32(1.0), np.float32(0.0), np.float32(0.0), np.float32(0.0), np.float32(1.0), np.float32(0.0), np.float32(1.0), np.float32(1.0)]",0.0,100013.0,17
2025-08-14_08-18-36,1360,"[np.float32(1.0), np.float32(1.0), np.float32(0.0), np.float32(0.0), np.float32(0.0), np.float32(1.0), np.float32(1.0), np.float32(0.0), np.float32(0.0), np.float32(1.0), np.float32(0.0), np.float32(0.0), np.float32(1.0), np.float32(1.0), np.float32(1.0), np.float32(1.0)]",-2.0,100011.0,23
2025-08-14_08-18-36,1361,"[np.float32(1.0), np.float32(0.0), np.float32(0.0), np.float32(0.0), np.float32(0.0), np.float32(1.0), np.float32(0.0), np.float32(1.0), np.float32(1.0), np.float32(0.0), np.float32(1.0), np.float32(0.0), np.float32(0.0), np.float32(1.0), np.float32(0.0), np.float32(1.0)]",4.0,100015.0,35
2025-08-14_08-18-36,1362,"[np.float32(0.0), np.float32(0.0), np.float32(1.0), np.float32(1.0), np.float32(1.0), np.float32(0.0), np.float32(1.0), np.float32(1.0), np.float32(0.0), np.float32(1.0), np.float32(1.0), np.float32(0.0), np.float32(1.0), np.float32(1.0), np.float32(0.0), np.float32(0.0)]",-1.0,100014.0,35
2025-08-14_08-18-36,1363,"[np.float32(0.0), np.float32(1.0), np.float32(1.0), np.float32(0.0), np.float32(1.0), np.float32(1.0), np.float32(0.0), np.float32(1.0), np.float32(1.0), np.float32(0.0), np.float32(1.0), np.float32(1.0), np.float32(1.0), np.float32(0.0), np.float32(0.0), np.float32(1.0)]",0.0,100014.0,32
2025-08-14_08-18-36,1364,"[np.float32(0.0), np.float32(0.0), np.float32(0.0), np.float32(1.0), np.float32(1.0), np.float32(1.0), np.float32(0.0), np.float32(1.0), np.float32(1.0), np.float32(1.0), np.float32(0.0), np.float32(1.0), np.float32(0.0), np.float32(1.0), np.float32(1.0), np.float32(0.0)]",-4.0,100010.0,20
2025-08-14_08-18-36,1365,"[np.float32(1.0), np.float32(0.0), np.float32(1.0), np.float32(1.0), np.float32(0.0), np.float32(0.0), np.float32(0.0), np.float32(1.0), np.float32(1.0), np.float32(0.0), np.float32(1.0), np.float32(1.0), np.float32(0.0), np.float32(0.0), np.float32(0.0), np.float32(1.0)]",-3.0,100007.0,2
2025-08-14_08-18-36,1366,"[np.float32(0.0), np.float32(1.0), np.float32(0.0), np.float32(1.0), np.float32(1.0), np.float32(1.0), np.float32(1.0), np.float32(0.0), np.float32(0.0), np.float32(1.0), np.float32(0.0), np.float32(0.0), np.float32(1.0), np.float32(0.0), np.float32(0.0), np.float32(1.0)]",-1.0,100006.0,25
2025-08-14_08-18-36,1367,"[np.float32(0.0), np.float32(1.0), np.float32(0.0), np.float32(1.0), np.float32(1.0), np.float32(0.0), np.float32(0.0), np.float32(1.0), np.float32(0.0), np.float32(0.0), np.float32(1.0), np.float32(0.0), np.float32(1.0), np.float32(0.0), np.float32(0.0), np.float32(0.0)]",-4.0,100002.0,0
2025-08-14_08-18-36,1368,"[np.float32(0.0), np.float32(0.0), np.float32(1.0), np.float32(1.0), np.float32(1.0), np.float32(0.0), np.float32(1.0), np.float32(1.0), np.float32(1.0), np.float32(1.0), np.float32(1.0), np.float32(0.0), np.float32(1.0), np.float32(1.0), np.float32(1.0), np.float32(1.0)]",1.0,100003.0,13
2025-08-14_08-18-36,1369,"[np.float32(1.0), np.float32(0.0), np.float32(0.0), np.float32(0.0), np.float32(1.0), np.float32(1.0), np.float32(1.0), np.float32(1.0), np.float32(1.0), np.float32(0.0), np.float32(1.0), np.float32(0.0), np.float32(1.0), np.float32(0.0), np.float32(1.0), np.float32(0.0)]",-1.0,100002.0,33
2025-08-14_08-18-36,1370,"[np.float32(0.0), np.float32(1.0), np.float32(1.0), np.float32(0.0), np.float32(0.0), np.float32(0.0), np.float32(0.0), np.float32(1.0), np.float32(1.0), np.float32(0.0), np.float32(0.0), np.float32(0.0), np.float32(1.0), np.float32(1.0), np.float32(1.0), np.float32(0.0)]",1.0,100003.0,13
2025-08-14_08-18-36,1371,"[np.float32(1.0), np.float32(0.0), np.float32(0.0), np.float32(1.0), np.float32(1.0), np.float32(0.0), np.float32(0.0), np.float32(0.0), np.float32(1.0), np.float32(1.0), np.float32(1.0), np.float32(1.0), np.float32(0.0), np.float32(0.0), np.float32(1.0), np.float32(0.0)]",-1.0,100002.0,19
2025-08-14_08-18-36,1372,"[np.float32(1.0), np.float32(0.0), np.float32(0.0), np.float32(1.0), np.float32(0.0), np.float32(1.0), np.float32(1.0), np.float32(1.0), np.float32(0.0), np.float32(0.0), np.float32(1.0), np.float32(1.0), np.float32(1.0), np.float32(0.0), np.float32(1.0), np.float32(0.0)]",-6.0,99996.0,4
2025-08-14_08-18-36,1373,"[np.float32(1.0), np.float32(0.0), np.float32(0.0), np.float32(0.0), np.float32(1.0), np.float32(1.0), np.float32(1.0), np.float32(0.0), np.float32(1.0), np.float32(1.0), np.float32(0.0), np.float32(0.0), np.float32(0.0), np.float32(0.0), np.float32(0.0), np.float32(1.0)]",0.0,99996.0,27
2025-08-14_08-18-36,1374,"[np.float32(0.0), np.float32(1.0), np.float32(0.0), np.float32(1.0), np.float32(1.0), np.float32(0.0), np.float32(1.0), np.float32(0.0), np.float32(1.0), np.float32(0.0), np.float32(0.0), np.float32(0.0), np.float32(0.0), np.float32(0.0), np.float32(0.0), np.float32(1.0)]",-4.0,99992.0,21
2025-08-14_08-18-36,1375,"[np.float32(0.0), np.float32(0.0), np.float32(1.0), np.float32(1.0), np.float32(0.0), np.float32(1.0), np.float32(1.0), np.float32(0.0), np.float32(1.0), np.float32(0.0), np.float32(1.0), np.float32(0.0), np.float32(1.0), np.float32(0.0), np.float32(1.0), np.float32(1.0)]",-5.0,99987.0,0
2025-08-14_08-18-36,1376,"[np.float32(1.0), np.float32(1.0), np.float32(0.0), np.float32(1.0), np.float32(1.0), np.float32(1.0), np.float32(0.0), np.float32(1.0), np.float32(1.0), np.float32(0.0), np.float32(1.0), np.float32(0.0), np.float32(1.0), np.float32(0.0), np.float32(0.0), np.float32(1.0)]",-1.0,99986.0,25
2025-08-14_08-18-36,1377,"[np.float32(1.0), np.float32(1.0), np.float32(1.0), np.float32(0.0), np.float32(1.0), np.float32(1.0), np.float32(1.0), np.float32(0.0), np.float32(0.0), np.float32(1.0), np.float32(0.0), np.float32(0.0), np.float32(0.0), np.float32(0.0), np.float32(0.0), np.float32(1.0)]",1.0,99987.0,22
2025-08-14_08-18-36,1378,"[np.float32(0.0), np.float32(0.0), np.float32(0.0), np.float32(1.0), np.float32(0.0), np.float32(0.0), np.float32(1.0), np.float32(1.0), np.float32(0.0), np.float32(0.0), np.float32(0.0), np.float32(1.0), np.float32(0.0), np.float32(1.0), np.float32(1.0), np.float32(0.0)]",-3.0,99984.0,28
2025-08-14_08-18-36,1379,"[np.float32(1.0), np.float32(1.0), np.float32(0.0), np.float32(0.0), np.float32(0.0), np.float32(1.0), np.float32(0.0), np.float32(1.0), np.float32(0.0), np.float32(1.0), np.float32(1.0), np.float32(0.0), np.float32(0.0), np.float32(1.0), np.float32(0.0), np.float32(0.0)]",-2.0,99982.0,5
2025-08-14_08-18-36,1380,"[np.float32(0.0), np.float32(0.0), np.float32(0.0), np.float32(1.0), np.float32(0.0), np.float32(0.0), np.float32(0.0), np.float32(1.0), np.float32(0.0), np.float32(0.0), np.float32(1.0), np.float32(1.0), np.float32(1.0), np.float32(0.0), np.float32(1.0), np.float32(1.0)]",1.0,99983.0,9
2025-08-14_08-18-36,1381,"[np.float32(1.0), np.float32(0.0), np.float32(1.0), np.float32(1.0), np.float32(1.0), np.float32(0.0), np.float32(0.0), np.float32(1.0), np.float32(0.0), np.float32(1.0), np.float32(0.0), np.float32(1.0), np.float32(1.0), np.float32(0.0), np.float32(1.0), np.float32(0.0)]",0.0,99983.0,1
2025-08-14_08-18-36,1382,"[np.float32(1.0), np.float32(1.0), np.float32(0.0), np.float32(1.0), np.float32(1.0), np.float32(1.0), np.float32(0.0), np.float32(1.0), np.float32(0.0), np.float32(0.0), np.float32(0.0), np.float32(0.0), np.float32(0.0), np.float32(1.0), np.float32(0.0), np.float32(0.0)]",0.0,99983.0,28
2025-08-14_08-18-36,1383,"[np.float32(0.0), np.float32(0.0), np.float32(1.0), np.float32(0.0), np.float32(0.0), np.float32(0.0), np.float32(1.0), np.float32(0.0), np.float32(1.0), np.float32(0.0), np.float32(0.0), np.float32(1.0), np.float32(1.0), np.float32(1.0), np.float32(0.0), np.float32(0.0)]",-1.0,99982.0,24
2025-08-14_08-18-36,1384,"[np.float32(1.0), np.float32(1.0), np.float32(0.0), np.float32(0.0), np.float32(1.0), np.float32(1.0), np.float32(0.0), np.float32(0.0), np.float32(1.0), np.float32(0.0), np.float32(1.0), np.float32(1.0), np.float32(1.0), np.float32(0.0), np.float32(0.0), np.float32(0.0)]",-1.0,99981.0,24
2025-08-14_08-18-36,1385,"[np.float32(0.0), np.float32(1.0), np.float32(0.0), np.float32(1.0), np.float32(0.0), np.float32(0.0), np.float32(1.0), np.float32(1.0), np.float32(0.0), np.float32(0.0), np.float32(1.0), np.float32(0.0), np.float32(0.0), np.float32(0.0), np.float32(1.0), np.float32(0.0)]",5.0,99986.0,23
2025-08-14_08-18-36,1386,"[np.float32(0.0), np.float32(1.0), np.float32(0.0), np.float32(1.0), np.float32(0.0), np.float32(1.0), np.float32(1.0), np.float32(1.0), np.float32(1.0), np.float32(0.0), np.float32(1.0), np.float32(1.0), np.float32(1.0), np.float32(0.0), np.float32(0.0), np.float32(0.0)]",1.0,99987.0,15
2025-08-14_08-18-36,1387,"[np.float32(0.0), np.float32(0.0), np.float32(1.0), np.float32(1.0), np.float32(0.0), np.float32(1.0), np.float32(0.0), np.float32(0.0), np.float32(1.0), np.float32(0.0), np.float32(0.0), np.float32(0.0), np.float32(0.0), np.float32(0.0), np.float32(0.0), np.float32(1.0)]",0.0,99987.0,17
2025-08-14_08-18-36,1388,"[np.float32(0.0), np.float32(1.0), np.float32(1.0), np.float32(0.0), np.float32(0.0), np.float32(0.0), np.float32(0.0), np.float32(1.0), np.float32(1.0), np.float32(1.0), np.float32(0.0), np.float32(0.0), np.float32(0.0), np.float32(0.0), np.float32(0.0), np.float32(0.0)]",5.0,99992.0,22
2025-08-14_08-18-36,1389,"[np.float32(0.0), np.float32(0.0), np.float32(1.0), np.float32(1.0), np.float32(1.0), np.float32(0.0), np.float32(1.0), np.float32(1.0), np.float32(0.0), np.float32(0.0), np.float32(1.0), np.float32(0.0), np.float32(1.0), np.float32(0.0), np.float32(0.0), np.float32(1.0)]",2.0,99994.0,6
2025-08-14_08-18-36,1390,"[np.float32(0.0), np.float32(0.0), np.float32(0.0), np.float32(1.0), np.float32(0.0), np.float32(1.0), np.float32(0.0), np.float32(1.0), np.float32(1.0), np.float32(1.0), np.float32(1.0), np.float32(1.0), np.float32(1.0), np.float32(1.0), np.float32(0.0), np.float32(1.0)]",0.0,99994.0,27
2025-08-14_08-18-36,1391,"[np.float32(1.0), np.float32(1.0), np.float32(0.0), np.float32(1.0), np.float32(0.0), np.float32(0.0), np.float32(0.0), np.float32(1.0), np.float32(1.0), np.float32(0.0), np.float32(1.0), np.float32(1.0), np.float32(0.0), np.float32(1.0), np.float32(0.0), np.float32(1.0)]",2.0,99996.0,26
2025-08-14_08-18-36,1392,"[np.float32(1.0), np.float32(0.0), np.float32(0.0), np.float32(1.0), np.float32(0.0), np.float32(1.0), np.float32(1.0), np.float32(0.0), np.float32(1.0), np.float32(1.0), np.float32(0.0), np.float32(0.0), np.float32(1.0), np.float32(0.0), np.float32(0.0), np.float32(1.0)]",5.0,100001.0,1
2025-08-14_08-18-36,1393,"[np.float32(0.0), np.float32(0.0), np.float32(1.0), np.float32(0.0), np.float32(0.0), np.float32(0.0), np.float32(0.0), np.float32(1.0), np.float32(0.0), np.float32(1.0), np.float32(0.0), np.float32(1.0), np.float32(0.0), np.float32(1.0), np.float32(0.0), np.float32(1.0)]",-1.0,100000.0,30
2025-08-14_08-18-36,1394,"[np.float32(0.0), np.float32(0.0), np.float32(0.0), np.float32(1.0), np.float32(0.0), np.float32(1.0), np.float32(0.0), np.float32(0.0), np.float32(1.0), np.float32(0.0), np.float32(1.0), np.float32(1.0), np.float32(1.0), np.float32(0.0), np.float32(1.0), np.float32(0.0)]",3.0,100003.0,35
2025-08-14_08-18-36,1395,"[np.float32(0.0), np.float32(1.0), np.float32(0.0), np.float32(1.0), np.float32(0.0), np.float32(1.0), np.float32(0.0), np.float32(0.0), np.float32(0.0), np.float32(0.0), np.float32(0.0), np.float32(1.0), np.float32(0.0), np.float32(0.0), np.float32(1.0), np.float32(1.0)]",4.0,100007.0,24
2025-08-14_08-18-36,1396,"[np.float32(0.0), np.float32(1.0), np.float32(1.0), np.float32(1.0), np.float32(1.0), np.float32(1.0), np.float32(0.0), np.float32(0.0), np.float32(0.0), np.float32(1.0), np.float32(1.0), np.float32(0.0), np.float32(0.0), np.float32(0.0), np.float32(0.0), np.float32(0.0)]",-3.0,100004.0,9
2025-08-14_08-18-36,1397,"[np.float32(1.0), np.float32(1.0), np.float32(0.0), np.float32(1.0), np.float32(1.0), np.float32(1.0), np.float32(1.0), np.float32(1.0), np.float32(0.0), np.float32(0.0), np.float32(0.0), np.float32(1.0), np.float32(1.0), np.float32(1.0), np.float32(0.0), np.float32(1.0)]",-4.0,100000.0,28
2025-08-14_08-18-36,1398,"[np.float32(1.0), np.float32(0.0), np.float32(1.0), np.float32(1.0), np.float32(0.0), np.float32(0.0), np.float32(1.0), np.float32(0.0), np.float32(1.0), np.float32(1.0), np.float32(0.0), np.float32(0.0), np.float32(0.0), np.float32(1.0), np.float32(1.0), np.float32(0.0)]",2.0,100002.0,30
2025-08-14_08-18-36,1399,"[np.float32(1.0), np.float32(0.0), np.float32(1.0), np.float32(0.0), np.float32(1.0), np.float32(0.0), np.float32(0.0), np.float32(1.0), np.float32(0.0), np.float32(1.0), np.float32(1.0), np.float32(1.0), np.float32(0.0), np.float32(1.0), np.float32(1.0), np.float32(1.0)]",1.0,100003.0,21
2025-08-14_08-18-36,1400,"[np.float32(0.0), np.float32(1.0), np.float32(0.0), np.float32(0.0), np.float32(0.0), np.float32(1.0), np.float32(0.0), np.float32(0.0), np.float32(0.0), np.float32(1.0), np.float32(0.0), np.float32(1.0), np.float32(1.0), np.float32(0.0), np.float32(1.0), np.float32(1.0)]",-2.0,100001.0,23
2025-08-14_08-18-36,1401,"[np.float32(1.0), np.float32(1.0), np.float32(0.0), np.float32(1.0), np.float32(0.0), np.float32(1.0), np.float32(0.0), np.float32(1.0), np.float32(0.0), np.float32(0.0), np.float32(1.0), np.float32(1.0), np.float32(1.0), np.float32(1.0), np.float32(0.0), np.float32(1.0)]",0.0,100001.0,9
2025-08-14_08-18-36,1402,"[np.float32(1.0), np.float32(1.0), np.float32(1.0), np.float32(1.0), np.float32(0.0), np.float32(0.0), np.float32(1.0), np.float32(1.0), np.float32(1.0), np.float32(0.0), np.float32(0.0), np.float32(1.0), np.float32(1.0), np.float32(1.0), np.float32(0.0), np.float32(1.0)]",-1.0,100000.0,33
2025-08-14_08-18-36,1403,"[np.float32(1.0), np.float32(0.0), np.float32(1.0), np.float32(0.0), np.float32(0.0), np.float32(1.0), np.float32(1.0), np.float32(1.0), np.float32(1.0), np.float32(0.0), np.float32(1.0), np.float32(1.0), np.float32(1.0), np.float32(0.0), np.float32(1.0), np.float32(0.0)]",-1.0,99999.0,34
2025-08-14_08-18-36,1404,"[np.float32(1.0), np.float32(1.0), np.float32(1.0), np.float32(0.0), np.float32(0.0), np.float32(1.0), np.float32(1.0), np.float32(1.0), np.float32(1.0), np.float32(1.0), np.float32(0.0), np.float32(1.0), np.float32(1.0), np.float32(1.0), np.float32(1.0), np.float32(0.0)]",-2.0,99997.0,8
2025-08-14_08-18-36,1405,"[np.float32(1.0), np.float32(0.0), np.float32(1.0), np.float32(1.0), np.float32(1.0), np.float32(0.0), np.float32(1.0), np.float32(0.0), np.float32(1.0), np.float32(1.0), np.float32(0.0), np.float32(0.0), np.float32(0.0), np.float32(0.0), np.float32(0.0), np.float32(1.0)]",-3.0,99994.0,35
2025-08-14_08-18-36,1406,"[np.float32(0.0), np.float32(1.0), np.float32(0.0), np.float32(1.0), np.float32(0.0), np.float32(1.0), np.float32(1.0), np.float32(1.0), np.float32(1.0), np.float32(0.0), np.float32(0.0), np.float32(1.0), np.float32(0.0), np.float32(1.0), np.float32(1.0), np.float32(0.0)]",-4.0,99990.0,1
2025-08-14_08-18-36,1407,"[np.float32(1.0), np.float32(0.0), np.float32(0.0), np.float32(0.0), np.float32(0.0), np.float32(1.0), np.float32(1.0), np.float32(0.0), np.float32(1.0), np.float32(0.0), np.float32(0.0), np.float32(0.0), np.float32(0.0), np.float32(1.0), np.float32(0.0), np.float32(0.0)]",0.0,99990.0,18
2025-08-14_08-18-36,1408,"[np.float32(0.0), np.float32(1.0), np.float32(0.0), np.float32(1.0), np.float32(0.0), np.float32(1.0), np.float32(0.0), np.float32(0.0), np.float32(1.0), np.float32(0.0), np.float32(0.0), np.float32(0.0), np.float32(0.0), np.float32(0.0), np.float32(1.0), np.float32(1.0)]",2.0,99992.0,30
2025-08-14_08-18-36,1409,"[np.float32(1.0), np.float32(0.0), np.float32(0.0), np.float32(0.0), np.float32(0.0), np.float32(1.0), np.float32(0.0), np.float32(1.0), np.float32(0.0), np.float32(0.0), np.float32(0.0), np.float32(1.0), np.float32(0.0), np.float32(0.0), np.float32(0.0), np.float32(0.0)]",-2.0,99990.0,1
2025-08-14_08-18-36,1410,"[np.float32(1.0), np.float32(1.0), np.float32(0.0), np.float32(1.0), np.float32(1.0), np.float32(1.0), np.float32(0.0), np.float32(0.0), np.float32(1.0), np.float32(1.0), np.float32(0.0), np.float32(1.0), np.float32(0.0), np.float32(0.0), np.float32(0.0), np.float32(0.0)]",-1.0,99989.0,32
2025-08-14_08-18-36,1411,"[np.float32(0.0), np.float32(0.0), np.float32(0.0), np.float32(1.0), np.float32(0.0), np.float32(1.0), np.float32(0.0), np.float32(1.0), np.float32(0.0), np.float32(0.0), np.float32(1.0), np.float32(0.0), np.float32(0.0), np.float32(0.0), np.float32(0.0), np.float32(0.0)]",-1.0,99988.0,16
2025-08-14_08-18-36,1412,"[np.float32(1.0), np.float32(0.0), np.float32(1.0), np.float32(0.0), np.float32(1.0), np.float32(1.0), np.float32(1.0), np.float32(1.0), np.float32(0.0), np.float32(1.0), np.float32(1.0), np.float32(0.0), np.float32(1.0), np.float32(0.0), np.float32(0.0), np.float32(1.0)]",-4.0,99984.0,36
2025-08-14_08-18-36,1413,"[np.float32(1.0), np.float32(1.0), np.float32(1.0), np.float32(1.0), np.float32(1.0), np.float32(0.0), np.float32(1.0), np.float32(1.0), np.float32(0.0), np.float32(1.0), np.float32(0.0), np.float32(1.0), np.float32(1.0), np.float32(1.0), np.float32(1.0), np.float32(0.0)]",0.0,99984.0,5
2025-08-14_08-18-36,1414,"[np.float32(0.0), np.float32(1.0), np.float32(1.0), np.float32(1.0), np.float32(1.0), np.float32(1.0), np.float32(1.0), np.float32(0.0), np.float32(0.0), np.float32(0.0), np.float32(1.0), np.float32(0.0), np.float32(0.0), np.float32(1.0), np.float32(1.0), np.float32(0.0)]",0.0,99984.0,24
2025-08-14_08-18-36,1415,"[np.float32(0.0), np.float32(0.0), np.float32(0.0), np.float32(1.0), np.float32(0.0), np.float32(1.0), np.float32(0.0), np.float32(0.0), np.float32(0.0), np.float32(1.0), np.float32(0.0), np.float32(1.0), np.float32(1.0), np.float32(0.0), np.float32(0.0), np.float32(1.0)]",1.0,99985.0,27
2025-08-14_08-18-36,1416,"[np.float32(1.0), np.float32(1.0), np.float32(1.0), np.float32(1.0), np.float32(1.0), np.float32(0.0), np.float32(1.0), np.float32(1.0), np.float32(1.0), np.float32(0.0), np.float32(1.0), np.float32(1.0), np.float32(0.0), np.float32(1.0), np.float32(0.0), np.float32(0.0)]",1.0,99986.0,7
2025-08-14_08-18-36,1417,"[np.float32(0.0), np.float32(1.0), np.float32(1.0), np.float32(1.0), np.float32(0.0), np.float32(0.0), np.float32(1.0), np.float32(1.0), np.float32(0.0), np.float32(0.0), np.float32(0.0), np.float32(0.0), np.float32(0.0), np.float32(1.0), np.float32(1.0), np.float32(1.0)]",0.0,99986.0,1
2025-08-14_08-18-36,1418,"[np.float32(1.0), np.float32(1.0), np.float32(1.0), np.float32(1.0), np.float32(1.0), np.float32(0.0), np.float32(1.0), np.float32(1.0), np.float32(1.0), np.float32(0.0), np.float32(1.0), np.float32(0.0), np.float32(1.0), np.float32(0.0), np.float32(1.0), np.float32(1.0)]",1.0,99987.0,20
2025-08-14_08-18-36,1419,"[np.float32(0.0), np.float32(1.0), np.float32(0.0), np.float32(1.0), np.float32(1.0), np.float32(0.0), np.float32(0.0), np.float32(0.0), np.float32(1.0), np.float32(1.0), np.float32(1.0), np.float32(0.0), np.float32(1.0), np.float32(1.0), np.float32(1.0), np.float32(0.0)]",1.0,99988.0,8
2025-08-14_08-18-36,1420,"[np.float32(1.0), np.float32(0.0), np.float32(0.0), np.float32(1.0), np.float32(1.0), np.float32(1.0), np.float32(0.0), np.float32(0.0), np.float32(0.0), np.float32(1.0), np.float32(1.0), np.float32(1.0), np.float32(1.0), np.float32(0.0), np.float32(0.0), np.float32(0.0)]",-1.0,99987.0,30
2025-08-14_08-18-36,1421,"[np.float32(0.0), np.float32(1.0), np.float32(0.0), np.float32(0.0), np.float32(0.0), np.float32(0.0), np.float32(0.0), np.float32(1.0), np.float32(0.0), np.float32(1.0), np.float32(0.0), np.float32(0.0), np.float32(1.0), np.float32(1.0), np.float32(0.0), np.float32(0.0)]",-2.0,99985.0,3
2025-08-14_08-18-36,1422,"[np.float32(0.0), np.float32(0.0), np.float32(0.0), np.float32(0.0), np.float32(1.0), np.float32(1.0), np.float32(1.0), np.float32(1.0), np.float32(0.0), np.float32(1.0), np.float32(1.0), np.float32(1.0), np.float32(0.0), np.float32(0.0), np.float32(1.0), np.float32(0.0)]",0.0,99985.0,18
2025-08-14_08-18-36,1423,"[np.float32(0.0), np.float32(1.0), np.float32(1.0), np.float32(1.0), np.float32(0.0), np.float32(0.0), np.float32(1.0), np.float32(0.0), np.float32(0.0), np.float32(1.0), np.float32(0.0), np.float32(0.0), np.float32(0.0), np.float32(1.0), np.float32(0.0), np.float32(0.0)]",2.0,99987.0,25
2025-08-14_08-18-36,1424,"[np.float32(1.0), np.float32(0.0), np.float32(0.0), np.float32(1.0), np.float32(0.0), np.float32(1.0), np.float32(0.0), np.float32(0.0), np.float32(0.0), np.float32(1.0), np.float32(0.0), np.float32(1.0), np.float32(1.0), np.float32(1.0), np.float32(0.0), np.float32(1.0)]",-1.0,99986.0,36
2025-08-14_08-18-36,1425,"[np.float32(0.0), np.float32(0.0), np.float32(1.0), np.float32(1.0), np.float32(1.0), np.float32(1.0), np.float32(1.0), np.float32(1.0), np.float32(0.0), np.float32(0.0), np.float32(1.0), np.float32(0.0), np.float32(0.0), np.float32(1.0), np.float32(1.0), np.float32(0.0)]",4.0,99990.0,11
2025-08-14_08-18-36,1426,"[np.float32(1.0), np.float32(0.0), np.float32(1.0), np.float32(0.0), np.float32(0.0), np.float32(0.0), np.float32(1.0), np.float32(1.0), np.float32(0.0), np.float32(0.0), np.float32(1.0), np.float32(0.0), np.float32(0.0), np.float32(1.0), np.float32(0.0), np.float32(1.0)]",1.0,99991.0,3
2025-08-14_08-18-36,1427,"[np.float32(1.0), np.float32(0.0), np.float32(1.0), np.float32(0.0), np.float32(1.0), np.float32(0.0), np.float32(1.0), np.float32(0.0), np.float32(1.0), np.float32(0.0), np.float32(1.0), np.float32(1.0), np.float32(0.0), np.float32(0.0), np.float32(0.0), np.float32(0.0)]",0.0,99991.0,34
2025-08-14_08-18-36,1428,"[np.float32(0.0), np.float32(0.0), np.float32(0.0), np.float32(0.0), np.float32(1.0), np.float32(0.0), np.float32(1.0), np.float32(0.0), np.float32(1.0), np.float32(0.0), np.float32(1.0), np.float32(0.0), np.float32(1.0), np.float32(0.0), np.float32(1.0), np.float32(0.0)]",0.0,99991.0,29
2025-08-14_08-18-36,1429,"[np.float32(0.0), np.float32(0.0), np.float32(1.0), np.float32(1.0), np.float32(1.0), np.float32(1.0), np.float32(0.0), np.float32(0.0), np.float32(0.0), np.float32(1.0), np.float32(0.0), np.float32(1.0), np.float32(1.0), np.float32(0.0), np.float32(0.0), np.float32(1.0)]",-1.0,99990.0,22
2025-08-14_08-18-36,1430,"[np.float32(0.0), np.float32(0.0), np.float32(0.0), np.float32(0.0), np.float32(1.0), np.float32(0.0), np.float32(0.0), np.float32(1.0), np.float32(1.0), np.float32(0.0), np.float32(1.0), np.float32(1.0), np.float32(1.0), np.float32(1.0), np.float32(0.0), np.float32(0.0)]",-1.0,99989.0,25
2025-08-14_08-18-36,1431,"[np.float32(0.0), np.float32(0.0), np.float32(0.0), np.float32(1.0), np.float32(1.0), np.float32(0.0), np.float32(1.0), np.float32(0.0), np.float32(1.0), np.float32(0.0), np.float32(0.0), np.float32(0.0), np.float32(0.0), np.float32(0.0), np.float32(0.0), np.float32(1.0)]",-2.0,99987.0,28
2025-08-14_08-18-36,1432,"[np.float32(0.0), np.float32(0.0), np.float32(0.0), np.float32(0.0), np.float32(1.0), np.float32(0.0), np.float32(1.0), np.float32(1.0), np.float32(0.0), np.float32(0.0), np.float32(0.0), np.float32(1.0), np.float32(1.0), np.float32(0.0), np.float32(1.0), np.float32(0.0)]",2.0,99989.0,6
2025-08-14_08-18-36,1433,"[np.float32(0.0), np.float32(0.0), np.float32(0.0), np.float32(0.0), np.float32(0.0), np.float32(1.0), np.float32(0.0), np.float32(0.0), np.float32(1.0), np.float32(0.0), np.float32(1.0), np.float32(1.0), np.float32(0.0), np.float32(0.0), np.float32(0.0), np.float32(0.0)]",-2.0,99987.0,19
2025-08-14_08-18-36,1434,"[np.float32(0.0), np.float32(0.0), np.float32(1.0), np.float32(0.0), np.float32(1.0), np.float32(1.0), np.float32(1.0), np.float32(0.0), np.float32(1.0), np.float32(0.0), np.float32(0.0), np.float32(0.0), np.float32(1.0), np.float32(1.0), np.float32(1.0), np.float32(0.0)]",-1.0,99986.0,16
2025-08-14_08-18-36,1435,"[np.float32(1.0), np.float32(0.0), np.float32(0.0), np.float32(0.0), np.float32(0.0), np.float32(0.0), np.float32(1.0), np.float32(1.0), np.float32(0.0), np.float32(0.0), np.float32(1.0), np.float32(0.0), np.float32(0.0), np.float32(1.0), np.float32(1.0), np.float32(1.0)]",1.0,99987.0,12
2025-08-14_08-18-36,1436,"[np.float32(1.0), np.float32(1.0), np.float32(0.0), np.float32(0.0), np.float32(1.0), np.float32(1.0), np.float32(1.0), np.float32(1.0), np.float32(1.0), np.float32(0.0), np.float32(0.0), np.float32(1.0), np.float32(1.0), np.float32(0.0), np.float32(0.0), np.float32(0.0)]",-2.0,99985.0,34
2025-08-14_08-18-36,1437,"[np.float32(0.0), np.float32(0.0), np.float32(1.0), np.float32(0.0), np.float32(1.0), np.float32(0.0), np.float32(1.0), np.float32(0.0), np.float32(1.0), np.float32(0.0), np.float32(0.0), np.float32(0.0), np.float32(1.0), np.float32(1.0), np.float32(1.0), np.float32(0.0)]",1.0,99986.0,3
2025-08-14_08-18-36,1438,"[np.float32(0.0), np.float32(1.0), np.float32(0.0), np.float32(0.0), np.float32(0.0), np.float32(1.0), np.float32(1.0), np.float32(1.0), np.float32(0.0), np.float32(0.0), np.float32(0.0), np.float32(1.0), np.float32(0.0), np.float32(0.0), np.float32(0.0), np.float32(1.0)]",-1.0,99985.0,27
2025-08-14_08-18-36,1439,"[np.float32(0.0), np.float32(1.0), np.float32(0.0), np.float32(1.0), np.float32(0.0), np.float32(0.0), np.float32(0.0), np.float32(1.0), np.float32(1.0), np.float32(1.0), np.float32(0.0), np.float32(1.0), np.float32(1.0), np.float32(1.0), np.float32(1.0), np.float32(0.0)]",-3.0,99982.0,34
2025-08-14_08-18-36,1440,"[np.float32(0.0), np.float32(0.0), np.float32(0.0), np.float32(0.0), np.float32(1.0), np.float32(1.0), np.float32(0.0), np.float32(1.0), np.float32(0.0), np.float32(1.0), np.float32(0.0), np.float32(0.0), np.float32(0.0), np.float32(1.0), np.float32(0.0), np.float32(1.0)]",-1.0,99981.0,23
2025-08-14_08-18-36,1441,"[np.float32(1.0), np.float32(1.0), np.float32(1.0), np.float32(0.0), np.float32(0.0), np.float32(0.0), np.float32(0.0), np.float32(1.0), np.float32(0.0), np.float32(0.0), np.float32(1.0), np.float32(1.0), np.float32(0.0), np.float32(1.0), np.float32(1.0), np.float32(1.0)]",4.0,99985.0,20
2025-08-14_08-18-36,1442,"[np.float32(1.0), np.float32(0.0), np.float32(1.0), np.float32(0.0), np.float32(0.0), np.float32(0.0), np.float32(0.0), np.float32(0.0), np.float32(0.0), np.float32(0.0), np.float32(0.0), np.float32(1.0), np.float32(0.0), np.float32(0.0), np.float32(1.0), np.float32(0.0)]",-2.0,99983.0,25
2025-08-14_08-18-36,1443,"[np.float32(1.0), np.float32(1.0), np.float32(1.0), np.float32(1.0), np.float32(0.0), np.float32(0.0), np.float32(0.0), np.float32(0.0), np.float32(1.0), np.float32(1.0), np.float32(0.0), np.float32(0.0), np.float32(1.0), np.float32(0.0), np.float32(1.0), np.float32(0.0)]",-4.0,99979.0,9
2025-08-14_08-18-36,1444,"[np.float32(0.0), np.float32(1.0), np.float32(0.0), np.float32(0.0), np.float32(1.0), np.float32(1.0), np.float32(0.0), np.float32(1.0), np.float32(0.0), np.float32(1.0), np.float32(1.0), np.float32(0.0), np.float32(0.0), np.float32(1.0), np.float32(0.0), np.float32(0.0)]",-3.0,99976.0,6
2025-08-14_08-18-36,1445,"[np.float32(1.0), np.float32(0.0), np.float32(0.0), np.float32(0.0), np.float32(1.0), np.float32(1.0), np.float32(1.0), np.float32(1.0), np.float32(0.0), np.float32(0.0), np.float32(0.0), np.float32(0.0), np.float32(0.0), np.float32(1.0), np.float32(0.0), np.float32(0.0)]",4.0,99980.0,12
2025-08-14_08-18-36,1446,"[np.float32(0.0), np.float32(1.0), np.float32(1.0), np.float32(1.0), np.float32(0.0), np.float32(1.0), np.float32(1.0), np.float32(1.0), np.float32(0.0), np.float32(1.0), np.float32(0.0), np.float32(0.0), np.float32(1.0), np.float32(0.0), np.float32(1.0), np.float32(0.0)]",-2.0,99978.0,17
2025-08-14_08-18-36,1447,"[np.float32(0.0), np.float32(1.0), np.float32(1.0), np.float32(1.0), np.float32(0.0), np.float32(0.0), np.float32(1.0), np.float32(1.0), np.float32(1.0), np.float32(1.0), np.float32(1.0), np.float32(0.0), np.float32(1.0), np.float32(1.0), np.float32(1.0), np.float32(0.0)]",-1.0,99977.0,33
2025-08-14_08-18-36,1448,"[np.float32(1.0), np.float32(1.0), np.float32(0.0), np.float32(1.0), np.float32(1.0), np.float32(1.0), np.float32(1.0), np.float32(1.0), np.float32(0.0), np.float32(0.0), np.float32(0.0), np.float32(0.0), np.float32(0.0), np.float32(1.0), np.float32(0.0), np.float32(0.0)]",1.0,99978.0,13
2025-08-14_08-18-36,1449,"[np.float32(1.0), np.float32(0.0), np.float32(1.0), np.float32(0.0), np.float32(0.0), np.float32(0.0), np.float32(1.0), np.float32(1.0), np.float32(0.0), np.float32(1.0), np.float32(0.0), np.float32(0.0), np.float32(0.0), np.float32(1.0), np.float32(1.0), np.float32(0.0)]",-2.0,99976.0,20
2025-08-14_08-18-36,1450,"[np.float32(0.0), np.float32(1.0), np.float32(1.0), np.float32(1.0), np.float32(0.0), np.float32(1.0), np.float32(1.0), np.float32(1.0), np.float32(0.0), np.float32(1.0), np.float32(0.0), np.float32(0.0), np.float32(0.0), np.float32(0.0), np.float32(0.0), np.float32(1.0)]",2.0,99978.0,4
2025-08-14_08-18-36,1451,"[np.float32(0.0), np.float32(0.0), np.float32(0.0), np.float32(1.0), np.float32(0.0), np.float32(1.0), np.float32(0.0), np.float32(0.0), np.float32(1.0), np.float32(1.0), np.float32(0.0), np.float32(1.0), np.float32(1.0), np.float32(0.0), np.float32(0.0), np.float32(0.0)]",-4.0,99974.0,11
2025-08-14_08-18-36,1452,"[np.float32(1.0), np.float32(0.0), np.float32(0.0), np.float32(0.0), np.float32(1.0), np.float32(1.0), np.float32(1.0), np.float32(0.0), np.float32(0.0), np.float32(1.0), np.float32(0.0), np.float32(0.0), np.float32(0.0), np.float32(1.0), np.float32(0.0), np.float32(1.0)]",-2.0,99972.0,17
2025-08-14_08-18-36,1453,"[np.float32(0.0), np.float32(0.0), np.float32(0.0), np.float32(1.0), np.float32(0.0), np.float32(0.0), np.float32(1.0), np.float32(0.0), np.float32(0.0), np.float32(0.0), np.float32(1.0), np.float32(0.0), np.float32(0.0), np.float32(0.0), np.float32(1.0), np.float32(0.0)]",1.0,99973.0,33
2025-08-14_08-18-36,1454,"[np.float32(1.0), np.float32(1.0), np.float32(0.0), np.float32(1.0), np.float32(0.0), np.float32(1.0), np.float32(0.0), np.float32(0.0), np.float32(1.0), np.float32(0.0), np.float32(0.0), np.float32(1.0), np.float32(0.0), np.float32(1.0), np.float32(0.0), np.float32(0.0)]",0.0,99973.0,34
2025-08-14_08-18-36,1455,"[np.float32(1.0), np.float32(0.0), np.float32(1.0), np.float32(0.0), np.float32(0.0), np.float32(1.0), np.float32(0.0), np.float32(0.0), np.float32(0.0), np.float32(1.0), np.float32(0.0), np.float32(0.0), np.float32(0.0), np.float32(0.0), np.float32(0.0), np.float32(1.0)]",-1.0,99972.0,27
2025-08-14_08-18-36,1456,"[np.float32(1.0), np.float32(1.0), np.float32(1.0), np.float32(1.0), np.float32(0.0), np.float32(0.0), np.float32(1.0), np.float32(0.0), np.float32(1.0), np.float32(1.0), np.float32(0.0), np.float32(1.0), np.float32(1.0), np.float32(1.0), np.float32(1.0), np.float32(0.0)]",-7.0,99965.0,17
2025-08-14_08-18-36,1457,"[np.float32(1.0), np.float32(0.0), np.float32(0.0), np.float32(1.0), np.float32(0.0), np.float32(0.0), np.float32(0.0), np.float32(1.0), np.float32(1.0), np.float32(1.0), np.float32(0.0), np.float32(0.0), np.float32(0.0), np.float32(0.0), np.float32(1.0), np.float32(0.0)]",-2.0,99963.0,9
2025-08-14_08-18-36,1458,"[np.float32(1.0), np.float32(1.0), np.float32(1.0), np.float32(0.0), np.float32(1.0), np.float32(1.0), np.float32(1.0), np.float32(1.0), np.float32(0.0), np.float32(0.0), np.float32(1.0), np.float32(0.0), np.float32(0.0), np.float32(1.0), np.float32(1.0), np.float32(0.0)]",2.0,99965.0,16
2025-08-14_08-18-36,1459,"[np.float32(0.0), np.float32(1.0), np.float32(1.0), np.float32(1.0), np.float32(1.0), np.float32(0.0), np.float32(1.0), np.float32(1.0), np.float32(1.0), np.float32(0.0), np.float32(1.0), np.float32(0.0), np.float32(1.0), np.float32(1.0), np.float32(0.0), np.float32(1.0)]",2.0,99967.0,26
2025-08-14_08-18-36,1460,"[np.float32(0.0), np.float32(1.0), np.float32(1.0), np.float32(1.0), np.float32(1.0), np.float32(1.0), np.float32(0.0), np.float32(1.0), np.float32(1.0), np.float32(1.0), np.float32(1.0), np.float32(1.0), np.float32(1.0), np.float32(0.0), np.float32(0.0), np.float32(1.0)]",-2.0,99965.0,25
2025-08-14_08-18-36,1461,"[np.float32(1.0), np.float32(1.0), np.float32(0.0), np.float32(0.0), np.float32(0.0), np.float32(0.0), np.float32(0.0), np.float32(1.0), np.float32(1.0), np.float32(1.0), np.float32(1.0), np.float32(0.0), np.float32(1.0), np.float32(1.0), np.float32(1.0), np.float32(1.0)]",-5.0,99960.0,6
2025-08-14_08-18-36,1462,"[np.float32(0.0), np.float32(1.0), np.float32(0.0), np.float32(0.0), np.float32(0.0), np.float32(1.0), np.float32(0.0), np.float32(1.0), np.float32(1.0), np.float32(1.0), np.float32(0.0), np.float32(0.0), np.float32(0.0), np.float32(1.0), np.float32(0.0), np.float32(0.0)]",-1.0,99959.0,30
2025-08-14_08-18-36,1463,"[np.float32(0.0), np.float32(0.0), np.float32(0.0), np.float32(1.0), np.float32(1.0), np.float32(1.0), np.float32(1.0), np.float32(1.0), np.float32(1.0), np.float32(0.0), np.float32(1.0), np.float32(1.0), np.float32(1.0), np.float32(0.0), np.float32(1.0), np.float32(1.0)]",-1.0,99958.0,29
2025-08-14_08-18-36,1464,"[np.float32(0.0), np.float32(0.0), np.float32(1.0), np.float32(0.0), np.float32(1.0), np.float32(1.0), np.float32(0.0), np.float32(1.0), np.float32(0.0), np.float32(0.0), np.float32(1.0), np.float32(1.0), np.float32(0.0), np.float32(1.0), np.float32(1.0), np.float32(0.0)]",0.0,99958.0,11
2025-08-14_08-18-36,1465,"[np.float32(0.0), np.float32(1.0), np.float32(1.0), np.float32(0.0), np.float32(1.0), np.float32(1.0), np.float32(0.0), np.float32(1.0), np.float32(1.0), np.float32(0.0), np.float32(0.0), np.float32(0.0), np.float32(0.0), np.float32(1.0), np.float32(0.0), np.float32(1.0)]",-1.0,99957.0,13
2025-08-14_08-18-36,1466,"[np.float32(0.0), np.float32(1.0), np.float32(0.0), np.float32(1.0), np.float32(0.0), np.float32(0.0), np.float32(1.0), np.float32(0.0), np.float32(0.0), np.float32(1.0), np.float32(1.0), np.float32(1.0), np.float32(0.0), np.float32(0.0), np.float32(1.0), np.float32(0.0)]",1.0,99958.0,9
2025-08-14_08-18-36,1467,"[np.float32(0.0), np.float32(0.0), np.float32(0.0), np.float32(0.0), np.float32(1.0), np.float32(1.0), np.float32(0.0), np.float32(0.0), np.float32(1.0), np.float32(0.0), np.float32(1.0), np.float32(0.0), np.float32(1.0), np.float32(0.0), np.float32(0.0), np.float32(0.0)]",0.0,99958.0,5
2025-08-14_08-18-36,1468,"[np.float32(0.0), np.float32(0.0), np.float32(0.0), np.float32(1.0), np.float32(0.0), np.float32(1.0), np.float32(0.0), np.float32(1.0), np.float32(1.0), np.float32(0.0), np.float32(1.0), np.float32(1.0), np.float32(1.0), np.float32(1.0), np.float32(1.0), np.float32(1.0)]",-4.0,99954.0,8
2025-08-14_08-18-36,1469,"[np.float32(1.0), np.float32(1.0), np.float32(1.0), np.float32(1.0), np.float32(1.0), np.float32(0.0), np.float32(1.0), np.float32(0.0), np.float32(1.0), np.float32(1.0), np.float32(0.0), np.float32(1.0), np.float32(1.0), np.float32(1.0), np.float32(0.0), np.float32(0.0)]",4.0,99958.0,12
2025-08-14_08-18-36,1470,"[np.float32(0.0), np.float32(1.0), np.float32(1.0), np.float32(1.0), np.float32(1.0), np.float32(1.0), np.float32(1.0), np.float32(0.0), np.float32(1.0), np.float32(1.0), np.float32(1.0), np.float32(0.0), np.float32(1.0), np.float32(1.0), np.float32(1.0), np.float32(1.0)]",2.0,99960.0,8
2025-08-14_08-18-36,1471,"[np.float32(0.0), np.float32(0.0), np.float32(1.0), np.float32(1.0), np.float32(0.0), np.float32(1.0), np.float32(0.0), np.float32(1.0), np.float32(1.0), np.float32(1.0), np.float32(1.0), np.float32(0.0), np.float32(1.0), np.float32(1.0), np.float32(1.0), np.float32(0.0)]",0.0,99960.0,21
2025-08-14_08-18-36,1472,"[np.float32(1.0), np.float32(1.0), np.float32(1.0), np.float32(1.0), np.float32(0.0), np.float32(0.0), np.float32(1.0), np.float32(1.0), np.float32(1.0), np.float32(1.0), np.float32(0.0), np.float32(1.0), np.float32(0.0), np.float32(0.0), np.float32(0.0), np.float32(0.0)]",1.0,99961.0,15
2025-08-14_08-18-36,1473,"[np.float32(1.0), np.float32(0.0), np.float32(1.0), np.float32(1.0), np.float32(0.0), np.float32(1.0), np.float32(1.0), np.float32(1.0), np.float32(0.0), np.float32(1.0), np.float32(1.0), np.float32(0.0), np.float32(1.0), np.float32(1.0), np.float32(0.0), np.float32(0.0)]",0.0,99961.0,5
2025-08-14_08-18-36,1474,"[np.float32(1.0), np.float32(0.0), np.float32(0.0), np.float32(1.0), np.float32(0.0), np.float32(1.0), np.float32(0.0), np.float32(1.0), np.float32(0.0), np.float32(0.0), np.float32(1.0), np.float32(0.0), np.float32(1.0), np.float32(1.0), np.float32(0.0), np.float32(1.0)]",-5.0,99956.0,6
2025-08-14_08-18-36,1475,"[np.float32(1.0), np.float32(1.0), np.float32(0.0), np.float32(1.0), np.float32(0.0), np.float32(1.0), np.float32(0.0), np.float32(1.0), np.float32(1.0), np.float32(1.0), np.float32(0.0), np.float32(1.0), np.float32(1.0), np.float32(0.0), np.float32(1.0), np.float32(1.0)]",-6.0,99950.0,8
2025-08-14_08-18-36,1476,"[np.float32(0.0), np.float32(0.0), np.float32(1.0), np.float32(0.0), np.float32(1.0), np.float32(1.0), np.float32(0.0), np.float32(0.0), np.float32(1.0), np.float32(1.0), np.float32(1.0), np.float32(1.0), np.float32(0.0), np.float32(0.0), np.float32(0.0), np.float32(0.0)]",-2.0,99948.0,9
2025-08-14_08-18-36,1477,"[np.float32(1.0), np.float32(0.0), np.float32(0.0), np.float32(1.0), np.float32(0.0), np.float32(0.0), np.float32(1.0), np.float32(1.0), np.float32(1.0), np.float32(1.0), np.float32(0.0), np.float32(0.0), np.float32(1.0), np.float32(0.0), np.float32(0.0), np.float32(0.0)]",0.0,99948.0,3
2025-08-14_08-18-36,1478,"[np.float32(1.0), np.float32(1.0), np.float32(1.0), np.float32(0.0), np.float32(1.0), np.float32(1.0), np.float32(1.0), np.float32(0.0), np.float32(1.0), np.float32(0.0), np.float32(0.0), np.float32(0.0), np.float32(0.0), np.float32(1.0), np.float32(1.0), np.float32(1.0)]",-1.0,99947.0,20
2025-08-14_08-18-36,1479,"[np.float32(1.0), np.float32(1.0), np.float32(0.0), np.float32(0.0), np.float32(1.0), np.float32(0.0), np.float32(0.0), np.float32(1.0), np.float32(1.0), np.float32(0.0), np.float32(0.0), np.float32(1.0), np.float32(0.0), np.float32(1.0), np.float32(0.0), np.float32(0.0)]",1.0,99948.0,24
2025-08-14_08-18-36,1480,"[np.float32(1.0), np.float32(1.0), np.float32(0.0), np.float32(0.0), np.float32(0.0), np.float32(0.0), np.float32(0.0), np.float32(1.0), np.float32(1.0), np.float32(0.0), np.float32(1.0), np.float32(1.0), np.float32(0.0), np.float32(0.0), np.float32(0.0), np.float32(0.0)]",-4.0,99944.0,7
2025-08-14_08-18-36,1481,"[np.float32(1.0), np.float32(0.0), np.float32(0.0), np.float32(0.0), np.float32(1.0), np.float32(1.0), np.float32(1.0), np.float32(1.0), np.float32(0.0), np.float32(0.0), np.float32(0.0), np.float32(0.0), np.float32(1.0), np.float32(0.0), np.float32(1.0), np.float32(1.0)]",2.0,99946.0,16
2025-08-14_08-18-36,1482,"[np.float32(1.0), np.float32(0.0), np.float32(1.0), np.float32(1.0), np.float32(0.0), np.float32(1.0), np.float32(0.0), np.float32(1.0), np.float32(0.0), np.float32(0.0), np.float32(0.0), np.float32(0.0), np.float32(0.0), np.float32(0.0), np.float32(0.0), np.float32(0.0)]",-1.0,99945.0,28
2025-08-14_08-18-36,1483,"[np.float32(1.0), np.float32(1.0), np.float32(0.0), np.float32(1.0), np.float32(0.0), np.float32(1.0), np.float32(0.0), np.float32(1.0), np.float32(0.0), np.float32(1.0), np.float32(1.0), np.float32(0.0), np.float32(0.0), np.float32(0.0), np.float32(0.0), np.float32(1.0)]",1.0,99946.0,25
2025-08-14_08-18-36,1484,"[np.float32(0.0), np.float32(1.0), np.float32(1.0), np.float32(1.0), np.float32(0.0), np.float32(1.0), np.float32(1.0), np.float32(0.0), np.float32(1.0), np.float32(1.0), np.float32(0.0), np.float32(1.0), np.float32(0.0), np.float32(1.0), np.float32(1.0), np.float32(0.0)]",0.0,99946.0,32
2025-08-14_08-18-36,1485,"[np.float32(0.0), np.float32(1.0), np.float32(1.0), np.float32(1.0), np.float32(1.0), np.float32(1.0), np.float32(0.0), np.float32(1.0), np.float32(1.0), np.float32(1.0), np.float32(1.0), np.float32(0.0), np.float32(0.0), np.float32(0.0), np.float32(0.0), np.float32(1.0)]",0.0,99946.0,16
2025-08-14_08-18-36,1486,"[np.float32(0.0), np.float32(1.0), np.float32(0.0), np.float32(0.0), np.float32(0.0), np.float32(1.0), np.float32(1.0), np.float32(0.0), np.float32(0.0), np.float32(0.0), np.float32(1.0), np.float32(0.0), np.float32(1.0), np.float32(0.0), np.float32(0.0), np.float32(0.0)]",-3.0,99943.0,34
2025-08-14_08-18-36,1487,"[np.float32(1.0), np.float32(1.0), np.float32(0.0), np.float32(1.0), np.float32(0.0), np.float32(1.0), np.float32(0.0), np.float32(1.0), np.float32(0.0), np.float32(1.0), np.float32(1.0), np.float32(1.0), np.float32(1.0), np.float32(0.0), np.float32(1.0), np.float32(0.0)]",-3.0,99940.0,34
2025-08-14_08-18-36,1488,"[np.float32(0.0), np.float32(0.0), np.float32(0.0), np.float32(1.0), np.float32(0.0), np.float32(1.0), np.float32(0.0), np.float32(0.0), np.float32(0.0), np.float32(1.0), np.float32(1.0), np.float32(1.0), np.float32(1.0), np.float32(0.0), np.float32(1.0), np.float32(0.0)]",-2.0,99938.0,3
2025-08-14_08-18-36,1489,"[np.float32(1.0), np.float32(0.0), np.float32(0.0), np.float32(0.0), np.float32(0.0), np.float32(1.0), np.float32(0.0), np.float32(0.0), np.float32(1.0), np.float32(0.0), np.float32(1.0), np.float32(0.0), np.float32(0.0), np.float32(0.0), np.float32(0.0), np.float32(0.0)]",6.0,99944.0,32
2025-08-14_08-18-36,1490,"[np.float32(0.0), np.float32(1.0), np.float32(0.0), np.float32(0.0), np.float32(0.0), np.float32(0.0), np.float32(0.0), np.float32(1.0), np.float32(0.0), np.float32(0.0), np.float32(0.0), np.float32(1.0), np.float32(1.0), np.float32(1.0), np.float32(1.0), np.float32(1.0)]",1.0,99945.0,17
2025-08-14_08-18-36,1491,"[np.float32(1.0), np.float32(0.0), np.float32(0.0), np.float32(1.0), np.float32(0.0), np.float32(0.0), np.float32(0.0), np.float32(1.0), np.float32(1.0), np.float32(0.0), np.float32(0.0), np.float32(0.0), np.float32(0.0), np.float32(0.0), np.float32(1.0), np.float32(0.0)]",0.0,99945.0,11
2025-08-14_08-18-36,1492,"[np.float32(1.0), np.float32(1.0), np.float32(1.0), np.float32(0.0), np.float32(1.0), np.float32(0.0), np.float32(0.0), np.float32(1.0), np.float32(0.0), np.float32(0.0), np.float32(1.0), np.float32(0.0), np.float32(0.0), np.float32(1.0), np.float32(0.0), np.float32(1.0)]",-1.0,99944.0,3
2025-08-14_08-18-36,1493,"[np.float32(0.0), np.float32(0.0), np.float32(1.0), np.float32(1.0), np.float32(0.0), np.float32(1.0), np.float32(0.0), np.float32(1.0), np.float32(0.0), np.float32(1.0), np.float32(1.0), np.float32(0.0), np.float32(1.0), np.float32(0.0), np.float32(1.0), np.float32(0.0)]",-1.0,99943.0,21
2025-08-14_08-18-36,1494,"[np.float32(1.0), np.float32(0.0), np.float32(0.0), np.float32(1.0), np.float32(1.0), np.float32(0.0), np.float32(0.0), np.float32(1.0), np.float32(0.0), np.float32(0.0), np.float32(0.0), np.float32(0.0), np.float32(1.0), np.float32(0.0), np.float32(1.0), np.float32(1.0)]",-7.0,99936.0,28
2025-08-14_08-18-36,1495,"[np.float32(0.0), np.float32(1.0), np.float32(1.0), np.float32(1.0), np.float32(0.0), np.float32(0.0), np.float32(0.0), np.float32(1.0), np.float32(0.0), np.float32(0.0), np.float32(0.0), np.float32(0.0), np.float32(0.0), np.float32(0.0), np.float32(0.0), np.float32(0.0)]",3.0,99939.0,22
2025-08-14_08-18-36,1496,"[np.float32(0.0), np.float32(0.0), np.float32(1.0), np.float32(0.0), np.float32(0.0), np.float32(1.0), np.float32(1.0), np.float32(0.0), np.float32(0.0), np.float32(0.0), np.float32(0.0), np.float32(1.0), np.float32(1.0), np.float32(1.0), np.float32(0.0), np.float32(1.0)]",0.0,99939.0,32
2025-08-14_08-18-36,1497,"[np.float32(1.0), np.float32(1.0), np.float32(1.0), np.float32(1.0), np.float32(1.0), np.float32(1.0), np.float32(0.0), np.float32(1.0), np.float32(1.0), np.float32(0.0), np.float32(1.0), np.float32(0.0), np.float32(1.0), np.float32(0.0), np.float32(1.0), np.float32(1.0)]",-6.0,99933.0,4
2025-08-14_08-18-36,1498,"[np.float32(1.0), np.float32(1.0), np.float32(0.0), np.float32(1.0), np.float32(1.0), np.float32(0.0), np.float32(0.0), np.float32(0.0), np.float32(0.0), np.float32(0.0), np.float32(0.0), np.float32(0.0), np.float32(1.0), np.float32(1.0), np.float32(0.0), np.float32(1.0)]",0.0,99933.0,2
2025-08-14_08-18-36,1499,"[np.float32(0.0), np.float32(1.0), np.float32(1.0), np.float32(0.0), np.float32(1.0), np.float32(0.0), np.float32(0.0), np.float32(1.0), np.float32(0.0), np.float32(0.0), np.float32(1.0), np.float32(0.0), np.float32(0.0), np.float32(1.0), np.float32(1.0), np.float32(0.0)]",-4.0,99929.0,27
2025-08-14_08-18-36,1500,"[np.float32(0.0), np.float32(1.0), np.float32(0.0), np.float32(0.0), np.float32(0.0), np.float32(1.0), np.float32(0.0), np.float32(0.0), np.float32(0.0), np.float32(0.0), np.float32(0.0), np.float32(1.0), np.float32(1.0), np.float32(1.0), np.float32(1.0), np.float32(1.0)]",-1.0,99928.0,18
2025-08-14_08-18-36,1501,"[np.float32(1.0), np.float32(0.0), np.float32(1.0), np.float32(0.0), np.float32(0.0), np.float32(0.0), np.float32(0.0), np.float32(0.0), np.float32(0.0), np.float32(1.0), np.float32(1.0), np.float32(1.0), np.float32(1.0), np.float32(0.0), np.float32(1.0), np.float32(0.0)]",3.0,99931.0,16
2025-08-14_08-18-36,1502,"[np.float32(0.0), np.float32(0.0), np.float32(1.0), np.float32(1.0), np.float32(1.0), np.float32(0.0), np.float32(1.0), np.float32(1.0), np.float32(1.0), np.float32(1.0), np.float32(1.0), np.float32(1.0), np.float32(1.0), np.float32(1.0), np.float32(1.0), np.float32(0.0)]",1.0,99932.0,18
2025-08-14_08-18-36,1503,"[np.float32(0.0), np.float32(0.0), np.float32(1.0), np.float32(0.0), np.float32(0.0), np.float32(1.0), np.float32(1.0), np.float32(0.0), np.float32(0.0), np.float32(1.0), np.float32(0.0), np.float32(0.0), np.float32(1.0), np.float32(0.0), np.float32(1.0), np.float32(1.0)]",-4.0,99928.0,17
2025-08-14_08-18-36,1504,"[np.float32(0.0), np.float32(0.0), np.float32(0.0), np.float32(0.0), np.float32(1.0), np.float32(1.0), np.float32(1.0), np.float32(0.0), np.float32(1.0), np.float32(0.0), np.float32(0.0), np.float32(0.0), np.float32(0.0), np.float32(0.0), np.float32(1.0), np.float32(0.0)]",0.0,99928.0,28
2025-08-14_08-18-36,1505,"[np.float32(0.0), np.float32(0.0), np.float32(0.0), np.float32(1.0), np.float32(1.0), np.float32(1.0), np.float32(1.0), np.float32(1.0), np.float32(0.0), np.float32(1.0), np.float32(0.0), np.float32(0.0), np.float32(0.0), np.float32(1.0), np.float32(0.0), np.float32(1.0)]",-3.0,99925.0,24
2025-08-14_08-18-36,1506,"[np.float32(0.0), np.float32(1.0), np.float32(0.0), np.float32(1.0), np.float32(1.0), np.float32(0.0), np.float32(0.0), np.float32(1.0), np.float32(0.0), np.float32(1.0), np.float32(1.0), np.float32(1.0), np.float32(1.0), np.float32(0.0), np.float32(0.0), np.float32(1.0)]",1.0,99926.0,6
2025-08-14_08-18-36,1507,"[np.float32(1.0), np.float32(0.0), np.float32(0.0), np.float32(0.0), np.float32(0.0), np.float32(1.0), np.float32(1.0), np.float32(1.0), np.float32(1.0), np.float32(0.0), np.float32(1.0), np.float32(0.0), np.float32(1.0), np.float32(1.0), np.float32(0.0), np.float32(0.0)]",-1.0,99925.0,34
2025-08-14_08-18-36,1508,"[np.float32(1.0), np.float32(0.0), np.float32(1.0), np.float32(0.0), np.float32(0.0), np.float32(1.0), np.float32(1.0), np.float32(0.0), np.float32(1.0), np.float32(0.0), np.float32(1.0), np.float32(1.0), np.float32(0.0), np.float32(0.0), np.float32(0.0), np.float32(1.0)]",3.0,99928.0,9
2025-08-14_08-18-36,1509,"[np.float32(1.0), np.float32(0.0), np.float32(0.0), np.float32(0.0), np.float32(1.0), np.float32(1.0), np.float32(0.0), np.float32(1.0), np.float32(0.0), np.float32(0.0), np.float32(0.0), np.float32(1.0), np.float32(1.0), np.float32(0.0), np.float32(1.0), np.float32(0.0)]",-2.0,99926.0,17
2025-08-14_08-18-36,1510,"[np.float32(0.0), np.float32(1.0), np.float32(0.0), np.float32(0.0), np.float32(0.0), np.float32(1.0), np.float32(1.0), np.float32(1.0), np.float32(0.0), np.float32(1.0), np.float32(0.0), np.float32(0.0), np.float32(1.0), np.float32(0.0), np.float32(1.0), np.float32(0.0)]",-2.0,99924.0,2
2025-08-14_08-18-36,1511,"[np.float32(1.0), np.float32(0.0), np.float32(0.0), np.float32(1.0), np.float32(0.0), np.float32(0.0), np.float32(0.0), np.float32(0.0), np.float32(1.0), np.float32(0.0), np.float32(0.0), np.float32(1.0), np.float32(1.0), np.float32(1.0), np.float32(0.0), np.float32(0.0)]",-1.0,99923.0,34
2025-08-14_08-18-36,1512,"[np.float32(1.0), np.float32(1.0), np.float32(0.0), np.float32(0.0), np.float32(0.0), np.float32(0.0), np.float32(0.0), np.float32(1.0), np.float32(1.0), np.float32(1.0), np.float32(0.0), np.float32(0.0), np.float32(0.0), np.float32(1.0), np.float32(0.0), np.float32(1.0)]",1.0,99924.0,17
2025-08-14_08-18-36,1513,"[np.float32(0.0), np.float32(1.0), np.float32(1.0), np.float32(1.0), np.float32(1.0), np.float32(1.0), np.float32(0.0), np.float32(0.0), np.float32(0.0), np.float32(0.0), np.float32(0.0), np.float32(0.0), np.float32(0.0), np.float32(1.0), np.float32(0.0), np.float32(1.0)]",2.0,99926.0,6
2025-08-14_08-18-36,1514,"[np.float32(0.0), np.float32(0.0), np.float32(0.0), np.float32(0.0), np.float32(1.0), np.float32(0.0), np.float32(1.0), np.float32(1.0), np.float32(1.0), np.float32(0.0), np.float32(0.0), np.float32(1.0), np.float32(1.0), np.float32(1.0), np.float32(0.0), np.float32(0.0)]",-4.0,99922.0,31
2025-08-14_08-18-36,1515,"[np.float32(0.0), np.float32(1.0), np.float32(1.0), np.float32(1.0), np.float32(1.0), np.float32(0.0), np.float32(0.0), np.float32(1.0), np.float32(0.0), np.float32(0.0), np.float32(0.0), np.float32(0.0), np.float32(1.0), np.float32(1.0), np.float32(1.0), np.float32(1.0)]",-2.0,99920.0,31
2025-08-14_08-18-36,1516,"[np.float32(0.0), np.float32(1.0), np.float32(0.0), np.float32(1.0), np.float32(0.0), np.float32(1.0), np.float32(0.0), np.float32(1.0), np.float32(0.0), np.float32(1.0), np.float32(1.0), np.float32(0.0), np.float32(0.0), np.float32(0.0), np.float32(1.0), np.float32(0.0)]",-2.0,99918.0,7
2025-08-14_08-18-36,1517,"[np.float32(0.0), np.float32(0.0), np.float32(1.0), np.float32(1.0), np.float32(0.0), np.float32(1.0), np.float32(1.0), np.float32(0.0), np.float32(0.0), np.float32(1.0), np.float32(0.0), np.float32(1.0), np.float32(1.0), np.float32(0.0), np.float32(1.0), np.float32(1.0)]",-2.0,99916.0,20
2025-08-14_08-18-36,1518,"[np.float32(0.0), np.float32(1.0), np.float32(0.0), np.float32(0.0), np.float32(1.0), np.float32(1.0), np.float32(1.0), np.float32(0.0), np.float32(1.0), np.float32(1.0), np.float32(0.0), np.float32(1.0), np.float32(1.0), np.float32(0.0), np.float32(0.0), np.float32(1.0)]",-2.0,99914.0,35
2025-08-14_08-18-36,1519,"[np.float32(0.0), np.float32(0.0), np.float32(0.0), np.float32(1.0), np.float32(1.0), np.float32(1.0), np.float32(0.0), np.float32(1.0), np.float32(1.0), np.float32(0.0), np.float32(0.0), np.float32(1.0), np.float32(1.0), np.float32(0.0), np.float32(1.0), np.float32(0.0)]",5.0,99919.0,27
2025-08-14_08-18-36,1520,"[np.float32(1.0), np.float32(1.0), np.float32(0.0), np.float32(1.0), np.float32(0.0), np.float32(1.0), np.float32(0.0), np.float32(0.0), np.float32(0.0), np.float32(1.0), np.float32(0.0), np.float32(1.0), np.float32(0.0), np.float32(0.0), np.float32(1.0), np.float32(0.0)]",2.0,99921.0,19
2025-08-14_08-18-36,1521,"[np.float32(0.0), np.float32(0.0), np.float32(1.0), np.float32(1.0), np.float32(0.0), np.float32(1.0), np.float32(0.0), np.float32(0.0), np.float32(1.0), np.float32(1.0), np.float32(0.0), np.float32(0.0), np.float32(0.0), np.float32(0.0), np.float32(1.0), np.float32(0.0)]",-4.0,99917.0,3
2025-08-14_08-18-36,1522,"[np.float32(1.0), np.float32(1.0), np.float32(1.0), np.float32(0.0), np.float32(1.0), np.float32(0.0), np.float32(0.0), np.float32(1.0), np.float32(0.0), np.float32(0.0), np.float32(1.0), np.float32(0.0), np.float32(0.0), np.float32(0.0), np.float32(0.0), np.float32(0.0)]",4.0,99921.0,17
2025-08-14_08-18-36,1523,"[np.float32(0.0), np.float32(0.0), np.float32(1.0), np.float32(0.0), np.float32(0.0), np.float32(1.0), np.float32(0.0), np.float32(1.0), np.float32(1.0), np.float32(0.0), np.float32(1.0), np.float32(1.0), np.float32(0.0), np.float32(0.0), np.float32(1.0), np.float32(0.0)]",6.0,99927.0,36
2025-08-14_08-18-36,1524,"[np.float32(1.0), np.float32(0.0), np.float32(1.0), np.float32(1.0), np.float32(1.0), np.float32(0.0), np.float32(1.0), np.float32(1.0), np.float32(1.0), np.float32(0.0), np.float32(0.0), np.float32(0.0), np.float32(0.0), np.float32(1.0), np.float32(0.0), np.float32(1.0)]",1.0,99928.0,21
2025-08-14_08-18-36,1525,"[np.float32(0.0), np.float32(0.0), np.float32(1.0), np.float32(1.0), np.float32(0.0), np.float32(1.0), np.float32(1.0), np.float32(1.0), np.float32(0.0), np.float32(1.0), np.float32(0.0), np.float32(1.0), np.float32(1.0), np.float32(0.0), np.float32(1.0), np.float32(0.0)]",1.0,99929.0,27
2025-08-14_08-18-36,1526,"[np.float32(1.0), np.float32(0.0), np.float32(0.0), np.float32(1.0), np.float32(1.0), np.float32(1.0), np.float32(1.0), np.float32(1.0), np.float32(0.0), np.float32(1.0), np.float32(1.0), np.float32(0.0), np.float32(1.0), np.float32(0.0), np.float32(1.0), np.float32(0.0)]",-5.0,99924.0,6
2025-08-14_08-18-36,1527,"[np.float32(1.0), np.float32(0.0), np.float32(0.0), np.float32(0.0), np.float32(1.0), np.float32(1.0), np.float32(0.0), np.float32(1.0), np.float32(0.0), np.float32(0.0), np.float32(0.0), np.float32(1.0), np.float32(1.0), np.float32(0.0), np.float32(0.0), np.float32(1.0)]",-5.0,99919.0,11
2025-08-14_08-18-36,1528,"[np.float32(1.0), np.float32(0.0), np.float32(0.0), np.float32(1.0), np.float32(0.0), np.float32(1.0), np.float32(0.0), np.float32(0.0), np.float32(0.0), np.float32(1.0), np.float32(1.0), np.float32(0.0), np.float32(1.0), np.float32(1.0), np.float32(1.0), np.float32(0.0)]",-3.0,99916.0,0
2025-08-14_08-18-36,1529,"[np.float32(1.0), np.float32(1.0), np.float32(0.0), np.float32(1.0), np.float32(1.0), np.float32(1.0), np.float32(1.0), np.float32(0.0), np.float32(1.0), np.float32(1.0), np.float32(0.0), np.float32(0.0), np.float32(1.0), np.float32(0.0), np.float32(0.0), np.float32(0.0)]",-3.0,99913.0,15
2025-08-14_08-18-36,1530,"[np.float32(0.0), np.float32(0.0), np.float32(0.0), np.float32(0.0), np.float32(0.0), np.float32(1.0), np.float32(0.0), np.float32(0.0), np.float32(1.0), np.float32(0.0), np.float32(1.0), np.float32(1.0), np.float32(0.0), np.float32(1.0), np.float32(0.0), np.float32(0.0)]",0.0,99913.0,24
2025-08-14_08-18-36,1531,"[np.float32(1.0), np.float32(0.0), np.float32(0.0), np.float32(1.0), np.float32(1.0), np.float32(0.0), np.float32(1.0), np.float32(1.0), np.float32(1.0), np.float32(0.0), np.float32(0.0), np.float32(0.0), np.float32(0.0), np.float32(0.0), np.float32(1.0), np.float32(1.0)]",-5.0,99908.0,28
2025-08-14_08-18-36,1532,"[np.float32(0.0), np.float32(0.0), np.float32(0.0), np.float32(1.0), np.float32(1.0), np.float32(1.0), np.float32(0.0), np.float32(1.0), np.float32(0.0), np.float32(0.0), np.float32(1.0), np.float32(1.0), np.float32(0.0), np.float32(1.0), np.float32(0.0), np.float32(0.0)]",-2.0,99906.0,8
2025-08-14_08-18-36,1533,"[np.float32(1.0), np.float32(1.0), np.float32(0.0), np.float32(1.0), np.float32(0.0), np.float32(0.0), np.float32(1.0), np.float32(0.0), np.float32(1.0), np.float32(0.0), np.float32(0.0), np.float32(1.0), np.float32(1.0), np.float32(1.0), np.float32(1.0), np.float32(1.0)]",0.0,99906.0,21
2025-08-14_08-18-36,1534,"[np.float32(1.0), np.float32(0.0), np.float32(0.0), np.float32(1.0), np.float32(1.0), np.float32(0.0), np.float32(0.0), np.float32(0.0), np.float32(0.0), np.float32(1.0), np.float32(0.0), np.float32(1.0), np.float32(0.0), np.float32(1.0), np.float32(1.0), np.float32(0.0)]",3.0,99909.0,13
2025-08-14_08-18-36,1535,"[np.float32(1.0), np.float32(0.0), np.float32(1.0), np.float32(1.0), np.float32(1.0), np.float32(1.0), np.float32(0.0), np.float32(0.0), np.float32(1.0), np.float32(1.0), np.float32(0.0), np.float32(1.0), np.float32(1.0), np.float32(0.0), np.float32(1.0), np.float32(0.0)]",-6.0,99903.0,17
2025-08-14_08-18-36,1536,"[np.float32(0.0), np.float32(1.0), np.float32(0.0), np.float32(1.0), np.float32(0.0), np.float32(1.0), np.float32(0.0), np.float32(1.0), np.float32(0.0), np.float32(1.0), np.float32(0.0), np.float32(0.0), np.float32(0.0), np.float32(1.0), np.float32(0.0), np.float32(1.0)]",-2.0,99901.0,10
2025-08-14_08-18-36,1537,"[np.float32(1.0), np.float32(1.0), np.float32(0.0), np.float32(1.0), np.float32(0.0), np.float32(0.0), np.float32(0.0), np.float32(0.0), np.float32(0.0), np.float32(1.0), np.float32(1.0), np.float32(0.0), np.float32(0.0), np.float32(0.0), np.float32(1.0), np.float32(1.0)]",-5.0,99896.0,18
2025-08-14_08-18-36,1538,"[np.float32(0.0), np.float32(1.0), np.float32(1.0), np.float32(1.0), np.float32(1.0), np.float32(0.0), np.float32(0.0), np.float32(1.0), np.float32(0.0), np.float32(1.0), np.float32(0.0), np.float32(1.0), np.float32(1.0), np.float32(1.0), np.float32(1.0), np.float32(0.0)]",-3.0,99893.0,26
2025-08-14_08-18-36,1539,"[np.float32(0.0), np.float32(1.0), np.float32(1.0), np.float32(1.0), np.float32(0.0), np.float32(0.0), np.float32(0.0), np.float32(0.0), np.float32(1.0), np.float32(1.0), np.float32(1.0), np.float32(1.0), np.float32(1.0), np.float32(0.0), np.float32(1.0), np.float32(0.0)]",-1.0,99892.0,16
2025-08-14_08-18-36,1540,"[np.float32(1.0), np.float32(0.0), np.float32(1.0), np.float32(0.0), np.float32(1.0), np.float32(0.0), np.float32(1.0), np.float32(0.0), np.float32(0.0), np.float32(0.0), np.float32(0.0), np.float32(0.0), np.float32(0.0), np.float32(0.0), np.float32(0.0), np.float32(0.0)]",-4.0,99888.0,35
2025-08-14_08-18-36,1541,"[np.float32(1.0), np.float32(1.0), np.float32(1.0), np.float32(1.0), np.float32(0.0), np.float32(0.0), np.float32(1.0), np.float32(0.0), np.float32(1.0), np.float32(1.0), np.float32(0.0), np.float32(1.0), np.float32(1.0), np.float32(0.0), np.float32(1.0), np.float32(0.0)]",0.0,99888.0,24
2025-08-14_08-18-36,1542,"[np.float32(0.0), np.float32(1.0), np.float32(0.0), np.float32(0.0), np.float32(0.0), np.float32(1.0), np.float32(1.0), np.float32(1.0), np.float32(0.0), np.float32(0.0), np.float32(1.0), np.float32(1.0), np.float32(0.0), np.float32(1.0), np.float32(1.0), np.float32(1.0)]",-3.0,99885.0,16
2025-08-14_08-18-36,1543,"[np.float32(0.0), np.float32(0.0), np.float32(1.0), np.float32(0.0), np.float32(1.0), np.float32(0.0), np.float32(0.0), np.float32(0.0), np.float32(0.0), np.float32(0.0), np.float32(0.0), np.float32(0.0), np.float32(0.0), np.float32(0.0), np.float32(1.0), np.float32(0.0)]",-1.0,99884.0,3
2025-08-14_08-18-36,1544,"[np.float32(0.0), np.float32(1.0), np.float32(1.0), np.float32(0.0), np.float32(0.0), np.float32(0.0), np.float32(0.0), np.float32(1.0), np.float32(1.0), np.float32(0.0), np.float32(0.0), np.float32(1.0), np.float32(0.0), np.float32(0.0), np.float32(1.0), np.float32(0.0)]",1.0,99885.0,10
2025-08-14_08-18-36,1545,"[np.float32(0.0), np.float32(0.0), np.float32(0.0), np.float32(0.0), np.float32(1.0), np.float32(0.0), np.float32(0.0), np.float32(1.0), np.float32(0.0), np.float32(0.0), np.float32(0.0), np.float32(0.0), np.float32(0.0), np.float32(1.0), np.float32(0.0), np.float32(0.0)]",0.0,99885.0,25
2025-08-14_08-18-36,1546,"[np.float32(1.0), np.float32(1.0), np.float32(0.0), np.float32(0.0), np.float32(1.0), np.float32(0.0), np.float32(0.0), np.float32(0.0), np.float32(0.0), np.float32(1.0), np.float32(1.0), np.float32(1.0), np.float32(1.0), np.float32(1.0), np.float32(1.0), np.float32(1.0)]",-2.0,99883.0,27
2025-08-14_08-18-36,1547,"[np.float32(1.0), np.float32(0.0), np.float32(1.0), np.float32(0.0), np.float32(0.0), np.float32(1.0), np.float32(0.0), np.float32(1.0), np.float32(1.0), np.float32(1.0), np.float32(1.0), np.float32(1.0), np.float32(0.0), np.float32(0.0), np.float32(0.0), np.float32(0.0)]",4.0,99887.0,32
2025-08-14_08-18-36,1548,"[np.float32(1.0), np.float32(1.0), np.float32(0.0), np.float32(1.0), np.float32(1.0), np.float32(0.0), np.float32(1.0), np.float32(0.0), np.float32(1.0), np.float32(0.0), np.float32(1.0), np.float32(1.0), np.float32(0.0), np.float32(1.0), np.float32(1.0), np.float32(0.0)]",-3.0,99884.0,19
2025-08-14_08-18-36,1549,"[np.float32(0.0), np.float32(1.0), np.float32(1.0), np.float32(0.0), np.float32(1.0), np.float32(1.0), np.float32(0.0), np.float32(1.0), np.float32(1.0), np.float32(1.0), np.float32(1.0), np.float32(0.0), np.float32(1.0), np.float32(1.0), np.float32(0.0), np.float32(0.0)]",-1.0,99883.0,24
2025-08-14_08-18-36,1550,"[np.float32(1.0), np.float32(0.0), np.float32(1.0), np.float32(1.0), np.float32(1.0), np.float32(0.0), np.float32(0.0), np.float32(0.0), np.float32(1.0), np.float32(0.0), np.float32(1.0), np.float32(0.0), np.float32(1.0), np.float32(0.0), np.float32(1.0), np.float32(0.0)]",-2.0,99881.0,9
2025-08-14_08-18-36,1551,"[np.float32(1.0), np.float32(1.0), np.float32(1.0), np.float32(1.0), np.float32(1.0), np.float32(1.0), np.float32(0.0), np.float32(0.0), np.float32(1.0), np.float32(1.0), np.float32(0.0), np.float32(0.0), np.float32(0.0), np.float32(1.0), np.float32(1.0), np.float32(1.0)]",-2.0,99879.0,11
2025-08-14_08-18-36,1552,"[np.float32(1.0), np.float32(0.0), np.float32(1.0), np.float32(1.0), np.float32(0.0), np.float32(0.0), np.float32(0.0), np.float32(1.0), np.float32(1.0), np.float32(1.0), np.float32(1.0), np.float32(1.0), np.float32(0.0), np.float32(1.0), np.float32(0.0), np.float32(1.0)]",1.0,99880.0,26
2025-08-14_08-18-36,1553,"[np.float32(1.0), np.float32(1.0), np.float32(1.0), np.float32(0.0), np.float32(1.0), np.float32(1.0), np.float32(1.0), np.float32(0.0), np.float32(0.0), np.float32(1.0), np.float32(0.0), np.float32(1.0), np.float32(1.0), np.float32(0.0), np.float32(1.0), np.float32(0.0)]",0.0,99880.0,27
2025-08-14_08-18-36,1554,"[np.float32(1.0), np.float32(0.0), np.float32(0.0), np.float32(1.0), np.float32(0.0), np.float32(1.0), np.float32(0.0), np.float32(1.0), np.float32(1.0), np.float32(0.0), np.float32(0.0), np.float32(1.0), np.float32(0.0), np.float32(0.0), np.float32(0.0), np.float32(1.0)]",3.0,99883.0,30
2025-08-14_08-18-36,1555,"[np.float32(1.0), np.float32(1.0), np.float32(1.0), np.float32(1.0), np.float32(1.0), np.float32(1.0), np.float32(1.0), np.float32(1.0), np.float32(0.0), np.float32(0.0), np.float32(1.0), np.float32(0.0), np.float32(0.0), np.float32(1.0), np.float32(1.0), np.float32(0.0)]",-2.0,99881.0,36
2025-08-14_08-18-36,1556,"[np.float32(0.0), np.float32(1.0), np.float32(1.0), np.float32(1.0), np.float32(1.0), np.float32(0.0), np.float32(1.0), np.float32(1.0), np.float32(0.0), np.float32(0.0), np.float32(0.0), np.float32(0.0), np.float32(0.0), np.float32(1.0), np.float32(0.0), np.float32(1.0)]",2.0,99883.0,7
2025-08-14_08-18-36,1557,"[np.float32(1.0), np.float32(0.0), np.float32(1.0), np.float32(1.0), np.float32(0.0), np.float32(0.0), np.float32(1.0), np.float32(0.0), np.float32(1.0), np.float32(1.0), np.float32(1.0), np.float32(0.0), np.float32(0.0), np.float32(0.0), np.float32(0.0), np.float32(0.0)]",-2.0,99881.0,20
2025-08-14_08-18-36,1558,"[np.float32(1.0), np.float32(0.0), np.float32(0.0), np.float32(1.0), np.float32(0.0), np.float32(0.0), np.float32(1.0), np.float32(1.0), np.float32(1.0), np.float32(1.0), np.float32(1.0), np.float32(0.0), np.float32(0.0), np.float32(0.0), np.float32(0.0), np.float32(0.0)]",1.0,99882.0,17
2025-08-14_08-18-36,1559,"[np.float32(0.0), np.float32(0.0), np.float32(1.0), np.float32(1.0), np.float32(1.0), np.float32(1.0), np.float32(1.0), np.float32(1.0), np.float32(0.0), np.float32(0.0), np.float32(1.0), np.float32(0.0), np.float32(1.0), np.float32(1.0), np.float32(1.0), np.float32(1.0)]",-1.0,99881.0,15
2025-08-14_08-18-36,1560,"[np.float32(1.0), np.float32(1.0), np.float32(1.0), np.float32(0.0), np.float32(0.0), np.float32(1.0), np.float32(1.0), np.float32(1.0), np.float32(0.0), np.float32(1.0), np.float32(0.0), np.float32(0.0), np.float32(0.0), np.float32(1.0), np.float32(1.0), np.float32(0.0)]",1.0,99882.0,18
2025-08-14_08-18-36,1561,"[np.float32(0.0), np.float32(1.0), np.float32(0.0), np.float32(0.0), np.float32(1.0), np.float32(1.0), np.float32(1.0), np.float32(0.0), np.float32(1.0), np.float32(1.0), np.float32(1.0), np.float32(0.0), np.float32(1.0), np.float32(1.0), np.float32(0.0), np.float32(0.0)]",-5.0,99877.0,24
2025-08-14_08-18-36,1562,"[np.float32(0.0), np.float32(1.0), np.float32(1.0), np.float32(0.0), np.float32(1.0), np.float32(0.0), np.float32(1.0), np.float32(1.0), np.float32(1.0), np.float32(1.0), np.float32(1.0), np.float32(1.0), np.float32(0.0), np.float32(0.0), np.float32(0.0), np.float32(0.0)]",-1.0,99876.0,5
2025-08-14_08-18-36,1563,"[np.float32(1.0), np.float32(0.0), np.float32(1.0), np.float32(0.0), np.float32(1.0), np.float32(0.0), np.float32(1.0), np.float32(1.0), np.float32(1.0), np.float32(1.0), np.float32(1.0), np.float32(0.0), np.float32(0.0), np.float32(1.0), np.float32(0.0), np.float32(1.0)]",1.0,99877.0,17
2025-08-14_08-18-36,1564,"[np.float32(1.0), np.float32(0.0), np.float32(1.0), np.float32(0.0), np.float32(1.0), np.float32(1.0), np.float32(0.0), np.float32(1.0), np.float32(1.0), np.float32(1.0), np.float32(1.0), np.float32(1.0), np.float32(1.0), np.float32(1.0), np.float32(0.0), np.float32(0.0)]",-6.0,99871.0,11
2025-08-14_08-18-36,1565,"[np.float32(0.0), np.float32(0.0), np.float32(0.0), np.float32(0.0), np.float32(1.0), np.float32(0.0), np.float32(0.0), np.float32(1.0), np.float32(1.0), np.float32(0.0), np.float32(0.0), np.float32(0.0), np.float32(0.0), np.float32(1.0), np.float32(0.0), np.float32(1.0)]",3.0,99874.0,14
2025-08-14_08-18-36,1566,"[np.float32(1.0), np.float32(0.0), np.float32(1.0), np.float32(1.0), np.float32(1.0), np.float32(1.0), np.float32(0.0), np.float32(1.0), np.float32(0.0), np.float32(1.0), np.float32(0.0), np.float32(0.0), np.float32(0.0), np.float32(1.0), np.float32(0.0), np.float32(1.0)]",-2.0,99872.0,24
2025-08-14_08-18-36,1567,"[np.float32(1.0), np.float32(1.0), np.float32(0.0), np.float32(0.0), np.float32(1.0), np.float32(1.0), np.float32(1.0), np.float32(1.0), np.float32(1.0), np.float32(1.0), np.float32(0.0), np.float32(1.0), np.float32(0.0), np.float32(0.0), np.float32(1.0), np.float32(1.0)]",-7.0,99865.0,0
2025-08-14_08-18-36,1568,"[np.float32(1.0), np.float32(1.0), np.float32(1.0), np.float32(1.0), np.float32(0.0), np.float32(1.0), np.float32(0.0), np.float32(1.0), np.float32(0.0), np.float32(1.0), np.float32(1.0), np.float32(1.0), np.float32(0.0), np.float32(1.0), np.float32(1.0), np.float32(1.0)]",-3.0,99862.0,0
2025-08-14_08-18-36,1569,"[np.float32(1.0), np.float32(0.0), np.float32(1.0), np.float32(0.0), np.float32(1.0), np.float32(0.0), np.float32(0.0), np.float32(1.0), np.float32(1.0), np.float32(1.0), np.float32(1.0), np.float32(1.0), np.float32(1.0), np.float32(1.0), np.float32(0.0), np.float32(1.0)]",2.0,99864.0,32
2025-08-14_08-18-36,1570,"[np.float32(0.0), np.float32(1.0), np.float32(0.0), np.float32(0.0), np.float32(1.0), np.float32(1.0), np.float32(1.0), np.float32(1.0), np.float32(0.0), np.float32(1.0), np.float32(1.0), np.float32(0.0), np.float32(0.0), np.float32(1.0), np.float32(1.0), np.float32(0.0)]",-1.0,99863.0,32
2025-08-14_08-18-36,1571,"[np.float32(1.0), np.float32(0.0), np.float32(0.0), np.float32(1.0), np.float32(0.0), np.float32(0.0), np.float32(1.0), np.float32(1.0), np.float32(0.0), np.float32(1.0), np.float32(0.0), np.float32(0.0), np.float32(0.0), np.float32(0.0), np.float32(0.0), np.float32(1.0)]",-4.0,99859.0,33
2025-08-14_08-18-36,1572,"[np.float32(0.0), np.float32(1.0), np.float32(1.0), np.float32(1.0), np.float32(1.0), np.float32(1.0), np.float32(0.0), np.float32(1.0), np.float32(1.0), np.float32(1.0), np.float32(1.0), np.float32(1.0), np.float32(0.0), np.float32(1.0), np.float32(0.0), np.float32(0.0)]",2.0,99861.0,32
2025-08-14_08-18-36,1573,"[np.float32(1.0), np.float32(1.0), np.float32(0.0), np.float32(1.0), np.float32(0.0), np.float32(1.0), np.float32(0.0), np.float32(0.0), np.float32(1.0), np.float32(0.0), np.float32(0.0), np.float32(1.0), np.float32(1.0), np.float32(0.0), np.float32(0.0), np.float32(1.0)]",2.0,99863.0,34
2025-08-14_08-18-36,1574,"[np.float32(0.0), np.float32(1.0), np.float32(0.0), np.float32(1.0), np.float32(0.0), np.float32(0.0), np.float32(1.0), np.float32(0.0), np.float32(0.0), np.float32(0.0), np.float32(0.0), np.float32(0.0), np.float32(1.0), np.float32(0.0), np.float32(1.0), np.float32(1.0)]",2.0,99865.0,9
2025-08-14_08-18-36,1575,"[np.float32(0.0), np.float32(1.0), np.float32(0.0), np.float32(1.0), np.float32(0.0), np.float32(1.0), np.float32(0.0), np.float32(1.0), np.float32(0.0), np.float32(1.0), np.float32(1.0), np.float32(1.0), np.float32(1.0), np.float32(1.0), np.float32(1.0), np.float32(0.0)]",3.0,99868.0,22
2025-08-14_08-18-36,1576,"[np.float32(1.0), np.float32(0.0), np.float32(0.0), np.float32(1.0), np.float32(1.0), np.float32(1.0), np.float32(0.0), np.float32(0.0), np.float32(0.0), np.float32(1.0), np.float32(0.0), np.float32(1.0), np.float32(0.0), np.float32(1.0), np.float32(1.0), np.float32(0.0)]",-3.0,99865.0,6
2025-08-14_08-18-36,1577,"[np.float32(1.0), np.float32(0.0), np.float32(1.0), np.float32(1.0), np.float32(0.0), np.float32(1.0), np.float32(0.0), np.float32(1.0), np.float32(0.0), np.float32(0.0), np.float32(0.0), np.float32(1.0), np.float32(1.0), np.float32(0.0), np.float32(1.0), np.float32(1.0)]",-5.0,99860.0,0
2025-08-14_08-18-36,1578,"[np.float32(0.0), np.float32(1.0), np.float32(0.0), np.float32(1.0), np.float32(0.0), np.float32(0.0), np.float32(0.0), np.float32(0.0), np.float32(1.0), np.float32(0.0), np.float32(1.0), np.float32(0.0), np.float32(1.0), np.float32(0.0), np.float32(1.0), np.float32(0.0)]",4.0,99864.0,33
2025-08-14_08-18-36,1579,"[np.float32(0.0), np.float32(1.0), np.float32(1.0), np.float32(0.0), np.float32(0.0), np.float32(0.0), np.float32(1.0), np.float32(1.0), np.float32(0.0), np.float32(1.0), np.float32(1.0), np.float32(0.0), np.float32(1.0), np.float32(1.0), np.float32(0.0), np.float32(1.0)]",-7.0,99857.0,30
2025-08-14_08-18-36,1580,"[np.float32(0.0), np.float32(0.0), np.float32(1.0), np.float32(1.0), np.float32(1.0), np.float32(0.0), np.float32(0.0), np.float32(1.0), np.float32(0.0), np.float32(0.0), np.float32(0.0), np.float32(1.0), np.float32(1.0), np.float32(0.0), np.float32(1.0), np.float32(0.0)]",0.0,99857.0,8
2025-08-14_08-18-36,1581,"[np.float32(0.0), np.float32(1.0), np.float32(0.0), np.float32(1.0), np.float32(0.0), np.float32(1.0), np.float32(1.0), np.float32(1.0), np.float32(1.0), np.float32(0.0), np.float32(1.0), np.float32(1.0), np.float32(0.0), np.float32(1.0), np.float32(0.0), np.float32(1.0)]",3.0,99860.0,26
2025-08-14_08-18-36,1582,"[np.float32(1.0), np.float32(1.0), np.float32(1.0), np.float32(0.0), np.float32(1.0), np.float32(0.0), np.float32(1.0), np.float32(1.0), np.float32(0.0), np.float32(1.0), np.float32(1.0), np.float32(0.0), np.float32(0.0), np.float32(0.0), np.float32(1.0), np.float32(1.0)]",-3.0,99857.0,30
2025-08-14_08-18-36,1583,"[np.float32(0.0), np.float32(0.0), np.float32(0.0), np.float32(0.0), np.float32(0.0), np.float32(1.0), np.float32(0.0), np.float32(0.0), np.float32(1.0), np.float32(0.0), np.float32(0.0), np.float32(1.0), np.float32(1.0), np.float32(0.0), np.float32(1.0), np.float32(1.0)]",30.0,99887.0,7
2025-08-14_08-18-36,1584,"[np.float32(0.0), np.float32(0.0), np.float32(1.0), np.float32(1.0), np.float32(1.0), np.float32(0.0), np.float32(1.0), np.float32(1.0), np.float32(1.0), np.float32(1.0), np.float32(0.0), np.float32(1.0), np.float32(1.0), np.float32(0.0), np.float32(0.0), np.float32(0.0)]",-2.0,99885.0,17
2025-08-14_08-18-36,1585,"[np.float32(1.0), np.float32(1.0), np.float32(0.0), np.float32(0.0), np.float32(0.0), np.float32(1.0), np.float32(0.0), np.float32(0.0), np.float32(1.0), np.float32(0.0), np.float32(0.0), np.float32(1.0), np.float32(1.0), np.float32(0.0), np.float32(1.0), np.float32(1.0)]",-3.0,99882.0,12
2025-08-14_08-18-36,1586,"[np.float32(0.0), np.float32(0.0), np.float32(1.0), np.float32(1.0), np.float32(0.0), np.float32(0.0), np.float32(0.0), np.float32(0.0), np.float32(0.0), np.float32(0.0), np.float32(0.0), np.float32(1.0), np.float32(1.0), np.float32(1.0), np.float32(1.0), np.float32(1.0)]",-2.0,99880.0,22
2025-08-14_08-18-36,1587,"[np.float32(0.0), np.float32(0.0), np.float32(0.0), np.float32(0.0), np.float32(0.0), np.float32(0.0), np.float32(0.0), np.float32(1.0), np.float32(0.0), np.float32(1.0), np.float32(1.0), np.float32(1.0), np.float32(0.0), np.float32(1.0), np.float32(0.0), np.float32(1.0)]",0.0,99880.0,25
2025-08-14_08-18-36,1588,"[np.float32(1.0), np.float32(1.0), np.float32(0.0), np.float32(0.0), np.float32(1.0), np.float32(1.0), np.float32(0.0), np.float32(0.0), np.float32(0.0), np.float32(0.0), np.float32(0.0), np.float32(1.0), np.float32(1.0), np.float32(0.0), np.float32(1.0), np.float32(1.0)]",-1.0,99879.0,11
2025-08-14_08-18-36,1589,"[np.float32(1.0), np.float32(1.0), np.float32(1.0), np.float32(1.0), np.float32(1.0), np.float32(1.0), np.float32(1.0), np.float32(0.0), np.float32(0.0), np.float32(0.0), np.float32(0.0), np.float32(0.0), np.float32(0.0), np.float32(1.0), np.float32(1.0), np.float32(1.0)]",-1.0,99878.0,31
2025-08-14_08-18-36,1590,"[np.float32(1.0), np.float32(0.0), np.float32(0.0), np.float32(0.0), np.float32(1.0), np.float32(1.0), np.float32(0.0), np.float32(0.0), np.float32(0.0), np.float32(0.0), np.float32(1.0), np.float32(1.0), np.float32(1.0), np.float32(1.0), np.float32(0.0), np.float32(0.0)]",1.0,99879.0,26
2025-08-14_08-18-36,1591,"[np.float32(0.0), np.float32(0.0), np.float32(1.0), np.float32(1.0), np.float32(0.0), np.float32(0.0), np.float32(1.0), np.float32(1.0), np.float32(0.0), np.float32(0.0), np.float32(0.0), np.float32(1.0), np.float32(0.0), np.float32(0.0), np.float32(0.0), np.float32(1.0)]",-4.0,99875.0,0
2025-08-14_08-18-36,1592,"[np.float32(1.0), np.float32(1.0), np.float32(0.0), np.float32(0.0), np.float32(1.0), np.float32(0.0), np.float32(0.0), np.float32(0.0), np.float32(0.0), np.float32(0.0), np.float32(0.0), np.float32(1.0), np.float32(1.0), np.float32(0.0), np.float32(0.0), np.float32(1.0)]",1.0,99876.0,15
2025-08-14_08-18-36,1593,"[np.float32(1.0), np.float32(1.0), np.float32(1.0), np.float32(1.0), np.float32(0.0), np.float32(0.0), np.float32(1.0), np.float32(1.0), np.float32(0.0), np.float32(0.0), np.float32(1.0), np.float32(0.0), np.float32(0.0), np.float32(0.0), np.float32(0.0), np.float32(0.0)]",3.0,99879.0,14
2025-08-14_08-18-36,1594,"[np.float32(1.0), np.float32(0.0), np.float32(1.0), np.float32(0.0), np.float32(0.0), np.float32(1.0), np.float32(0.0), np.float32(1.0), np.float32(0.0), np.float32(0.0), np.float32(1.0), np.float32(1.0), np.float32(0.0), np.float32(0.0), np.float32(1.0), np.float32(1.0)]",-6.0,99873.0,7
2025-08-14_08-18-36,1595,"[np.float32(0.0), np.float32(1.0), np.float32(1.0), np.float32(1.0), np.float32(0.0), np.float32(1.0), np.float32(1.0), np.float32(0.0), np.float32(1.0), np.float32(1.0), np.float32(1.0), np.float32(0.0), np.float32(1.0), np.float32(0.0), np.float32(1.0), np.float32(1.0)]",-1.0,99872.0,30
2025-08-14_08-18-36,1596,"[np.float32(1.0), np.float32(1.0), np.float32(0.0), np.float32(1.0), np.float32(1.0), np.float32(1.0), np.float32(0.0), np.float32(0.0), np.float32(0.0), np.float32(0.0), np.float32(1.0), np.float32(0.0), np.float32(1.0), np.float32(0.0), np.float32(1.0), np.float32(0.0)]",34.0,99906.0,7
2025-08-14_08-18-36,1597,"[np.float32(1.0), np.float32(0.0), np.float32(1.0), np.float32(0.0), np.float32(1.0), np.float32(0.0), np.float32(0.0), np.float32(0.0), np.float32(0.0), np.float32(0.0), np.float32(1.0), np.float32(1.0), np.float32(0.0), np.float32(0.0), np.float32(1.0), np.float32(1.0)]",1.0,99907.0,11
2025-08-14_08-18-36,1598,"[np.float32(1.0), np.float32(0.0), np.float32(1.0), np.float32(1.0), np.float32(0.0), np.float32(1.0), np.float32(1.0), np.float32(0.0), np.float32(1.0), np.float32(0.0), np.float32(0.0), np.float32(0.0), np.float32(1.0), np.float32(0.0), np.float32(0.0), np.float32(1.0)]",1.0,99908.0,36
2025-08-14_08-18-36,1599,"[np.float32(1.0), np.float32(0.0), np.float32(0.0), np.float32(1.0), np.float32(0.0), np.float32(1.0), np.float32(0.0), np.float32(0.0), np.float32(0.0), np.float32(1.0), np.float32(0.0), np.float32(1.0), np.float32(0.0), np.float32(1.0), np.float32(1.0), np.float32(1.0)]",1.0,99909.0,23
2025-08-14_08-18-36,1600,"[np.float32(0.0), np.float32(1.0), np.float32(0.0), np.float32(0.0), np.float32(0.0), np.float32(1.0), np.float32(0.0), np.float32(0.0), np.float32(0.0), np.float32(0.0), np.float32(0.0), np.float32(0.0), np.float32(1.0), np.float32(1.0), np.float32(0.0), np.float32(0.0)]",1.0,99910.0,4
2025-08-14_08-18-36,1601,"[np.float32(1.0), np.float32(1.0), np.float32(1.0), np.float32(1.0), np.float32(1.0), np.float32(0.0), np.float32(0.0), np.float32(0.0), np.float32(0.0), np.float32(1.0), np.float32(0.0), np.float32(1.0), np.float32(1.0), np.float32(0.0), np.float32(0.0), np.float32(0.0)]",-4.0,99906.0,26
2025-08-14_08-18-36,1602,"[np.float32(1.0), np.float32(0.0), np.float32(1.0), np.float32(1.0), np.float32(1.0), np.float32(1.0), np.float32(0.0), np.float32(1.0), np.float32(0.0), np.float32(1.0), np.float32(0.0), np.float32(1.0), np.float32(0.0), np.float32(1.0), np.float32(0.0), np.float32(1.0)]",3.0,99909.0,22
2025-08-14_08-18-36,1603,"[np.float32(1.0), np.float32(0.0), np.float32(1.0), np.float32(1.0), np.float32(1.0), np.float32(1.0), np.float32(0.0), np.float32(1.0), np.float32(0.0), np.float32(0.0), np.float32(0.0), np.float32(0.0), np.float32(1.0), np.float32(0.0), np.float32(0.0), np.float32(0.0)]",-1.0,99908.0,34
2025-08-14_08-18-36,1604,"[np.float32(0.0), np.float32(1.0), np.float32(0.0), np.float32(1.0), np.float32(0.0), np.float32(1.0), np.float32(0.0), np.float32(0.0), np.float32(1.0), np.float32(0.0), np.float32(0.0), np.float32(1.0), np.float32(1.0), np.float32(1.0), np.float32(1.0), np.float32(1.0)]",-2.0,99906.0,0
2025-08-14_08-18-36,1605,"[np.float32(0.0), np.float32(1.0), np.float32(1.0), np.float32(0.0), np.float32(0.0), np.float32(0.0), np.float32(0.0), np.float32(1.0), np.float32(1.0), np.float32(1.0), np.float32(0.0), np.float32(1.0), np.float32(0.0), np.float32(1.0), np.float32(1.0), np.float32(1.0)]",-3.0,99903.0,1
2025-08-14_08-18-36,1606,"[np.float32(1.0), np.float32(0.0), np.float32(0.0), np.float32(1.0), np.float32(1.0), np.float32(1.0), np.float32(1.0), np.float32(0.0), np.float32(1.0), np.float32(1.0), np.float32(0.0), np.float32(0.0), np.float32(0.0), np.float32(0.0), np.float32(1.0), np.float32(0.0)]",4.0,99907.0,7
2025-08-14_08-18-36,1607,"[np.float32(0.0), np.float32(0.0), np.float32(0.0), np.float32(1.0), np.float32(0.0), np.float32(1.0), np.float32(1.0), np.float32(1.0), np.float32(1.0), np.float32(0.0), np.float32(1.0), np.float32(0.0), np.float32(0.0), np.float32(0.0), np.float32(1.0), np.float32(0.0)]",4.0,99911.0,5
2025-08-14_08-18-36,1608,"[np.float32(1.0), np.float32(0.0), np.float32(0.0), np.float32(0.0), np.float32(0.0), np.float32(1.0), np.float32(1.0), np.float32(0.0), np.float32(0.0), np.float32(1.0), np.float32(1.0), np.float32(0.0), np.float32(0.0), np.float32(1.0), np.float32(0.0), np.float32(1.0)]",-2.0,99909.0,16
2025-08-14_08-18-36,1609,"[np.float32(0.0), np.float32(1.0), np.float32(1.0), np.float32(1.0), np.float32(1.0), np.float32(1.0), np.float32(0.0), np.float32(0.0), np.float32(1.0), np.float32(0.0), np.float32(1.0), np.float32(0.0), np.float32(1.0), np.float32(1.0), np.float32(1.0), np.float32(0.0)]",-3.0,99906.0,21
2025-08-14_08-18-36,1610,"[np.float32(0.0), np.float32(1.0), np.float32(1.0), np.float32(1.0), np.float32(0.0), np.float32(1.0), np.float32(1.0), np.float32(1.0), np.float32(1.0), np.float32(0.0), np.float32(1.0), np.float32(1.0), np.float32(0.0), np.float32(1.0), np.float32(0.0), np.float32(0.0)]",2.0,99908.0,22
2025-08-14_08-18-36,1611,"[np.float32(0.0), np.float32(0.0), np.float32(1.0), np.float32(1.0), np.float32(1.0), np.float32(0.0), np.float32(1.0), np.float32(0.0), np.float32(1.0), np.float32(1.0), np.float32(1.0), np.float32(0.0), np.float32(1.0), np.float32(0.0), np.float32(1.0), np.float32(1.0)]",-8.0,99900.0,21
2025-08-14_08-18-36,1612,"[np.float32(1.0), np.float32(1.0), np.float32(1.0), np.float32(1.0), np.float32(1.0), np.float32(1.0), np.float32(0.0), np.float32(1.0), np.float32(0.0), np.float32(0.0), np.float32(1.0), np.float32(1.0), np.float32(1.0), np.float32(1.0), np.float32(0.0), np.float32(1.0)]",0.0,99900.0,24
2025-08-14_08-18-36,1613,"[np.float32(0.0), np.float32(0.0), np.float32(0.0), np.float32(0.0), np.float32(0.0), np.float32(1.0), np.float32(1.0), np.float32(0.0), np.float32(1.0), np.float32(1.0), np.float32(1.0), np.float32(0.0), np.float32(1.0), np.float32(1.0), np.float32(0.0), np.float32(1.0)]",-3.0,99897.0,0
2025-08-14_08-18-36,1614,"[np.float32(0.0), np.float32(0.0), np.float32(0.0), np.float32(0.0), np.float32(0.0), np.float32(1.0), np.float32(1.0), np.float32(0.0), np.float32(0.0), np.float32(0.0), np.float32(1.0), np.float32(1.0), np.float32(0.0), np.float32(0.0), np.float32(0.0), np.float32(1.0)]",0.0,99897.0,26
2025-08-14_08-18-36,1615,"[np.float32(1.0), np.float32(1.0), np.float32(0.0), np.float32(0.0), np.float32(1.0), np.float32(0.0), np.float32(0.0), np.float32(1.0), np.float32(0.0), np.float32(0.0), np.float32(1.0), np.float32(0.0), np.float32(0.0), np.float32(1.0), np.float32(1.0), np.float32(0.0)]",-2.0,99895.0,33
2025-08-14_08-18-36,1616,"[np.float32(1.0), np.float32(0.0), np.float32(1.0), np.float32(1.0), np.float32(1.0), np.float32(0.0), np.float32(1.0), np.float32(1.0), np.float32(0.0), np.float32(1.0), np.float32(0.0), np.float32(0.0), np.float32(1.0), np.float32(1.0), np.float32(0.0), np.float32(1.0)]",0.0,99895.0,25
2025-08-14_08-18-36,1617,"[np.float32(1.0), np.float32(1.0), np.float32(1.0), np.float32(1.0), np.float32(0.0), np.float32(0.0), np.float32(1.0), np.float32(0.0), np.float32(1.0), np.float32(1.0), np.float32(0.0), np.float32(0.0), np.float32(0.0), np.float32(1.0), np.float32(0.0), np.float32(1.0)]",1.0,99896.0,12
2025-08-14_08-18-36,1618,"[np.float32(0.0), np.float32(1.0), np.float32(1.0), np.float32(1.0), np.float32(1.0), np.float32(1.0), np.float32(1.0), np.float32(0.0), np.float32(1.0), np.float32(1.0), np.float32(0.0), np.float32(0.0), np.float32(1.0), np.float32(1.0), np.float32(0.0), np.float32(0.0)]",2.0,99898.0,26
2025-08-14_08-18-36,1619,"[np.float32(0.0), np.float32(1.0), np.float32(1.0), np.float32(1.0), np.float32(0.0), np.float32(1.0), np.float32(0.0), np.float32(1.0), np.float32(1.0), np.float32(1.0), np.float32(0.0), np.float32(1.0), np.float32(0.0), np.float32(0.0), np.float32(0.0), np.float32(1.0)]",0.0,99898.0,29
2025-08-14_08-18-36,1620,"[np.float32(0.0), np.float32(0.0), np.float32(1.0), np.float32(1.0), np.float32(1.0), np.float32(0.0), np.float32(1.0), np.float32(1.0), np.float32(0.0), np.float32(1.0), np.float32(1.0), np.float32(0.0), np.float32(1.0), np.float32(1.0), np.float32(0.0), np.float32(0.0)]",-7.0,99891.0,30
2025-08-14_08-18-36,1621,"[np.float32(0.0), np.float32(0.0), np.float32(1.0), np.float32(0.0), np.float32(0.0), np.float32(1.0), np.float32(0.0), np.float32(0.0), np.float32(0.0), np.float32(1.0), np.float32(0.0), np.float32(0.0), np.float32(0.0), np.float32(1.0), np.float32(1.0), np.float32(0.0)]",-5.0,99886.0,9
2025-08-14_08-18-36,1622,"[np.float32(1.0), np.float32(1.0), np.float32(0.0), np.float32(0.0), np.float32(1.0), np.float32(1.0), np.float32(1.0), np.float32(1.0), np.float32(0.0), np.float32(1.0), np.float32(1.0), np.float32(1.0), np.float32(0.0), np.float32(1.0), np.float32(1.0), np.float32(1.0)]",-2.0,99884.0,28
2025-08-14_08-18-36,1623,"[np.float32(0.0), np.float32(1.0), np.float32(0.0), np.float32(0.0), np.float32(0.0), np.float32(0.0), np.float32(0.0), np.float32(1.0), np.float32(1.0), np.float32(1.0), np.float32(1.0), np.float32(0.0), np.float32(0.0), np.float32(1.0), np.float32(0.0), np.float32(0.0)]",-1.0,99883.0,24
2025-08-14_08-18-36,1624,"[np.float32(0.0), np.float32(1.0), np.float32(0.0), np.float32(0.0), np.float32(1.0), np.float32(0.0), np.float32(0.0), np.float32(1.0), np.float32(1.0), np.float32(0.0), np.float32(1.0), np.float32(0.0), np.float32(0.0), np.float32(1.0), np.float32(0.0), np.float32(1.0)]",-4.0,99879.0,27
2025-08-14_08-18-36,1625,"[np.float32(0.0), np.float32(1.0), np.float32(1.0), np.float32(1.0), np.float32(1.0), np.float32(0.0), np.float32(1.0), np.float32(1.0), np.float32(1.0), np.float32(0.0), np.float32(1.0), np.float32(0.0), np.float32(1.0), np.float32(1.0), np.float32(1.0), np.float32(0.0)]",-2.0,99877.0,6
2025-08-14_08-18-36,1626,"[np.float32(1.0), np.float32(1.0), np.float32(1.0), np.float32(1.0), np.float32(1.0), np.float32(1.0), np.float32(0.0), np.float32(1.0), np.float32(0.0), np.float32(0.0), np.float32(1.0), np.float32(1.0), np.float32(0.0), np.float32(1.0), np.float32(0.0), np.float32(1.0)]",1.0,99878.0,35
2025-08-14_08-18-36,1627,"[np.float32(0.0), np.float32(1.0), np.float32(1.0), np.float32(0.0), np.float32(0.0), np.float32(1.0), np.float32(1.0), np.float32(1.0), np.float32(0.0), np.float32(0.0), np.float32(1.0), np.float32(0.0), np.float32(1.0), np.float32(0.0), np.float32(1.0), np.float32(1.0)]",-4.0,99874.0,18
2025-08-14_08-18-36,1628,"[np.float32(1.0), np.float32(1.0), np.float32(0.0), np.float32(1.0), np.float32(1.0), np.float32(0.0), np.float32(1.0), np.float32(0.0), np.float32(1.0), np.float32(1.0), np.float32(0.0), np.float32(1.0), np.float32(0.0), np.float32(0.0), np.float32(0.0), np.float32(0.0)]",4.0,99878.0,1
2025-08-14_08-18-36,1629,"[np.float32(0.0), np.float32(0.0), np.float32(0.0), np.float32(1.0), np.float32(1.0), np.float32(1.0), np.float32(0.0), np.float32(0.0), np.float32(1.0), np.float32(1.0), np.float32(0.0), np.float32(0.0), np.float32(1.0), np.float32(0.0), np.float32(0.0), np.float32(0.0)]",-2.0,99876.0,23
2025-08-14_08-18-36,1630,"[np.float32(0.0), np.float32(1.0), np.float32(0.0), np.float32(0.0), np.float32(1.0), np.float32(1.0), np.float32(0.0), np.float32(0.0), np.float32(0.0), np.float32(1.0), np.float32(0.0), np.float32(0.0), np.float32(1.0), np.float32(1.0), np.float32(0.0), np.float32(0.0)]",-2.0,99874.0,6
2025-08-14_08-18-36,1631,"[np.float32(1.0), np.float32(0.0), np.float32(0.0), np.float32(1.0), np.float32(0.0), np.float32(0.0), np.float32(1.0), np.float32(0.0), np.float32(1.0), np.float32(0.0), np.float32(0.0), np.float32(1.0), np.float32(1.0), np.float32(1.0), np.float32(1.0), np.float32(1.0)]",-1.0,99873.0,34
2025-08-14_08-18-36,1632,"[np.float32(1.0), np.float32(1.0), np.float32(0.0), np.float32(1.0), np.float32(1.0), np.float32(1.0), np.float32(0.0), np.float32(1.0), np.float32(1.0), np.float32(1.0), np.float32(0.0), np.float32(0.0), np.float32(1.0), np.float32(1.0), np.float32(0.0), np.float32(0.0)]",-1.0,99872.0,33
2025-08-14_08-18-36,1633,"[np.float32(0.0), np.float32(1.0), np.float32(1.0), np.float32(0.0), np.float32(1.0), np.float32(0.0), np.float32(1.0), np.float32(1.0), np.float32(0.0), np.float32(0.0), np.float32(1.0), np.float32(1.0), np.float32(0.0), np.float32(0.0), np.float32(1.0), np.float32(1.0)]",-3.0,99869.0,21
2025-08-14_08-18-36,1634,"[np.float32(1.0), np.float32(0.0), np.float32(0.0), np.float32(0.0), np.float32(1.0), np.float32(1.0), np.float32(0.0), np.float32(0.0), np.float32(0.0), np.float32(0.0), np.float32(0.0), np.float32(1.0), np.float32(1.0), np.float32(1.0), np.float32(1.0), np.float32(0.0)]",-5.0,99864.0,31
2025-08-14_08-18-36,1635,"[np.float32(1.0), np.float32(0.0), np.float32(0.0), np.float32(0.0), np.float32(0.0), np.float32(1.0), np.float32(1.0), np.float32(0.0), np.float32(1.0), np.float32(0.0), np.float32(0.0), np.float32(1.0), np.float32(1.0), np.float32(0.0), np.float32(1.0), np.float32(0.0)]",-5.0,99859.0,14
2025-08-14_08-18-36,1636,"[np.float32(1.0), np.float32(1.0), np.float32(1.0), np.float32(1.0), np.float32(0.0), np.float32(0.0), np.float32(0.0), np.float32(1.0), np.float32(1.0), np.float32(0.0), np.float32(1.0), np.float32(0.0), np.float32(0.0), np.float32(1.0), np.float32(0.0), np.float32(0.0)]",2.0,99861.0,20
2025-08-14_08-18-36,1637,"[np.float32(0.0), np.float32(0.0), np.float32(1.0), np.float32(0.0), np.float32(1.0), np.float32(1.0), np.float32(0.0), np.float32(0.0), np.float32(0.0), np.float32(1.0), np.float32(1.0), np.float32(1.0), np.float32(1.0), np.float32(0.0), np.float32(1.0), np.float32(0.0)]",-1.0,99860.0,12
2025-08-14_08-18-36,1638,"[np.float32(1.0), np.float32(0.0), np.float32(0.0), np.float32(1.0), np.float32(0.0), np.float32(1.0), np.float32(0.0), np.float32(0.0), np.float32(0.0), np.float32(0.0), np.float32(1.0), np.float32(0.0), np.float32(1.0), np.float32(0.0), np.float32(0.0), np.float32(0.0)]",2.0,99862.0,29
2025-08-14_08-18-36,1639,"[np.float32(1.0), np.float32(1.0), np.float32(1.0), np.float32(0.0), np.float32(1.0), np.float32(0.0), np.float32(0.0), np.float32(1.0), np.float32(1.0), np.float32(1.0), np.float32(0.0), np.float32(1.0), np.float32(1.0), np.float32(1.0), np.float32(0.0), np.float32(1.0)]",-1.0,99861.0,1
2025-08-14_08-18-36,1640,"[np.float32(1.0), np.float32(0.0), np.float32(1.0), np.float32(1.0), np.float32(1.0), np.float32(1.0), np.float32(0.0), np.float32(0.0), np.float32(0.0), np.float32(0.0), np.float32(0.0), np.float32(0.0), np.float32(1.0), np.float32(0.0), np.float32(0.0), np.float32(0.0)]",-2.0,99859.0,17
2025-08-14_08-18-36,1641,"[np.float32(1.0), np.float32(0.0), np.float32(0.0), np.float32(1.0), np.float32(1.0), np.float32(0.0), np.float32(1.0), np.float32(1.0), np.float32(1.0), np.float32(1.0), np.float32(1.0), np.float32(1.0), np.float32(1.0), np.float32(0.0), np.float32(0.0), np.float32(0.0)]",-10.0,99849.0,0
2025-08-14_08-18-36,1642,"[np.float32(0.0), np.float32(0.0), np.float32(1.0), np.float32(1.0), np.float32(1.0), np.float32(1.0), np.float32(0.0), np.float32(1.0), np.float32(1.0), np.float32(0.0), np.float32(1.0), np.float32(0.0), np.float32(1.0), np.float32(0.0), np.float32(0.0), np.float32(0.0)]",-1.0,99848.0,5
2025-08-14_08-18-36,1643,"[np.float32(0.0), np.float32(0.0), np.float32(0.0), np.float32(1.0), np.float32(0.0), np.float32(0.0), np.float32(1.0), np.float32(0.0), np.float32(0.0), np.float32(1.0), np.float32(0.0), np.float32(0.0), np.float32(0.0), np.float32(1.0), np.float32(0.0), np.float32(0.0)]",4.0,99852.0,1
2025-08-14_08-18-36,1644,"[np.float32(1.0), np.float32(1.0), np.float32(0.0), np.float32(1.0), np.float32(0.0), np.float32(1.0), np.float32(0.0), np.float32(1.0), np.float32(1.0), np.float32(1.0), np.float32(1.0), np.float32(1.0), np.float32(0.0), np.float32(1.0), np.float32(1.0), np.float32(1.0)]",1.0,99853.0,15
2025-08-14_08-18-36,1645,"[np.float32(1.0), np.float32(0.0), np.float32(0.0), np.float32(1.0), np.float32(0.0), np.float32(0.0), np.float32(0.0), np.float32(0.0), np.float32(0.0), np.float32(0.0), np.float32(0.0), np.float32(0.0), np.float32(1.0), np.float32(0.0), np.float32(0.0), np.float32(1.0)]",-2.0,99851.0,13
2025-08-14_08-18-36,1646,"[np.float32(1.0), np.float32(1.0), np.float32(0.0), np.float32(0.0), np.float32(0.0), np.float32(1.0), np.float32(1.0), np.float32(1.0), np.float32(1.0), np.float32(0.0), np.float32(0.0), np.float32(1.0), np.float32(1.0), np.float32(1.0), np.float32(0.0), np.float32(1.0)]",-5.0,99846.0,11
2025-08-14_08-18-36,1647,"[np.float32(1.0), np.float32(0.0), np.float32(0.0), np.float32(0.0), np.float32(0.0), np.float32(0.0), np.float32(1.0), np.float32(1.0), np.float32(0.0), np.float32(1.0), np.float32(1.0), np.float32(1.0), np.float32(1.0), np.float32(0.0), np.float32(0.0), np.float32(0.0)]",-7.0,99839.0,0
2025-08-14_08-18-36,1648,"[np.float32(0.0), np.float32(0.0), np.float32(1.0), np.float32(1.0), np.float32(0.0), np.float32(0.0), np.float32(1.0), np.float32(1.0), np.float32(1.0), np.float32(1.0), np.float32(0.0), np.float32(0.0), np.float32(1.0), np.float32(1.0), np.float32(1.0), np.float32(0.0)]",-1.0,99838.0,15
2025-08-14_08-18-36,1649,"[np.float32(0.0), np.float32(1.0), np.float32(0.0), np.float32(1.0), np.float32(0.0), np.float32(0.0), np.float32(0.0), np.float32(1.0), np.float32(0.0), np.float32(1.0), np.float32(0.0), np.float32(1.0), np.float32(1.0), np.float32(1.0), np.float32(0.0), np.float32(1.0)]",-3.0,99835.0,0
2025-08-14_08-18-36,1650,"[np.float32(0.0), np.float32(0.0), np.float32(1.0), np.float32(0.0), np.float32(0.0), np.float32(1.0), np.float32(0.0), np.float32(1.0), np.float32(1.0), np.float32(1.0), np.float32(0.0), np.float32(1.0), np.float32(0.0), np.float32(0.0), np.float32(0.0), np.float32(1.0)]",1.0,99836.0,27
2025-08-14_08-18-36,1651,"[np.float32(0.0), np.float32(0.0), np.float32(0.0), np.float32(1.0), np.float32(1.0), np.float32(1.0), np.float32(1.0), np.float32(0.0), np.float32(1.0), np.float32(0.0), np.float32(0.0), np.float32(0.0), np.float32(1.0), np.float32(1.0), np.float32(1.0), np.float32(1.0)]",1.0,99837.0,29
2025-08-14_08-18-36,1652,"[np.float32(0.0), np.float32(1.0), np.float32(1.0), np.float32(1.0), np.float32(1.0), np.float32(0.0), np.float32(0.0), np.float32(0.0), np.float32(1.0), np.float32(1.0), np.float32(1.0), np.float32(0.0), np.float32(0.0), np.float32(1.0), np.float32(0.0), np.float32(0.0)]",-3.0,99834.0,30
2025-08-14_08-18-36,1653,"[np.float32(1.0), np.float32(0.0), np.float32(1.0), np.float32(1.0), np.float32(0.0), np.float32(1.0), np.float32(0.0), np.float32(1.0), np.float32(0.0), np.float32(1.0), np.float32(1.0), np.float32(0.0), np.float32(0.0), np.float32(0.0), np.float32(0.0), np.float32(1.0)]",-4.0,99830.0,33
2025-08-14_08-18-36,1654,"[np.float32(1.0), np.float32(1.0), np.float32(1.0), np.float32(1.0), np.float32(1.0), np.float32(1.0), np.float32(0.0), np.float32(1.0), np.float32(1.0), np.float32(1.0), np.float32(0.0), np.float32(0.0), np.float32(0.0), np.float32(1.0), np.float32(1.0), np.float32(0.0)]",1.0,99831.0,24
2025-08-14_08-18-36,1655,"[np.float32(1.0), np.float32(0.0), np.float32(0.0), np.float32(1.0), np.float32(1.0), np.float32(1.0), np.float32(0.0), np.float32(0.0), np.float32(1.0), np.float32(1.0), np.float32(1.0), np.float32(1.0), np.float32(0.0), np.float32(1.0), np.float32(0.0), np.float32(0.0)]",1.0,99832.0,15
2025-08-14_08-18-36,1656,"[np.float32(1.0), np.float32(1.0), np.float32(1.0), np.float32(1.0), np.float32(1.0), np.float32(1.0), np.float32(0.0), np.float32(1.0), np.float32(1.0), np.float32(1.0), np.float32(1.0), np.float32(1.0), np.float32(1.0), np.float32(0.0), np.float32(0.0), np.float32(0.0)]",-3.0,99829.0,4
2025-08-14_08-18-36,1657,"[np.float32(0.0), np.float32(1.0), np.float32(0.0), np.float32(1.0), np.float32(0.0), np.float32(1.0), np.float32(0.0), np.float32(0.0), np.float32(0.0), np.float32(1.0), np.float32(1.0), np.float32(1.0), np.float32(0.0), np.float32(0.0), np.float32(1.0), np.float32(1.0)]",-2.0,99827.0,14
2025-08-14_08-18-36,1658,"[np.float32(0.0), np.float32(1.0), np.float32(0.0), np.float32(0.0), np.float32(0.0), np.float32(0.0), np.float32(0.0), np.float32(0.0), np.float32(1.0), np.float32(0.0), np.float32(1.0), np.float32(0.0), np.float32(0.0), np.float32(1.0), np.float32(0.0), np.float32(0.0)]",4.0,99831.0,2
2025-08-14_08-18-36,1659,"[np.float32(0.0), np.float32(1.0), np.float32(1.0), np.float32(1.0), np.float32(0.0), np.float32(1.0), np.float32(0.0), np.float32(0.0), np.float32(0.0), np.float32(1.0), np.float32(0.0), np.float32(0.0), np.float32(0.0), np.float32(0.0), np.float32(1.0), np.float32(0.0)]",0.0,99831.0,26
2025-08-14_08-18-36,1660,"[np.float32(1.0), np.float32(1.0), np.float32(1.0), np.float32(1.0), np.float32(0.0), np.float32(1.0), np.float32(0.0), np.float32(0.0), np.float32(1.0), np.float32(1.0), np.float32(1.0), np.float32(1.0), np.float32(0.0), np.float32(0.0), np.float32(0.0), np.float32(0.0)]",-2.0,99829.0,14
2025-08-14_08-18-36,1661,"[np.float32(1.0), np.float32(0.0), np.float32(0.0), np.float32(1.0), np.float32(0.0), np.float32(1.0), np.float32(1.0), np.float32(1.0), np.float32(0.0), np.float32(0.0), np.float32(1.0), np.float32(0.0), np.float32(1.0), np.float32(1.0), np.float32(1.0), np.float32(0.0)]",-3.0,99826.0,4
2025-08-14_08-18-36,1662,"[np.float32(1.0), np.float32(0.0), np.float32(1.0), np.float32(0.0), np.float32(0.0), np.float32(0.0), np.float32(1.0), np.float32(0.0), np.float32(1.0), np.float32(1.0), np.float32(1.0), np.float32(1.0), np.float32(1.0), np.float32(0.0), np.float32(0.0), np.float32(0.0)]",0.0,99826.0,10
2025-08-14_08-18-36,1663,"[np.float32(1.0), np.float32(1.0), np.float32(1.0), np.float32(0.0), np.float32(0.0), np.float32(1.0), np.float32(1.0), np.float32(1.0), np.float32(1.0), np.float32(0.0), np.float32(0.0), np.float32(1.0), np.float32(1.0), np.float32(1.0), np.float32(1.0), np.float32(1.0)]",-4.0,99822.0,1
2025-08-14_08-18-36,1664,"[np.float32(1.0), np.float32(0.0), np.float32(0.0), np.float32(1.0), np.float32(0.0), np.float32(1.0), np.float32(1.0), np.float32(1.0), np.float32(0.0), np.float32(0.0), np.float32(0.0), np.float32(1.0), np.float32(1.0), np.float32(0.0), np.float32(1.0), np.float32(0.0)]",-3.0,99819.0,14
2025-08-14_08-18-36,1665,"[np.float32(1.0), np.float32(1.0), np.float32(0.0), np.float32(0.0), np.float32(0.0), np.float32(1.0), np.float32(0.0), np.float32(0.0), np.float32(0.0), np.float32(0.0), np.float32(1.0), np.float32(1.0), np.float32(0.0), np.float32(0.0), np.float32(1.0), np.float32(1.0)]",-2.0,99817.0,10
2025-08-14_08-18-36,1666,"[np.float32(1.0), np.float32(1.0), np.float32(0.0), np.float32(0.0), np.float32(0.0), np.float32(1.0), np.float32(1.0), np.float32(0.0), np.float32(1.0), np.float32(1.0), np.float32(1.0), np.float32(1.0), np.float32(0.0), np.float32(1.0), np.float32(0.0), np.float32(1.0)]",0.0,99817.0,33
2025-08-14_08-18-36,1667,"[np.float32(1.0), np.float32(0.0), np.float32(0.0), np.float32(0.0), np.float32(0.0), np.float32(1.0), np.float32(1.0), np.float32(1.0), np.float32(1.0), np.float32(1.0), np.float32(1.0), np.float32(0.0), np.float32(0.0), np.float32(1.0), np.float32(0.0), np.float32(0.0)]",0.0,99817.0,14
2025-08-14_08-18-36,1668,"[np.float32(1.0), np.float32(1.0), np.float32(1.0), np.float32(1.0), np.float32(1.0), np.float32(0.0), np.float32(0.0), np.float32(0.0), np.float32(1.0), np.float32(1.0), np.float32(0.0), np.float32(1.0), np.float32(1.0), np.float32(0.0), np.float32(0.0), np.float32(1.0)]",-3.0,99814.0,19
2025-08-14_08-18-36,1669,"[np.float32(0.0), np.float32(0.0), np.float32(1.0), np.float32(0.0), np.float32(1.0), np.float32(1.0), np.float32(0.0), np.float32(1.0), np.float32(1.0), np.float32(1.0), np.float32(0.0), np.float32(0.0), np.float32(1.0), np.float32(1.0), np.float32(1.0), np.float32(0.0)]",-2.0,99812.0,8
2025-08-14_08-18-36,1670,"[np.float32(1.0), np.float32(0.0), np.float32(1.0), np.float32(1.0), np.float32(0.0), np.float32(0.0), np.float32(1.0), np.float32(1.0), np.float32(1.0), np.float32(1.0), np.float32(1.0), np.float32(0.0), np.float32(1.0), np.float32(1.0), np.float32(0.0), np.float32(1.0)]",-1.0,99811.0,16
2025-08-14_08-18-36,1671,"[np.float32(1.0), np.float32(1.0), np.float32(0.0), np.float32(1.0), np.float32(1.0), np.float32(1.0), np.float32(1.0), np.float32(1.0), np.float32(1.0), np.float32(1.0), np.float32(0.0), np.float32(1.0), np.float32(1.0), np.float32(0.0), np.float32(0.0), np.float32(0.0)]",1.0,99812.0,21
2025-08-14_08-18-36,1672,"[np.float32(1.0), np.float32(1.0), np.float32(1.0), np.float32(1.0), np.float32(1.0), np.float32(1.0), np.float32(0.0), np.float32(0.0), np.float32(1.0), np.float32(0.0), np.float32(0.0), np.float32(1.0), np.float32(0.0), np.float32(1.0), np.float32(1.0), np.float32(0.0)]",2.0,99814.0,3
2025-08-14_08-18-36,1673,"[np.float32(0.0), np.float32(1.0), np.float32(1.0), np.float32(0.0), np.float32(0.0), np.float32(1.0), np.float32(0.0), np.float32(1.0), np.float32(1.0), np.float32(1.0), np.float32(0.0), np.float32(1.0), np.float32(0.0), np.float32(1.0), np.float32(1.0), np.float32(0.0)]",4.0,99818.0,30
2025-08-14_08-18-36,1674,"[np.float32(1.0), np.float32(0.0), np.float32(0.0), np.float32(1.0), np.float32(1.0), np.float32(1.0), np.float32(0.0), np.float32(0.0), np.float32(0.0), np.float32(1.0), np.float32(1.0), np.float32(0.0), np.float32(0.0), np.float32(0.0), np.float32(0.0), np.float32(1.0)]",-3.0,99815.0,30
2025-08-14_08-18-36,1675,"[np.float32(1.0), np.float32(1.0), np.float32(0.0), np.float32(0.0), np.float32(0.0), np.float32(0.0), np.float32(1.0), np.float32(0.0), np.float32(1.0), np.float32(0.0), np.float32(0.0), np.float32(1.0), np.float32(0.0), np.float32(1.0), np.float32(0.0), np.float32(0.0)]",2.0,99817.0,32
2025-08-14_08-18-36,1676,"[np.float32(1.0), np.float32(0.0), np.float32(1.0), np.float32(0.0), np.float32(0.0), np.float32(0.0), np.float32(1.0), np.float32(0.0), np.float32(0.0), np.float32(1.0), np.float32(0.0), np.float32(1.0), np.float32(1.0), np.float32(1.0), np.float32(1.0), np.float32(1.0)]",-3.0,99814.0,13
2025-08-14_08-18-36,1677,"[np.float32(1.0), np.float32(1.0), np.float32(1.0), np.float32(0.0), np.float32(0.0), np.float32(0.0), np.float32(0.0), np.float32(1.0), np.float32(1.0), np.float32(1.0), np.float32(1.0), np.float32(0.0), np.float32(1.0), np.float32(0.0), np.float32(0.0), np.float32(0.0)]",-3.0,99811.0,11
2025-08-14_08-18-36,1678,"[np.float32(0.0), np.float32(1.0), np.float32(0.0), np.float32(1.0), np.float32(1.0), np.float32(0.0), np.float32(1.0), np.float32(0.0), np.float32(1.0), np.float32(1.0), np.float32(0.0), np.float32(0.0), np.float32(0.0), np.float32(1.0), np.float32(1.0), np.float32(0.0)]",-3.0,99808.0,18
2025-08-14_08-18-36,1679,"[np.float32(1.0), np.float32(1.0), np.float32(0.0), np.float32(1.0), np.float32(1.0), np.float32(1.0), np.float32(1.0), np.float32(1.0), np.float32(1.0), np.float32(0.0), np.float32(1.0), np.float32(1.0), np.float32(0.0), np.float32(0.0), np.float32(1.0), np.float32(0.0)]",-1.0,99807.0,14
2025-08-14_08-18-36,1680,"[np.float32(0.0), np.float32(0.0), np.float32(1.0), np.float32(1.0), np.float32(1.0), np.float32(0.0), np.float32(0.0), np.float32(1.0), np.float32(1.0), np.float32(1.0), np.float32(0.0), np.float32(1.0), np.float32(1.0), np.float32(1.0), np.float32(0.0), np.float32(0.0)]",4.0,99811.0,15
2025-08-14_08-18-36,1681,"[np.float32(0.0), np.float32(1.0), np.float32(1.0), np.float32(1.0), np.float32(0.0), np.float32(0.0), np.float32(1.0), np.float32(0.0), np.float32(0.0), np.float32(1.0), np.float32(1.0), np.float32(1.0), np.float32(0.0), np.float32(0.0), np.float32(0.0), np.float32(1.0)]",-3.0,99808.0,18
2025-08-14_08-18-36,1682,"[np.float32(1.0), np.float32(0.0), np.float32(0.0), np.float32(1.0), np.float32(0.0), np.float32(0.0), np.float32(1.0), np.float32(1.0), np.float32(1.0), np.float32(1.0), np.float32(0.0), np.float32(0.0), np.float32(1.0), np.float32(0.0), np.float32(1.0), np.float32(0.0)]",0.0,99808.0,33
2025-08-14_08-18-36,1683,"[np.float32(1.0), np.float32(1.0), np.float32(1.0), np.float32(0.0), np.float32(0.0), np.float32(1.0), np.float32(0.0), np.float32(0.0), np.float32(1.0), np.float32(1.0), np.float32(0.0), np.float32(0.0), np.float32(0.0), np.float32(1.0), np.float32(1.0), np.float32(1.0)]",-2.0,99806.0,18
2025-08-14_08-18-36,1684,"[np.float32(1.0), np.float32(0.0), np.float32(0.0), np.float32(1.0), np.float32(1.0), np.float32(0.0), np.float32(0.0), np.float32(1.0), np.float32(1.0), np.float32(0.0), np.float32(0.0), np.float32(1.0), np.float32(0.0), np.float32(0.0), np.float32(0.0), np.float32(0.0)]",0.0,99806.0,1
2025-08-14_08-18-36,1685,"[np.float32(1.0), np.float32(1.0), np.float32(1.0), np.float32(1.0), np.float32(0.0), np.float32(1.0), np.float32(1.0), np.float32(0.0), np.float32(0.0), np.float32(0.0), np.float32(0.0), np.float32(0.0), np.float32(0.0), np.float32(1.0), np.float32(0.0), np.float32(1.0)]",1.0,99807.0,19
2025-08-14_08-18-36,1686,"[np.float32(1.0), np.float32(0.0), np.float32(0.0), np.float32(0.0), np.float32(0.0), np.float32(1.0), np.float32(0.0), np.float32(1.0), np.float32(1.0), np.float32(0.0), np.float32(0.0), np.float32(0.0), np.float32(1.0), np.float32(1.0), np.float32(1.0), np.float32(1.0)]",-5.0,99802.0,10
2025-08-14_08-18-36,1687,"[np.float32(0.0), np.float32(0.0), np.float32(0.0), np.float32(0.0), np.float32(0.0), np.float32(1.0), np.float32(0.0), np.float32(0.0), np.float32(0.0), np.float32(1.0), np.float32(1.0), np.float32(1.0), np.float32(0.0), np.float32(0.0), np.float32(1.0), np.float32(0.0)]",0.0,99802.0,28
2025-08-14_08-18-36,1688,"[np.float32(0.0), np.float32(0.0), np.float32(1.0), np.float32(1.0), np.float32(0.0), np.float32(1.0), np.float32(1.0), np.float32(1.0), np.float32(0.0), np.float32(1.0), np.float32(1.0), np.float32(1.0), np.float32(1.0), np.float32(0.0), np.float32(1.0), np.float32(1.0)]",0.0,99802.0,13
2025-08-14_08-18-36,1689,"[np.float32(0.0), np.float32(0.0), np.float32(0.0), np.float32(1.0), np.float32(0.0), np.float32(0.0), np.float32(0.0), np.float32(1.0), np.float32(0.0), np.float32(1.0), np.float32(1.0), np.float32(0.0), np.float32(0.0), np.float32(1.0), np.float32(0.0), np.float32(1.0)]",-1.0,99801.0,3
2025-08-14_08-18-36,1690,"[np.float32(0.0), np.float32(1.0), np.float32(1.0), np.float32(0.0), np.float32(1.0), np.float32(0.0), np.float32(1.0), np.float32(1.0), np.float32(1.0), np.float32(1.0), np.float32(0.0), np.float32(0.0), np.float32(1.0), np.float32(1.0), np.float32(1.0), np.float32(0.0)]",-2.0,99799.0,31
2025-08-14_08-18-36,1691,"[np.float32(0.0), np.float32(1.0), np.float32(0.0), np.float32(0.0), np.float32(1.0), np.float32(1.0), np.float32(1.0), np.float32(0.0), np.float32(1.0), np.float32(1.0), np.float32(0.0), np.float32(0.0), np.float32(1.0), np.float32(0.0), np.float32(1.0), np.float32(1.0)]",1.0,99800.0,28
2025-08-14_08-18-36,1692,"[np.float32(1.0), np.float32(0.0), np.float32(0.0), np.float32(1.0), np.float32(0.0), np.float32(1.0), np.float32(1.0), np.float32(1.0), np.float32(0.0), np.float32(1.0), np.float32(1.0), np.float32(1.0), np.float32(0.0), np.float32(0.0), np.float32(1.0), np.float32(1.0)]",1.0,99801.0,17
2025-08-14_08-18-36,1693,"[np.float32(1.0), np.float32(1.0), np.float32(0.0), np.float32(1.0), np.float32(1.0), np.float32(0.0), np.float32(0.0), np.float32(1.0), np.float32(0.0), np.float32(1.0), np.float32(0.0), np.float32(1.0), np.float32(0.0), np.float32(0.0), np.float32(0.0), np.float32(0.0)]",-5.0,99796.0,26
2025-08-14_08-18-36,1694,"[np.float32(0.0), np.float32(0.0), np.float32(1.0), np.float32(1.0), np.float32(0.0), np.float32(0.0), np.float32(1.0), np.float32(1.0), np.float32(0.0), np.float32(0.0), np.float32(0.0), np.float32(0.0), np.float32(0.0), np.float32(0.0), np.float32(1.0), np.float32(0.0)]",0.0,99796.0,6
2025-08-14_08-18-36,1695,"[np.float32(1.0), np.float32(1.0), np.float32(1.0), np.float32(1.0), np.float32(0.0), np.float32(1.0), np.float32(0.0), np.float32(1.0), np.float32(1.0), np.float32(1.0), np.float32(0.0), np.float32(1.0), np.float32(1.0), np.float32(1.0), np.float32(0.0), np.float32(1.0)]",-2.0,99794.0,13
2025-08-14_08-18-36,1696,"[np.float32(1.0), np.float32(0.0), np.float32(1.0), np.float32(1.0), np.float32(0.0), np.float32(1.0), np.float32(0.0), np.float32(0.0), np.float32(0.0), np.float32(0.0), np.float32(0.0), np.float32(0.0), np.float32(0.0), np.float32(1.0), np.float32(0.0), np.float32(1.0)]",1.0,99795.0,0
2025-08-14_08-18-36,1697,"[np.float32(0.0), np.float32(1.0), np.float32(0.0), np.float32(0.0), np.float32(0.0), np.float32(1.0), np.float32(1.0), np.float32(0.0), np.float32(1.0), np.float32(0.0), np.float32(1.0), np.float32(0.0), np.float32(1.0), np.float32(0.0), np.float32(0.0), np.float32(0.0)]",-3.0,99792.0,9
2025-08-14_08-18-36,1698,"[np.float32(0.0), np.float32(1.0), np.float32(1.0), np.float32(0.0), np.float32(0.0), np.float32(0.0), np.float32(1.0), np.float32(1.0), np.float32(1.0), np.float32(1.0), np.float32(0.0), np.float32(1.0), np.float32(0.0), np.float32(1.0), np.float32(1.0), np.float32(1.0)]",-1.0,99791.0,21
2025-08-14_08-18-36,1699,"[np.float32(1.0), np.float32(0.0), np.float32(0.0), np.float32(0.0), np.float32(0.0), np.float32(0.0), np.float32(1.0), np.float32(1.0), np.float32(0.0), np.float32(0.0), np.float32(1.0), np.float32(0.0), np.float32(1.0), np.float32(1.0), np.float32(1.0), np.float32(0.0)]",2.0,99793.0,2
2025-08-14_08-18-36,1700,"[np.float32(1.0), np.float32(0.0), np.float32(1.0), np.float32(1.0), np.float32(1.0), np.float32(1.0), np.float32(0.0), np.float32(0.0), np.float32(0.0), np.float32(0.0), np.float32(1.0), np.float32(0.0), np.float32(1.0), np.float32(1.0), np.float32(1.0), np.float32(1.0)]",-3.0,99790.0,15
2025-08-14_08-18-36,1701,"[np.float32(0.0), np.float32(0.0), np.float32(0.0), np.float32(0.0), np.float32(0.0), np.float32(0.0), np.float32(0.0), np.float32(0.0), np.float32(0.0), np.float32(1.0), np.float32(0.0), np.float32(0.0), np.float32(0.0), np.float32(1.0), np.float32(1.0), np.float32(1.0)]",-1.0,99789.0,21
2025-08-14_08-18-36,1702,"[np.float32(1.0), np.float32(0.0), np.float32(0.0), np.float32(1.0), np.float32(0.0), np.float32(1.0), np.float32(0.0), np.float32(1.0), np.float32(1.0), np.float32(1.0), np.float32(1.0), np.float32(1.0), np.float32(1.0), np.float32(1.0), np.float32(1.0), np.float32(0.0)]",-4.0,99785.0,9
2025-08-14_08-18-36,1703,"[np.float32(0.0), np.float32(1.0), np.float32(1.0), np.float32(1.0), np.float32(1.0), np.float32(1.0), np.float32(0.0), np.float32(1.0), np.float32(0.0), np.float32(0.0), np.float32(0.0), np.float32(0.0), np.float32(0.0), np.float32(1.0), np.float32(1.0), np.float32(1.0)]",-2.0,99783.0,7
2025-08-14_08-18-36,1704,"[np.float32(1.0), np.float32(0.0), np.float32(1.0), np.float32(1.0), np.float32(1.0), np.float32(0.0), np.float32(1.0), np.float32(0.0), np.float32(0.0), np.float32(1.0), np.float32(1.0), np.float32(0.0), np.float32(0.0), np.float32(1.0), np.float32(1.0), np.float32(0.0)]",-2.0,99781.0,36
2025-08-14_08-18-36,1705,"[np.float32(0.0), np.float32(0.0), np.float32(0.0), np.float32(0.0), np.float32(1.0), np.float32(0.0), np.float32(1.0), np.float32(0.0), np.float32(1.0), np.float32(1.0), np.float32(1.0), np.float32(0.0), np.float32(1.0), np.float32(0.0), np.float32(0.0), np.float32(0.0)]",2.0,99783.0,5
2025-08-14_08-18-36,1706,"[np.float32(0.0), np.float32(0.0), np.float32(0.0), np.float32(0.0), np.float32(0.0), np.float32(0.0), np.float32(0.0), np.float32(0.0), np.float32(1.0), np.float32(0.0), np.float32(1.0), np.float32(1.0), np.float32(1.0), np.float32(1.0), np.float32(0.0), np.float32(0.0)]",-2.0,99781.0,14
2025-08-14_08-18-36,1707,"[np.float32(1.0), np.float32(0.0), np.float32(1.0), np.float32(1.0), np.float32(0.0), np.float32(1.0), np.float32(0.0), np.float32(1.0), np.float32(0.0), np.float32(0.0), np.float32(1.0), np.float32(0.0), np.float32(0.0), np.float32(0.0), np.float32(1.0), np.float32(1.0)]",2.0,99783.0,5
2025-08-14_08-18-36,1708,"[np.float32(1.0), np.float32(1.0), np.float32(0.0), np.float32(1.0), np.float32(1.0), np.float32(1.0), np.float32(0.0), np.float32(1.0), np.float32(1.0), np.float32(1.0), np.float32(0.0), np.float32(0.0), np.float32(0.0), np.float32(1.0), np.float32(1.0), np.float32(0.0)]",-3.0,99780.0,2
2025-08-14_08-18-36,1709,"[np.float32(0.0), np.float32(1.0), np.float32(0.0), np.float32(1.0), np.float32(1.0), np.float32(1.0), np.float32(0.0), np.float32(1.0), np.float32(0.0), np.float32(0.0), np.float32(0.0), np.float32(0.0), np.float32(0.0), np.float32(0.0), np.float32(1.0), np.float32(0.0)]",4.0,99784.0,23
2025-08-14_08-18-36,1710,"[np.float32(0.0), np.float32(0.0), np.float32(1.0), np.float32(0.0), np.float32(0.0), np.float32(0.0), np.float32(0.0), np.float32(0.0), np.float32(0.0), np.float32(1.0), np.float32(0.0), np.float32(0.0), np.float32(0.0), np.float32(1.0), np.float32(0.0), np.float32(1.0)]",-2.0,99782.0,36
2025-08-14_08-18-36,1711,"[np.float32(1.0), np.float32(1.0), np.float32(1.0), np.float32(0.0), np.float32(0.0), np.float32(0.0), np.float32(0.0), np.float32(1.0), np.float32(0.0), np.float32(1.0), np.float32(1.0), np.float32(0.0), np.float32(0.0), np.float32(1.0), np.float32(0.0), np.float32(0.0)]",-5.0,99777.0,27
2025-08-14_08-18-36,1712,"[np.float32(0.0), np.float32(1.0), np.float32(1.0), np.float32(1.0), np.float32(0.0), np.float32(1.0), np.float32(0.0), np.float32(1.0), np.float32(1.0), np.float32(0.0), np.float32(1.0), np.float32(1.0), np.float32(0.0), np.float32(1.0), np.float32(0.0), np.float32(1.0)]",0.0,99777.0,30
2025-08-14_08-18-36,1713,"[np.float32(0.0), np.float32(1.0), np.float32(0.0), np.float32(1.0), np.float32(0.0), np.float32(0.0), np.float32(0.0), np.float32(0.0), np.float32(1.0), np.float32(0.0), np.float32(1.0), np.float32(1.0), np.float32(0.0), np.float32(0.0), np.float32(0.0), np.float32(0.0)]",-1.0,99776.0,13
2025-08-14_08-18-36,1714,"[np.float32(1.0), np.float32(1.0), np.float32(0.0), np.float32(1.0), np.float32(0.0), np.float32(1.0), np.float32(1.0), np.float32(1.0), np.float32(0.0), np.float32(0.0), np.float32(1.0), np.float32(0.0), np.float32(0.0), np.float32(0.0), np.float32(0.0), np.float32(1.0)]",-2.0,99774.0,27
2025-08-14_08-18-36,1715,"[np.float32(1.0), np.float32(0.0), np.float32(0.0), np.float32(0.0), np.float32(1.0), np.float32(0.0), np.float32(1.0), np.float32(0.0), np.float32(1.0), np.float32(1.0), np.float32(0.0), np.float32(1.0), np.float32(0.0), np.float32(0.0), np.float32(0.0), np.float32(1.0)]",4.0,99778.0,6
2025-08-14_08-18-36,1716,"[np.float32(1.0), np.float32(0.0), np.float32(1.0), np.float32(0.0), np.float32(1.0), np.float32(1.0), np.float32(0.0), np.float32(1.0), np.float32(1.0), np.float32(1.0), np.float32(1.0), np.float32(0.0), np.float32(1.0), np.float32(1.0), np.float32(1.0), np.float32(0.0)]",-1.0,99777.0,2
2025-08-14_08-18-36,1717,"[np.float32(0.0), np.float32(1.0), np.float32(1.0), np.float32(0.0), np.float32(0.0), np.float32(1.0), np.float32(0.0), np.float32(0.0), np.float32(1.0), np.float32(1.0), np.float32(0.0), np.float32(0.0), np.float32(0.0), np.float32(1.0), np.float32(1.0), np.float32(0.0)]",3.0,99780.0,36
2025-08-14_08-18-36,1718,"[np.float32(1.0), np.float32(1.0), np.float32(0.0), np.float32(0.0), np.float32(1.0), np.float32(1.0), np.float32(0.0), np.float32(1.0), np.float32(0.0), np.float32(0.0), np.float32(1.0), np.float32(1.0), np.float32(1.0), np.float32(0.0), np.float32(1.0), np.float32(1.0)]",3.0,99783.0,14
2025-08-14_08-18-36,1719,"[np.float32(0.0), np.float32(1.0), np.float32(0.0), np.float32(1.0), np.float32(0.0), np.float32(1.0), np.float32(1.0), np.float32(1.0), np.float32(0.0), np.float32(1.0), np.float32(1.0), np.float32(0.0), np.float32(1.0), np.float32(0.0), np.float32(1.0), np.float32(0.0)]",-4.0,99779.0,6
2025-08-14_08-18-36,1720,"[np.float32(0.0), np.float32(1.0), np.float32(0.0), np.float32(1.0), np.float32(0.0), np.float32(0.0), np.float32(0.0), np.float32(0.0), np.float32(0.0), np.float32(1.0), np.float32(1.0), np.float32(0.0), np.float32(1.0), np.float32(1.0), np.float32(0.0), np.float32(0.0)]",-4.0,99775.0,24
2025-08-14_08-18-36,1721,"[np.float32(0.0), np.float32(1.0), np.float32(1.0), np.float32(0.0), np.float32(0.0), np.float32(1.0), np.float32(0.0), np.float32(1.0), np.float32(1.0), np.float32(1.0), np.float32(1.0), np.float32(1.0), np.float32(1.0), np.float32(0.0), np.float32(0.0), np.float32(1.0)]",-2.0,99773.0,27
2025-08-14_08-18-36,1722,"[np.float32(0.0), np.float32(1.0), np.float32(0.0), np.float32(0.0), np.float32(0.0), np.float32(0.0), np.float32(0.0), np.float32(1.0), np.float32(0.0), np.float32(1.0), np.float32(0.0), np.float32(0.0), np.float32(1.0), np.float32(0.0), np.float32(1.0), np.float32(1.0)]",-3.0,99770.0,25
2025-08-14_08-18-36,1723,"[np.float32(1.0), np.float32(1.0), np.float32(0.0), np.float32(0.0), np.float32(0.0), np.float32(0.0), np.float32(1.0), np.float32(1.0), np.float32(1.0), np.float32(0.0), np.float32(1.0), np.float32(1.0), np.float32(0.0), np.float32(1.0), np.float32(1.0), np.float32(0.0)]",-4.0,99766.0,1
2025-08-14_08-18-36,1724,"[np.float32(1.0), np.float32(1.0), np.float32(1.0), np.float32(0.0), np.float32(1.0), np.float32(0.0), np.float32(0.0), np.float32(0.0), np.float32(0.0), np.float32(1.0), np.float32(0.0), np.float32(0.0), np.float32(0.0), np.float32(1.0), np.float32(1.0), np.float32(0.0)]",0.0,99766.0,36
2025-08-14_08-18-36,1725,"[np.float32(0.0), np.float32(0.0), np.float32(1.0), np.float32(0.0), np.float32(0.0), np.float32(1.0), np.float32(1.0), np.float32(1.0), np.float32(0.0), np.float32(1.0), np.float32(0.0), np.float32(1.0), np.float32(0.0), np.float32(0.0), np.float32(0.0), np.float32(0.0)]",-1.0,99765.0,14
2025-08-14_08-18-36,1726,"[np.float32(1.0), np.float32(0.0), np.float32(1.0), np.float32(1.0), np.float32(0.0), np.float32(0.0), np.float32(1.0), np.float32(0.0), np.float32(1.0), np.float32(1.0), np.float32(0.0), np.float32(0.0), np.float32(0.0), np.float32(1.0), np.float32(1.0), np.float32(1.0)]",1.0,99766.0,27
2025-08-14_08-18-36,1727,"[np.float32(1.0), np.float32(0.0), np.float32(1.0), np.float32(1.0), np.float32(0.0), np.float32(1.0), np.float32(0.0), np.float32(1.0), np.float32(0.0), np.float32(1.0), np.float32(1.0), np.float32(0.0), np.float32(0.0), np.float32(1.0), np.float32(1.0), np.float32(1.0)]",-5.0,99761.0,6
2025-08-14_08-18-36,1728,"[np.float32(0.0), np.float32(1.0), np.float32(1.0), np.float32(0.0), np.float32(1.0), np.float32(0.0), np.float32(1.0), np.float32(0.0), np.float32(0.0), np.float32(0.0), np.float32(0.0), np.float32(1.0), np.float32(0.0), np.float32(0.0), np.float32(0.0), np.float32(0.0)]",0.0,99761.0,7
2025-08-14_08-18-36,1729,"[np.float32(0.0), np.float32(1.0), np.float32(0.0), np.float32(1.0), np.float32(1.0), np.float32(1.0), np.float32(1.0), np.float32(0.0), np.float32(0.0), np.float32(1.0), np.float32(0.0), np.float32(0.0), np.float32(0.0), np.float32(1.0), np.float32(1.0), np.float32(0.0)]",-1.0,99760.0,27
2025-08-14_08-18-36,1730,"[np.float32(1.0), np.float32(1.0), np.float32(0.0), np.float32(0.0), np.float32(1.0), np.float32(1.0), np.float32(1.0), np.float32(1.0), np.float32(0.0), np.float32(0.0), np.float32(0.0), np.float32(0.0), np.float32(1.0), np.float32(1.0), np.float32(0.0), np.float32(0.0)]",-1.0,99759.0,32
2025-08-14_08-18-36,1731,"[np.float32(1.0), np.float32(0.0), np.float32(1.0), np.float32(1.0), np.float32(0.0), np.float32(0.0), np.float32(1.0), np.float32(1.0), np.float32(0.0), np.float32(0.0), np.float32(0.0), np.float32(1.0), np.float32(0.0), np.float32(1.0), np.float32(1.0), np.float32(1.0)]",2.0,99761.0,15
2025-08-14_08-18-36,1732,"[np.float32(1.0), np.float32(1.0), np.float32(0.0), np.float32(0.0), np.float32(0.0), np.float32(0.0), np.float32(1.0), np.float32(0.0), np.float32(1.0), np.float32(1.0), np.float32(1.0), np.float32(0.0), np.float32(0.0), np.float32(0.0), np.float32(0.0), np.float32(0.0)]",-1.0,99760.0,16
2025-08-14_08-18-36,1733,"[np.float32(0.0), np.float32(0.0), np.float32(0.0), np.float32(0.0), np.float32(1.0), np.float32(1.0), np.float32(0.0), np.float32(0.0), np.float32(0.0), np.float32(1.0), np.float32(0.0), np.float32(1.0), np.float32(0.0), np.float32(0.0), np.float32(0.0), np.float32(1.0)]",3.0,99763.0,34
2025-08-14_08-18-36,1734,"[np.float32(1.0), np.float32(0.0), np.float32(0.0), np.float32(0.0), np.float32(0.0), np.float32(0.0), np.float32(0.0), np.float32(0.0), np.float32(1.0), np.float32(0.0), np.float32(0.0), np.float32(0.0), np.float32(0.0), np.float32(0.0), np.float32(0.0), np.float32(1.0)]",2.0,99765.0,1
2025-08-14_08-18-36,1735,"[np.float32(1.0), np.float32(1.0), np.float32(1.0), np.float32(1.0), np.float32(0.0), np.float32(1.0), np.float32(1.0), np.float32(1.0), np.float32(0.0), np.float32(1.0), np.float32(1.0), np.float32(0.0), np.float32(0.0), np.float32(1.0), np.float32(1.0), np.float32(1.0)]",3.0,99768.0,22
2025-08-14_08-18-36,1736,"[np.float32(1.0), np.float32(0.0), np.float32(1.0), np.float32(0.0), np.float32(0.0), np.float32(1.0), np.float32(0.0), np.float32(1.0), np.float32(0.0), np.float32(1.0), np.float32(0.0), np.float32(0.0), np.float32(1.0), np.float32(0.0), np.float32(1.0), np.float32(1.0)]",0.0,99768.0,10
2025-08-14_08-18-36,1737,"[np.float32(1.0), np.float32(1.0), np.float32(1.0), np.float32(1.0), np.float32(1.0), np.float32(0.0), np.float32(0.0), np.float32(1.0), np.float32(1.0), np.float32(1.0), np.float32(1.0), np.float32(1.0), np.float32(0.0), np.float32(0.0), np.float32(1.0), np.float32(0.0)]",1.0,99769.0,10
2025-08-14_08-18-36,1738,"[np.float32(0.0), np.float32(1.0), np.float32(1.0), np.float32(0.0), np.float32(1.0), np.float32(0.0), np.float32(0.0), np.float32(1.0), np.float32(1.0), np.float32(0.0), np.float32(0.0), np.float32(1.0), np.float32(1.0), np.float32(1.0), np.float32(0.0), np.float32(1.0)]",-1.0,99768.0,29
2025-08-14_08-18-36,1739,"[np.float32(0.0), np.float32(1.0), np.float32(1.0), np.float32(1.0), np.float32(1.0), np.float32(1.0), np.float32(1.0), np.float32(1.0), np.float32(0.0), np.float32(1.0), np.float32(0.0), np.float32(0.0), np.float32(1.0), np.float32(0.0), np.float32(1.0), np.float32(0.0)]",2.0,99770.0,22
2025-08-14_08-18-36,1740,"[np.float32(1.0), np.float32(0.0), np.float32(1.0), np.float32(1.0), np.float32(0.0), np.float32(1.0), np.float32(1.0), np.float32(1.0), np.float32(1.0), np.float32(0.0), np.float32(1.0), np.float32(1.0), np.float32(1.0), np.float32(0.0), np.float32(0.0), np.float32(1.0)]",-7.0,99763.0,0
2025-08-14_08-18-36,1741,"[np.float32(1.0), np.float32(0.0), np.float32(1.0), np.float32(0.0), np.float32(0.0), np.float32(1.0), np.float32(0.0), np.float32(1.0), np.float32(1.0), np.float32(1.0), np.float32(1.0), np.float32(0.0), np.float32(1.0), np.float32(1.0), np.float32(0.0), np.float32(1.0)]",-2.0,99761.0,2
2025-08-14_08-18-36,1742,"[np.float32(1.0), np.float32(1.0), np.float32(0.0), np.float32(1.0), np.float32(0.0), np.float32(1.0), np.float32(0.0), np.float32(1.0), np.float32(0.0), np.float32(0.0), np.float32(1.0), np.float32(0.0), np.float32(0.0), np.float32(1.0), np.float32(0.0), np.float32(1.0)]",-1.0,99760.0,9
2025-08-14_08-18-36,1743,"[np.float32(1.0), np.float32(1.0), np.float32(0.0), np.float32(0.0), np.float32(0.0), np.float32(1.0), np.float32(0.0), np.float32(1.0), np.float32(1.0), np.float32(0.0), np.float32(0.0), np.float32(1.0), np.float32(1.0), np.float32(1.0), np.float32(1.0), np.float32(1.0)]",3.0,99763.0,36
2025-08-14_08-18-36,1744,"[np.float32(0.0), np.float32(1.0), np.float32(0.0), np.float32(0.0), np.float32(0.0), np.float32(0.0), np.float32(0.0), np.float32(0.0), np.float32(1.0), np.float32(1.0), np.float32(0.0), np.float32(0.0), np.float32(0.0), np.float32(0.0), np.float32(1.0), np.float32(0.0)]",-1.0,99762.0,32
2025-08-14_08-18-36,1745,"[np.float32(1.0), np.float32(0.0), np.float32(1.0), np.float32(0.0), np.float32(0.0), np.float32(1.0), np.float32(1.0), np.float32(1.0), np.float32(1.0), np.float32(0.0), np.float32(1.0), np.float32(0.0), np.float32(0.0), np.float32(1.0), np.float32(0.0), np.float32(1.0)]",-1.0,99761.0,1
2025-08-14_08-18-36,1746,"[np.float32(1.0), np.float32(0.0), np.float32(1.0), np.float32(0.0), np.float32(1.0), np.float32(1.0), np.float32(1.0), np.float32(0.0), np.float32(1.0), np.float32(0.0), np.float32(0.0), np.float32(0.0), np.float32(1.0), np.float32(1.0), np.float32(0.0), np.float32(1.0)]",-2.0,99759.0,19
2025-08-14_08-18-36,1747,"[np.float32(1.0), np.float32(0.0), np.float32(1.0), np.float32(0.0), np.float32(1.0), np.float32(0.0), np.float32(1.0), np.float32(0.0), np.float32(1.0), np.float32(0.0), np.float32(0.0), np.float32(0.0), np.float32(0.0), np.float32(0.0), np.float32(1.0), np.float32(1.0)]",-2.0,99757.0,17
2025-08-14_08-18-36,1748,"[np.float32(1.0), np.float32(1.0), np.float32(1.0), np.float32(1.0), np.float32(0.0), np.float32(1.0), np.float32(0.0), np.float32(0.0), np.float32(1.0), np.float32(1.0), np.float32(0.0), np.float32(0.0), np.float32(1.0), np.float32(1.0), np.float32(1.0), np.float32(0.0)]",-6.0,99751.0,14
2025-08-14_08-18-36,1749,"[np.float32(0.0), np.float32(0.0), np.float32(1.0), np.float32(1.0), np.float32(0.0), np.float32(0.0), np.float32(0.0), np.float32(1.0), np.float32(1.0), np.float32(1.0), np.float32(0.0), np.float32(0.0), np.float32(1.0), np.float32(0.0), np.float32(0.0), np.float32(0.0)]",-4.0,99747.0,8
2025-08-14_08-18-36,1750,"[np.float32(1.0), np.float32(0.0), np.float32(1.0), np.float32(0.0), np.float32(1.0), np.float32(0.0), np.float32(1.0), np.float32(0.0), np.float32(0.0), np.float32(1.0), np.float32(0.0), np.float32(1.0), np.float32(1.0), np.float32(1.0), np.float32(1.0), np.float32(0.0)]",3.0,99750.0,18
2025-08-14_08-18-36,1751,"[np.float32(0.0), np.float32(1.0), np.float32(0.0), np.float32(1.0), np.float32(0.0), np.float32(0.0), np.float32(1.0), np.float32(1.0), np.float32(0.0), np.float32(1.0), np.float32(1.0), np.float32(0.0), np.float32(0.0), np.float32(0.0), np.float32(0.0), np.float32(1.0)]",1.0,99751.0,7
2025-08-14_08-18-36,1752,"[np.float32(1.0), np.float32(0.0), np.float32(1.0), np.float32(1.0), np.float32(1.0), np.float32(1.0), np.float32(0.0), np.float32(0.0), np.float32(1.0), np.float32(0.0), np.float32(1.0), np.float32(0.0), np.float32(1.0), np.float32(1.0), np.float32(0.0), np.float32(0.0)]",-3.0,99748.0,1
2025-08-14_08-18-36,1753,"[np.float32(0.0), np.float32(0.0), np.float32(1.0), np.float32(1.0), np.float32(0.0), np.float32(1.0), np.float32(1.0), np.float32(0.0), np.float32(1.0), np.float32(0.0), np.float32(1.0), np.float32(0.0), np.float32(1.0), np.float32(0.0), np.float32(0.0), np.float32(1.0)]",2.0,99750.0,29
2025-08-14_08-18-36,1754,"[np.float32(1.0), np.float32(1.0), np.float32(1.0), np.float32(1.0), np.float32(1.0), np.float32(0.0), np.float32(0.0), np.float32(0.0), np.float32(1.0), np.float32(0.0), np.float32(1.0), np.float32(0.0), np.float32(0.0), np.float32(0.0), np.float32(1.0), np.float32(0.0)]",-1.0,99749.0,34
2025-08-14_08-18-36,1755,"[np.float32(0.0), np.float32(1.0), np.float32(0.0), np.float32(1.0), np.float32(1.0), np.float32(0.0), np.float32(0.0), np.float32(1.0), np.float32(1.0), np.float32(1.0), np.float32(0.0), np.float32(1.0), np.float32(1.0), np.float32(1.0), np.float32(1.0), np.float32(0.0)]",0.0,99749.0,10
2025-08-14_08-18-36,1756,"[np.float32(0.0), np.float32(1.0), np.float32(0.0), np.float32(1.0), np.float32(0.0), np.float32(0.0), np.float32(1.0), np.float32(1.0), np.float32(1.0), np.float32(0.0), np.float32(1.0), np.float32(1.0), np.float32(0.0), np.float32(1.0), np.float32(1.0), np.float32(0.0)]",-1.0,99748.0,28
2025-08-14_08-18-36,1757,"[np.float32(0.0), np.float32(0.0), np.float32(0.0), np.float32(1.0), np.float32(0.0), np.float32(1.0), np.float32(1.0), np.float32(1.0), np.float32(1.0), np.float32(0.0), np.float32(1.0), np.float32(1.0), np.float32(1.0), np.float32(1.0), np.float32(1.0), np.float32(1.0)]",-3.0,99745.0,22
2025-08-14_08-18-36,1758,"[np.float32(0.0), np.float32(1.0), np.float32(1.0), np.float32(1.0), np.float32(1.0), np.float32(1.0), np.float32(0.0), np.float32(0.0), np.float32(0.0), np.float32(0.0), np.float32(1.0), np.float32(1.0), np.float32(1.0), np.float32(0.0), np.float32(1.0), np.float32(1.0)]",-3.0,99742.0,18
2025-08-14_08-18-36,1759,"[np.float32(1.0), np.float32(1.0), np.float32(1.0), np.float32(1.0), np.float32(1.0), np.float32(0.0), np.float32(0.0), np.float32(0.0), np.float32(1.0), np.float32(0.0), np.float32(0.0), np.float32(0.0), np.float32(0.0), np.float32(0.0), np.float32(1.0), np.float32(1.0)]",2.0,99744.0,33
2025-08-14_08-18-36,1760,"[np.float32(1.0), np.float32(1.0), np.float32(0.0), np.float32(0.0), np.float32(0.0), np.float32(0.0), np.float32(0.0), np.float32(1.0), np.float32(1.0), np.float32(1.0), np.float32(1.0), np.float32(1.0), np.float32(0.0), np.float32(1.0), np.float32(0.0), np.float32(0.0)]",3.0,99747.0,32
2025-08-14_08-18-36,1761,"[np.float32(1.0), np.float32(1.0), np.float32(0.0), np.float32(1.0), np.float32(0.0), np.float32(0.0), np.float32(0.0), np.float32(1.0), np.float32(1.0), np.float32(1.0), np.float32(0.0), np.float32(0.0), np.float32(1.0), np.float32(0.0), np.float32(1.0), np.float32(1.0)]",-7.0,99740.0,2
2025-08-14_08-18-36,1762,"[np.float32(1.0), np.float32(0.0), np.float32(1.0), np.float32(1.0), np.float32(1.0), np.float32(0.0), np.float32(0.0), np.float32(1.0), np.float32(0.0), np.float32(0.0), np.float32(0.0), np.float32(0.0), np.float32(1.0), np.float32(0.0), np.float32(0.0), np.float32(0.0)]",0.0,99740.0,12
2025-08-14_08-18-36,1763,"[np.float32(1.0), np.float32(0.0), np.float32(1.0), np.float32(1.0), np.float32(0.0), np.float32(1.0), np.float32(0.0), np.float32(1.0), np.float32(0.0), np.float32(0.0), np.float32(1.0), np.float32(1.0), np.float32(1.0), np.float32(1.0), np.float32(1.0), np.float32(1.0)]",4.0,99744.0,23
2025-08-14_08-18-36,1764,"[np.float32(0.0), np.float32(0.0), np.float32(0.0), np.float32(0.0), np.float32(1.0), np.float32(1.0), np.float32(1.0), np.float32(1.0), np.float32(1.0), np.float32(0.0), np.float32(0.0), np.float32(1.0), np.float32(1.0), np.float32(0.0), np.float32(1.0), np.float32(0.0)]",-3.0,99741.0,29
2025-08-14_08-18-36,1765,"[np.float32(0.0), np.float32(0.0), np.float32(0.0), np.float32(1.0), np.float32(0.0), np.float32(0.0), np.float32(1.0), np.float32(1.0), np.float32(1.0), np.float32(0.0), np.float32(1.0), np.float32(1.0), np.float32(0.0), np.float32(0.0), np.float32(1.0), np.float32(0.0)]",-2.0,99739.0,19
2025-08-14_08-18-36,1766,"[np.float32(0.0), np.float32(0.0), np.float32(1.0), np.float32(1.0), np.float32(1.0), np.float32(0.0), np.float32(0.0), np.float32(0.0), np.float32(0.0), np.float32(0.0), np.float32(0.0), np.float32(1.0), np.float32(1.0), np.float32(1.0), np.float32(1.0), np.float32(1.0)]",-3.0,99736.0,0
2025-08-14_08-18-36,1767,"[np.float32(0.0), np.float32(1.0), np.float32(0.0), np.float32(1.0), np.float32(0.0), np.float32(0.0), np.float32(1.0), np.float32(0.0), np.float32(1.0), np.float32(1.0), np.float32(0.0), np.float32(1.0), np.float32(1.0), np.float32(1.0), np.float32(1.0), np.float32(1.0)]",-2.0,99734.0,24
2025-08-14_08-18-36,1768,"[np.float32(1.0), np.float32(0.0), np.float32(1.0), np.float32(1.0), np.float32(0.0), np.float32(1.0), np.float32(0.0), np.float32(1.0), np.float32(0.0), np.float32(1.0), np.float32(0.0), np.float32(0.0), np.float32(0.0), np.float32(0.0), np.float32(0.0), np.float32(1.0)]",-2.0,99732.0,4
2025-08-14_08-18-36,1769,"[np.float32(0.0), np.float32(1.0), np.float32(0.0), np.float32(0.0), np.float32(1.0), np.float32(0.0), np.float32(1.0), np.float32(1.0), np.float32(1.0), np.float32(0.0), np.float32(1.0), np.float32(1.0), np.float32(0.0), np.float32(0.0), np.float32(0.0), np.float32(1.0)]",-2.0,99730.0,27
2025-08-14_08-18-36,1770,"[np.float32(0.0), np.float32(0.0), np.float32(1.0), np.float32(1.0), np.float32(0.0), np.float32(1.0), np.float32(1.0), np.float32(0.0), np.float32(1.0), np.float32(0.0), np.float32(1.0), np.float32(1.0), np.float32(1.0), np.float32(1.0), np.float32(0.0), np.float32(0.0)]",-4.0,99726.0,14
2025-08-14_08-18-36,1771,"[np.float32(0.0), np.float32(1.0), np.float32(1.0), np.float32(0.0), np.float32(0.0), np.float32(1.0), np.float32(1.0), np.float32(1.0), np.float32(0.0), np.float32(0.0), np.float32(1.0), np.float32(0.0), np.float32(0.0), np.float32(1.0), np.float32(1.0), np.float32(0.0)]",-1.0,99725.0,33
2025-08-14_08-18-36,1772,"[np.float32(1.0), np.float32(1.0), np.float32(0.0), np.float32(1.0), np.float32(1.0), np.float32(0.0), np.float32(1.0), np.float32(1.0), np.float32(1.0), np.float32(0.0), np.float32(0.0), np.float32(1.0), np.float32(1.0), np.float32(1.0), np.float32(0.0), np.float32(0.0)]",3.0,99728.0,18
2025-08-14_08-18-36,1773,"[np.float32(0.0), np.float32(0.0), np.float32(0.0), np.float32(0.0), np.float32(0.0), np.float32(0.0), np.float32(1.0), np.float32(1.0), np.float32(1.0), np.float32(1.0), np.float32(0.0), np.float32(1.0), np.float32(1.0), np.float32(1.0), np.float32(0.0), np.float32(0.0)]",-1.0,99727.0,36
2025-08-14_08-18-36,1774,"[np.float32(0.0), np.float32(0.0), np.float32(0.0), np.float32(0.0), np.float32(0.0), np.float32(1.0), np.float32(0.0), np.float32(1.0), np.float32(1.0), np.float32(0.0), np.float32(1.0), np.float32(0.0), np.float32(0.0), np.float32(0.0), np.float32(0.0), np.float32(1.0)]",-5.0,99722.0,4
2025-08-14_08-18-36,1775,"[np.float32(1.0), np.float32(1.0), np.float32(1.0), np.float32(1.0), np.float32(0.0), np.float32(0.0), np.float32(0.0), np.float32(1.0), np.float32(1.0), np.float32(0.0), np.float32(1.0), np.float32(1.0), np.float32(0.0), np.float32(0.0), np.float32(1.0), np.float32(0.0)]",-2.0,99720.0,6
2025-08-14_08-18-36,1776,"[np.float32(0.0), np.float32(1.0), np.float32(1.0), np.float32(1.0), np.float32(1.0), np.float32(0.0), np.float32(1.0), np.float32(0.0), np.float32(1.0), np.float32(0.0), np.float32(0.0), np.float32(1.0), np.float32(0.0), np.float32(1.0), np.float32(0.0), np.float32(1.0)]",3.0,99723.0,2
2025-08-14_08-18-36,1777,"[np.float32(1.0), np.float32(1.0), np.float32(0.0), np.float32(0.0), np.float32(1.0), np.float32(0.0), np.float32(0.0), np.float32(1.0), np.float32(1.0), np.float32(1.0), np.float32(0.0), np.float32(0.0), np.float32(1.0), np.float32(1.0), np.float32(0.0), np.float32(0.0)]",-1.0,99722.0,12
2025-08-14_08-18-36,1778,"[np.float32(0.0), np.float32(1.0), np.float32(0.0), np.float32(1.0), np.float32(1.0), np.float32(0.0), np.float32(0.0), np.float32(1.0), np.float32(1.0), np.float32(0.0), np.float32(0.0), np.float32(1.0), np.float32(1.0), np.float32(1.0), np.float32(0.0), np.float32(1.0)]",1.0,99723.0,9
2025-08-14_08-18-36,1779,"[np.float32(1.0), np.float32(1.0), np.float32(1.0), np.float32(0.0), np.float32(1.0), np.float32(0.0), np.float32(1.0), np.float32(0.0), np.float32(0.0), np.float32(0.0), np.float32(0.0), np.float32(1.0), np.float32(0.0), np.float32(1.0), np.float32(0.0), np.float32(0.0)]",0.0,99723.0,0
2025-08-14_08-18-36,1780,"[np.float32(1.0), np.float32(1.0), np.float32(1.0), np.float32(1.0), np.float32(0.0), np.float32(0.0), np.float32(1.0), np.float32(1.0), np.float32(0.0), np.float32(0.0), np.float32(0.0), np.float32(0.0), np.float32(0.0), np.float32(1.0), np.float32(1.0), np.float32(0.0)]",2.0,99725.0,7
2025-08-14_08-18-36,1781,"[np.float32(0.0), np.float32(1.0), np.float32(0.0), np.float32(1.0), np.float32(0.0), np.float32(0.0), np.float32(1.0), np.float32(1.0), np.float32(1.0), np.float32(0.0), np.float32(0.0), np.float32(1.0), np.float32(1.0), np.float32(0.0), np.float32(1.0), np.float32(0.0)]",-6.0,99719.0,0
2025-08-14_08-18-36,1782,"[np.float32(0.0), np.float32(1.0), np.float32(1.0), np.float32(1.0), np.float32(0.0), np.float32(0.0), np.float32(1.0), np.float32(0.0), np.float32(0.0), np.float32(1.0), np.float32(1.0), np.float32(0.0), np.float32(1.0), np.float32(1.0), np.float32(0.0), np.float32(0.0)]",-3.0,99716.0,14
2025-08-14_08-18-36,1783,"[np.float32(1.0), np.float32(0.0), np.float32(0.0), np.float32(0.0), np.float32(1.0), np.float32(1.0), np.float32(1.0), np.float32(1.0), np.float32(0.0), np.float32(0.0), np.float32(1.0), np.float32(0.0), np.float32(1.0), np.float32(0.0), np.float32(1.0), np.float32(0.0)]",5.0,99721.0,5
2025-08-14_08-18-36,1784,"[np.float32(1.0), np.float32(1.0), np.float32(0.0), np.float32(1.0), np.float32(1.0), np.float32(1.0), np.float32(0.0), np.float32(0.0), np.float32(1.0), np.float32(1.0), np.float32(1.0), np.float32(0.0), np.float32(1.0), np.float32(1.0), np.float32(0.0), np.float32(0.0)]",5.0,99726.0,29
2025-08-14_08-18-36,1785,"[np.float32(0.0), np.float32(1.0), np.float32(0.0), np.float32(1.0), np.float32(1.0), np.float32(1.0), np.float32(0.0), np.float32(0.0), np.float32(0.0), np.float32(0.0), np.float32(0.0), np.float32(1.0), np.float32(1.0), np.float32(1.0), np.float32(0.0), np.float32(1.0)]",-1.0,99725.0,20
2025-08-14_08-18-36,1786,"[np.float32(1.0), np.float32(0.0), np.float32(1.0), np.float32(1.0), np.float32(0.0), np.float32(1.0), np.float32(0.0), np.float32(1.0), np.float32(1.0), np.float32(0.0), np.float32(1.0), np.float32(1.0), np.float32(0.0), np.float32(1.0), np.float32(0.0), np.float32(1.0)]",-5.0,99720.0,11
2025-08-14_08-18-36,1787,"[np.float32(0.0), np.float32(1.0), np.float32(1.0), np.float32(1.0), np.float32(1.0), np.float32(1.0), np.float32(0.0), np.float32(1.0), np.float32(0.0), np.float32(1.0), np.float32(1.0), np.float32(1.0), np.float32(1.0), np.float32(0.0), np.float32(0.0), np.float32(0.0)]",-3.0,99717.0,25
2025-08-14_08-18-36,1788,"[np.float32(0.0), np.float32(0.0), np.float32(1.0), np.float32(0.0), np.float32(1.0), np.float32(1.0), np.float32(1.0), np.float32(0.0), np.float32(0.0), np.float32(0.0), np.float32(1.0), np.float32(1.0), np.float32(0.0), np.float32(0.0), np.float32(0.0), np.float32(1.0)]",3.0,99720.0,8
2025-08-14_08-18-36,1789,"[np.float32(0.0), np.float32(0.0), np.float32(1.0), np.float32(1.0), np.float32(1.0), np.float32(1.0), np.float32(0.0), np.float32(1.0), np.float32(0.0), np.float32(0.0), np.float32(1.0), np.float32(0.0), np.float32(1.0), np.float32(0.0), np.float32(0.0), np.float32(1.0)]",5.0,99725.0,17
2025-08-14_08-18-36,1790,"[np.float32(0.0), np.float32(1.0), np.float32(0.0), np.float32(0.0), np.float32(0.0), np.float32(1.0), np.float32(1.0), np.float32(1.0), np.float32(0.0), np.float32(0.0), np.float32(0.0), np.float32(1.0), np.float32(1.0), np.float32(1.0), np.float32(0.0), np.float32(0.0)]",2.0,99727.0,3
2025-08-14_08-18-36,1791,"[np.float32(1.0), np.float32(0.0), np.float32(1.0), np.float32(1.0), np.float32(0.0), np.float32(0.0), np.float32(0.0), np.float32(1.0), np.float32(1.0), np.float32(1.0), np.float32(0.0), np.float32(0.0), np.float32(0.0), np.float32(0.0), np.float32(1.0), np.float32(1.0)]",2.0,99729.0,25
2025-08-14_08-18-36,1792,"[np.float32(0.0), np.float32(1.0), np.float32(0.0), np.float32(1.0), np.float32(1.0), np.float32(0.0), np.float32(1.0), np.float32(0.0), np.float32(1.0), np.float32(1.0), np.float32(1.0), np.float32(1.0), np.float32(0.0), np.float32(1.0), np.float32(0.0), np.float32(1.0)]",-1.0,99728.0,13
2025-08-14_08-18-36,1793,"[np.float32(1.0), np.float32(0.0), np.float32(1.0), np.float32(1.0), np.float32(0.0), np.float32(0.0), np.float32(0.0), np.float32(1.0), np.float32(1.0), np.float32(0.0), np.float32(0.0), np.float32(1.0), np.float32(1.0), np.float32(0.0), np.float32(1.0), np.float32(1.0)]",4.0,99732.0,27
2025-08-14_08-18-36,1794,"[np.float32(1.0), np.float32(0.0), np.float32(1.0), np.float32(1.0), np.float32(0.0), np.float32(1.0), np.float32(1.0), np.float32(1.0), np.float32(0.0), np.float32(0.0), np.float32(0.0), np.float32(1.0), np.float32(1.0), np.float32(1.0), np.float32(0.0), np.float32(1.0)]",-3.0,99729.0,28
2025-08-14_08-18-36,1795,"[np.float32(0.0), np.float32(1.0), np.float32(0.0), np.float32(0.0), np.float32(0.0), np.float32(0.0), np.float32(0.0), np.float32(1.0), np.float32(1.0), np.float32(0.0), np.float32(0.0), np.float32(0.0), np.float32(1.0), np.float32(1.0), np.float32(1.0), np.float32(0.0)]",33.0,99762.0,7
2025-08-14_08-18-36,1796,"[np.float32(0.0), np.float32(1.0), np.float32(1.0), np.float32(0.0), np.float32(1.0), np.float32(0.0), np.float32(0.0), np.float32(1.0), np.float32(0.0), np.float32(1.0), np.float32(0.0), np.float32(1.0), np.float32(1.0), np.float32(0.0), np.float32(0.0), np.float32(1.0)]",-1.0,99761.0,12
2025-08-14_08-18-36,1797,"[np.float32(0.0), np.float32(0.0), np.float32(1.0), np.float32(0.0), np.float32(0.0), np.float32(1.0), np.float32(1.0), np.float32(0.0), np.float32(0.0), np.float32(0.0), np.float32(1.0), np.float32(1.0), np.float32(1.0), np.float32(0.0), np.float32(1.0), np.float32(0.0)]",-2.0,99759.0,18
2025-08-14_08-18-36,1798,"[np.float32(1.0), np.float32(0.0), np.float32(1.0), np.float32(1.0), np.float32(1.0), np.float32(1.0), np.float32(1.0), np.float32(1.0), np.float32(0.0), np.float32(1.0), np.float32(0.0), np.float32(1.0), np.float32(1.0), np.float32(1.0), np.float32(1.0), np.float32(1.0)]",-3.0,99756.0,31
2025-08-14_08-18-36,1799,"[np.float32(1.0), np.float32(0.0), np.float32(1.0), np.float32(0.0), np.float32(1.0), np.float32(0.0), np.float32(1.0), np.float32(0.0), np.float32(1.0), np.float32(0.0), np.float32(0.0), np.float32(0.0), np.float32(1.0), np.float32(0.0), np.float32(1.0), np.float32(0.0)]",2.0,99758.0,12
2025-08-14_08-18-36,1800,"[np.float32(1.0), np.float32(1.0), np.float32(1.0), np.float32(1.0), np.float32(0.0), np.float32(1.0), np.float32(0.0), np.float32(1.0), np.float32(0.0), np.float32(1.0), np.float32(0.0), np.float32(1.0), np.float32(1.0), np.float32(1.0), np.float32(1.0), np.float32(1.0)]",-3.0,99755.0,32
2025-08-14_08-18-36,1801,"[np.float32(0.0), np.float32(0.0), np.float32(1.0), np.float32(1.0), np.float32(1.0), np.float32(1.0), np.float32(0.0), np.float32(0.0), np.float32(1.0), np.float32(0.0), np.float32(1.0), np.float32(1.0), np.float32(1.0), np.float32(1.0), np.float32(0.0), np.float32(1.0)]",-6.0,99749.0,13
2025-08-14_08-18-36,1802,"[np.float32(0.0), np.float32(0.0), np.float32(0.0), np.float32(1.0), np.float32(1.0), np.float32(1.0), np.float32(0.0), np.float32(1.0), np.float32(1.0), np.float32(0.0), np.float32(1.0), np.float32(0.0), np.float32(1.0), np.float32(0.0), np.float32(0.0), np.float32(1.0)]",-3.0,99746.0,28
2025-08-14_08-18-36,1803,"[np.float32(1.0), np.float32(0.0), np.float32(0.0), np.float32(0.0), np.float32(1.0), np.float32(0.0), np.float32(1.0), np.float32(1.0), np.float32(0.0), np.float32(1.0), np.float32(1.0), np.float32(0.0), np.float32(0.0), np.float32(1.0), np.float32(0.0), np.float32(1.0)]",5.0,99751.0,14
2025-08-14_08-18-36,1804,"[np.float32(1.0), np.float32(0.0), np.float32(1.0), np.float32(0.0), np.float32(0.0), np.float32(1.0), np.float32(1.0), np.float32(1.0), np.float32(1.0), np.float32(0.0), np.float32(1.0), np.float32(1.0), np.float32(1.0), np.float32(0.0), np.float32(0.0), np.float32(1.0)]",0.0,99751.0,12
2025-08-14_08-18-36,1805,"[np.float32(1.0), np.float32(0.0), np.float32(0.0), np.float32(1.0), np.float32(0.0), np.float32(0.0), np.float32(1.0), np.float32(1.0), np.float32(1.0), np.float32(1.0), np.float32(0.0), np.float32(1.0), np.float32(1.0), np.float32(1.0), np.float32(1.0), np.float32(0.0)]",-1.0,99750.0,22
2025-08-14_08-18-36,1806,"[np.float32(0.0), np.float32(0.0), np.float32(0.0), np.float32(1.0), np.float32(1.0), np.float32(0.0), np.float32(0.0), np.float32(1.0), np.float32(0.0), np.float32(0.0), np.float32(1.0), np.float32(0.0), np.float32(0.0), np.float32(1.0), np.float32(0.0), np.float32(0.0)]",-3.0,99747.0,6
2025-08-14_08-18-36,1807,"[np.float32(1.0), np.float32(0.0), np.float32(1.0), np.float32(1.0), np.float32(0.0), np.float32(0.0), np.float32(0.0), np.float32(1.0), np.float32(1.0), np.float32(1.0), np.float32(0.0), np.float32(1.0), np.float32(0.0), np.float32(1.0), np.float32(1.0), np.float32(0.0)]",1.0,99748.0,12
2025-08-14_08-18-36,1808,"[np.float32(0.0), np.float32(0.0), np.float32(0.0), np.float32(0.0), np.float32(0.0), np.float32(1.0), np.float32(0.0), np.float32(0.0), np.float32(0.0), np.float32(1.0), np.float32(1.0), np.float32(0.0), np.float32(0.0), np.float32(0.0), np.float32(1.0), np.float32(0.0)]",-1.0,99747.0,14
2025-08-14_08-18-36,1809,"[np.float32(1.0), np.float32(1.0), np.float32(1.0), np.float32(1.0), np.float32(0.0), np.float32(1.0), np.float32(0.0), np.float32(0.0), np.float32(0.0), np.float32(1.0), np.float32(0.0), np.float32(1.0), np.float32(1.0), np.float32(0.0), np.float32(0.0), np.float32(0.0)]",1.0,99748.0,22
2025-08-14_08-18-36,1810,"[np.float32(1.0), np.float32(0.0), np.float32(1.0), np.float32(0.0), np.float32(1.0), np.float32(1.0), np.float32(1.0), np.float32(1.0), np.float32(0.0), np.float32(1.0), np.float32(0.0), np.float32(1.0), np.float32(1.0), np.float32(1.0), np.float32(1.0), np.float32(1.0)]",3.0,99751.0,12
2025-08-14_08-18-36,1811,"[np.float32(0.0), np.float32(1.0), np.float32(0.0), np.float32(1.0), np.float32(1.0), np.float32(1.0), np.float32(0.0), np.float32(1.0), np.float32(1.0), np.float32(1.0), np.float32(0.0), np.float32(1.0), np.float32(1.0), np.float32(1.0), np.float32(0.0), np.float32(1.0)]",-3.0,99748.0,12
2025-08-14_08-18-36,1812,"[np.float32(1.0), np.float32(0.0), np.float32(1.0), np.float32(0.0), np.float32(1.0), np.float32(0.0), np.float32(0.0), np.float32(0.0), np.float32(0.0), np.float32(1.0), np.float32(0.0), np.float32(0.0), np.float32(0.0), np.float32(1.0), np.float32(0.0), np.float32(1.0)]",-1.0,99747.0,26
2025-08-14_08-18-36,1813,"[np.float32(0.0), np.float32(0.0), np.float32(0.0), np.float32(0.0), np.float32(0.0), np.float32(0.0), np.float32(1.0), np.float32(1.0), np.float32(1.0), np.float32(1.0), np.float32(1.0), np.float32(1.0), np.float32(1.0), np.float32(1.0), np.float32(1.0), np.float32(0.0)]",0.0,99747.0,10
2025-08-14_08-18-36,1814,"[np.float32(1.0), np.float32(0.0), np.float32(0.0), np.float32(1.0), np.float32(0.0), np.float32(1.0), np.float32(1.0), np.float32(1.0), np.float32(1.0), np.float32(1.0), np.float32(0.0), np.float32(1.0), np.float32(1.0), np.float32(1.0), np.float32(0.0), np.float32(0.0)]",1.0,99748.0,22
2025-08-14_08-18-36,1815,"[np.float32(1.0), np.float32(0.0), np.float32(1.0), np.float32(0.0), np.float32(1.0), np.float32(0.0), np.float32(0.0), np.float32(1.0), np.float32(0.0), np.float32(1.0), np.float32(0.0), np.float32(0.0), np.float32(1.0), np.float32(1.0), np.float32(1.0), np.float32(0.0)]",0.0,99748.0,15
2025-08-14_08-18-36,1816,"[np.float32(0.0), np.float32(0.0), np.float32(1.0), np.float32(1.0), np.float32(1.0), np.float32(0.0), np.float32(1.0), np.float32(1.0), np.float32(0.0), np.float32(0.0), np.float32(1.0), np.float32(1.0), np.float32(0.0), np.float32(0.0), np.float32(0.0), np.float32(0.0)]",1.0,99749.0,24
2025-08-14_08-18-36,1817,"[np.float32(1.0), np.float32(0.0), np.float32(0.0), np.float32(1.0), np.float32(1.0), np.float32(1.0), np.float32(1.0), np.float32(1.0), np.float32(0.0), np.float32(0.0), np.float32(0.0), np.float32(0.0), np.float32(1.0), np.float32(1.0), np.float32(0.0), np.float32(1.0)]",-1.0,99748.0,6
2025-08-14_08-18-36,1818,"[np.float32(0.0), np.float32(0.0), np.float32(1.0), np.float32(1.0), np.float32(1.0), np.float32(1.0), np.float32(0.0), np.float32(1.0), np.float32(0.0), np.float32(1.0), np.float32(1.0), np.float32(1.0), np.float32(1.0), np.float32(0.0), np.float32(1.0), np.float32(0.0)]",0.0,99748.0,14
2025-08-14_08-18-36,1819,"[np.float32(0.0), np.float32(0.0), np.float32(0.0), np.float32(0.0), np.float32(1.0), np.float32(0.0), np.float32(0.0), np.float32(0.0), np.float32(0.0), np.float32(1.0), np.float32(0.0), np.float32(1.0), np.float32(0.0), np.float32(0.0), np.float32(0.0), np.float32(1.0)]",2.0,99750.0,34
2025-08-14_08-18-36,1820,"[np.float32(1.0), np.float32(1.0), np.float32(1.0), np.float32(1.0), np.float32(0.0), np.float32(1.0), np.float32(1.0), np.float32(1.0), np.float32(0.0), np.float32(1.0), np.float32(0.0), np.float32(0.0), np.float32(1.0), np.float32(1.0), np.float32(0.0), np.float32(1.0)]",1.0,99751.0,20
2025-08-14_08-18-36,1821,"[np.float32(0.0), np.float32(1.0), np.float32(1.0), np.float32(0.0), np.float32(1.0), np.float32(1.0), np.float32(0.0), np.float32(1.0), np.float32(0.0), np.float32(1.0), np.float32(0.0), np.float32(0.0), np.float32(0.0), np.float32(0.0), np.float32(0.0), np.float32(0.0)]",4.0,99755.0,16
2025-08-14_08-18-36,1822,"[np.float32(1.0), np.float32(1.0), np.float32(0.0), np.float32(0.0), np.float32(0.0), np.float32(1.0), np.float32(0.0), np.float32(1.0), np.float32(0.0), np.float32(1.0), np.float32(1.0), np.float32(0.0), np.float32(0.0), np.float32(0.0), np.float32(0.0), np.float32(1.0)]",3.0,99758.0,31
2025-08-14_08-18-36,1823,"[np.float32(0.0), np.float32(1.0), np.float32(1.0), np.float32(1.0), np.float32(1.0), np.float32(0.0), np.float32(0.0), np.float32(0.0), np.float32(1.0), np.float32(1.0), np.float32(1.0), np.float32(0.0), np.float32(0.0), np.float32(1.0), np.float32(1.0), np.float32(0.0)]",-1.0,99757.0,30
2025-08-14_08-18-36,1824,"[np.float32(0.0), np.float32(0.0), np.float32(0.0), np.float32(0.0), np.float32(1.0), np.float32(0.0), np.float32(1.0), np.float32(0.0), np.float32(0.0), np.float32(1.0), np.float32(1.0), np.float32(0.0), np.float32(1.0), np.float32(0.0), np.float32(0.0), np.float32(1.0)]",-1.0,99756.0,12
2025-08-14_08-18-36,1825,"[np.float32(0.0), np.float32(1.0), np.float32(1.0), np.float32(1.0), np.float32(1.0), np.float32(1.0), np.float32(0.0), np.float32(1.0), np.float32(0.0), np.float32(0.0), np.float32(0.0), np.float32(1.0), np.float32(0.0), np.float32(0.0), np.float32(1.0), np.float32(0.0)]",4.0,99760.0,15
2025-08-14_08-18-36,1826,"[np.float32(0.0), np.float32(0.0), np.float32(1.0), np.float32(1.0), np.float32(0.0), np.float32(1.0), np.float32(0.0), np.float32(0.0), np.float32(1.0), np.float32(1.0), np.float32(0.0), np.float32(0.0), np.float32(1.0), np.float32(1.0), np.float32(0.0), np.float32(1.0)]",-6.0,99754.0,11
2025-08-14_08-18-36,1827,"[np.float32(1.0), np.float32(0.0), np.float32(0.0), np.float32(1.0), np.float32(1.0), np.float32(1.0), np.float32(0.0), np.float32(1.0), np.float32(0.0), np.float32(1.0), np.float32(1.0), np.float32(0.0), np.float32(0.0), np.float32(1.0), np.float32(1.0), np.float32(0.0)]",-2.0,99752.0,30
2025-08-14_08-18-36,1828,"[np.float32(1.0), np.float32(0.0), np.float32(0.0), np.float32(0.0), np.float32(0.0), np.float32(0.0), np.float32(0.0), np.float32(0.0), np.float32(0.0), np.float32(0.0), np.float32(1.0), np.float32(1.0), np.float32(1.0), np.float32(1.0), np.float32(1.0), np.float32(1.0)]",-4.0,99748.0,28
2025-08-14_08-18-36,1829,"[np.float32(0.0), np.float32(1.0), np.float32(0.0), np.float32(1.0), np.float32(0.0), np.float32(1.0), np.float32(1.0), np.float32(0.0), np.float32(1.0), np.float32(0.0), np.float32(1.0), np.float32(0.0), np.float32(1.0), np.float32(0.0), np.float32(1.0), np.float32(1.0)]",-1.0,99747.0,30
2025-08-14_08-18-36,1830,"[np.float32(1.0), np.float32(1.0), np.float32(0.0), np.float32(0.0), np.float32(1.0), np.float32(1.0), np.float32(1.0), np.float32(1.0), np.float32(1.0), np.float32(0.0), np.float32(0.0), np.float32(1.0), np.float32(1.0), np.float32(1.0), np.float32(0.0), np.float32(1.0)]",-1.0,99746.0,32
2025-08-14_08-18-36,1831,"[np.float32(0.0), np.float32(0.0), np.float32(0.0), np.float32(1.0), np.float32(0.0), np.float32(1.0), np.float32(0.0), np.float32(0.0), np.float32(1.0), np.float32(1.0), np.float32(0.0), np.float32(0.0), np.float32(1.0), np.float32(0.0), np.float32(0.0), np.float32(0.0)]",-3.0,99743.0,20
2025-08-14_08-18-36,1832,"[np.float32(1.0), np.float32(1.0), np.float32(0.0), np.float32(1.0), np.float32(1.0), np.float32(0.0), np.float32(1.0), np.float32(0.0), np.float32(0.0), np.float32(1.0), np.float32(0.0), np.float32(1.0), np.float32(1.0), np.float32(1.0), np.float32(1.0), np.float32(1.0)]",2.0,99745.0,6
2025-08-14_08-18-36,1833,"[np.float32(1.0), np.float32(1.0), np.float32(0.0), np.float32(0.0), np.float32(1.0), np.float32(0.0), np.float32(1.0), np.float32(0.0), np.float32(0.0), np.float32(1.0), np.float32(0.0), np.float32(0.0), np.float32(0.0), np.float32(0.0), np.float32(0.0), np.float32(0.0)]",-1.0,99744.0,14
2025-08-14_08-18-36,1834,"[np.float32(1.0), np.float32(0.0), np.float32(1.0), np.float32(1.0), np.float32(0.0), np.float32(1.0), np.float32(1.0), np.float32(1.0), np.float32(0.0), np.float32(0.0), np.float32(0.0), np.float32(0.0), np.float32(1.0), np.float32(0.0), np.float32(1.0), np.float32(1.0)]",-2.0,99742.0,31
2025-08-14_08-18-36,1835,"[np.float32(1.0), np.float32(0.0), np.float32(0.0), np.float32(1.0), np.float32(0.0), np.float32(0.0), np.float32(0.0), np.float32(1.0), np.float32(0.0), np.float32(1.0), np.float32(1.0), np.float32(0.0), np.float32(1.0), np.float32(1.0), np.float32(0.0), np.float32(0.0)]",1.0,99743.0,15
2025-08-14_08-18-36,1836,"[np.float32(0.0), np.float32(1.0), np.float32(0.0), np.float32(1.0), np.float32(0.0), np.float32(0.0), np.float32(0.0), np.float32(0.0), np.float32(0.0), np.float32(1.0), np.float32(0.0), np.float32(1.0), np.float32(1.0), np.float32(1.0), np.float32(0.0), np.float32(1.0)]",0.0,99743.0,35
2025-08-14_08-18-36,1837,"[np.float32(0.0), np.float32(0.0), np.float32(1.0), np.float32(1.0), np.float32(1.0), np.float32(1.0), np.float32(1.0), np.float32(0.0), np.float32(0.0), np.float32(1.0), np.float32(1.0), np.float32(0.0), np.float32(1.0), np.float32(1.0), np.float32(0.0), np.float32(1.0)]",0.0,99743.0,25
2025-08-14_08-18-36,1838,"[np.float32(1.0), np.float32(0.0), np.float32(0.0), np.float32(1.0), np.float32(1.0), np.float32(1.0), np.float32(0.0), np.float32(1.0), np.float32(0.0), np.float32(0.0), np.float32(1.0), np.float32(1.0), np.float32(0.0), np.float32(1.0), np.float32(0.0), np.float32(0.0)]",-1.0,99742.0,36
2025-08-14_08-18-36,1839,"[np.float32(0.0), np.float32(0.0), np.float32(1.0), np.float32(0.0), np.float32(1.0), np.float32(1.0), np.float32(0.0), np.float32(0.0), np.float32(0.0), np.float32(0.0), np.float32(1.0), np.float32(0.0), np.float32(1.0), np.float32(0.0), np.float32(0.0), np.float32(0.0)]",-3.0,99739.0,19
2025-08-14_08-18-36,1840,"[np.float32(0.0), np.float32(0.0), np.float32(1.0), np.float32(0.0), np.float32(0.0), np.float32(0.0), np.float32(1.0), np.float32(1.0), np.float32(0.0), np.float32(1.0), np.float32(0.0), np.float32(0.0), np.float32(1.0), np.float32(1.0), np.float32(1.0), np.float32(1.0)]",0.0,99739.0,2
2025-08-14_08-18-36,1841,"[np.float32(1.0), np.float32(0.0), np.float32(0.0), np.float32(1.0), np.float32(1.0), np.float32(1.0), np.float32(0.0), np.float32(0.0), np.float32(0.0), np.float32(0.0), np.float32(0.0), np.float32(0.0), np.float32(0.0), np.float32(0.0), np.float32(1.0), np.float32(1.0)]",-1.0,99738.0,20
2025-08-14_08-18-36,1842,"[np.float32(1.0), np.float32(0.0), np.float32(0.0), np.float32(0.0), np.float32(0.0), np.float32(0.0), np.float32(0.0), np.float32(0.0), np.float32(1.0), np.float32(1.0), np.float32(0.0), np.float32(0.0), np.float32(1.0), np.float32(0.0), np.float32(0.0), np.float32(0.0)]",-4.0,99734.0,15
2025-08-14_08-18-36,1843,"[np.float32(0.0), np.float32(1.0), np.float32(1.0), np.float32(1.0), np.float32(0.0), np.float32(1.0), np.float32(1.0), np.float32(1.0), np.float32(0.0), np.float32(0.0), np.float32(0.0), np.float32(1.0), np.float32(1.0), np.float32(1.0), np.float32(0.0), np.float32(0.0)]",-2.0,99732.0,17
2025-08-14_08-18-36,1844,"[np.float32(1.0), np.float32(1.0), np.float32(1.0), np.float32(1.0), np.float32(0.0), np.float32(1.0), np.float32(1.0), np.float32(0.0), np.float32(1.0), np.float32(0.0), np.float32(0.0), np.float32(0.0), np.float32(0.0), np.float32(0.0), np.float32(0.0), np.float32(0.0)]",-3.0,99729.0,16
2025-08-14_08-18-36,1845,"[np.float32(1.0), np.float32(1.0), np.float32(1.0), np.float32(0.0), np.float32(1.0), np.float32(1.0), np.float32(1.0), np.float32(0.0), np.float32(1.0), np.float32(0.0), np.float32(1.0), np.float32(1.0), np.float32(0.0), np.float32(1.0), np.float32(0.0), np.float32(1.0)]",2.0,99731.0,35
2025-08-14_08-18-36,1846,"[np.float32(0.0), np.float32(1.0), np.float32(0.0), np.float32(1.0), np.float32(0.0), np.float32(1.0), np.float32(1.0), np.float32(1.0), np.float32(0.0), np.float32(1.0), np.float32(1.0), np.float32(1.0), np.float32(0.0), np.float32(1.0), np.float32(0.0), np.float32(1.0)]",-1.0,99730.0,12
2025-08-14_08-18-36,1847,"[np.float32(0.0), np.float32(0.0), np.float32(1.0), np.float32(1.0), np.float32(0.0), np.float32(0.0), np.float32(1.0), np.float32(1.0), np.float32(1.0), np.float32(1.0), np.float32(1.0), np.float32(0.0), np.float32(0.0), np.float32(1.0), np.float32(0.0), np.float32(0.0)]",0.0,99730.0,16
2025-08-14_08-18-36,1848,"[np.float32(0.0), np.float32(0.0), np.float32(1.0), np.float32(1.0), np.float32(0.0), np.float32(1.0), np.float32(0.0), np.float32(1.0), np.float32(1.0), np.float32(0.0), np.float32(0.0), np.float32(1.0), np.float32(1.0), np.float32(0.0), np.float32(1.0), np.float32(0.0)]",-3.0,99727.0,10
2025-08-14_08-18-36,1849,"[np.float32(1.0), np.float32(0.0), np.float32(1.0), np.float32(0.0), np.float32(1.0), np.float32(0.0), np.float32(0.0), np.float32(0.0), np.float32(0.0), np.float32(1.0), np.float32(0.0), np.float32(1.0), np.float32(0.0), np.float32(0.0), np.float32(1.0), np.float32(1.0)]",-2.0,99725.0,11
2025-08-14_08-18-36,1850,"[np.float32(0.0), np.float32(1.0), np.float32(1.0), np.float32(1.0), np.float32(1.0), np.float32(1.0), np.float32(0.0), np.float32(1.0), np.float32(1.0), np.float32(0.0), np.float32(1.0), np.float32(0.0), np.float32(1.0), np.float32(0.0), np.float32(1.0), np.float32(0.0)]",3.0,99728.0,23
2025-08-14_08-18-36,1851,"[np.float32(1.0), np.float32(0.0), np.float32(1.0), np.float32(1.0), np.float32(1.0), np.float32(1.0), np.float32(0.0), np.float32(1.0), np.float32(1.0), np.float32(0.0), np.float32(0.0), np.float32(0.0), np.float32(1.0), np.float32(0.0), np.float32(1.0), np.float32(0.0)]",3.0,99731.0,23
2025-08-14_08-18-36,1852,"[np.float32(0.0), np.float32(1.0), np.float32(0.0), np.float32(1.0), np.float32(0.0), np.float32(1.0), np.float32(0.0), np.float32(0.0), np.float32(0.0), np.float32(1.0), np.float32(1.0), np.float32(0.0), np.float32(1.0), np.float32(1.0), np.float32(1.0), np.float32(0.0)]",2.0,99733.0,28
2025-08-14_08-18-36,1853,"[np.float32(1.0), np.float32(1.0), np.float32(1.0), np.float32(0.0), np.float32(0.0), np.float32(0.0), np.float32(1.0), np.float32(1.0), np.float32(1.0), np.float32(1.0), np.float32(1.0), np.float32(1.0), np.float32(1.0), np.float32(0.0), np.float32(0.0), np.float32(1.0)]",-1.0,99732.0,16
2025-08-14_08-18-36,1854,"[np.float32(1.0), np.float32(1.0), np.float32(0.0), np.float32(1.0), np.float32(1.0), np.float32(1.0), np.float32(0.0), np.float32(1.0), np.float32(1.0), np.float32(1.0), np.float32(0.0), np.float32(0.0), np.float32(0.0), np.float32(0.0), np.float32(0.0), np.float32(0.0)]",4.0,99736.0,13
2025-08-14_08-18-36,1855,"[np.float32(1.0), np.float32(1.0), np.float32(1.0), np.float32(1.0), np.float32(0.0), np.float32(1.0), np.float32(1.0), np.float32(1.0), np.float32(0.0), np.float32(1.0), np.float32(0.0), np.float32(1.0), np.float32(1.0), np.float32(0.0), np.float32(1.0), np.float32(1.0)]",0.0,99736.0,19
2025-08-14_08-18-36,1856,"[np.float32(0.0), np.float32(1.0), np.float32(0.0), np.float32(1.0), np.float32(0.0), np.float32(1.0), np.float32(0.0), np.float32(0.0), np.float32(1.0), np.float32(0.0), np.float32(1.0), np.float32(1.0), np.float32(0.0), np.float32(0.0), np.float32(1.0), np.float32(1.0)]",-6.0,99730.0,7
2025-08-14_08-18-36,1857,"[np.float32(1.0), np.float32(1.0), np.float32(0.0), np.float32(1.0), np.float32(0.0), np.float32(0.0), np.float32(0.0), np.float32(1.0), np.float32(1.0), np.float32(1.0), np.float32(1.0), np.float32(1.0), np.float32(0.0), np.float32(1.0), np.float32(0.0), np.float32(1.0)]",-2.0,99728.0,2
2025-08-14_08-18-36,1858,"[np.float32(0.0), np.float32(0.0), np.float32(1.0), np.float32(1.0), np.float32(0.0), np.float32(1.0), np.float32(1.0), np.float32(1.0), np.float32(0.0), np.float32(0.0), np.float32(1.0), np.float32(0.0), np.float32(0.0), np.float32(1.0), np.float32(0.0), np.float32(0.0)]",1.0,99729.0,17
2025-08-14_08-18-36,1859,"[np.float32(0.0), np.float32(0.0), np.float32(0.0), np.float32(1.0), np.float32(1.0), np.float32(0.0), np.float32(0.0), np.float32(0.0), np.float32(1.0), np.float32(0.0), np.float32(0.0), np.float32(0.0), np.float32(0.0), np.float32(0.0), np.float32(0.0), np.float32(0.0)]",-3.0,99726.0,0
2025-08-14_08-18-36,1860,"[np.float32(0.0), np.float32(1.0), np.float32(0.0), np.float32(1.0), np.float32(1.0), np.float32(1.0), np.float32(0.0), np.float32(0.0), np.float32(0.0), np.float32(1.0), np.float32(0.0), np.float32(0.0), np.float32(1.0), np.float32(0.0), np.float32(0.0), np.float32(1.0)]",1.0,99727.0,34
2025-08-14_08-18-36,1861,"[np.float32(1.0), np.float32(0.0), np.float32(1.0), np.float32(1.0), np.float32(1.0), np.float32(1.0), np.float32(0.0), np.float32(1.0), np.float32(0.0), np.float32(1.0), np.float32(0.0), np.float32(0.0), np.float32(0.0), np.float32(0.0), np.float32(0.0), np.float32(1.0)]",-4.0,99723.0,26
2025-08-14_08-18-36,1862,"[np.float32(0.0), np.float32(0.0), np.float32(1.0), np.float32(1.0), np.float32(1.0), np.float32(0.0), np.float32(0.0), np.float32(1.0), np.float32(1.0), np.float32(1.0), np.float32(0.0), np.float32(0.0), np.float32(0.0), np.float32(0.0), np.float32(0.0), np.float32(0.0)]",-1.0,99722.0,20
2025-08-14_08-18-36,1863,"[np.float32(1.0), np.float32(1.0), np.float32(0.0), np.float32(1.0), np.float32(1.0), np.float32(0.0), np.float32(0.0), np.float32(1.0), np.float32(0.0), np.float32(0.0), np.float32(1.0), np.float32(1.0), np.float32(1.0), np.float32(0.0), np.float32(0.0), np.float32(0.0)]",-1.0,99721.0,6
2025-08-14_08-18-36,1864,"[np.float32(0.0), np.float32(1.0), np.float32(1.0), np.float32(0.0), np.float32(1.0), np.float32(1.0), np.float32(1.0), np.float32(1.0), np.float32(0.0), np.float32(1.0), np.float32(0.0), np.float32(1.0), np.float32(1.0), np.float32(1.0), np.float32(0.0), np.float32(0.0)]",-5.0,99716.0,5
2025-08-14_08-18-36,1865,"[np.float32(0.0), np.float32(0.0), np.float32(1.0), np.float32(1.0), np.float32(1.0), np.float32(1.0), np.float32(0.0), np.float32(1.0), np.float32(1.0), np.float32(1.0), np.float32(0.0), np.float32(0.0), np.float32(0.0), np.float32(0.0), np.float32(1.0), np.float32(1.0)]",1.0,99717.0,33
2025-08-14_08-18-36,1866,"[np.float32(1.0), np.float32(0.0), np.float32(1.0), np.float32(0.0), np.float32(1.0), np.float32(1.0), np.float32(0.0), np.float32(1.0), np.float32(1.0), np.float32(1.0), np.float32(0.0), np.float32(1.0), np.float32(1.0), np.float32(1.0), np.float32(0.0), np.float32(0.0)]",2.0,99719.0,34
2025-08-14_08-18-36,1867,"[np.float32(1.0), np.float32(1.0), np.float32(1.0), np.float32(1.0), np.float32(1.0), np.float32(0.0), np.float32(1.0), np.float32(0.0), np.float32(1.0), np.float32(1.0), np.float32(0.0), np.float32(1.0), np.float32(1.0), np.float32(0.0), np.float32(1.0), np.float32(0.0)]",-2.0,99717.0,2
2025-08-14_08-18-36,1868,"[np.float32(1.0), np.float32(0.0), np.float32(1.0), np.float32(0.0), np.float32(0.0), np.float32(1.0), np.float32(1.0), np.float32(1.0), np.float32(1.0), np.float32(0.0), np.float32(1.0), np.float32(0.0), np.float32(0.0), np.float32(1.0), np.float32(1.0), np.float32(0.0)]",-1.0,99716.0,3
2025-08-14_08-18-36,1869,"[np.float32(0.0), np.float32(0.0), np.float32(1.0), np.float32(0.0), np.float32(1.0), np.float32(1.0), np.float32(0.0), np.float32(0.0), np.float32(0.0), np.float32(0.0), np.float32(0.0), np.float32(0.0), np.float32(0.0), np.float32(0.0), np.float32(0.0), np.float32(1.0)]",-2.0,99714.0,19
2025-08-14_08-18-36,1870,"[np.float32(1.0), np.float32(1.0), np.float32(1.0), np.float32(0.0), np.float32(1.0), np.float32(1.0), np.float32(1.0), np.float32(0.0), np.float32(0.0), np.float32(1.0), np.float32(1.0), np.float32(1.0), np.float32(1.0), np.float32(1.0), np.float32(0.0), np.float32(0.0)]",-2.0,99712.0,24
2025-08-14_08-18-36,1871,"[np.float32(0.0), np.float32(1.0), np.float32(1.0), np.float32(1.0), np.float32(0.0), np.float32(1.0), np.float32(1.0), np.float32(1.0), np.float32(0.0), np.float32(1.0), np.float32(0.0), np.float32(0.0), np.float32(0.0), np.float32(0.0), np.float32(0.0), np.float32(0.0)]",-2.0,99710.0,12
2025-08-14_08-18-36,1872,"[np.float32(1.0), np.float32(0.0), np.float32(1.0), np.float32(1.0), np.float32(1.0), np.float32(0.0), np.float32(1.0), np.float32(1.0), np.float32(0.0), np.float32(1.0), np.float32(1.0), np.float32(0.0), np.float32(0.0), np.float32(0.0), np.float32(0.0), np.float32(0.0)]",-1.0,99709.0,32
2025-08-14_08-18-36,1873,"[np.float32(1.0), np.float32(1.0), np.float32(1.0), np.float32(1.0), np.float32(0.0), np.float32(0.0), np.float32(1.0), np.float32(1.0), np.float32(0.0), np.float32(1.0), np.float32(0.0), np.float32(1.0), np.float32(1.0), np.float32(1.0), np.float32(1.0), np.float32(0.0)]",2.0,99711.0,24
2025-08-14_08-18-36,1874,"[np.float32(1.0), np.float32(1.0), np.float32(0.0), np.float32(1.0), np.float32(0.0), np.float32(0.0), np.float32(0.0), np.float32(0.0), np.float32(1.0), np.float32(1.0), np.float32(0.0), np.float32(0.0), np.float32(0.0), np.float32(0.0), np.float32(1.0), np.float32(0.0)]",-1.0,99710.0,4
2025-08-14_08-18-36,1875,"[np.float32(1.0), np.float32(1.0), np.float32(0.0), np.float32(0.0), np.float32(1.0), np.float32(0.0), np.float32(0.0), np.float32(0.0), np.float32(1.0), np.float32(0.0), np.float32(1.0), np.float32(0.0), np.float32(1.0), np.float32(1.0), np.float32(0.0), np.float32(1.0)]",-3.0,99707.0,19
2025-08-14_08-18-36,1876,"[np.float32(0.0), np.float32(0.0), np.float32(0.0), np.float32(0.0), np.float32(1.0), np.float32(1.0), np.float32(0.0), np.float32(1.0), np.float32(1.0), np.float32(1.0), np.float32(0.0), np.float32(0.0), np.float32(1.0), np.float32(0.0), np.float32(0.0), np.float32(0.0)]",-1.0,99706.0,23
2025-08-14_08-18-36,1877,"[np.float32(1.0), np.float32(0.0), np.float32(0.0), np.float32(1.0), np.float32(0.0), np.float32(1.0), np.float32(0.0), np.float32(1.0), np.float32(0.0), np.float32(1.0), np.float32(1.0), np.float32(1.0), np.float32(1.0), np.float32(0.0), np.float32(1.0), np.float32(0.0)]",2.0,99708.0,13
2025-08-14_08-18-36,1878,"[np.float32(0.0), np.float32(0.0), np.float32(1.0), np.float32(0.0), np.float32(0.0), np.float32(1.0), np.float32(1.0), np.float32(0.0), np.float32(0.0), np.float32(0.0), np.float32(0.0), np.float32(1.0), np.float32(1.0), np.float32(0.0), np.float32(1.0), np.float32(0.0)]",-4.0,99704.0,35
2025-08-14_08-18-36,1879,"[np.float32(0.0), np.float32(1.0), np.float32(0.0), np.float32(0.0), np.float32(1.0), np.float32(1.0), np.float32(1.0), np.float32(0.0), np.float32(1.0), np.float32(0.0), np.float32(1.0), np.float32(0.0), np.float32(0.0), np.float32(0.0), np.float32(0.0), np.float32(1.0)]",-2.0,99702.0,7
2025-08-14_08-18-36,1880,"[np.float32(1.0), np.float32(0.0), np.float32(1.0), np.float32(1.0), np.float32(1.0), np.float32(0.0), np.float32(1.0), np.float32(0.0), np.float32(0.0), np.float32(0.0), np.float32(0.0), np.float32(0.0), np.float32(1.0), np.float32(0.0), np.float32(1.0), np.float32(0.0)]",0.0,99702.0,6
2025-08-14_08-18-36,1881,"[np.float32(1.0), np.float32(0.0), np.float32(1.0), np.float32(1.0), np.float32(1.0), np.float32(1.0), np.float32(0.0), np.float32(0.0), np.float32(1.0), np.float32(1.0), np.float32(1.0), np.float32(0.0), np.float32(0.0), np.float32(0.0), np.float32(0.0), np.float32(1.0)]",4.0,99706.0,31
2025-08-14_08-18-36,1882,"[np.float32(0.0), np.float32(0.0), np.float32(0.0), np.float32(0.0), np.float32(0.0), np.float32(1.0), np.float32(0.0), np.float32(0.0), np.float32(0.0), np.float32(1.0), np.float32(1.0), np.float32(0.0), np.float32(1.0), np.float32(0.0), np.float32(1.0), np.float32(1.0)]",-3.0,99703.0,9
2025-08-14_08-18-36,1883,"[np.float32(1.0), np.float32(0.0), np.float32(0.0), np.float32(0.0), np.float32(1.0), np.float32(1.0), np.float32(0.0), np.float32(0.0), np.float32(1.0), np.float32(0.0), np.float32(1.0), np.float32(1.0), np.float32(1.0), np.float32(0.0), np.float32(1.0), np.float32(1.0)]",-2.0,99701.0,1
2025-08-14_08-18-36,1884,"[np.float32(1.0), np.float32(0.0), np.float32(1.0), np.float32(0.0), np.float32(0.0), np.float32(0.0), np.float32(0.0), np.float32(1.0), np.float32(0.0), np.float32(0.0), np.float32(0.0), np.float32(0.0), np.float32(1.0), np.float32(1.0), np.float32(0.0), np.float32(0.0)]",-3.0,99698.0,10
2025-08-14_08-18-36,1885,"[np.float32(1.0), np.float32(0.0), np.float32(0.0), np.float32(1.0), np.float32(1.0), np.float32(1.0), np.float32(1.0), np.float32(1.0), np.float32(0.0), np.float32(0.0), np.float32(1.0), np.float32(0.0), np.float32(1.0), np.float32(0.0), np.float32(1.0), np.float32(0.0)]",-2.0,99696.0,30
2025-08-14_08-18-36,1886,"[np.float32(1.0), np.float32(1.0), np.float32(0.0), np.float32(1.0), np.float32(1.0), np.float32(1.0), np.float32(0.0), np.float32(1.0), np.float32(1.0), np.float32(0.0), np.float32(0.0), np.float32(1.0), np.float32(1.0), np.float32(1.0), np.float32(1.0), np.float32(1.0)]",3.0,99699.0,15
2025-08-14_08-18-36,1887,"[np.float32(0.0), np.float32(0.0), np.float32(0.0), np.float32(0.0), np.float32(0.0), np.float32(1.0), np.float32(0.0), np.float32(1.0), np.float32(0.0), np.float32(0.0), np.float32(0.0), np.float32(0.0), np.float32(1.0), np.float32(1.0), np.float32(0.0), np.float32(1.0)]",-2.0,99697.0,16
2025-08-14_08-18-36,1888,"[np.float32(1.0), np.float32(0.0), np.float32(1.0), np.float32(1.0), np.float32(0.0), np.float32(1.0), np.float32(1.0), np.float32(1.0), np.float32(0.0), np.float32(0.0), np.float32(0.0), np.float32(0.0), np.float32(0.0), np.float32(0.0), np.float32(0.0), np.float32(0.0)]",-2.0,99695.0,35
2025-08-14_08-18-36,1889,"[np.float32(1.0), np.float32(0.0), np.float32(1.0), np.float32(1.0), np.float32(1.0), np.float32(0.0), np.float32(1.0), np.float32(1.0), np.float32(1.0), np.float32(1.0), np.float32(1.0), np.float32(0.0), np.float32(1.0), np.float32(1.0), np.float32(1.0), np.float32(1.0)]",0.0,99695.0,17
2025-08-14_08-18-36,1890,"[np.float32(0.0), np.float32(1.0), np.float32(0.0), np.float32(1.0), np.float32(0.0), np.float32(1.0), np.float32(1.0), np.float32(1.0), np.float32(0.0), np.float32(0.0), np.float32(0.0), np.float32(0.0), np.float32(0.0), np.float32(1.0), np.float32(0.0), np.float32(0.0)]",1.0,99696.0,20
2025-08-14_08-18-36,1891,"[np.float32(0.0), np.float32(1.0), np.float32(0.0), np.float32(0.0), np.float32(0.0), np.float32(0.0), np.float32(0.0), np.float32(1.0), np.float32(1.0), np.float32(1.0), np.float32(0.0), np.float32(0.0), np.float32(1.0), np.float32(1.0), np.float32(0.0), np.float32(0.0)]",-3.0,99693.0,1
2025-08-14_08-18-36,1892,"[np.float32(0.0), np.float32(1.0), np.float32(0.0), np.float32(0.0), np.float32(0.0), np.float32(1.0), np.float32(0.0), np.float32(0.0), np.float32(0.0), np.float32(1.0), np.float32(0.0), np.float32(1.0), np.float32(1.0), np.float32(0.0), np.float32(1.0), np.float32(0.0)]",-4.0,99689.0,2
2025-08-14_08-18-36,1893,"[np.float32(0.0), np.float32(0.0), np.float32(1.0), np.float32(0.0), np.float32(0.0), np.float32(0.0), np.float32(0.0), np.float32(1.0), np.float32(0.0), np.float32(0.0), np.float32(0.0), np.float32(0.0), np.float32(1.0), np.float32(1.0), np.float32(0.0), np.float32(1.0)]",-2.0,99687.0,25
2025-08-14_08-18-36,1894,"[np.float32(1.0), np.float32(0.0), np.float32(1.0), np.float32(0.0), np.float32(1.0), np.float32(1.0), np.float32(0.0), np.float32(1.0), np.float32(0.0), np.float32(0.0), np.float32(1.0), np.float32(1.0), np.float32(0.0), np.float32(0.0), np.float32(0.0), np.float32(0.0)]",-3.0,99684.0,1
2025-08-14_08-18-36,1895,"[np.float32(1.0), np.float32(0.0), np.float32(1.0), np.float32(0.0), np.float32(1.0), np.float32(1.0), np.float32(0.0), np.float32(0.0), np.float32(1.0), np.float32(0.0), np.float32(0.0), np.float32(0.0), np.float32(1.0), np.float32(1.0), np.float32(0.0), np.float32(0.0)]",0.0,99684.0,19
2025-08-14_08-18-36,1896,"[np.float32(0.0), np.float32(1.0), np.float32(0.0), np.float32(1.0), np.float32(1.0), np.float32(0.0), np.float32(0.0), np.float32(0.0), np.float32(1.0), np.float32(0.0), np.float32(0.0), np.float32(0.0), np.float32(1.0), np.float32(1.0), np.float32(1.0), np.float32(1.0)]",-3.0,99681.0,20
2025-08-14_08-18-36,1897,"[np.float32(0.0), np.float32(0.0), np.float32(0.0), np.float32(1.0), np.float32(0.0), np.float32(1.0), np.float32(0.0), np.float32(0.0), np.float32(0.0), np.float32(0.0), np.float32(0.0), np.float32(0.0), np.float32(1.0), np.float32(1.0), np.float32(0.0), np.float32(1.0)]",2.0,99683.0,31
2025-08-14_08-18-36,1898,"[np.float32(0.0), np.float32(0.0), np.float32(1.0), np.float32(1.0), np.float32(0.0), np.float32(1.0), np.float32(0.0), np.float32(1.0), np.float32(0.0), np.float32(1.0), np.float32(1.0), np.float32(0.0), np.float32(0.0), np.float32(0.0), np.float32(1.0), np.float32(0.0)]",-2.0,99681.0,18
2025-08-14_08-18-36,1899,"[np.float32(0.0), np.float32(0.0), np.float32(0.0), np.float32(0.0), np.float32(0.0), np.float32(0.0), np.float32(0.0), np.float32(1.0), np.float32(0.0), np.float32(0.0), np.float32(0.0), np.float32(0.0), np.float32(0.0), np.float32(1.0), np.float32(0.0), np.float32(0.0)]",-2.0,99679.0,11
2025-08-14_08-18-36,1900,"[np.float32(1.0), np.float32(0.0), np.float32(0.0), np.float32(0.0), np.float32(1.0), np.float32(1.0), np.float32(0.0), np.float32(0.0), np.float32(0.0), np.float32(1.0), np.float32(0.0), np.float32(1.0), np.float32(0.0), np.float32(1.0), np.float32(1.0), np.float32(1.0)]",-3.0,99676.0,17
2025-08-14_08-18-36,1901,"[np.float32(0.0), np.float32(0.0), np.float32(1.0), np.float32(0.0), np.float32(1.0), np.float32(1.0), np.float32(0.0), np.float32(0.0), np.float32(1.0), np.float32(0.0), np.float32(0.0), np.float32(0.0), np.float32(1.0), np.float32(0.0), np.float32(0.0), np.float32(1.0)]",-1.0,99675.0,33
2025-08-14_08-18-36,1902,"[np.float32(1.0), np.float32(0.0), np.float32(0.0), np.float32(1.0), np.float32(0.0), np.float32(0.0), np.float32(1.0), np.float32(1.0), np.float32(1.0), np.float32(1.0), np.float32(0.0), np.float32(1.0), np.float32(0.0), np.float32(1.0), np.float32(0.0), np.float32(0.0)]",-2.0,99673.0,6
2025-08-14_08-18-36,1903,"[np.float32(0.0), np.float32(1.0), np.float32(1.0), np.float32(0.0), np.float32(0.0), np.float32(1.0), np.float32(0.0), np.float32(1.0), np.float32(1.0), np.float32(1.0), np.float32(0.0), np.float32(1.0), np.float32(1.0), np.float32(1.0), np.float32(1.0), np.float32(0.0)]",-7.0,99666.0,1
2025-08-14_08-18-36,1904,"[np.float32(0.0), np.float32(1.0), np.float32(1.0), np.float32(1.0), np.float32(0.0), np.float32(1.0), np.float32(0.0), np.float32(1.0), np.float32(1.0), np.float32(0.0), np.float32(1.0), np.float32(1.0), np.float32(1.0), np.float32(1.0), np.float32(0.0), np.float32(0.0)]",0.0,99666.0,23
2025-08-14_08-18-36,1905,"[np.float32(1.0), np.float32(0.0), np.float32(1.0), np.float32(1.0), np.float32(0.0), np.float32(0.0), np.float32(0.0), np.float32(1.0), np.float32(0.0), np.float32(0.0), np.float32(0.0), np.float32(0.0), np.float32(0.0), np.float32(0.0), np.float32(1.0), np.float32(0.0)]",-1.0,99665.0,7
2025-08-14_08-18-36,1906,"[np.float32(1.0), np.float32(0.0), np.float32(1.0), np.float32(0.0), np.float32(0.0), np.float32(1.0), np.float32(0.0), np.float32(1.0), np.float32(0.0), np.float32(0.0), np.float32(1.0), np.float32(1.0), np.float32(0.0), np.float32(1.0), np.float32(1.0), np.float32(0.0)]",4.0,99669.0,30
2025-08-14_08-18-36,1907,"[np.float32(0.0), np.float32(0.0), np.float32(1.0), np.float32(1.0), np.float32(1.0), np.float32(0.0), np.float32(1.0), np.float32(0.0), np.float32(1.0), np.float32(0.0), np.float32(1.0), np.float32(0.0), np.float32(0.0), np.float32(0.0), np.float32(0.0), np.float32(0.0)]",1.0,99670.0,1
2025-08-14_08-18-36,1908,"[np.float32(0.0), np.float32(0.0), np.float32(1.0), np.float32(0.0), np.float32(1.0), np.float32(1.0), np.float32(0.0), np.float32(0.0), np.float32(0.0), np.float32(1.0), np.float32(0.0), np.float32(1.0), np.float32(0.0), np.float32(0.0), np.float32(1.0), np.float32(0.0)]",-1.0,99669.0,21
2025-08-14_08-18-36,1909,"[np.float32(1.0), np.float32(0.0), np.float32(1.0), np.float32(0.0), np.float32(0.0), np.float32(0.0), np.float32(0.0), np.float32(1.0), np.float32(0.0), np.float32(1.0), np.float32(1.0), np.float32(0.0), np.float32(1.0), np.float32(1.0), np.float32(0.0), np.float32(0.0)]",-1.0,99668.0,15
2025-08-14_08-18-36,1910,"[np.float32(1.0), np.float32(1.0), np.float32(1.0), np.float32(1.0), np.float32(0.0), np.float32(1.0), np.float32(0.0), np.float32(1.0), np.float32(1.0), np.float32(0.0), np.float32(0.0), np.float32(0.0), np.float32(1.0), np.float32(0.0), np.float32(1.0), np.float32(1.0)]",2.0,99670.0,27
2025-08-14_08-18-36,1911,"[np.float32(0.0), np.float32(0.0), np.float32(1.0), np.float32(1.0), np.float32(1.0), np.float32(0.0), np.float32(1.0), np.float32(1.0), np.float32(0.0), np.float32(0.0), np.float32(0.0), np.float32(0.0), np.float32(1.0), np.float32(0.0), np.float32(1.0), np.float32(1.0)]",-6.0,99664.0,29
2025-08-14_08-18-36,1912,"[np.float32(1.0), np.float32(1.0), np.float32(1.0), np.float32(0.0), np.float32(1.0), np.float32(1.0), np.float32(0.0), np.float32(1.0), np.float32(1.0), np.float32(1.0), np.float32(0.0), np.float32(1.0), np.float32(1.0), np.float32(1.0), np.float32(0.0), np.float32(1.0)]",-2.0,99662.0,35
2025-08-14_08-18-36,1913,"[np.float32(0.0), np.float32(0.0), np.float32(0.0), np.float32(0.0), np.float32(1.0), np.float32(0.0), np.float32(0.0), np.float32(1.0), np.float32(0.0), np.float32(0.0), np.float32(1.0), np.float32(1.0), np.float32(1.0), np.float32(1.0), np.float32(1.0), np.float32(0.0)]",-1.0,99661.0,27
2025-08-14_08-18-36,1914,"[np.float32(0.0), np.float32(0.0), np.float32(1.0), np.float32(1.0), np.float32(0.0), np.float32(1.0), np.float32(1.0), np.float32(1.0), np.float32(1.0), np.float32(0.0), np.float32(0.0), np.float32(1.0), np.float32(1.0), np.float32(1.0), np.float32(0.0), np.float32(1.0)]",1.0,99662.0,18
2025-08-14_08-18-36,1915,"[np.float32(1.0), np.float32(1.0), np.float32(0.0), np.float32(0.0), np.float32(0.0), np.float32(0.0), np.float32(0.0), np.float32(0.0), np.float32(1.0), np.float32(1.0), np.float32(0.0), np.float32(1.0), np.float32(1.0), np.float32(0.0), np.float32(0.0), np.float32(0.0)]",-1.0,99661.0,18
2025-08-14_08-18-36,1916,"[np.float32(0.0), np.float32(0.0), np.float32(0.0), np.float32(0.0), np.float32(1.0), np.float32(1.0), np.float32(1.0), np.float32(1.0), np.float32(0.0), np.float32(1.0), np.float32(1.0), np.float32(1.0), np.float32(0.0), np.float32(1.0), np.float32(0.0), np.float32(0.0)]",3.0,99664.0,22
2025-08-14_08-18-36,1917,"[np.float32(0.0), np.float32(0.0), np.float32(0.0), np.float32(1.0), np.float32(1.0), np.float32(1.0), np.float32(1.0), np.float32(1.0), np.float32(1.0), np.float32(1.0), np.float32(0.0), np.float32(1.0), np.float32(1.0), np.float32(0.0), np.float32(0.0), np.float32(0.0)]",1.0,99665.0,3
2025-08-14_08-18-36,1918,"[np.float32(0.0), np.float32(0.0), np.float32(1.0), np.float32(1.0), np.float32(1.0), np.float32(1.0), np.float32(0.0), np.float32(1.0), np.float32(1.0), np.float32(1.0), np.float32(0.0), np.float32(1.0), np.float32(0.0), np.float32(0.0), np.float32(1.0), np.float32(1.0)]",3.0,99668.0,27
2025-08-14_08-18-36,1919,"[np.float32(1.0), np.float32(0.0), np.float32(1.0), np.float32(1.0), np.float32(1.0), np.float32(0.0), np.float32(0.0), np.float32(0.0), np.float32(0.0), np.float32(1.0), np.float32(0.0), np.float32(0.0), np.float32(1.0), np.float32(1.0), np.float32(0.0), np.float32(1.0)]",-2.0,99666.0,5
2025-08-14_08-18-36,1920,"[np.float32(1.0), np.float32(0.0), np.float32(0.0), np.float32(1.0), np.float32(0.0), np.float32(1.0), np.float32(0.0), np.float32(1.0), np.float32(0.0), np.float32(1.0), np.float32(1.0), np.float32(1.0), np.float32(0.0), np.float32(1.0), np.float32(1.0), np.float32(1.0)]",0.0,99666.0,30
2025-08-14_08-18-36,1921,"[np.float32(0.0), np.float32(0.0), np.float32(1.0), np.float32(0.0), np.float32(1.0), np.float32(0.0), np.float32(0.0), np.float32(1.0), np.float32(1.0), np.float32(0.0), np.float32(1.0), np.float32(1.0), np.float32(1.0), np.float32(0.0), np.float32(0.0), np.float32(1.0)]",0.0,99666.0,36
2025-08-14_08-18-36,1922,"[np.float32(1.0), np.float32(1.0), np.float32(1.0), np.float32(1.0), np.float32(1.0), np.float32(0.0), np.float32(1.0), np.float32(1.0), np.float32(1.0), np.float32(1.0), np.float32(1.0), np.float32(1.0), np.float32(1.0), np.float32(0.0), np.float32(1.0), np.float32(0.0)]",-3.0,99663.0,19
2025-08-14_08-18-36,1923,"[np.float32(0.0), np.float32(1.0), np.float32(0.0), np.float32(0.0), np.float32(0.0), np.float32(1.0), np.float32(0.0), np.float32(1.0), np.float32(1.0), np.float32(0.0), np.float32(1.0), np.float32(1.0), np.float32(0.0), np.float32(0.0), np.float32(1.0), np.float32(1.0)]",0.0,99663.0,6
2025-08-14_08-18-36,1924,"[np.float32(0.0), np.float32(0.0), np.float32(0.0), np.float32(1.0), np.float32(1.0), np.float32(0.0), np.float32(1.0), np.float32(1.0), np.float32(1.0), np.float32(0.0), np.float32(1.0), np.float32(1.0), np.float32(0.0), np.float32(0.0), np.float32(1.0), np.float32(0.0)]",3.0,99666.0,27
2025-08-14_08-18-36,1925,"[np.float32(1.0), np.float32(0.0), np.float32(0.0), np.float32(1.0), np.float32(1.0), np.float32(1.0), np.float32(0.0), np.float32(0.0), np.float32(0.0), np.float32(1.0), np.float32(1.0), np.float32(1.0), np.float32(1.0), np.float32(1.0), np.float32(0.0), np.float32(1.0)]",0.0,99666.0,32
2025-08-14_08-18-36,1926,"[np.float32(1.0), np.float32(0.0), np.float32(0.0), np.float32(0.0), np.float32(0.0), np.float32(1.0), np.float32(0.0), np.float32(0.0), np.float32(0.0), np.float32(0.0), np.float32(0.0), np.float32(0.0), np.float32(0.0), np.float32(0.0), np.float32(0.0), np.float32(0.0)]",0.0,99666.0,29
2025-08-14_08-18-36,1927,"[np.float32(0.0), np.float32(0.0), np.float32(1.0), np.float32(0.0), np.float32(1.0), np.float32(1.0), np.float32(0.0), np.float32(0.0), np.float32(1.0), np.float32(0.0), np.float32(0.0), np.float32(1.0), np.float32(0.0), np.float32(1.0), np.float32(0.0), np.float32(0.0)]",1.0,99667.0,6
2025-08-14_08-18-36,1928,"[np.float32(0.0), np.float32(0.0), np.float32(1.0), np.float32(1.0), np.float32(1.0), np.float32(0.0), np.float32(1.0), np.float32(0.0), np.float32(1.0), np.float32(1.0), np.float32(1.0), np.float32(1.0), np.float32(1.0), np.float32(1.0), np.float32(1.0), np.float32(0.0)]",0.0,99667.0,32
2025-08-14_08-18-36,1929,"[np.float32(0.0), np.float32(0.0), np.float32(1.0), np.float32(0.0), np.float32(1.0), np.float32(1.0), np.float32(0.0), np.float32(1.0), np.float32(1.0), np.float32(1.0), np.float32(0.0), np.float32(1.0), np.float32(1.0), np.float32(1.0), np.float32(1.0), np.float32(1.0)]",-1.0,99666.0,20
2025-08-14_08-18-36,1930,"[np.float32(1.0), np.float32(1.0), np.float32(0.0), np.float32(0.0), np.float32(1.0), np.float32(0.0), np.float32(0.0), np.float32(1.0), np.float32(0.0), np.float32(0.0), np.float32(1.0), np.float32(1.0), np.float32(1.0), np.float32(0.0), np.float32(0.0), np.float32(1.0)]",-3.0,99663.0,34
2025-08-14_08-18-36,1931,"[np.float32(0.0), np.float32(1.0), np.float32(0.0), np.float32(1.0), np.float32(1.0), np.float32(0.0), np.float32(0.0), np.float32(1.0), np.float32(1.0), np.float32(1.0), np.float32(0.0), np.float32(1.0), np.float32(1.0), np.float32(1.0), np.float32(1.0), np.float32(0.0)]",-3.0,99660.0,8
2025-08-14_08-18-36,1932,"[np.float32(0.0), np.float32(0.0), np.float32(1.0), np.float32(0.0), np.float32(1.0), np.float32(0.0), np.float32(0.0), np.float32(0.0), np.float32(0.0), np.float32(0.0), np.float32(0.0), np.float32(0.0), np.float32(1.0), np.float32(1.0), np.float32(1.0), np.float32(1.0)]",-3.0,99657.0,31
2025-08-14_08-18-36,1933,"[np.float32(1.0), np.float32(0.0), np.float32(0.0), np.float32(0.0), np.float32(1.0), np.float32(0.0), np.float32(0.0), np.float32(1.0), np.float32(1.0), np.float32(0.0), np.float32(1.0), np.float32(0.0), np.float32(0.0), np.float32(0.0), np.float32(0.0), np.float32(0.0)]",0.0,99657.0,13
2025-08-14_08-18-36,1934,"[np.float32(0.0), np.float32(1.0), np.float32(0.0), np.float32(1.0), np.float32(1.0), np.float32(0.0), np.float32(1.0), np.float32(0.0), np.float32(0.0), np.float32(0.0), np.float32(0.0), np.float32(0.0), np.float32(1.0), np.float32(1.0), np.float32(0.0), np.float32(1.0)]",-2.0,99655.0,20
2025-08-14_08-18-36,1935,"[np.float32(1.0), np.float32(0.0), np.float32(0.0), np.float32(1.0), np.float32(1.0), np.float32(1.0), np.float32(0.0), np.float32(0.0), np.float32(1.0), np.float32(0.0), np.float32(0.0), np.float32(0.0), np.float32(1.0), np.float32(0.0), np.float32(0.0), np.float32(1.0)]",-3.0,99652.0,11
2025-08-14_08-18-36,1936,"[np.float32(0.0), np.float32(0.0), np.float32(1.0), np.float32(0.0), np.float32(0.0), np.float32(1.0), np.float32(0.0), np.float32(0.0), np.float32(0.0), np.float32(1.0), np.float32(0.0), np.float32(0.0), np.float32(0.0), np.float32(0.0), np.float32(1.0), np.float32(0.0)]",-2.0,99650.0,29
2025-08-14_08-18-36,1937,"[np.float32(1.0), np.float32(1.0), np.float32(0.0), np.float32(1.0), np.float32(1.0), np.float32(0.0), np.float32(1.0), np.float32(0.0), np.float32(1.0), np.float32(0.0), np.float32(0.0), np.float32(1.0), np.float32(1.0), np.float32(0.0), np.float32(1.0), np.float32(0.0)]",36.0,99686.0,7
2025-08-14_08-18-36,1938,"[np.float32(0.0), np.float32(1.0), np.float32(0.0), np.float32(1.0), np.float32(1.0), np.float32(0.0), np.float32(1.0), np.float32(0.0), np.float32(0.0), np.float32(0.0), np.float32(1.0), np.float32(1.0), np.float32(1.0), np.float32(1.0), np.float32(0.0), np.float32(1.0)]",-4.0,99682.0,22
2025-08-14_08-18-36,1939,"[np.float32(0.0), np.float32(0.0), np.float32(0.0), np.float32(0.0), np.float32(0.0), np.float32(1.0), np.float32(0.0), np.float32(0.0), np.float32(1.0), np.float32(1.0), np.float32(1.0), np.float32(0.0), np.float32(0.0), np.float32(0.0), np.float32(0.0), np.float32(0.0)]",-1.0,99681.0,13
2025-08-14_08-18-36,1940,"[np.float32(1.0), np.float32(1.0), np.float32(1.0), np.float32(0.0), np.float32(0.0), np.float32(1.0), np.float32(1.0), np.float32(1.0), np.float32(0.0), np.float32(1.0), np.float32(1.0), np.float32(0.0), np.float32(1.0), np.float32(0.0), np.float32(1.0), np.float32(1.0)]",2.0,99683.0,10
2025-08-14_08-18-36,1941,"[np.float32(1.0), np.float32(1.0), np.float32(1.0), np.float32(0.0), np.float32(0.0), np.float32(1.0), np.float32(1.0), np.float32(0.0), np.float32(0.0), np.float32(0.0), np.float32(0.0), np.float32(0.0), np.float32(1.0), np.float32(0.0), np.float32(0.0), np.float32(1.0)]",-1.0,99682.0,0
2025-08-14_08-18-36,1942,"[np.float32(0.0), np.float32(1.0), np.float32(1.0), np.float32(0.0), np.float32(1.0), np.float32(0.0), np.float32(1.0), np.float32(1.0), np.float32(1.0), np.float32(1.0), np.float32(0.0), np.float32(0.0), np.float32(0.0), np.float32(0.0), np.float32(1.0), np.float32(0.0)]",-2.0,99680.0,19
2025-08-14_08-18-36,1943,"[np.float32(0.0), np.float32(1.0), np.float32(1.0), np.float32(1.0), np.float32(0.0), np.float32(1.0), np.float32(0.0), np.float32(1.0), np.float32(0.0), np.float32(0.0), np.float32(0.0), np.float32(1.0), np.float32(1.0), np.float32(0.0), np.float32(0.0), np.float32(0.0)]",-1.0,99679.0,28
2025-08-14_08-18-36,1944,"[np.float32(0.0), np.float32(0.0), np.float32(1.0), np.float32(1.0), np.float32(0.0), np.float32(1.0), np.float32(0.0), np.float32(0.0), np.float32(1.0), np.float32(1.0), np.float32(0.0), np.float32(0.0), np.float32(0.0), np.float32(1.0), np.float32(1.0), np.float32(1.0)]",2.0,99681.0,36
2025-08-14_08-18-36,1945,"[np.float32(0.0), np.float32(1.0), np.float32(1.0), np.float32(0.0), np.float32(1.0), np.float32(1.0), np.float32(1.0), np.float32(1.0), np.float32(1.0), np.float32(0.0), np.float32(1.0), np.float32(1.0), np.float32(0.0), np.float32(1.0), np.float32(1.0), np.float32(0.0)]",1.0,99682.0,4
2025-08-14_08-18-36,1946,"[np.float32(1.0), np.float32(1.0), np.float32(0.0), np.float32(0.0), np.float32(0.0), np.float32(0.0), np.float32(1.0), np.float32(0.0), np.float32(1.0), np.float32(1.0), np.float32(1.0), np.float32(0.0), np.float32(0.0), np.float32(0.0), np.float32(1.0), np.float32(0.0)]",1.0,99683.0,25
2025-08-14_08-18-36,1947,"[np.float32(0.0), np.float32(1.0), np.float32(0.0), np.float32(1.0), np.float32(0.0), np.float32(1.0), np.float32(0.0), np.float32(0.0), np.float32(1.0), np.float32(0.0), np.float32(0.0), np.float32(0.0), np.float32(0.0), np.float32(0.0), np.float32(0.0), np.float32(1.0)]",2.0,99685.0,17
2025-08-14_08-18-36,1948,"[np.float32(1.0), np.float32(0.0), np.float32(1.0), np.float32(1.0), np.float32(1.0), np.float32(0.0), np.float32(1.0), np.float32(1.0), np.float32(0.0), np.float32(0.0), np.float32(0.0), np.float32(1.0), np.float32(0.0), np.float32(0.0), np.float32(0.0), np.float32(0.0)]",0.0,99685.0,30
2025-08-14_08-18-36,1949,"[np.float32(1.0), np.float32(0.0), np.float32(0.0), np.float32(0.0), np.float32(0.0), np.float32(1.0), np.float32(0.0), np.float32(0.0), np.float32(1.0), np.float32(0.0), np.float32(1.0), np.float32(1.0), np.float32(1.0), np.float32(1.0), np.float32(1.0), np.float32(0.0)]",3.0,99688.0,33
2025-08-14_08-18-36,1950,"[np.float32(0.0), np.float32(0.0), np.float32(0.0), np.float32(0.0), np.float32(1.0), np.float32(1.0), np.float32(0.0), np.float32(1.0), np.float32(1.0), np.float32(1.0), np.float32(1.0), np.float32(0.0), np.float32(1.0), np.float32(1.0), np.float32(0.0), np.float32(0.0)]",0.0,99688.0,13
2025-08-14_08-18-36,1951,"[np.float32(1.0), np.float32(0.0), np.float32(1.0), np.float32(1.0), np.float32(0.0), np.float32(0.0), np.float32(0.0), np.float32(1.0), np.float32(0.0), np.float32(0.0), np.float32(0.0), np.float32(0.0), np.float32(0.0), np.float32(0.0), np.float32(1.0), np.float32(0.0)]",0.0,99688.0,15
2025-08-14_08-18-36,1952,"[np.float32(1.0), np.float32(1.0), np.float32(1.0), np.float32(1.0), np.float32(0.0), np.float32(1.0), np.float32(1.0), np.float32(0.0), np.float32(0.0), np.float32(0.0), np.float32(0.0), np.float32(1.0), np.float32(1.0), np.float32(0.0), np.float32(1.0), np.float32(0.0)]",3.0,99691.0,36
2025-08-14_08-18-36,1953,"[np.float32(0.0), np.float32(1.0), np.float32(1.0), np.float32(0.0), np.float32(1.0), np.float32(1.0), np.float32(0.0), np.float32(1.0), np.float32(1.0), np.float32(1.0), np.float32(0.0), np.float32(1.0), np.float32(0.0), np.float32(0.0), np.float32(1.0), np.float32(0.0)]",4.0,99695.0,16
2025-08-14_08-18-36,1954,"[np.float32(0.0), np.float32(0.0), np.float32(1.0), np.float32(1.0), np.float32(0.0), np.float32(1.0), np.float32(0.0), np.float32(0.0), np.float32(1.0), np.float32(1.0), np.float32(0.0), np.float32(0.0), np.float32(1.0), np.float32(1.0), np.float32(0.0), np.float32(0.0)]",6.0,99701.0,25
2025-08-14_08-18-36,1955,"[np.float32(0.0), np.float32(1.0), np.float32(1.0), np.float32(1.0), np.float32(1.0), np.float32(0.0), np.float32(0.0), np.float32(0.0), np.float32(1.0), np.float32(1.0), np.float32(0.0), np.float32(1.0), np.float32(1.0), np.float32(1.0), np.float32(1.0), np.float32(1.0)]",-4.0,99697.0,20
2025-08-14_08-18-36,1956,"[np.float32(1.0), np.float32(0.0), np.float32(1.0), np.float32(1.0), np.float32(0.0), np.float32(1.0), np.float32(1.0), np.float32(0.0), np.float32(0.0), np.float32(0.0), np.float32(1.0), np.float32(0.0), np.float32(0.0), np.float32(0.0), np.float32(0.0), np.float32(1.0)]",0.0,99697.0,29
2025-08-14_08-18-36,1957,"[np.float32(0.0), np.float32(1.0), np.float32(0.0), np.float32(0.0), np.float32(1.0), np.float32(1.0), np.float32(1.0), np.float32(1.0), np.float32(0.0), np.float32(0.0), np.float32(0.0), np.float32(0.0), np.float32(1.0), np.float32(0.0), np.float32(0.0), np.float32(0.0)]",-4.0,99693.0,27
2025-08-14_08-18-36,1958,"[np.float32(1.0), np.float32(1.0), np.float32(0.0), np.float32(0.0), np.float32(0.0), np.float32(1.0), np.float32(1.0), np.float32(0.0), np.float32(1.0), np.float32(1.0), np.float32(0.0), np.float32(0.0), np.float32(1.0), np.float32(1.0), np.float32(1.0), np.float32(0.0)]",1.0,99694.0,33
2025-08-14_08-18-36,1959,"[np.float32(1.0), np.float32(0.0), np.float32(0.0), np.float32(0.0), np.float32(0.0), np.float32(1.0), np.float32(0.0), np.float32(0.0), np.float32(1.0), np.float32(0.0), np.float32(1.0), np.float32(1.0), np.float32(1.0), np.float32(1.0), np.float32(0.0), np.float32(0.0)]",-2.0,99692.0,22
2025-08-14_08-18-36,1960,"[np.float32(0.0), np.float32(1.0), np.float32(0.0), np.float32(0.0), np.float32(1.0), np.float32(1.0), np.float32(1.0), np.float32(0.0), np.float32(1.0), np.float32(0.0), np.float32(0.0), np.float32(1.0), np.float32(1.0), np.float32(0.0), np.float32(0.0), np.float32(0.0)]",1.0,99693.0,9
2025-08-14_08-18-36,1961,"[np.float32(0.0), np.float32(0.0), np.float32(1.0), np.float32(0.0), np.float32(0.0), np.float32(1.0), np.float32(1.0), np.float32(1.0), np.float32(1.0), np.float32(0.0), np.float32(0.0), np.float32(1.0), np.float32(0.0), np.float32(0.0), np.float32(0.0), np.float32(0.0)]",4.0,99697.0,36
2025-08-14_08-18-36,1962,"[np.float32(0.0), np.float32(1.0), np.float32(0.0), np.float32(1.0), np.float32(0.0), np.float32(0.0), np.float32(0.0), np.float32(1.0), np.float32(1.0), np.float32(0.0), np.float32(0.0), np.float32(1.0), np.float32(1.0), np.float32(1.0), np.float32(0.0), np.float32(1.0)]",-6.0,99691.0,8
2025-08-14_08-18-36,1963,"[np.float32(1.0), np.float32(1.0), np.float32(1.0), np.float32(0.0), np.float32(0.0), np.float32(0.0), np.float32(0.0), np.float32(0.0), np.float32(0.0), np.float32(0.0), np.float32(1.0), np.float32(0.0), np.float32(1.0), np.float32(1.0), np.float32(0.0), np.float32(0.0)]",-2.0,99689.0,30
2025-08-14_08-18-36,1964,"[np.float32(0.0), np.float32(0.0), np.float32(1.0), np.float32(1.0), np.float32(0.0), np.float32(0.0), np.float32(0.0), np.float32(1.0), np.float32(0.0), np.float32(1.0), np.float32(1.0), np.float32(1.0), np.float32(0.0), np.float32(1.0), np.float32(0.0), np.float32(0.0)]",-2.0,99687.0,6
2025-08-14_08-18-36,1965,"[np.float32(0.0), np.float32(1.0), np.float32(0.0), np.float32(0.0), np.float32(1.0), np.float32(1.0), np.float32(0.0), np.float32(1.0), np.float32(0.0), np.float32(0.0), np.float32(1.0), np.float32(0.0), np.float32(0.0), np.float32(1.0), np.float32(1.0), np.float32(1.0)]",-3.0,99684.0,1
2025-08-14_08-18-36,1966,"[np.float32(0.0), np.float32(0.0), np.float32(1.0), np.float32(0.0), np.float32(1.0), np.float32(0.0), np.float32(1.0), np.float32(0.0), np.float32(1.0), np.float32(1.0), np.float32(0.0), np.float32(0.0), np.float32(1.0), np.float32(0.0), np.float32(0.0), np.float32(1.0)]",-4.0,99680.0,27
2025-08-14_08-18-36,1967,"[np.float32(1.0), np.float32(0.0), np.float32(0.0), np.float32(0.0), np.float32(1.0), np.float32(1.0), np.float32(1.0), np.float32(0.0), np.float32(0.0), np.float32(1.0), np.float32(1.0), np.float32(1.0), np.float32(0.0), np.float32(1.0), np.float32(0.0), np.float32(1.0)]",1.0,99681.0,32
2025-08-14_08-18-36,1968,"[np.float32(0.0), np.float32(0.0), np.float32(0.0), np.float32(1.0), np.float32(0.0), np.float32(0.0), np.float32(0.0), np.float32(0.0), np.float32(1.0), np.float32(1.0), np.float32(0.0), np.float32(0.0), np.float32(0.0), np.float32(1.0), np.float32(0.0), np.float32(0.0)]",1.0,99682.0,3
2025-08-14_08-18-36,1969,"[np.float32(1.0), np.float32(1.0), np.float32(1.0), np.float32(0.0), np.float32(0.0), np.float32(1.0), np.float32(1.0), np.float32(1.0), np.float32(0.0), np.float32(0.0), np.float32(1.0), np.float32(0.0), np.float32(0.0), np.float32(0.0), np.float32(0.0), np.float32(0.0)]",3.0,99685.0,23
2025-08-14_08-18-36,1970,"[np.float32(0.0), np.float32(0.0), np.float32(0.0), np.float32(0.0), np.float32(0.0), np.float32(1.0), np.float32(0.0), np.float32(0.0), np.float32(0.0), np.float32(1.0), np.float32(1.0), np.float32(0.0), np.float32(0.0), np.float32(0.0), np.float32(1.0), np.float32(0.0)]",1.0,99686.0,24
2025-08-14_08-18-36,1971,"[np.float32(0.0), np.float32(0.0), np.float32(1.0), np.float32(1.0), np.float32(1.0), np.float32(1.0), np.float32(1.0), np.float32(1.0), np.float32(1.0), np.float32(0.0), np.float32(0.0), np.float32(0.0), np.float32(1.0), np.float32(1.0), np.float32(1.0), np.float32(0.0)]",-3.0,99683.0,31
2025-08-14_08-18-36,1972,"[np.float32(0.0), np.float32(0.0), np.float32(0.0), np.float32(0.0), np.float32(1.0), np.float32(1.0), np.float32(0.0), np.float32(1.0), np.float32(0.0), np.float32(1.0), np.float32(1.0), np.float32(1.0), np.float32(1.0), np.float32(1.0), np.float32(1.0), np.float32(1.0)]",-2.0,99681.0,6
2025-08-14_08-18-36,1973,"[np.float32(1.0), np.float32(0.0), np.float32(0.0), np.float32(1.0), np.float32(0.0), np.float32(0.0), np.float32(0.0), np.float32(1.0), np.float32(0.0), np.float32(1.0), np.float32(1.0), np.float32(0.0), np.float32(0.0), np.float32(0.0), np.float32(0.0), np.float32(1.0)]",-2.0,99679.0,3
2025-08-14_08-18-36,1974,"[np.float32(0.0), np.float32(0.0), np.float32(0.0), np.float32(0.0), np.float32(0.0), np.float32(0.0), np.float32(0.0), np.float32(0.0), np.float32(0.0), np.float32(0.0), np.float32(0.0), np.float32(0.0), np.float32(1.0), np.float32(0.0), np.float32(1.0), np.float32(1.0)]",0.0,99679.0,31
2025-08-14_08-18-36,1975,"[np.float32(0.0), np.float32(1.0), np.float32(0.0), np.float32(0.0), np.float32(0.0), np.float32(0.0), np.float32(0.0), np.float32(0.0), np.float32(0.0), np.float32(1.0), np.float32(0.0), np.float32(0.0), np.float32(1.0), np.float32(1.0), np.float32(0.0), np.float32(0.0)]",-1.0,99678.0,32
2025-08-14_08-18-36,1976,"[np.float32(0.0), np.float32(1.0), np.float32(1.0), np.float32(1.0), np.float32(1.0), np.float32(1.0), np.float32(1.0), np.float32(0.0), np.float32(0.0), np.float32(1.0), np.float32(1.0), np.float32(0.0), np.float32(0.0), np.float32(1.0), np.float32(1.0), np.float32(1.0)]",1.0,99679.0,20
2025-08-14_08-18-36,1977,"[np.float32(0.0), np.float32(0.0), np.float32(1.0), np.float32(1.0), np.float32(1.0), np.float32(1.0), np.float32(1.0), np.float32(1.0), np.float32(0.0), np.float32(0.0), np.float32(1.0), np.float32(1.0), np.float32(1.0), np.float32(1.0), np.float32(1.0), np.float32(0.0)]",-4.0,99675.0,0
2025-08-14_08-18-36,1978,"[np.float32(1.0), np.float32(1.0), np.float32(0.0), np.float32(1.0), np.float32(0.0), np.float32(1.0), np.float32(0.0), np.float32(1.0), np.float32(0.0), np.float32(1.0), np.float32(0.0), np.float32(1.0), np.float32(1.0), np.float32(0.0), np.float32(1.0), np.float32(1.0)]",-6.0,99669.0,26
2025-08-14_08-18-36,1979,"[np.float32(1.0), np.float32(1.0), np.float32(0.0), np.float32(0.0), np.float32(1.0), np.float32(1.0), np.float32(1.0), np.float32(1.0), np.float32(0.0), np.float32(0.0), np.float32(1.0), np.float32(1.0), np.float32(1.0), np.float32(0.0), np.float32(1.0), np.float32(0.0)]",-6.0,99663.0,25
2025-08-14_08-18-36,1980,"[np.float32(1.0), np.float32(1.0), np.float32(0.0), np.float32(1.0), np.float32(1.0), np.float32(1.0), np.float32(0.0), np.float32(0.0), np.float32(0.0), np.float32(1.0), np.float32(0.0), np.float32(0.0), np.float32(0.0), np.float32(0.0), np.float32(0.0), np.float32(1.0)]",5.0,99668.0,31
2025-08-14_08-18-36,1981,"[np.float32(1.0), np.float32(0.0), np.float32(1.0), np.float32(0.0), np.float32(0.0), np.float32(0.0), np.float32(0.0), np.float32(1.0), np.float32(0.0), np.float32(1.0), np.float32(1.0), np.float32(0.0), np.float32(0.0), np.float32(0.0), np.float32(1.0), np.float32(0.0)]",5.0,99673.0,23
2025-08-14_08-18-36,1982,"[np.float32(1.0), np.float32(0.0), np.float32(0.0), np.float32(0.0), np.float32(0.0), np.float32(0.0), np.float32(0.0), np.float32(1.0), np.float32(0.0), np.float32(1.0), np.float32(1.0), np.float32(0.0), np.float32(1.0), np.float32(1.0), np.float32(1.0), np.float32(1.0)]",-2.0,99671.0,11
2025-08-14_08-18-36,1983,"[np.float32(0.0), np.float32(1.0), np.float32(1.0), np.float32(1.0), np.float32(0.0), np.float32(0.0), np.float32(0.0), np.float32(0.0), np.float32(1.0), np.float32(0.0), np.float32(1.0), np.float32(0.0), np.float32(1.0), np.float32(0.0), np.float32(1.0), np.float32(1.0)]",30.0,99701.0,7
2025-08-14_08-18-36,1984,"[np.float32(0.0), np.float32(1.0), np.float32(0.0), np.float32(1.0), np.float32(1.0), np.float32(0.0), np.float32(0.0), np.float32(0.0), np.float32(0.0), np.float32(0.0), np.float32(1.0), np.float32(1.0), np.float32(0.0), np.float32(1.0), np.float32(0.0), np.float32(1.0)]",3.0,99704.0,2
2025-08-14_08-18-36,1985,"[np.float32(1.0), np.float32(1.0), np.float32(0.0), np.float32(0.0), np.float32(1.0), np.float32(1.0), np.float32(0.0), np.float32(1.0), np.float32(1.0), np.float32(0.0), np.float32(1.0), np.float32(1.0), np.float32(1.0), np.float32(1.0), np.float32(0.0), np.float32(1.0)]",2.0,99706.0,14
2025-08-14_08-18-36,1986,"[np.float32(1.0), np.float32(0.0), np.float32(1.0), np.float32(0.0), np.float32(1.0), np.float32(1.0), np.float32(1.0), np.float32(1.0), np.float32(0.0), np.float32(0.0), np.float32(1.0), np.float32(0.0), np.float32(0.0), np.float32(1.0), np.float32(1.0), np.float32(1.0)]",3.0,99709.0,2
2025-08-14_08-18-36,1987,"[np.float32(0.0), np.float32(1.0), np.float32(1.0), np.float32(0.0), np.float32(0.0), np.float32(0.0), np.float32(1.0), np.float32(1.0), np.float32(1.0), np.float32(1.0), np.float32(1.0), np.float32(0.0), np.float32(0.0), np.float32(0.0), np.float32(0.0), np.float32(1.0)]",0.0,99709.0,13
2025-08-14_08-18-36,1988,"[np.float32(1.0), np.float32(0.0), np.float32(0.0), np.float32(0.0), np.float32(1.0), np.float32(0.0), np.float32(0.0), np.float32(1.0), np.float32(0.0), np.float32(1.0), np.float32(0.0), np.float32(1.0), np.float32(1.0), np.float32(0.0), np.float32(0.0), np.float32(0.0)]",-6.0,99703.0,26
2025-08-14_08-18-36,1989,"[np.float32(1.0), np.float32(1.0), np.float32(0.0), np.float32(1.0), np.float32(1.0), np.float32(1.0), np.float32(0.0), np.float32(0.0), np.float32(1.0), np.float32(0.0), np.float32(0.0), np.float32(1.0), np.float32(0.0), np.float32(1.0), np.float32(1.0), np.float32(1.0)]",0.0,99703.0,6
2025-08-14_08-18-36,1990,"[np.float32(1.0), np.float32(1.0), np.float32(1.0), np.float32(0.0), np.float32(0.0), np.float32(1.0), np.float32(0.0), np.float32(0.0), np.float32(1.0), np.float32(1.0), np.float32(0.0), np.float32(0.0), np.float32(0.0), np.float32(0.0), np.float32(0.0), np.float32(0.0)]",1.0,99704.0,19
2025-08-14_08-18-36,1991,"[np.float32(1.0), np.float32(1.0), np.float32(0.0), np.float32(0.0), np.float32(1.0), np.float32(0.0), np.float32(0.0), np.float32(0.0), np.float32(0.0), np.float32(0.0), np.float32(0.0), np.float32(0.0), np.float32(0.0), np.float32(0.0), np.float32(0.0), np.float32(0.0)]",1.0,99705.0,8
2025-08-14_08-18-36,1992,"[np.float32(1.0), np.float32(0.0), np.float32(1.0), np.float32(0.0), np.float32(0.0), np.float32(1.0), np.float32(0.0), np.float32(1.0), np.float32(0.0), np.float32(1.0), np.float32(1.0), np.float32(0.0), np.float32(0.0), np.float32(1.0), np.float32(0.0), np.float32(0.0)]",-1.0,99704.0,36
2025-08-14_08-18-36,1993,"[np.float32(0.0), np.float32(0.0), np.float32(0.0), np.float32(0.0), np.float32(0.0), np.float32(0.0), np.float32(1.0), np.float32(0.0), np.float32(0.0), np.float32(0.0), np.float32(1.0), np.float32(0.0), np.float32(0.0), np.float32(1.0), np.float32(1.0), np.float32(0.0)]",-1.0,99703.0,25
2025-08-14_08-18-36,1994,"[np.float32(1.0), np.float32(0.0), np.float32(1.0), np.float32(1.0), np.float32(1.0), np.float32(1.0), np.float32(1.0), np.float32(0.0), np.float32(0.0), np.float32(0.0), np.float32(0.0), np.float32(1.0), np.float32(0.0), np.float32(1.0), np.float32(1.0), np.float32(0.0)]",3.0,99706.0,30
2025-08-14_08-18-36,1995,"[np.float32(1.0), np.float32(1.0), np.float32(1.0), np.float32(1.0), np.float32(1.0), np.float32(0.0), np.float32(0.0), np.float32(1.0), np.float32(0.0), np.float32(0.0), np.float32(1.0), np.float32(0.0), np.float32(0.0), np.float32(0.0), np.float32(1.0), np.float32(0.0)]",2.0,99708.0,24
2025-08-14_08-18-36,1996,"[np.float32(0.0), np.float32(1.0), np.float32(0.0), np.float32(0.0), np.float32(1.0), np.float32(1.0), np.float32(0.0), np.float32(1.0), np.float32(1.0), np.float32(1.0), np.float32(0.0), np.float32(1.0), np.float32(0.0), np.float32(0.0), np.float32(1.0), np.float32(0.0)]",0.0,99708.0,21
2025-08-14_08-18-36,1997,"[np.float32(0.0), np.float32(1.0), np.float32(1.0), np.float32(0.0), np.float32(1.0), np.float32(1.0), np.float32(1.0), np.float32(0.0), np.float32(0.0), np.float32(1.0), np.float32(1.0), np.float32(0.0), np.float32(1.0), np.float32(1.0), np.float32(1.0), np.float32(1.0)]",4.0,99712.0,8
2025-08-14_08-18-36,1998,"[np.float32(1.0), np.float32(0.0), np.float32(0.0), np.float32(0.0), np.float32(1.0), np.float32(0.0), np.float32(1.0), np.float32(1.0), np.float32(0.0), np.float32(1.0), np.float32(1.0), np.float32(0.0), np.float32(1.0), np.float32(0.0), np.float32(1.0), np.float32(0.0)]",-1.0,99711.0,12
2025-08-14_08-18-36,1999,"[np.float32(0.0), np.float32(0.0), np.float32(1.0), np.float32(1.0), np.float32(1.0), np.float32(0.0), np.float32(1.0), np.float32(1.0), np.float32(1.0), np.float32(0.0), np.float32(0.0), np.float32(0.0), np.float32(1.0), np.float32(1.0), np.float32(1.0), np.float32(1.0)]",0.0,99711.0,13
2025-08-14_08-18-36,2000,"[np.float32(1.0), np.float32(1.0), np.float32(0.0), np.float32(1.0), np.float32(0.0), np.float32(0.0), np.float32(0.0), np.float32(0.0), np.float32(1.0), np.float32(1.0), np.float32(1.0), np.float32(1.0), np.float32(0.0), np.float32(0.0), np.float32(0.0), np.float32(0.0)]",1.0,99712.0,28
2025-08-14_08-18-36,2001,"[np.float32(1.0), np.float32(0.0), np.float32(0.0), np.float32(1.0), np.float32(0.0), np.float32(0.0), np.float32(1.0), np.float32(1.0), np.float32(1.0), np.float32(1.0), np.float32(1.0), np.float32(1.0), np.float32(0.0), np.float32(1.0), np.float32(0.0), np.float32(0.0)]",4.0,99674.0,25
2025-08-14_08-18-36,2002,"[np.float32(0.0), np.float32(0.0), np.float32(1.0), np.float32(0.0), np.float32(1.0), np.float32(1.0), np.float32(0.0), np.float32(0.0), np.float32(0.0), np.float32(1.0), np.float32(0.0), np.float32(0.0), np.float32(1.0), np.float32(0.0), np.float32(1.0), np.float32(1.0)]",1.0,99675.0,31
2025-08-14_08-18-36,2003,"[np.float32(1.0), np.float32(1.0), np.float32(0.0), np.float32(1.0), np.float32(0.0), np.float32(0.0), np.float32(0.0), np.float32(1.0), np.float32(0.0), np.float32(1.0), np.float32(1.0), np.float32(1.0), np.float32(0.0), np.float32(1.0), np.float32(0.0), np.float32(1.0)]",-1.0,99674.0,24
2025-08-14_08-18-36,2004,"[np.float32(1.0), np.float32(1.0), np.float32(0.0), np.float32(0.0), np.float32(0.0), np.float32(1.0), np.float32(1.0), np.float32(1.0), np.float32(1.0), np.float32(0.0), np.float32(0.0), np.float32(0.0), np.float32(0.0), np.float32(0.0), np.float32(1.0), np.float32(0.0)]",1.0,99675.0,11
2025-08-14_08-18-36,2005,"[np.float32(1.0), np.float32(0.0), np.float32(0.0), np.float32(1.0), np.float32(1.0), np.float32(1.0), np.float32(1.0), np.float32(1.0), np.float32(1.0), np.float32(0.0), np.float32(0.0), np.float32(0.0), np.float32(1.0), np.float32(1.0), np.float32(0.0), np.float32(0.0)]",-2.0,99673.0,30
2025-08-14_08-18-36,2006,"[np.float32(1.0), np.float32(0.0), np.float32(0.0), np.float32(1.0), np.float32(0.0), np.float32(1.0), np.float32(1.0), np.float32(1.0), np.float32(0.0), np.float32(1.0), np.float32(0.0), np.float32(1.0), np.float32(1.0), np.float32(1.0), np.float32(1.0), np.float32(0.0)]",-1.0,99672.0,4
2025-08-14_08-18-36,2007,"[np.float32(1.0), np.float32(1.0), np.float32(1.0), np.float32(0.0), np.float32(0.0), np.float32(0.0), np.float32(1.0), np.float32(0.0), np.float32(0.0), np.float32(1.0), np.float32(1.0), np.float32(0.0), np.float32(1.0), np.float32(0.0), np.float32(1.0), np.float32(0.0)]",36.0,99708.0,7
2025-08-14_08-18-36,2008,"[np.float32(1.0), np.float32(0.0), np.float32(1.0), np.float32(0.0), np.float32(0.0), np.float32(0.0), np.float32(1.0), np.float32(0.0), np.float32(0.0), np.float32(0.0), np.float32(0.0), np.float32(0.0), np.float32(0.0), np.float32(0.0), np.float32(0.0), np.float32(0.0)]",2.0,99710.0,2
2025-08-14_08-18-36,2009,"[np.float32(1.0), np.float32(1.0), np.float32(1.0), np.float32(0.0), np.float32(0.0), np.float32(1.0), np.float32(1.0), np.float32(1.0), np.float32(0.0), np.float32(0.0), np.float32(0.0), np.float32(0.0), np.float32(1.0), np.float32(1.0), np.float32(0.0), np.float32(1.0)]",-4.0,99706.0,11
2025-08-14_08-18-36,2010,"[np.float32(0.0), np.float32(1.0), np.float32(1.0), np.float32(0.0), np.float32(0.0), np.float32(0.0), np.float32(0.0), np.float32(1.0), np.float32(1.0), np.float32(0.0), np.float32(0.0), np.float32(1.0), np.float32(1.0), np.float32(0.0), np.float32(0.0), np.float32(1.0)]",-7.0,99699.0,5
2025-08-14_08-18-36,2011,"[np.float32(0.0), np.float32(0.0), np.float32(1.0), np.float32(0.0), np.float32(1.0), np.float32(1.0), np.float32(0.0), np.float32(0.0), np.float32(1.0), np.float32(1.0), np.float32(0.0), np.float32(1.0), np.float32(1.0), np.float32(1.0), np.float32(0.0), np.float32(0.0)]",-1.0,99698.0,10
2025-08-14_08-18-36,2012,"[np.float32(0.0), np.float32(1.0), np.float32(0.0), np.float32(1.0), np.float32(0.0), np.float32(1.0), np.float32(1.0), np.float32(1.0), np.float32(0.0), np.float32(1.0), np.float32(1.0), np.float32(0.0), np.float32(0.0), np.float32(1.0), np.float32(0.0), np.float32(1.0)]",4.0,99702.0,17
2025-08-14_08-18-36,2013,"[np.float32(1.0), np.float32(1.0), np.float32(0.0), np.float32(1.0), np.float32(0.0), np.float32(0.0), np.float32(0.0), np.float32(0.0), np.float32(0.0), np.float32(1.0), np.float32(1.0), np.float32(0.0), np.float32(0.0), np.float32(1.0), np.float32(1.0), np.float32(1.0)]",-1.0,99701.0,33
2025-08-14_08-18-36,2014,"[np.float32(1.0), np.float32(1.0), np.float32(0.0), np.float32(1.0), np.float32(1.0), np.float32(0.0), np.float32(0.0), np.float32(0.0), np.float32(1.0), np.float32(0.0), np.float32(0.0), np.float32(1.0), np.float32(1.0), np.float32(1.0), np.float32(0.0), np.float32(1.0)]",-1.0,99700.0,26
2025-08-14_08-18-36,2015,"[np.float32(0.0), np.float32(1.0), np.float32(1.0), np.float32(1.0), np.float32(0.0), np.float32(0.0), np.float32(1.0), np.float32(1.0), np.float32(0.0), np.float32(1.0), np.float32(0.0), np.float32(1.0), np.float32(1.0), np.float32(1.0), np.float32(1.0), np.float32(1.0)]",-6.0,99694.0,32
2025-08-14_08-18-36,2016,"[np.float32(1.0), np.float32(1.0), np.float32(0.0), np.float32(0.0), np.float32(0.0), np.float32(1.0), np.float32(0.0), np.float32(1.0), np.float32(1.0), np.float32(0.0), np.float32(0.0), np.float32(0.0), np.float32(0.0), np.float32(0.0), np.float32(0.0), np.float32(0.0)]",-3.0,99691.0,12
2025-08-14_08-18-36,2017,"[np.float32(0.0), np.float32(0.0), np.float32(1.0), np.float32(1.0), np.float32(0.0), np.float32(1.0), np.float32(0.0), np.float32(1.0), np.float32(0.0), np.float32(1.0), np.float32(0.0), np.float32(0.0), np.float32(1.0), np.float32(0.0), np.float32(1.0), np.float32(1.0)]",-4.0,99687.0,29
2025-08-14_08-18-36,2018,"[np.float32(0.0), np.float32(1.0), np.float32(1.0), np.float32(1.0), np.float32(1.0), np.float32(0.0), np.float32(0.0), np.float32(1.0), np.float32(0.0), np.float32(1.0), np.float32(1.0), np.float32(1.0), np.float32(1.0), np.float32(1.0), np.float32(0.0), np.float32(0.0)]",5.0,99692.0,15
2025-08-14_08-18-36,2019,"[np.float32(0.0), np.float32(1.0), np.float32(1.0), np.float32(0.0), np.float32(0.0), np.float32(0.0), np.float32(0.0), np.float32(1.0), np.float32(1.0), np.float32(1.0), np.float32(0.0), np.float32(0.0), np.float32(0.0), np.float32(0.0), np.float32(0.0), np.float32(1.0)]",-1.0,99691.0,18
2025-08-14_08-18-36,2020,"[np.float32(0.0), np.float32(0.0), np.float32(1.0), np.float32(0.0), np.float32(1.0), np.float32(1.0), np.float32(1.0), np.float32(0.0), np.float32(1.0), np.float32(1.0), np.float32(0.0), np.float32(1.0), np.float32(0.0), np.float32(1.0), np.float32(0.0), np.float32(1.0)]",4.0,99695.0,12
2025-08-14_08-18-36,2021,"[np.float32(1.0), np.float32(1.0), np.float32(1.0), np.float32(0.0), np.float32(1.0), np.float32(1.0), np.float32(0.0), np.float32(1.0), np.float32(0.0), np.float32(0.0), np.float32(1.0), np.float32(0.0), np.float32(1.0), np.float32(0.0), np.float32(1.0), np.float32(0.0)]",-2.0,99693.0,35
2025-08-14_08-18-36,2022,"[np.float32(1.0), np.float32(1.0), np.float32(1.0), np.float32(1.0), np.float32(0.0), np.float32(1.0), np.float32(1.0), np.float32(1.0), np.float32(1.0), np.float32(1.0), np.float32(1.0), np.float32(0.0), np.float32(1.0), np.float32(1.0), np.float32(1.0), np.float32(0.0)]",-1.0,99692.0,21
2025-08-14_08-18-36,2023,"[np.float32(0.0), np.float32(1.0), np.float32(0.0), np.float32(1.0), np.float32(1.0), np.float32(1.0), np.float32(1.0), np.float32(1.0), np.float32(0.0), np.float32(1.0), np.float32(1.0), np.float32(1.0), np.float32(0.0), np.float32(1.0), np.float32(0.0), np.float32(1.0)]",-1.0,99691.0,24
2025-08-14_08-18-36,2024,"[np.float32(1.0), np.float32(1.0), np.float32(0.0), np.float32(1.0), np.float32(0.0), np.float32(0.0), np.float32(1.0), np.float32(1.0), np.float32(0.0), np.float32(0.0), np.float32(1.0), np.float32(1.0), np.float32(0.0), np.float32(1.0), np.float32(1.0), np.float32(1.0)]",1.0,99692.0,24
2025-08-14_08-18-36,2025,"[np.float32(1.0), np.float32(1.0), np.float32(1.0), np.float32(0.0), np.float32(0.0), np.float32(1.0), np.float32(1.0), np.float32(0.0), np.float32(1.0), np.float32(1.0), np.float32(1.0), np.float32(0.0), np.float32(0.0), np.float32(1.0), np.float32(1.0), np.float32(0.0)]",3.0,99695.0,29
2025-08-14_08-18-36,2026,"[np.float32(1.0), np.float32(0.0), np.float32(1.0), np.float32(1.0), np.float32(1.0), np.float32(0.0), np.float32(1.0), np.float32(0.0), np.float32(0.0), np.float32(1.0), np.float32(1.0), np.float32(1.0), np.float32(1.0), np.float32(1.0), np.float32(1.0), np.float32(1.0)]",-4.0,99691.0,28
2025-08-14_08-18-36,2027,"[np.float32(0.0), np.float32(1.0), np.float32(1.0), np.float32(1.0), np.float32(0.0), np.float32(0.0), np.float32(1.0), np.float32(1.0), np.float32(1.0), np.float32(0.0), np.float32(1.0), np.float32(0.0), np.float32(0.0), np.float32(0.0), np.float32(1.0), np.float32(1.0)]",1.0,99692.0,24
2025-08-14_08-18-36,2028,"[np.float32(0.0), np.float32(0.0), np.float32(0.0), np.float32(1.0), np.float32(0.0), np.float32(0.0), np.float32(0.0), np.float32(1.0), np.float32(0.0), np.float32(0.0), np.float32(1.0), np.float32(0.0), np.float32(0.0), np.float32(0.0), np.float32(1.0), np.float32(0.0)]",1.0,99693.0,19
2025-08-14_08-18-36,2029,"[np.float32(1.0), np.float32(0.0), np.float32(1.0), np.float32(0.0), np.float32(0.0), np.float32(0.0), np.float32(1.0), np.float32(0.0), np.float32(1.0), np.float32(0.0), np.float32(0.0), np.float32(0.0), np.float32(1.0), np.float32(1.0), np.float32(0.0), np.float32(1.0)]",-3.0,99690.0,16
2025-08-14_08-18-36,2030,"[np.float32(0.0), np.float32(0.0), np.float32(0.0), np.float32(1.0), np.float32(1.0), np.float32(1.0), np.float32(1.0), np.float32(0.0), np.float32(0.0), np.float32(0.0), np.float32(1.0), np.float32(0.0), np.float32(0.0), np.float32(0.0), np.float32(0.0), np.float32(1.0)]",-4.0,99686.0,28
2025-08-14_08-18-36,2031,"[np.float32(0.0), np.float32(1.0), np.float32(0.0), np.float32(0.0), np.float32(1.0), np.float32(0.0), np.float32(0.0), np.float32(1.0), np.float32(0.0), np.float32(1.0), np.float32(0.0), np.float32(0.0), np.float32(1.0), np.float32(0.0), np.float32(1.0), np.float32(0.0)]",-4.0,99682.0,35
2025-08-14_08-18-36,2032,"[np.float32(0.0), np.float32(0.0), np.float32(0.0), np.float32(1.0), np.float32(0.0), np.float32(1.0), np.float32(1.0), np.float32(1.0), np.float32(0.0), np.float32(1.0), np.float32(0.0), np.float32(0.0), np.float32(1.0), np.float32(0.0), np.float32(0.0), np.float32(1.0)]",1.0,99683.0,22
2025-08-14_08-18-36,2033,"[np.float32(0.0), np.float32(0.0), np.float32(1.0), np.float32(1.0), np.float32(1.0), np.float32(1.0), np.float32(0.0), np.float32(1.0), np.float32(1.0), np.float32(0.0), np.float32(0.0), np.float32(0.0), np.float32(1.0), np.float32(0.0), np.float32(0.0), np.float32(1.0)]",-1.0,99682.0,26
2025-08-14_08-18-36,2034,"[np.float32(0.0), np.float32(0.0), np.float32(1.0), np.float32(1.0), np.float32(0.0), np.float32(1.0), np.float32(1.0), np.float32(1.0), np.float32(1.0), np.float32(0.0), np.float32(0.0), np.float32(1.0), np.float32(1.0), np.float32(1.0), np.float32(0.0), np.float32(1.0)]",-5.0,99677.0,10
2025-08-14_08-18-36,2035,"[np.float32(1.0), np.float32(1.0), np.float32(1.0), np.float32(0.0), np.float32(0.0), np.float32(1.0), np.float32(0.0), np.float32(1.0), np.float32(1.0), np.float32(1.0), np.float32(1.0), np.float32(1.0), np.float32(0.0), np.float32(0.0), np.float32(0.0), np.float32(0.0)]",1.0,99678.0,35
2025-08-14_08-18-36,2036,"[np.float32(0.0), np.float32(1.0), np.float32(1.0), np.float32(0.0), np.float32(0.0), np.float32(0.0), np.float32(1.0), np.float32(0.0), np.float32(0.0), np.float32(1.0), np.float32(0.0), np.float32(1.0), np.float32(1.0), np.float32(1.0), np.float32(0.0), np.float32(1.0)]",5.0,99683.0,4
2025-08-14_08-18-36,2037,"[np.float32(1.0), np.float32(0.0), np.float32(1.0), np.float32(0.0), np.float32(1.0), np.float32(1.0), np.float32(0.0), np.float32(1.0), np.float32(0.0), np.float32(1.0), np.float32(0.0), np.float32(1.0), np.float32(0.0), np.float32(1.0), np.float32(1.0), np.float32(0.0)]",3.0,99686.0,36
2025-08-14_08-18-36,2038,"[np.float32(0.0), np.float32(1.0), np.float32(0.0), np.float32(1.0), np.float32(0.0), np.float32(0.0), np.float32(1.0), np.float32(1.0), np.float32(0.0), np.float32(0.0), np.float32(0.0), np.float32(0.0), np.float32(0.0), np.float32(0.0), np.float32(0.0), np.float32(0.0)]",-2.0,99684.0,28
2025-08-14_08-18-36,2039,"[np.float32(1.0), np.float32(0.0), np.float32(1.0), np.float32(0.0), np.float32(0.0), np.float32(1.0), np.float32(0.0), np.float32(1.0), np.float32(1.0), np.float32(1.0), np.float32(1.0), np.float32(1.0), np.float32(1.0), np.float32(0.0), np.float32(1.0), np.float32(0.0)]",-1.0,99683.0,13
2025-08-14_08-18-36,2040,"[np.float32(1.0), np.float32(1.0), np.float32(1.0), np.float32(1.0), np.float32(0.0), np.float32(1.0), np.float32(0.0), np.float32(0.0), np.float32(1.0), np.float32(0.0), np.float32(0.0), np.float32(0.0), np.float32(1.0), np.float32(0.0), np.float32(1.0), np.float32(0.0)]",1.0,99684.0,26
2025-08-14_08-18-36,2041,"[np.float32(1.0), np.float32(0.0), np.float32(1.0), np.float32(0.0), np.float32(0.0), np.float32(1.0), np.float32(1.0), np.float32(0.0), np.float32(1.0), np.float32(0.0), np.float32(0.0), np.float32(0.0), np.float32(1.0), np.float32(1.0), np.float32(1.0), np.float32(1.0)]",-2.0,99682.0,20
2025-08-14_08-18-36,2042,"[np.float32(0.0), np.float32(0.0), np.float32(1.0), np.float32(0.0), np.float32(0.0), np.float32(1.0), np.float32(1.0), np.float32(0.0), np.float32(1.0), np.float32(1.0), np.float32(1.0), np.float32(0.0), np.float32(0.0), np.float32(0.0), np.float32(1.0), np.float32(0.0)]",4.0,99686.0,8
2025-08-14_08-18-36,2043,"[np.float32(1.0), np.float32(0.0), np.float32(0.0), np.float32(1.0), np.float32(0.0), np.float32(1.0), np.float32(0.0), np.float32(1.0), np.float32(1.0), np.float32(0.0), np.float32(0.0), np.float32(1.0), np.float32(1.0), np.float32(1.0), np.float32(1.0), np.float32(0.0)]",3.0,99689.0,25
2025-08-14_08-18-36,2044,"[np.float32(1.0), np.float32(1.0), np.float32(0.0), np.float32(0.0), np.float32(1.0), np.float32(1.0), np.float32(1.0), np.float32(0.0), np.float32(0.0), np.float32(1.0), np.float32(0.0), np.float32(0.0), np.float32(0.0), np.float32(1.0), np.float32(1.0), np.float32(1.0)]",4.0,99693.0,7
2025-08-14_08-18-36,2045,"[np.float32(0.0), np.float32(1.0), np.float32(0.0), np.float32(1.0), np.float32(1.0), np.float32(0.0), np.float32(1.0), np.float32(1.0), np.float32(1.0), np.float32(0.0), np.float32(0.0), np.float32(0.0), np.float32(1.0), np.float32(0.0), np.float32(0.0), np.float32(1.0)]",-1.0,99692.0,35
2025-08-14_08-18-36,2046,"[np.float32(1.0), np.float32(1.0), np.float32(0.0), np.float32(0.0), np.float32(0.0), np.float32(0.0), np.float32(1.0), np.float32(1.0), np.float32(0.0), np.float32(1.0), np.float32(1.0), np.float32(1.0), np.float32(0.0), np.float32(0.0), np.float32(0.0), np.float32(0.0)]",-2.0,99690.0,26
2025-08-14_08-18-36,2047,"[np.float32(0.0), np.float32(1.0), np.float32(0.0), np.float32(0.0), np.float32(1.0), np.float32(0.0), np.float32(1.0), np.float32(0.0), np.float32(0.0), np.float32(1.0), np.float32(1.0), np.float32(0.0), np.float32(0.0), np.float32(1.0), np.float32(1.0), np.float32(0.0)]",-1.0,99689.0,32
2025-08-14_08-18-36,2048,"[np.float32(0.0), np.float32(0.0), np.float32(1.0), np.float32(0.0), np.float32(1.0), np.float32(1.0), np.float32(1.0), np.float32(0.0), np.float32(0.0), np.float32(0.0), np.float32(0.0), np.float32(1.0), np.float32(1.0), np.float32(1.0), np.float32(0.0), np.float32(1.0)]",-1.0,99688.0,30
2025-08-14_08-18-36,2049,"[np.float32(1.0), np.float32(1.0), np.float32(0.0), np.float32(1.0), np.float32(1.0), np.float32(1.0), np.float32(0.0), np.float32(1.0), np.float32(0.0), np.float32(1.0), np.float32(0.0), np.float32(0.0), np.float32(0.0), np.float32(0.0), np.float32(0.0), np.float32(0.0)]",2.0,99690.0,15
2025-08-14_08-18-36,2050,"[np.float32(0.0), np.float32(0.0), np.float32(1.0), np.float32(1.0), np.float32(0.0), np.float32(0.0), np.float32(0.0), np.float32(1.0), np.float32(0.0), np.float32(0.0), np.float32(0.0), np.float32(1.0), np.float32(1.0), np.float32(1.0), np.float32(0.0), np.float32(0.0)]",-1.0,99689.0,16
2025-08-14_08-18-36,2051,"[np.float32(0.0), np.float32(0.0), np.float32(1.0), np.float32(0.0), np.float32(0.0), np.float32(1.0), np.float32(0.0), np.float32(1.0), np.float32(0.0), np.float32(1.0), np.float32(0.0), np.float32(0.0), np.float32(0.0), np.float32(1.0), np.float32(1.0), np.float32(0.0)]",1.0,99690.0,20
2025-08-14_08-18-36,2052,"[np.float32(0.0), np.float32(1.0), np.float32(1.0), np.float32(1.0), np.float32(1.0), np.float32(1.0), np.float32(0.0), np.float32(1.0), np.float32(0.0), np.float32(1.0), np.float32(0.0), np.float32(0.0), np.float32(0.0), np.float32(1.0), np.float32(0.0), np.float32(0.0)]",4.0,99694.0,4
2025-08-14_08-18-36,2053,"[np.float32(1.0), np.float32(0.0), np.float32(0.0), np.float32(1.0), np.float32(0.0), np.float32(0.0), np.float32(1.0), np.float32(0.0), np.float32(0.0), np.float32(1.0), np.float32(0.0), np.float32(1.0), np.float32(1.0), np.float32(0.0), np.float32(0.0), np.float32(0.0)]",-6.0,99688.0,26
2025-08-14_08-18-36,2054,"[np.float32(0.0), np.float32(1.0), np.float32(1.0), np.float32(0.0), np.float32(1.0), np.float32(1.0), np.float32(0.0), np.float32(1.0), np.float32(1.0), np.float32(0.0), np.float32(1.0), np.float32(0.0), np.float32(0.0), np.float32(0.0), np.float32(0.0), np.float32(0.0)]",2.0,99690.0,22
2025-08-14_08-18-36,2055,"[np.float32(0.0), np.float32(0.0), np.float32(0.0), np.float32(0.0), np.float32(1.0), np.float32(0.0), np.float32(0.0), np.float32(0.0), np.float32(0.0), np.float32(0.0), np.float32(1.0), np.float32(1.0), np.float32(1.0), np.float32(1.0), np.float32(0.0), np.float32(0.0)]",3.0,99693.0,3
2025-08-14_08-18-36,2056,"[np.float32(1.0), np.float32(0.0), np.float32(0.0), np.float32(1.0), np.float32(0.0), np.float32(0.0), np.float32(0.0), np.float32(1.0), np.float32(1.0), np.float32(0.0), np.float32(0.0), np.float32(0.0), np.float32(0.0), np.float32(1.0), np.float32(0.0), np.float32(0.0)]",1.0,99694.0,26
2025-08-14_08-18-36,2057,"[np.float32(0.0), np.float32(1.0), np.float32(1.0), np.float32(0.0), np.float32(0.0), np.float32(1.0), np.float32(1.0), np.float32(0.0), np.float32(0.0), np.float32(1.0), np.float32(1.0), np.float32(0.0), np.float32(0.0), np.float32(0.0), np.float32(0.0), np.float32(0.0)]",-1.0,99693.0,13
2025-08-14_08-18-36,2058,"[np.float32(0.0), np.float32(1.0), np.float32(1.0), np.float32(0.0), np.float32(0.0), np.float32(1.0), np.float32(0.0), np.float32(0.0), np.float32(0.0), np.float32(0.0), np.float32(1.0), np.float32(1.0), np.float32(1.0), np.float32(0.0), np.float32(0.0), np.float32(1.0)]",1.0,99694.0,17
2025-08-14_08-18-36,2059,"[np.float32(1.0), np.float32(1.0), np.float32(0.0), np.float32(0.0), np.float32(0.0), np.float32(1.0), np.float32(1.0), np.float32(0.0), np.float32(0.0), np.float32(1.0), np.float32(0.0), np.float32(1.0), np.float32(0.0), np.float32(0.0), np.float32(0.0), np.float32(0.0)]",-2.0,99692.0,20
2025-08-14_08-18-36,2060,"[np.float32(0.0), np.float32(0.0), np.float32(0.0), np.float32(1.0), np.float32(0.0), np.float32(1.0), np.float32(1.0), np.float32(1.0), np.float32(1.0), np.float32(1.0), np.float32(0.0), np.float32(0.0), np.float32(1.0), np.float32(0.0), np.float32(1.0), np.float32(1.0)]",-3.0,99689.0,6
2025-08-14_08-18-36,2061,"[np.float32(1.0), np.float32(1.0), np.float32(0.0), np.float32(0.0), np.float32(0.0), np.float32(1.0), np.float32(0.0), np.float32(1.0), np.float32(0.0), np.float32(1.0), np.float32(0.0), np.float32(0.0), np.float32(0.0), np.float32(0.0), np.float32(1.0), np.float32(1.0)]",1.0,99690.0,1
2025-08-14_08-18-36,2062,"[np.float32(0.0), np.float32(0.0), np.float32(1.0), np.float32(1.0), np.float32(1.0), np.float32(1.0), np.float32(0.0), np.float32(0.0), np.float32(0.0), np.float32(0.0), np.float32(1.0), np.float32(0.0), np.float32(0.0), np.float32(0.0), np.float32(0.0), np.float32(1.0)]",-2.0,99688.0,0
2025-08-14_08-18-36,2063,"[np.float32(0.0), np.float32(0.0), np.float32(0.0), np.float32(1.0), np.float32(0.0), np.float32(1.0), np.float32(0.0), np.float32(1.0), np.float32(1.0), np.float32(1.0), np.float32(1.0), np.float32(0.0), np.float32(0.0), np.float32(1.0), np.float32(1.0), np.float32(0.0)]",2.0,99690.0,31
2025-08-14_08-18-36,2064,"[np.float32(1.0), np.float32(0.0), np.float32(1.0), np.float32(1.0), np.float32(1.0), np.float32(1.0), np.float32(0.0), np.float32(0.0), np.float32(0.0), np.float32(0.0), np.float32(1.0), np.float32(0.0), np.float32(0.0), np.float32(1.0), np.float32(1.0), np.float32(0.0)]",2.0,99692.0,2
2025-08-14_08-18-36,2065,"[np.float32(1.0), np.float32(0.0), np.float32(0.0), np.float32(0.0), np.float32(0.0), np.float32(0.0), np.float32(1.0), np.float32(1.0), np.float32(1.0), np.float32(0.0), np.float32(0.0), np.float32(1.0), np.float32(0.0), np.float32(0.0), np.float32(0.0), np.float32(0.0)]",0.0,99692.0,25
2025-08-14_08-18-36,2066,"[np.float32(0.0), np.float32(1.0), np.float32(1.0), np.float32(0.0), np.float32(1.0), np.float32(1.0), np.float32(1.0), np.float32(0.0), np.float32(0.0), np.float32(1.0), np.float32(0.0), np.float32(1.0), np.float32(1.0), np.float32(0.0), np.float32(0.0), np.float32(0.0)]",0.0,99692.0,9
2025-08-14_08-18-36,2067,"[np.float32(0.0), np.float32(0.0), np.float32(0.0), np.float32(0.0), np.float32(0.0), np.float32(1.0), np.float32(1.0), np.float32(0.0), np.float32(0.0), np.float32(0.0), np.float32(1.0), np.float32(1.0), np.float32(0.0), np.float32(1.0), np.float32(0.0), np.float32(0.0)]",0.0,99692.0,24
2025-08-14_08-18-36,2068,"[np.float32(0.0), np.float32(1.0), np.float32(1.0), np.float32(0.0), np.float32(0.0), np.float32(0.0), np.float32(0.0), np.float32(0.0), np.float32(0.0), np.float32(1.0), np.float32(0.0), np.float32(0.0), np.float32(1.0), np.float32(1.0), np.float32(1.0), np.float32(1.0)]",-2.0,99690.0,12
2025-08-14_08-18-36,2069,"[np.float32(0.0), np.float32(0.0), np.float32(1.0), np.float32(1.0), np.float32(1.0), np.float32(1.0), np.float32(1.0), np.float32(1.0), np.float32(1.0), np.float32(0.0), np.float32(0.0), np.float32(0.0), np.float32(0.0), np.float32(0.0), np.float32(0.0), np.float32(0.0)]",0.0,99690.0,28
2025-08-14_08-18-36,2070,"[np.float32(1.0), np.float32(0.0), np.float32(0.0), np.float32(0.0), np.float32(0.0), np.float32(1.0), np.float32(1.0), np.float32(1.0), np.float32(0.0), np.float32(0.0), np.float32(1.0), np.float32(0.0), np.float32(0.0), np.float32(1.0), np.float32(0.0), np.float32(0.0)]",4.0,99694.0,19
2025-08-14_08-18-36,2071,"[np.float32(1.0), np.float32(1.0), np.float32(1.0), np.float32(1.0), np.float32(1.0), np.float32(0.0), np.float32(0.0), np.float32(0.0), np.float32(0.0), np.float32(0.0), np.float32(0.0), np.float32(0.0), np.float32(0.0), np.float32(0.0), np.float32(1.0), np.float32(1.0)]",-1.0,99693.0,4
2025-08-14_08-18-36,2072,"[np.float32(1.0), np.float32(1.0), np.float32(1.0), np.float32(0.0), np.float32(0.0), np.float32(1.0), np.float32(0.0), np.float32(1.0), np.float32(1.0), np.float32(1.0), np.float32(0.0), np.float32(0.0), np.float32(0.0), np.float32(0.0), np.float32(0.0), np.float32(1.0)]",-1.0,99692.0,18
2025-08-14_08-18-36,2073,"[np.float32(0.0), np.float32(0.0), np.float32(0.0), np.float32(0.0), np.float32(0.0), np.float32(1.0), np.float32(1.0), np.float32(1.0), np.float32(0.0), np.float32(1.0), np.float32(1.0), np.float32(1.0), np.float32(1.0), np.float32(1.0), np.float32(1.0), np.float32(0.0)]",0.0,99692.0,15
2025-08-14_08-18-36,2074,"[np.float32(1.0), np.float32(0.0), np.float32(1.0), np.float32(0.0), np.float32(0.0), np.float32(0.0), np.float32(1.0), np.float32(1.0), np.float32(1.0), np.float32(1.0), np.float32(0.0), np.float32(1.0), np.float32(1.0), np.float32(0.0), np.float32(1.0), np.float32(0.0)]",-4.0,99688.0,20
2025-08-14_08-18-36,2075,"[np.float32(0.0), np.float32(1.0), np.float32(1.0), np.float32(0.0), np.float32(1.0), np.float32(0.0), np.float32(1.0), np.float32(1.0), np.float32(0.0), np.float32(1.0), np.float32(0.0), np.float32(0.0), np.float32(0.0), np.float32(1.0), np.float32(0.0), np.float32(1.0)]",-8.0,99680.0,27
2025-08-14_08-18-36,2076,"[np.float32(0.0), np.float32(0.0), np.float32(1.0), np.float32(0.0), np.float32(1.0), np.float32(0.0), np.float32(0.0), np.float32(1.0), np.float32(0.0), np.float32(1.0), np.float32(0.0), np.float32(0.0), np.float32(1.0), np.float32(0.0), np.float32(0.0), np.float32(0.0)]",-3.0,99677.0,3
2025-08-14_08-18-36,2077,"[np.float32(1.0), np.float32(0.0), np.float32(0.0), np.float32(1.0), np.float32(0.0), np.float32(0.0), np.float32(0.0), np.float32(0.0), np.float32(0.0), np.float32(0.0), np.float32(0.0), np.float32(0.0), np.float32(0.0), np.float32(1.0), np.float32(0.0), np.float32(1.0)]",1.0,99678.0,14
2025-08-14_08-18-36,2078,"[np.float32(0.0), np.float32(0.0), np.float32(0.0), np.float32(0.0), np.float32(0.0), np.float32(0.0), np.float32(0.0), np.float32(1.0), np.float32(1.0), np.float32(0.0), np.float32(1.0), np.float32(0.0), np.float32(0.0), np.float32(1.0), np.float32(0.0), np.float32(1.0)]",1.0,99679.0,21
2025-08-14_08-18-36,2079,"[np.float32(1.0), np.float32(1.0), np.float32(0.0), np.float32(0.0), np.float32(1.0), np.float32(1.0), np.float32(0.0), np.float32(0.0), np.float32(1.0), np.float32(1.0), np.float32(0.0), np.float32(1.0), np.float32(0.0), np.float32(1.0), np.float32(1.0), np.float32(0.0)]",-5.0,99674.0,14
2025-08-14_08-18-36,2080,"[np.float32(1.0), np.float32(1.0), np.float32(0.0), np.float32(1.0), np.float32(0.0), np.float32(1.0), np.float32(1.0), np.float32(1.0), np.float32(0.0), np.float32(0.0), np.float32(1.0), np.float32(0.0), np.float32(1.0), np.float32(1.0), np.float32(1.0), np.float32(1.0)]",-4.0,99670.0,30
2025-08-14_08-18-36,2081,"[np.float32(1.0), np.float32(0.0), np.float32(1.0), np.float32(0.0), np.float32(1.0), np.float32(1.0), np.float32(1.0), np.float32(0.0), np.float32(0.0), np.float32(1.0), np.float32(0.0), np.float32(1.0), np.float32(0.0), np.float32(1.0), np.float32(1.0), np.float32(0.0)]",1.0,99671.0,1
2025-08-14_08-18-36,2082,"[np.float32(0.0), np.float32(0.0), np.float32(0.0), np.float32(0.0), np.float32(1.0), np.float32(0.0), np.float32(0.0), np.float32(1.0), np.float32(1.0), np.float32(0.0), np.float32(1.0), np.float32(1.0), np.float32(1.0), np.float32(1.0), np.float32(1.0), np.float32(0.0)]",-2.0,99669.0,25
2025-08-14_08-18-36,2083,"[np.float32(1.0), np.float32(1.0), np.float32(0.0), np.float32(0.0), np.float32(0.0), np.float32(1.0), np.float32(0.0), np.float32(0.0), np.float32(1.0), np.float32(0.0), np.float32(1.0), np.float32(0.0), np.float32(0.0), np.float32(0.0), np.float32(1.0), np.float32(1.0)]",1.0,99670.0,8
2025-08-14_08-18-36,2084,"[np.float32(0.0), np.float32(0.0), np.float32(1.0), np.float32(0.0), np.float32(0.0), np.float32(1.0), np.float32(0.0), np.float32(0.0), np.float32(1.0), np.float32(1.0), np.float32(0.0), np.float32(1.0), np.float32(0.0), np.float32(1.0), np.float32(1.0), np.float32(1.0)]",5.0,99675.0,34
2025-08-14_08-18-36,2085,"[np.float32(1.0), np.float32(0.0), np.float32(1.0), np.float32(1.0), np.float32(1.0), np.float32(0.0), np.float32(0.0), np.float32(1.0), np.float32(1.0), np.float32(0.0), np.float32(0.0), np.float32(0.0), np.float32(1.0), np.float32(0.0), np.float32(0.0), np.float32(1.0)]",1.0,99676.0,18
2025-08-14_08-18-36,2086,"[np.float32(0.0), np.float32(0.0), np.float32(0.0), np.float32(0.0), np.float32(1.0), np.float32(1.0), np.float32(0.0), np.float32(0.0), np.float32(0.0), np.float32(1.0), np.float32(1.0), np.float32(0.0), np.float32(0.0), np.float32(1.0), np.float32(0.0), np.float32(1.0)]",2.0,99678.0,20
2025-08-14_08-18-36,2087,"[np.float32(1.0), np.float32(0.0), np.float32(1.0), np.float32(0.0), np.float32(0.0), np.float32(1.0), np.float32(0.0), np.float32(1.0), np.float32(0.0), np.float32(0.0), np.float32(1.0), np.float32(1.0), np.float32(0.0), np.float32(0.0), np.float32(1.0), np.float32(1.0)]",0.0,99678.0,6
2025-08-14_08-18-36,2088,"[np.float32(0.0), np.float32(0.0), np.float32(0.0), np.float32(0.0), np.float32(0.0), np.float32(1.0), np.float32(1.0), np.float32(1.0), np.float32(0.0), np.float32(1.0), np.float32(1.0), np.float32(0.0), np.float32(1.0), np.float32(0.0), np.float32(0.0), np.float32(1.0)]",-2.0,99676.0,28
2025-08-14_08-18-36,2089,"[np.float32(0.0), np.float32(0.0), np.float32(0.0), np.float32(0.0), np.float32(0.0), np.float32(0.0), np.float32(0.0), np.float32(0.0), np.float32(1.0), np.float32(1.0), np.float32(1.0), np.float32(0.0), np.float32(0.0), np.float32(1.0), np.float32(0.0), np.float32(1.0)]",1.0,99677.0,17
2025-08-14_08-18-36,2090,"[np.float32(1.0), np.float32(1.0), np.float32(0.0), np.float32(1.0), np.float32(0.0), np.float32(0.0), np.float32(0.0), np.float32(1.0), np.float32(1.0), np.float32(0.0), np.float32(1.0), np.float32(0.0), np.float32(0.0), np.float32(0.0), np.float32(0.0), np.float32(1.0)]",-5.0,99672.0,10
2025-08-14_08-18-36,2091,"[np.float32(0.0), np.float32(0.0), np.float32(1.0), np.float32(0.0), np.float32(0.0), np.float32(0.0), np.float32(0.0), np.float32(0.0), np.float32(0.0), np.float32(0.0), np.float32(1.0), np.float32(0.0), np.float32(0.0), np.float32(1.0), np.float32(0.0), np.float32(1.0)]",-4.0,99668.0,33
2025-08-14_08-18-36,2092,"[np.float32(0.0), np.float32(1.0), np.float32(1.0), np.float32(0.0), np.float32(0.0), np.float32(0.0), np.float32(0.0), np.float32(1.0), np.float32(0.0), np.float32(1.0), np.float32(0.0), np.float32(1.0), np.float32(1.0), np.float32(1.0), np.float32(0.0), np.float32(1.0)]",-2.0,99666.0,25
2025-08-14_08-18-36,2093,"[np.float32(1.0), np.float32(0.0), np.float32(1.0), np.float32(0.0), np.float32(1.0), np.float32(1.0), np.float32(1.0), np.float32(0.0), np.float32(1.0), np.float32(1.0), np.float32(1.0), np.float32(0.0), np.float32(1.0), np.float32(0.0), np.float32(1.0), np.float32(0.0)]",0.0,99666.0,26
2025-08-14_08-18-36,2094,"[np.float32(0.0), np.float32(1.0), np.float32(0.0), np.float32(1.0), np.float32(0.0), np.float32(0.0), np.float32(1.0), np.float32(1.0), np.float32(0.0), np.float32(0.0), np.float32(0.0), np.float32(0.0), np.float32(0.0), np.float32(0.0), np.float32(0.0), np.float32(0.0)]",1.0,99667.0,1
2025-08-14_08-18-36,2095,"[np.float32(1.0), np.float32(0.0), np.float32(1.0), np.float32(0.0), np.float32(1.0), np.float32(1.0), np.float32(0.0), np.float32(0.0), np.float32(1.0), np.float32(0.0), np.float32(0.0), np.float32(1.0), np.float32(1.0), np.float32(0.0), np.float32(0.0), np.float32(1.0)]",1.0,99668.0,18
2025-08-14_08-18-36,2096,"[np.float32(0.0), np.float32(0.0), np.float32(1.0), np.float32(0.0), np.float32(0.0), np.float32(1.0), np.float32(1.0), np.float32(0.0), np.float32(1.0), np.float32(1.0), np.float32(0.0), np.float32(0.0), np.float32(0.0), np.float32(0.0), np.float32(0.0), np.float32(0.0)]",-5.0,99663.0,17
2025-08-14_08-18-36,2097,"[np.float32(1.0), np.float32(1.0), np.float32(0.0), np.float32(0.0), np.float32(1.0), np.float32(1.0), np.float32(1.0), np.float32(0.0), np.float32(0.0), np.float32(0.0), np.float32(0.0), np.float32(0.0), np.float32(0.0), np.float32(1.0), np.float32(0.0), np.float32(0.0)]",1.0,99664.0,0
2025-08-14_08-18-36,2098,"[np.float32(1.0), np.float32(1.0), np.float32(1.0), np.float32(0.0), np.float32(0.0), np.float32(0.0), np.float32(0.0), np.float32(1.0), np.float32(1.0), np.float32(0.0), np.float32(0.0), np.float32(0.0), np.float32(1.0), np.float32(1.0), np.float32(1.0), np.float32(0.0)]",2.0,99666.0,36
2025-08-14_08-18-36,2099,"[np.float32(1.0), np.float32(1.0), np.float32(0.0), np.float32(1.0), np.float32(0.0), np.float32(0.0), np.float32(1.0), np.float32(0.0), np.float32(1.0), np.float32(1.0), np.float32(0.0), np.float32(0.0), np.float32(1.0), np.float32(1.0), np.float32(1.0), np.float32(1.0)]",1.0,99667.0,10
2025-08-14_08-18-36,2100,"[np.float32(1.0), np.float32(1.0), np.float32(1.0), np.float32(0.0), np.float32(0.0), np.float32(0.0), np.float32(1.0), np.float32(1.0), np.float32(1.0), np.float32(0.0), np.float32(0.0), np.float32(1.0), np.float32(1.0), np.float32(0.0), np.float32(0.0), np.float32(0.0)]",-3.0,99664.0,11
2025-08-14_08-18-36,2101,"[np.float32(0.0), np.float32(0.0), np.float32(0.0), np.float32(0.0), np.float32(1.0), np.float32(0.0), np.float32(1.0), np.float32(0.0), np.float32(0.0), np.float32(0.0), np.float32(1.0), np.float32(1.0), np.float32(1.0), np.float32(0.0), np.float32(0.0), np.float32(0.0)]",3.0,99667.0,9
2025-08-14_08-18-36,2102,"[np.float32(0.0), np.float32(1.0), np.float32(0.0), np.float32(0.0), np.float32(0.0), np.float32(1.0), np.float32(0.0), np.float32(1.0), np.float32(0.0), np.float32(0.0), np.float32(1.0), np.float32(1.0), np.float32(0.0), np.float32(0.0), np.float32(0.0), np.float32(1.0)]",2.0,99669.0,21
2025-08-14_08-18-36,2103,"[np.float32(0.0), np.float32(0.0), np.float32(1.0), np.float32(0.0), np.float32(0.0), np.float32(0.0), np.float32(1.0), np.float32(1.0), np.float32(1.0), np.float32(0.0), np.float32(1.0), np.float32(1.0), np.float32(0.0), np.float32(0.0), np.float32(0.0), np.float32(0.0)]",0.0,99669.0,11
2025-08-14_08-18-36,2104,"[np.float32(0.0), np.float32(0.0), np.float32(0.0), np.float32(0.0), np.float32(1.0), np.float32(1.0), np.float32(0.0), np.float32(0.0), np.float32(0.0), np.float32(0.0), np.float32(1.0), np.float32(0.0), np.float32(0.0), np.float32(0.0), np.float32(1.0), np.float32(0.0)]",-2.0,99667.0,9
2025-08-14_08-18-36,2105,"[np.float32(1.0), np.float32(1.0), np.float32(0.0), np.float32(0.0), np.float32(1.0), np.float32(1.0), np.float32(0.0), np.float32(0.0), np.float32(1.0), np.float32(1.0), np.float32(0.0), np.float32(0.0), np.float32(0.0), np.float32(0.0), np.float32(0.0), np.float32(1.0)]",6.0,99673.0,31
2025-08-14_08-18-36,2106,"[np.float32(0.0), np.float32(0.0), np.float32(1.0), np.float32(0.0), np.float32(1.0), np.float32(1.0), np.float32(0.0), np.float32(0.0), np.float32(0.0), np.float32(0.0), np.float32(0.0), np.float32(0.0), np.float32(0.0), np.float32(1.0), np.float32(1.0), np.float32(0.0)]",2.0,99675.0,12
2025-08-14_08-18-36,2107,"[np.float32(0.0), np.float32(0.0), np.float32(0.0), np.float32(1.0), np.float32(0.0), np.float32(1.0), np.float32(0.0), np.float32(1.0), np.float32(1.0), np.float32(1.0), np.float32(1.0), np.float32(1.0), np.float32(0.0), np.float32(1.0), np.float32(0.0), np.float32(1.0)]",4.0,99679.0,25
2025-08-14_08-18-36,2108,"[np.float32(1.0), np.float32(1.0), np.float32(0.0), np.float32(0.0), np.float32(0.0), np.float32(1.0), np.float32(0.0), np.float32(1.0), np.float32(1.0), np.float32(0.0), np.float32(1.0), np.float32(1.0), np.float32(0.0), np.float32(0.0), np.float32(0.0), np.float32(1.0)]",-3.0,99676.0,13
2025-08-14_08-18-36,2109,"[np.float32(0.0), np.float32(0.0), np.float32(1.0), np.float32(1.0), np.float32(1.0), np.float32(1.0), np.float32(1.0), np.float32(1.0), np.float32(1.0), np.float32(0.0), np.float32(0.0), np.float32(1.0), np.float32(1.0), np.float32(0.0), np.float32(1.0), np.float32(1.0)]",-1.0,99675.0,3
2025-08-14_08-18-36,2110,"[np.float32(1.0), np.float32(1.0), np.float32(0.0), np.float32(0.0), np.float32(0.0), np.float32(0.0), np.float32(1.0), np.float32(0.0), np.float32(1.0), np.float32(0.0), np.float32(0.0), np.float32(0.0), np.float32(0.0), np.float32(1.0), np.float32(0.0), np.float32(1.0)]",2.0,99677.0,6
2025-08-14_08-18-36,2111,"[np.float32(1.0), np.float32(0.0), np.float32(0.0), np.float32(0.0), np.float32(1.0), np.float32(0.0), np.float32(1.0), np.float32(0.0), np.float32(0.0), np.float32(0.0), np.float32(0.0), np.float32(1.0), np.float32(1.0), np.float32(1.0), np.float32(0.0), np.float32(0.0)]",-4.0,99673.0,13
2025-08-14_08-18-36,2112,"[np.float32(1.0), np.float32(1.0), np.float32(0.0), np.float32(1.0), np.float32(1.0), np.float32(1.0), np.float32(1.0), np.float32(1.0), np.float32(0.0), np.float32(1.0), np.float32(0.0), np.float32(1.0), np.float32(0.0), np.float32(1.0), np.float32(1.0), np.float32(0.0)]",4.0,99677.0,21
2025-08-14_08-18-36,2113,"[np.float32(1.0), np.float32(0.0), np.float32(0.0), np.float32(1.0), np.float32(1.0), np.float32(0.0), np.float32(0.0), np.float32(0.0), np.float32(1.0), np.float32(0.0), np.float32(1.0), np.float32(0.0), np.float32(0.0), np.float32(1.0), np.float32(1.0), np.float32(0.0)]",1.0,99678.0,30
2025-08-14_08-18-36,2114,"[np.float32(1.0), np.float32(0.0), np.float32(0.0), np.float32(1.0), np.float32(1.0), np.float32(1.0), np.float32(0.0), np.float32(1.0), np.float32(1.0), np.float32(0.0), np.float32(0.0), np.float32(1.0), np.float32(0.0), np.float32(0.0), np.float32(1.0), np.float32(0.0)]",-2.0,99676.0,1
2025-08-14_08-18-36,2115,"[np.float32(0.0), np.float32(0.0), np.float32(0.0), np.float32(1.0), np.float32(0.0), np.float32(0.0), np.float32(0.0), np.float32(1.0), np.float32(1.0), np.float32(1.0), np.float32(0.0), np.float32(1.0), np.float32(0.0), np.float32(0.0), np.float32(1.0), np.float32(1.0)]",4.0,99680.0,27
2025-08-14_08-18-36,2116,"[np.float32(1.0), np.float32(0.0), np.float32(0.0), np.float32(1.0), np.float32(0.0), np.float32(1.0), np.float32(0.0), np.float32(1.0), np.float32(0.0), np.float32(1.0), np.float32(0.0), np.float32(0.0), np.float32(0.0), np.float32(1.0), np.float32(0.0), np.float32(0.0)]",1.0,99681.0,34
2025-08-14_08-18-36,2117,"[np.float32(1.0), np.float32(1.0), np.float32(1.0), np.float32(1.0), np.float32(1.0), np.float32(0.0), np.float32(0.0), np.float32(0.0), np.float32(0.0), np.float32(1.0), np.float32(0.0), np.float32(0.0), np.float32(0.0), np.float32(1.0), np.float32(0.0), np.float32(1.0)]",2.0,99683.0,19
2025-08-14_08-18-36,2118,"[np.float32(1.0), np.float32(0.0), np.float32(0.0), np.float32(0.0), np.float32(1.0), np.float32(0.0), np.float32(0.0), np.float32(1.0), np.float32(0.0), np.float32(0.0), np.float32(0.0), np.float32(0.0), np.float32(1.0), np.float32(0.0), np.float32(1.0), np.float32(0.0)]",-3.0,99680.0,6
2025-08-14_08-18-36,2119,"[np.float32(0.0), np.float32(1.0), np.float32(1.0), np.float32(0.0), np.float32(0.0), np.float32(1.0), np.float32(0.0), np.float32(0.0), np.float32(0.0), np.float32(0.0), np.float32(0.0), np.float32(1.0), np.float32(0.0), np.float32(1.0), np.float32(0.0), np.float32(0.0)]",2.0,99682.0,33
2025-08-14_08-18-36,2120,"[np.float32(1.0), np.float32(0.0), np.float32(0.0), np.float32(0.0), np.float32(1.0), np.float32(0.0), np.float32(1.0), np.float32(0.0), np.float32(0.0), np.float32(1.0), np.float32(0.0), np.float32(0.0), np.float32(1.0), np.float32(1.0), np.float32(0.0), np.float32(1.0)]",-2.0,99680.0,13
2025-08-14_08-18-36,2121,"[np.float32(1.0), np.float32(0.0), np.float32(1.0), np.float32(0.0), np.float32(1.0), np.float32(0.0), np.float32(0.0), np.float32(0.0), np.float32(1.0), np.float32(1.0), np.float32(1.0), np.float32(0.0), np.float32(1.0), np.float32(1.0), np.float32(1.0), np.float32(1.0)]",1.0,99681.0,26
2025-08-14_08-18-36,2122,"[np.float32(0.0), np.float32(0.0), np.float32(0.0), np.float32(1.0), np.float32(0.0), np.float32(0.0), np.float32(1.0), np.float32(0.0), np.float32(0.0), np.float32(0.0), np.float32(0.0), np.float32(0.0), np.float32(1.0), np.float32(0.0), np.float32(0.0), np.float32(0.0)]",-3.0,99678.0,16
2025-08-14_08-18-36,2123,"[np.float32(1.0), np.float32(1.0), np.float32(1.0), np.float32(1.0), np.float32(0.0), np.float32(1.0), np.float32(0.0), np.float32(1.0), np.float32(0.0), np.float32(1.0), np.float32(1.0), np.float32(1.0), np.float32(1.0), np.float32(1.0), np.float32(1.0), np.float32(0.0)]",-3.0,99675.0,31
2025-08-14_08-18-36,2124,"[np.float32(0.0), np.float32(1.0), np.float32(0.0), np.float32(1.0), np.float32(0.0), np.float32(0.0), np.float32(0.0), np.float32(1.0), np.float32(1.0), np.float32(0.0), np.float32(1.0), np.float32(0.0), np.float32(1.0), np.float32(1.0), np.float32(0.0), np.float32(0.0)]",1.0,99676.0,21
2025-08-14_08-18-36,2125,"[np.float32(0.0), np.float32(1.0), np.float32(0.0), np.float32(0.0), np.float32(1.0), np.float32(0.0), np.float32(1.0), np.float32(0.0), np.float32(0.0), np.float32(1.0), np.float32(1.0), np.float32(0.0), np.float32(1.0), np.float32(0.0), np.float32(0.0), np.float32(1.0)]",3.0,99679.0,11
2025-08-14_08-18-36,2126,"[np.float32(1.0), np.float32(1.0), np.float32(0.0), np.float32(0.0), np.float32(0.0), np.float32(1.0), np.float32(1.0), np.float32(1.0), np.float32(0.0), np.float32(1.0), np.float32(0.0), np.float32(0.0), np.float32(1.0), np.float32(0.0), np.float32(1.0), np.float32(0.0)]",0.0,99679.0,11
2025-08-14_08-18-36,2127,"[np.float32(0.0), np.float32(0.0), np.float32(0.0), np.float32(1.0), np.float32(1.0), np.float32(0.0), np.float32(1.0), np.float32(1.0), np.float32(1.0), np.float32(0.0), np.float32(1.0), np.float32(0.0), np.float32(0.0), np.float32(0.0), np.float32(0.0), np.float32(0.0)]",-3.0,99676.0,36
2025-08-14_08-18-36,2128,"[np.float32(0.0), np.float32(1.0), np.float32(0.0), np.float32(0.0), np.float32(1.0), np.float32(1.0), np.float32(0.0), np.float32(1.0), np.float32(1.0), np.float32(1.0), np.float32(1.0), np.float32(0.0), np.float32(0.0), np.float32(0.0), np.float32(1.0), np.float32(0.0)]",3.0,99679.0,23
2025-08-14_08-18-36,2129,"[np.float32(0.0), np.float32(1.0), np.float32(1.0), np.float32(0.0), np.float32(0.0), np.float32(1.0), np.float32(1.0), np.float32(0.0), np.float32(1.0), np.float32(1.0), np.float32(0.0), np.float32(1.0), np.float32(1.0), np.float32(1.0), np.float32(0.0), np.float32(0.0)]",1.0,99680.0,2
2025-08-14_08-18-36,2130,"[np.float32(0.0), np.float32(1.0), np.float32(1.0), np.float32(0.0), np.float32(0.0), np.float32(0.0), np.float32(1.0), np.float32(0.0), np.float32(0.0), np.float32(1.0), np.float32(0.0), np.float32(0.0), np.float32(0.0), np.float32(1.0), np.float32(0.0), np.float32(1.0)]",2.0,99682.0,31
2025-08-14_08-18-36,2131,"[np.float32(0.0), np.float32(0.0), np.float32(1.0), np.float32(1.0), np.float32(0.0), np.float32(1.0), np.float32(1.0), np.float32(1.0), np.float32(1.0), np.float32(0.0), np.float32(1.0), np.float32(1.0), np.float32(1.0), np.float32(1.0), np.float32(0.0), np.float32(1.0)]",-3.0,99679.0,11
2025-08-14_08-18-36,2132,"[np.float32(0.0), np.float32(0.0), np.float32(0.0), np.float32(1.0), np.float32(0.0), np.float32(0.0), np.float32(1.0), np.float32(1.0), np.float32(0.0), np.float32(0.0), np.float32(1.0), np.float32(1.0), np.float32(0.0), np.float32(1.0), np.float32(0.0), np.float32(1.0)]",-4.0,99675.0,28
2025-08-14_08-18-36,2133,"[np.float32(0.0), np.float32(0.0), np.float32(0.0), np.float32(1.0), np.float32(0.0), np.float32(1.0), np.float32(0.0), np.float32(1.0), np.float32(0.0), np.float32(1.0), np.float32(1.0), np.float32(1.0), np.float32(1.0), np.float32(1.0), np.float32(1.0), np.float32(1.0)]",3.0,99678.0,23
2025-08-14_08-18-36,2134,"[np.float32(1.0), np.float32(1.0), np.float32(1.0), np.float32(0.0), np.float32(0.0), np.float32(1.0), np.float32(0.0), np.float32(0.0), np.float32(0.0), np.float32(0.0), np.float32(1.0), np.float32(0.0), np.float32(0.0), np.float32(0.0), np.float32(0.0), np.float32(1.0)]",0.0,99678.0,0
2025-08-14_08-18-36,2135,"[np.float32(1.0), np.float32(0.0), np.float32(0.0), np.float32(1.0), np.float32(1.0), np.float32(0.0), np.float32(1.0), np.float32(1.0), np.float32(1.0), np.float32(1.0), np.float32(0.0), np.float32(1.0), np.float32(1.0), np.float32(0.0), np.float32(1.0), np.float32(1.0)]",1.0,99679.0,5
2025-08-14_08-18-36,2136,"[np.float32(0.0), np.float32(0.0), np.float32(0.0), np.float32(0.0), np.float32(0.0), np.float32(0.0), np.float32(1.0), np.float32(0.0), np.float32(1.0), np.float32(1.0), np.float32(1.0), np.float32(0.0), np.float32(0.0), np.float32(1.0), np.float32(1.0), np.float32(0.0)]",-3.0,99676.0,6
2025-08-14_08-18-36,2137,"[np.float32(1.0), np.float32(1.0), np.float32(1.0), np.float32(0.0), np.float32(1.0), np.float32(0.0), np.float32(1.0), np.float32(0.0), np.float32(0.0), np.float32(0.0), np.float32(0.0), np.float32(0.0), np.float32(0.0), np.float32(0.0), np.float32(0.0), np.float32(1.0)]",-2.0,99674.0,24
2025-08-14_08-18-36,2138,"[np.float32(1.0), np.float32(0.0), np.float32(0.0), np.float32(1.0), np.float32(0.0), np.float32(1.0), np.float32(0.0), np.float32(0.0), np.float32(1.0), np.float32(1.0), np.float32(0.0), np.float32(0.0), np.float32(1.0), np.float32(1.0), np.float32(1.0), np.float32(0.0)]",2.0,99676.0,29
2025-08-14_08-18-36,2139,"[np.float32(0.0), np.float32(1.0), np.float32(1.0), np.float32(1.0), np.float32(0.0), np.float32(0.0), np.float32(0.0), np.float32(0.0), np.float32(1.0), np.float32(1.0), np.float32(0.0), np.float32(0.0), np.float32(0.0), np.float32(1.0), np.float32(1.0), np.float32(0.0)]",-2.0,99674.0,3
2025-08-14_08-18-36,2140,"[np.float32(1.0), np.float32(1.0), np.float32(0.0), np.float32(0.0), np.float32(1.0), np.float32(1.0), np.float32(1.0), np.float32(0.0), np.float32(1.0), np.float32(1.0), np.float32(1.0), np.float32(0.0), np.float32(0.0), np.float32(0.0), np.float32(0.0), np.float32(0.0)]",2.0,99676.0,7
2025-08-14_08-18-36,2141,"[np.float32(0.0), np.float32(1.0), np.float32(0.0), np.float32(1.0), np.float32(1.0), np.float32(0.0), np.float32(1.0), np.float32(1.0), np.float32(0.0), np.float32(1.0), np.float32(0.0), np.float32(1.0), np.float32(1.0), np.float32(1.0), np.float32(1.0), np.float32(1.0)]",-1.0,99675.0,2
2025-08-14_08-18-36,2142,"[np.float32(1.0), np.float32(0.0), np.float32(0.0), np.float32(1.0), np.float32(0.0), np.float32(0.0), np.float32(1.0), np.float32(0.0), np.float32(1.0), np.float32(0.0), np.float32(1.0), np.float32(0.0), np.float32(0.0), np.float32(1.0), np.float32(0.0), np.float32(0.0)]",-3.0,99672.0,6
2025-08-14_08-18-36,2143,"[np.float32(1.0), np.float32(1.0), np.float32(1.0), np.float32(1.0), np.float32(0.0), np.float32(1.0), np.float32(0.0), np.float32(1.0), np.float32(0.0), np.float32(0.0), np.float32(0.0), np.float32(1.0), np.float32(0.0), np.float32(1.0), np.float32(0.0), np.float32(0.0)]",1.0,99673.0,26
2025-08-14_08-18-36,2144,"[np.float32(0.0), np.float32(1.0), np.float32(1.0), np.float32(0.0), np.float32(0.0), np.float32(0.0), np.float32(0.0), np.float32(1.0), np.float32(0.0), np.float32(0.0), np.float32(0.0), np.float32(1.0), np.float32(1.0), np.float32(1.0), np.float32(0.0), np.float32(0.0)]",-1.0,99672.0,13
2025-08-14_08-18-36,2145,"[np.float32(1.0), np.float32(1.0), np.float32(0.0), np.float32(1.0), np.float32(1.0), np.float32(0.0), np.float32(0.0), np.float32(1.0), np.float32(1.0), np.float32(1.0), np.float32(0.0), np.float32(1.0), np.float32(0.0), np.float32(1.0), np.float32(1.0), np.float32(1.0)]",0.0,99672.0,30
2025-08-14_08-18-36,2146,"[np.float32(0.0), np.float32(1.0), np.float32(0.0), np.float32(0.0), np.float32(0.0), np.float32(1.0), np.float32(1.0), np.float32(1.0), np.float32(0.0), np.float32(1.0), np.float32(0.0), np.float32(1.0), np.float32(0.0), np.float32(1.0), np.float32(0.0), np.float32(0.0)]",0.0,99672.0,29
2025-08-14_08-18-36,2147,"[np.float32(0.0), np.float32(1.0), np.float32(0.0), np.float32(0.0), np.float32(0.0), np.float32(1.0), np.float32(0.0), np.float32(1.0), np.float32(1.0), np.float32(1.0), np.float32(1.0), np.float32(0.0), np.float32(1.0), np.float32(1.0), np.float32(1.0), np.float32(0.0)]",-7.0,99665.0,6
2025-08-14_08-18-36,2148,"[np.float32(1.0), np.float32(1.0), np.float32(1.0), np.float32(0.0), np.float32(1.0), np.float32(0.0), np.float32(1.0), np.float32(1.0), np.float32(0.0), np.float32(0.0), np.float32(0.0), np.float32(0.0), np.float32(1.0), np.float32(0.0), np.float32(1.0), np.float32(0.0)]",-3.0,99662.0,21
2025-08-14_08-18-36,2149,"[np.float32(1.0), np.float32(0.0), np.float32(0.0), np.float32(1.0), np.float32(1.0), np.float32(0.0), np.float32(1.0), np.float32(0.0), np.float32(1.0), np.float32(0.0), np.float32(0.0), np.float32(1.0), np.float32(1.0), np.float32(1.0), np.float32(0.0), np.float32(1.0)]",1.0,99663.0,21
2025-08-14_08-18-36,2150,"[np.float32(0.0), np.float32(0.0), np.float32(0.0), np.float32(1.0), np.float32(1.0), np.float32(0.0), np.float32(1.0), np.float32(1.0), np.float32(0.0), np.float32(0.0), np.float32(1.0), np.float32(1.0), np.float32(0.0), np.float32(1.0), np.float32(0.0), np.float32(1.0)]",-5.0,99658.0,36
2025-08-14_08-18-36,2151,"[np.float32(0.0), np.float32(0.0), np.float32(1.0), np.float32(0.0), np.float32(0.0), np.float32(0.0), np.float32(0.0), np.float32(0.0), np.float32(0.0), np.float32(1.0), np.float32(1.0), np.float32(0.0), np.float32(1.0), np.float32(1.0), np.float32(0.0), np.float32(0.0)]",-2.0,99656.0,11
2025-08-14_08-18-36,2152,"[np.float32(1.0), np.float32(1.0), np.float32(1.0), np.float32(1.0), np.float32(0.0), np.float32(1.0), np.float32(0.0), np.float32(1.0), np.float32(0.0), np.float32(0.0), np.float32(0.0), np.float32(1.0), np.float32(1.0), np.float32(1.0), np.float32(1.0), np.float32(0.0)]",5.0,99661.0,21
2025-08-14_08-18-36,2153,"[np.float32(0.0), np.float32(0.0), np.float32(1.0), np.float32(0.0), np.float32(1.0), np.float32(1.0), np.float32(0.0), np.float32(0.0), np.float32(0.0), np.float32(0.0), np.float32(1.0), np.float32(0.0), np.float32(0.0), np.float32(1.0), np.float32(1.0), np.float32(0.0)]",1.0,99662.0,30
2025-08-14_08-18-36,2154,"[np.float32(0.0), np.float32(1.0), np.float32(0.0), np.float32(0.0), np.float32(0.0), np.float32(1.0), np.float32(1.0), np.float32(0.0), np.float32(1.0), np.float32(0.0), np.float32(1.0), np.float32(1.0), np.float32(0.0), np.float32(1.0), np.float32(0.0), np.float32(1.0)]",0.0,99662.0,30
2025-08-14_08-18-36,2155,"[np.float32(1.0), np.float32(1.0), np.float32(1.0), np.float32(0.0), np.float32(0.0), np.float32(0.0), np.float32(1.0), np.float32(0.0), np.float32(1.0), np.float32(1.0), np.float32(1.0), np.float32(0.0), np.float32(1.0), np.float32(0.0), np.float32(0.0), np.float32(0.0)]",-6.0,99656.0,21
2025-08-14_08-18-36,2156,"[np.float32(0.0), np.float32(1.0), np.float32(1.0), np.float32(0.0), np.float32(0.0), np.float32(1.0), np.float32(1.0), np.float32(1.0), np.float32(1.0), np.float32(1.0), np.float32(0.0), np.float32(1.0), np.float32(0.0), np.float32(1.0), np.float32(1.0), np.float32(0.0)]",0.0,99656.0,29
2025-08-14_08-18-36,2157,"[np.float32(1.0), np.float32(1.0), np.float32(0.0), np.float32(1.0), np.float32(1.0), np.float32(1.0), np.float32(0.0), np.float32(1.0), np.float32(1.0), np.float32(1.0), np.float32(0.0), np.float32(1.0), np.float32(1.0), np.float32(0.0), np.float32(0.0), np.float32(1.0)]",-5.0,99651.0,11
2025-08-14_08-18-36,2158,"[np.float32(1.0), np.float32(0.0), np.float32(0.0), np.float32(1.0), np.float32(1.0), np.float32(0.0), np.float32(1.0), np.float32(1.0), np.float32(0.0), np.float32(1.0), np.float32(1.0), np.float32(0.0), np.float32(0.0), np.float32(0.0), np.float32(0.0), np.float32(1.0)]",1.0,99652.0,20
2025-08-14_08-18-36,2159,"[np.float32(0.0), np.float32(1.0), np.float32(1.0), np.float32(0.0), np.float32(0.0), np.float32(1.0), np.float32(1.0), np.float32(1.0), np.float32(1.0), np.float32(0.0), np.float32(1.0), np.float32(1.0), np.float32(0.0), np.float32(1.0), np.float32(0.0), np.float32(0.0)]",-1.0,99651.0,17
2025-08-14_08-18-36,2160,"[np.float32(0.0), np.float32(0.0), np.float32(0.0), np.float32(1.0), np.float32(0.0), np.float32(0.0), np.float32(1.0), np.float32(0.0), np.float32(0.0), np.float32(0.0), np.float32(1.0), np.float32(0.0), np.float32(0.0), np.float32(1.0), np.float32(1.0), np.float32(0.0)]",6.0,99657.0,11
2025-08-14_08-18-36,2161,"[np.float32(0.0), np.float32(0.0), np.float32(0.0), np.float32(1.0), np.float32(0.0), np.float32(1.0), np.float32(1.0), np.float32(1.0), np.float32(1.0), np.float32(1.0), np.float32(0.0), np.float32(1.0), np.float32(1.0), np.float32(0.0), np.float32(0.0), np.float32(0.0)]",0.0,99657.0,13
2025-08-14_08-18-36,2162,"[np.float32(1.0), np.float32(1.0), np.float32(1.0), np.float32(1.0), np.float32(0.0), np.float32(0.0), np.float32(0.0), np.float32(0.0), np.float32(1.0), np.float32(1.0), np.float32(0.0), np.float32(1.0), np.float32(0.0), np.float32(0.0), np.float32(0.0), np.float32(1.0)]",-1.0,99656.0,29
2025-08-14_08-18-36,2163,"[np.float32(0.0), np.float32(0.0), np.float32(0.0), np.float32(1.0), np.float32(0.0), np.float32(0.0), np.float32(0.0), np.float32(0.0), np.float32(0.0), np.float32(0.0), np.float32(1.0), np.float32(1.0), np.float32(0.0), np.float32(0.0), np.float32(1.0), np.float32(0.0)]",1.0,99657.0,13
2025-08-14_08-18-36,2164,"[np.float32(1.0), np.float32(0.0), np.float32(0.0), np.float32(0.0), np.float32(1.0), np.float32(0.0), np.float32(0.0), np.float32(1.0), np.float32(0.0), np.float32(0.0), np.float32(1.0), np.float32(1.0), np.float32(1.0), np.float32(0.0), np.float32(0.0), np.float32(0.0)]",-1.0,99656.0,2
2025-08-14_08-18-36,2165,"[np.float32(0.0), np.float32(0.0), np.float32(1.0), np.float32(1.0), np.float32(0.0), np.float32(0.0), np.float32(0.0), np.float32(0.0), np.float32(1.0), np.float32(1.0), np.float32(1.0), np.float32(0.0), np.float32(1.0), np.float32(0.0), np.float32(0.0), np.float32(0.0)]",-1.0,99655.0,22
2025-08-14_08-18-36,2166,"[np.float32(0.0), np.float32(0.0), np.float32(0.0), np.float32(0.0), np.float32(0.0), np.float32(0.0), np.float32(0.0), np.float32(1.0), np.float32(1.0), np.float32(1.0), np.float32(1.0), np.float32(0.0), np.float32(1.0), np.float32(0.0), np.float32(0.0), np.float32(0.0)]",-5.0,99650.0,3
2025-08-14_08-18-36,2167,"[np.float32(0.0), np.float32(1.0), np.float32(0.0), np.float32(0.0), np.float32(0.0), np.float32(1.0), np.float32(0.0), np.float32(1.0), np.float32(0.0), np.float32(1.0), np.float32(1.0), np.float32(0.0), np.float32(1.0), np.float32(0.0), np.float32(1.0), np.float32(1.0)]",-1.0,99649.0,33
2025-08-14_08-18-36,2168,"[np.float32(0.0), np.float32(1.0), np.float32(0.0), np.float32(1.0), np.float32(1.0), np.float32(0.0), np.float32(1.0), np.float32(0.0), np.float32(1.0), np.float32(1.0), np.float32(0.0), np.float32(1.0), np.float32(1.0), np.float32(0.0), np.float32(0.0), np.float32(1.0)]",-2.0,99647.0,2
2025-08-14_08-18-36,2169,"[np.float32(0.0), np.float32(1.0), np.float32(0.0), np.float32(1.0), np.float32(1.0), np.float32(1.0), np.float32(0.0), np.float32(1.0), np.float32(1.0), np.float32(1.0), np.float32(1.0), np.float32(1.0), np.float32(1.0), np.float32(1.0), np.float32(0.0), np.float32(1.0)]",1.0,99648.0,26
2025-08-14_08-18-36,2170,"[np.float32(0.0), np.float32(0.0), np.float32(0.0), np.float32(0.0), np.float32(0.0), np.float32(0.0), np.float32(0.0), np.float32(1.0), np.float32(1.0), np.float32(0.0), np.float32(1.0), np.float32(0.0), np.float32(1.0), np.float32(0.0), np.float32(0.0), np.float32(1.0)]",-2.0,99646.0,9
2025-08-14_08-18-36,2171,"[np.float32(1.0), np.float32(0.0), np.float32(0.0), np.float32(1.0), np.float32(0.0), np.float32(1.0), np.float32(1.0), np.float32(0.0), np.float32(1.0), np.float32(1.0), np.float32(0.0), np.float32(0.0), np.float32(0.0), np.float32(1.0), np.float32(0.0), np.float32(1.0)]",-1.0,99645.0,33
2025-08-14_08-18-36,2172,"[np.float32(1.0), np.float32(1.0), np.float32(1.0), np.float32(1.0), np.float32(0.0), np.float32(1.0), np.float32(0.0), np.float32(1.0), np.float32(1.0), np.float32(1.0), np.float32(0.0), np.float32(1.0), np.float32(0.0), np.float32(0.0), np.float32(0.0), np.float32(1.0)]",0.0,99645.0,18
2025-08-14_08-18-36,2173,"[np.float32(1.0), np.float32(0.0), np.float32(1.0), np.float32(1.0), np.float32(0.0), np.float32(1.0), np.float32(0.0), np.float32(1.0), np.float32(0.0), np.float32(1.0), np.float32(0.0), np.float32(1.0), np.float32(0.0), np.float32(0.0), np.float32(0.0), np.float32(0.0)]",3.0,99648.0,16
2025-08-14_08-18-36,2174,"[np.float32(1.0), np.float32(0.0), np.float32(0.0), np.float32(0.0), np.float32(0.0), np.float32(0.0), np.float32(1.0), np.float32(0.0), np.float32(1.0), np.float32(1.0), np.float32(0.0), np.float32(1.0), np.float32(0.0), np.float32(0.0), np.float32(0.0), np.float32(1.0)]",-1.0,99647.0,16
2025-08-14_08-18-36,2175,"[np.float32(1.0), np.float32(0.0), np.float32(1.0), np.float32(1.0), np.float32(0.0), np.float32(1.0), np.float32(1.0), np.float32(0.0), np.float32(1.0), np.float32(0.0), np.float32(1.0), np.float32(0.0), np.float32(0.0), np.float32(1.0), np.float32(0.0), np.float32(0.0)]",2.0,99649.0,7
2025-08-14_08-18-36,2176,"[np.float32(0.0), np.float32(0.0), np.float32(1.0), np.float32(1.0), np.float32(0.0), np.float32(1.0), np.float32(1.0), np.float32(1.0), np.float32(1.0), np.float32(0.0), np.float32(1.0), np.float32(0.0), np.float32(1.0), np.float32(1.0), np.float32(1.0), np.float32(0.0)]",-2.0,99647.0,15
2025-08-14_08-18-36,2177,"[np.float32(0.0), np.float32(1.0), np.float32(1.0), np.float32(1.0), np.float32(0.0), np.float32(1.0), np.float32(1.0), np.float32(1.0), np.float32(0.0), np.float32(1.0), np.float32(0.0), np.float32(1.0), np.float32(0.0), np.float32(1.0), np.float32(0.0), np.float32(0.0)]",0.0,99647.0,29
2025-08-14_08-18-36,2178,"[np.float32(0.0), np.float32(0.0), np.float32(0.0), np.float32(1.0), np.float32(1.0), np.float32(0.0), np.float32(0.0), np.float32(0.0), np.float32(0.0), np.float32(0.0), np.float32(0.0), np.float32(0.0), np.float32(0.0), np.float32(0.0), np.float32(1.0), np.float32(1.0)]",1.0,99648.0,14
2025-08-14_08-18-36,2179,"[np.float32(0.0), np.float32(1.0), np.float32(1.0), np.float32(1.0), np.float32(0.0), np.float32(0.0), np.float32(1.0), np.float32(1.0), np.float32(1.0), np.float32(1.0), np.float32(1.0), np.float32(1.0), np.float32(0.0), np.float32(0.0), np.float32(1.0), np.float32(1.0)]",0.0,99648.0,27
2025-08-14_08-18-36,2180,"[np.float32(1.0), np.float32(1.0), np.float32(1.0), np.float32(1.0), np.float32(0.0), np.float32(0.0), np.float32(1.0), np.float32(0.0), np.float32(1.0), np.float32(1.0), np.float32(0.0), np.float32(0.0), np.float32(0.0), np.float32(0.0), np.float32(1.0), np.float32(1.0)]",1.0,99649.0,7
2025-08-14_08-18-36,2181,"[np.float32(0.0), np.float32(0.0), np.float32(0.0), np.float32(1.0), np.float32(0.0), np.float32(0.0), np.float32(1.0), np.float32(1.0), np.float32(0.0), np.float32(0.0), np.float32(1.0), np.float32(0.0), np.float32(1.0), np.float32(0.0), np.float32(0.0), np.float32(1.0)]",0.0,99649.0,8
2025-08-14_08-18-36,2182,"[np.float32(1.0), np.float32(0.0), np.float32(0.0), np.float32(0.0), np.float32(1.0), np.float32(1.0), np.float32(0.0), np.float32(1.0), np.float32(0.0), np.float32(0.0), np.float32(0.0), np.float32(0.0), np.float32(1.0), np.float32(1.0), np.float32(1.0), np.float32(0.0)]",-2.0,99647.0,35
2025-08-14_08-18-36,2183,"[np.float32(0.0), np.float32(0.0), np.float32(1.0), np.float32(1.0), np.float32(0.0), np.float32(0.0), np.float32(1.0), np.float32(1.0), np.float32(0.0), np.float32(1.0), np.float32(0.0), np.float32(0.0), np.float32(0.0), np.float32(0.0), np.float32(1.0), np.float32(1.0)]",-5.0,99642.0,35
2025-08-14_08-18-36,2184,"[np.float32(0.0), np.float32(0.0), np.float32(0.0), np.float32(1.0), np.float32(0.0), np.float32(0.0), np.float32(0.0), np.float32(1.0), np.float32(1.0), np.float32(0.0), np.float32(1.0), np.float32(0.0), np.float32(0.0), np.float32(0.0), np.float32(1.0), np.float32(0.0)]",0.0,99642.0,15
2025-08-14_08-18-36,2185,"[np.float32(0.0), np.float32(0.0), np.float32(1.0), np.float32(0.0), np.float32(1.0), np.float32(1.0), np.float32(1.0), np.float32(1.0), np.float32(1.0), np.float32(0.0), np.float32(0.0), np.float32(0.0), np.float32(0.0), np.float32(0.0), np.float32(1.0), np.float32(1.0)]",-4.0,99638.0,0
2025-08-14_08-18-36,2186,"[np.float32(1.0), np.float32(1.0), np.float32(1.0), np.float32(0.0), np.float32(0.0), np.float32(1.0), np.float32(1.0), np.float32(1.0), np.float32(1.0), np.float32(1.0), np.float32(0.0), np.float32(1.0), np.float32(1.0), np.float32(0.0), np.float32(0.0), np.float32(0.0)]",-3.0,99635.0,23
2025-08-14_08-18-36,2187,"[np.float32(1.0), np.float32(0.0), np.float32(0.0), np.float32(1.0), np.float32(0.0), np.float32(0.0), np.float32(0.0), np.float32(1.0), np.float32(1.0), np.float32(0.0), np.float32(1.0), np.float32(1.0), np.float32(1.0), np.float32(0.0), np.float32(0.0), np.float32(0.0)]",-2.0,99633.0,34
2025-08-14_08-18-36,2188,"[np.float32(1.0), np.float32(1.0), np.float32(1.0), np.float32(0.0), np.float32(0.0), np.float32(1.0), np.float32(0.0), np.float32(1.0), np.float32(1.0), np.float32(0.0), np.float32(1.0), np.float32(0.0), np.float32(0.0), np.float32(0.0), np.float32(1.0), np.float32(1.0)]",1.0,99634.0,27
2025-08-14_08-18-36,2189,"[np.float32(1.0), np.float32(1.0), np.float32(0.0), np.float32(1.0), np.float32(1.0), np.float32(1.0), np.float32(0.0), np.float32(1.0), np.float32(0.0), np.float32(1.0), np.float32(1.0), np.float32(1.0), np.float32(0.0), np.float32(1.0), np.float32(0.0), np.float32(0.0)]",2.0,99636.0,29
2025-08-14_08-18-36,2190,"[np.float32(0.0), np.float32(0.0), np.float32(0.0), np.float32(0.0), np.float32(0.0), np.float32(1.0), np.float32(1.0), np.float32(0.0), np.float32(0.0), np.float32(0.0), np.float32(0.0), np.float32(1.0), np.float32(0.0), np.float32(1.0), np.float32(1.0), np.float32(1.0)]",0.0,99636.0,11
2025-08-14_08-18-36,2191,"[np.float32(1.0), np.float32(0.0), np.float32(1.0), np.float32(0.0), np.float32(1.0), np.float32(1.0), np.float32(1.0), np.float32(0.0), np.float32(0.0), np.float32(0.0), np.float32(0.0), np.float32(1.0), np.float32(0.0), np.float32(0.0), np.float32(1.0), np.float32(1.0)]",-3.0,99633.0,13
2025-08-14_08-18-36,2192,"[np.float32(1.0), np.float32(0.0), np.float32(0.0), np.float32(0.0), np.float32(1.0), np.float32(1.0), np.float32(1.0), np.float32(1.0), np.float32(0.0), np.float32(0.0), np.float32(0.0), np.float32(1.0), np.float32(0.0), np.float32(0.0), np.float32(0.0), np.float32(0.0)]",-1.0,99632.0,2
2025-08-14_08-18-36,2193,"[np.float32(1.0), np.float32(1.0), np.float32(0.0), np.float32(1.0), np.float32(1.0), np.float32(1.0), np.float32(1.0), np.float32(1.0), np.float32(1.0), np.float32(1.0), np.float32(1.0), np.float32(0.0), np.float32(1.0), np.float32(1.0), np.float32(1.0), np.float32(0.0)]",2.0,99634.0,29
2025-08-14_08-18-36,2194,"[np.float32(0.0), np.float32(1.0), np.float32(0.0), np.float32(1.0), np.float32(0.0), np.float32(1.0), np.float32(1.0), np.float32(1.0), np.float32(1.0), np.float32(0.0), np.float32(1.0), np.float32(1.0), np.float32(0.0), np.float32(0.0), np.float32(0.0), np.float32(0.0)]",-2.0,99632.0,12
2025-08-14_08-18-36,2195,"[np.float32(1.0), np.float32(0.0), np.float32(1.0), np.float32(1.0), np.float32(1.0), np.float32(0.0), np.float32(0.0), np.float32(1.0), np.float32(1.0), np.float32(1.0), np.float32(1.0), np.float32(0.0), np.float32(0.0), np.float32(1.0), np.float32(1.0), np.float32(0.0)]",3.0,99635.0,23
2025-08-14_08-18-36,2196,"[np.float32(0.0), np.float32(1.0), np.float32(0.0), np.float32(0.0), np.float32(0.0), np.float32(0.0), np.float32(0.0), np.float32(1.0), np.float32(1.0), np.float32(1.0), np.float32(1.0), np.float32(1.0), np.float32(0.0), np.float32(0.0), np.float32(1.0), np.float32(0.0)]",-4.0,99631.0,9
2025-08-14_08-18-36,2197,"[np.float32(1.0), np.float32(0.0), np.float32(1.0), np.float32(0.0), np.float32(0.0), np.float32(1.0), np.float32(1.0), np.float32(0.0), np.float32(1.0), np.float32(0.0), np.float32(0.0), np.float32(1.0), np.float32(0.0), np.float32(1.0), np.float32(0.0), np.float32(1.0)]",3.0,99634.0,6
2025-08-14_08-18-36,2198,"[np.float32(1.0), np.float32(1.0), np.float32(0.0), np.float32(0.0), np.float32(1.0), np.float32(1.0), np.float32(0.0), np.float32(0.0), np.float32(1.0), np.float32(0.0), np.float32(0.0), np.float32(1.0), np.float32(1.0), np.float32(1.0), np.float32(0.0), np.float32(1.0)]",1.0,99635.0,36
2025-08-14_08-18-36,2199,"[np.float32(0.0), np.float32(0.0), np.float32(0.0), np.float32(1.0), np.float32(1.0), np.float32(1.0), np.float32(1.0), np.float32(1.0), np.float32(0.0), np.float32(0.0), np.float32(1.0), np.float32(1.0), np.float32(0.0), np.float32(0.0), np.float32(0.0), np.float32(0.0)]",1.0,99636.0,12
2025-08-14_08-18-36,2200,"[np.float32(0.0), np.float32(0.0), np.float32(1.0), np.float32(1.0), np.float32(1.0), np.float32(0.0), np.float32(0.0), np.float32(1.0), np.float32(1.0), np.float32(1.0), np.float32(0.0), np.float32(0.0), np.float32(1.0), np.float32(1.0), np.float32(0.0), np.float32(1.0)]",-2.0,99634.0,9
2025-08-14_08-18-36,2201,"[np.float32(0.0), np.float32(0.0), np.float32(0.0), np.float32(0.0), np.float32(1.0), np.float32(1.0), np.float32(0.0), np.float32(1.0), np.float32(1.0), np.float32(1.0), np.float32(0.0), np.float32(1.0), np.float32(1.0), np.float32(0.0), np.float32(1.0), np.float32(0.0)]",-3.0,99631.0,8
2025-08-14_08-18-36,2202,"[np.float32(1.0), np.float32(0.0), np.float32(1.0), np.float32(1.0), np.float32(0.0), np.float32(1.0), np.float32(0.0), np.float32(1.0), np.float32(1.0), np.float32(0.0), np.float32(0.0), np.float32(1.0), np.float32(0.0), np.float32(1.0), np.float32(0.0), np.float32(1.0)]",-2.0,99629.0,16
2025-08-14_08-18-36,2203,"[np.float32(0.0), np.float32(0.0), np.float32(1.0), np.float32(1.0), np.float32(0.0), np.float32(0.0), np.float32(0.0), np.float32(0.0), np.float32(1.0), np.float32(1.0), np.float32(1.0), np.float32(0.0), np.float32(1.0), np.float32(0.0), np.float32(1.0), np.float32(0.0)]",-2.0,99627.0,4
2025-08-14_08-18-36,2204,"[np.float32(0.0), np.float32(0.0), np.float32(0.0), np.float32(0.0), np.float32(0.0), np.float32(1.0), np.float32(0.0), np.float32(0.0), np.float32(1.0), np.float32(1.0), np.float32(0.0), np.float32(1.0), np.float32(1.0), np.float32(1.0), np.float32(1.0), np.float32(1.0)]",3.0,99630.0,31
2025-08-14_08-18-36,2205,"[np.float32(0.0), np.float32(0.0), np.float32(1.0), np.float32(1.0), np.float32(0.0), np.float32(1.0), np.float32(1.0), np.float32(1.0), np.float32(1.0), np.float32(0.0), np.float32(0.0), np.float32(1.0), np.float32(0.0), np.float32(0.0), np.float32(1.0), np.float32(1.0)]",-2.0,99628.0,28
2025-08-14_08-18-36,2206,"[np.float32(0.0), np.float32(0.0), np.float32(1.0), np.float32(0.0), np.float32(0.0), np.float32(1.0), np.float32(0.0), np.float32(1.0), np.float32(1.0), np.float32(0.0), np.float32(1.0), np.float32(1.0), np.float32(1.0), np.float32(1.0), np.float32(1.0), np.float32(1.0)]",-1.0,99627.0,17
2025-08-14_08-18-36,2207,"[np.float32(1.0), np.float32(1.0), np.float32(0.0), np.float32(1.0), np.float32(1.0), np.float32(0.0), np.float32(1.0), np.float32(0.0), np.float32(0.0), np.float32(1.0), np.float32(0.0), np.float32(1.0), np.float32(1.0), np.float32(1.0), np.float32(0.0), np.float32(0.0)]",-4.0,99623.0,26
2025-08-14_08-18-36,2208,"[np.float32(0.0), np.float32(1.0), np.float32(0.0), np.float32(1.0), np.float32(0.0), np.float32(0.0), np.float32(0.0), np.float32(0.0), np.float32(1.0), np.float32(0.0), np.float32(0.0), np.float32(0.0), np.float32(1.0), np.float32(1.0), np.float32(1.0), np.float32(1.0)]",-2.0,99621.0,20
2025-08-14_08-18-36,2209,"[np.float32(1.0), np.float32(1.0), np.float32(0.0), np.float32(0.0), np.float32(0.0), np.float32(0.0), np.float32(1.0), np.float32(1.0), np.float32(1.0), np.float32(1.0), np.float32(0.0), np.float32(0.0), np.float32(1.0), np.float32(0.0), np.float32(1.0), np.float32(0.0)]",0.0,99621.0,11
2025-08-14_08-18-36,2210,"[np.float32(0.0), np.float32(1.0), np.float32(1.0), np.float32(0.0), np.float32(1.0), np.float32(1.0), np.float32(0.0), np.float32(0.0), np.float32(0.0), np.float32(0.0), np.float32(0.0), np.float32(1.0), np.float32(0.0), np.float32(1.0), np.float32(0.0), np.float32(1.0)]",2.0,99623.0,28
2025-08-14_08-18-36,2211,"[np.float32(1.0), np.float32(1.0), np.float32(1.0), np.float32(0.0), np.float32(1.0), np.float32(1.0), np.float32(1.0), np.float32(0.0), np.float32(0.0), np.float32(0.0), np.float32(0.0), np.float32(0.0), np.float32(0.0), np.float32(0.0), np.float32(1.0), np.float32(1.0)]",1.0,99624.0,34
2025-08-14_08-18-36,2212,"[np.float32(0.0), np.float32(0.0), np.float32(0.0), np.float32(0.0), np.float32(0.0), np.float32(1.0), np.float32(0.0), np.float32(0.0), np.float32(0.0), np.float32(0.0), np.float32(0.0), np.float32(0.0), np.float32(0.0), np.float32(1.0), np.float32(0.0), np.float32(0.0)]",0.0,99624.0,36
2025-08-14_08-18-36,2213,"[np.float32(1.0), np.float32(0.0), np.float32(0.0), np.float32(0.0), np.float32(1.0), np.float32(0.0), np.float32(1.0), np.float32(1.0), np.float32(0.0), np.float32(1.0), np.float32(0.0), np.float32(1.0), np.float32(1.0), np.float32(1.0), np.float32(0.0), np.float32(0.0)]",-5.0,99619.0,20
2025-08-14_08-18-36,2214,"[np.float32(0.0), np.float32(0.0), np.float32(0.0), np.float32(1.0), np.float32(0.0), np.float32(1.0), np.float32(0.0), np.float32(1.0), np.float32(1.0), np.float32(0.0), np.float32(0.0), np.float32(0.0), np.float32(0.0), np.float32(1.0), np.float32(1.0), np.float32(0.0)]",-6.0,99613.0,6
2025-08-14_08-18-36,2215,"[np.float32(0.0), np.float32(1.0), np.float32(0.0), np.float32(0.0), np.float32(0.0), np.float32(0.0), np.float32(1.0), np.float32(0.0), np.float32(1.0), np.float32(0.0), np.float32(0.0), np.float32(0.0), np.float32(0.0), np.float32(1.0), np.float32(1.0), np.float32(0.0)]",1.0,99614.0,12
2025-08-14_08-18-36,2216,"[np.float32(1.0), np.float32(1.0), np.float32(0.0), np.float32(1.0), np.float32(1.0), np.float32(0.0), np.float32(1.0), np.float32(1.0), np.float32(0.0), np.float32(1.0), np.float32(1.0), np.float32(1.0), np.float32(0.0), np.float32(1.0), np.float32(1.0), np.float32(1.0)]",3.0,99617.0,15
2025-08-14_08-18-36,2217,"[np.float32(1.0), np.float32(0.0), np.float32(1.0), np.float32(0.0), np.float32(0.0), np.float32(0.0), np.float32(0.0), np.float32(1.0), np.float32(1.0), np.float32(0.0), np.float32(1.0), np.float32(0.0), np.float32(1.0), np.float32(1.0), np.float32(0.0), np.float32(0.0)]",3.0,99620.0,14
2025-08-14_08-18-36,2218,"[np.float32(0.0), np.float32(1.0), np.float32(1.0), np.float32(1.0), np.float32(1.0), np.float32(1.0), np.float32(0.0), np.float32(1.0), np.float32(0.0), np.float32(1.0), np.float32(0.0), np.float32(0.0), np.float32(1.0), np.float32(0.0), np.float32(1.0), np.float32(1.0)]",-1.0,99619.0,8
2025-08-14_08-18-36,2219,"[np.float32(1.0), np.float32(1.0), np.float32(0.0), np.float32(0.0), np.float32(1.0), np.float32(1.0), np.float32(0.0), np.float32(0.0), np.float32(0.0), np.float32(1.0), np.float32(1.0), np.float32(1.0), np.float32(0.0), np.float32(0.0), np.float32(0.0), np.float32(0.0)]",0.0,99619.0,26
2025-08-14_08-18-36,2220,"[np.float32(0.0), np.float32(1.0), np.float32(0.0), np.float32(1.0), np.float32(1.0), np.float32(1.0), np.float32(1.0), np.float32(1.0), np.float32(0.0), np.float32(1.0), np.float32(0.0), np.float32(0.0), np.float32(0.0), np.float32(0.0), np.float32(0.0), np.float32(1.0)]",2.0,99621.0,9
2025-08-14_08-18-36,2221,"[np.float32(0.0), np.float32(1.0), np.float32(1.0), np.float32(1.0), np.float32(0.0), np.float32(1.0), np.float32(1.0), np.float32(1.0), np.float32(0.0), np.float32(0.0), np.float32(0.0), np.float32(1.0), np.float32(1.0), np.float32(0.0), np.float32(0.0), np.float32(0.0)]",-4.0,99617.0,25
2025-08-14_08-18-36,2222,"[np.float32(0.0), np.float32(1.0), np.float32(1.0), np.float32(0.0), np.float32(0.0), np.float32(1.0), np.float32(0.0), np.float32(0.0), np.float32(1.0), np.float32(0.0), np.float32(1.0), np.float32(1.0), np.float32(1.0), np.float32(1.0), np.float32(1.0), np.float32(0.0)]",-1.0,99616.0,23
2025-08-14_08-18-36,2223,"[np.float32(1.0), np.float32(0.0), np.float32(1.0), np.float32(1.0), np.float32(0.0), np.float32(1.0), np.float32(0.0), np.float32(0.0), np.float32(0.0), np.float32(0.0), np.float32(1.0), np.float32(0.0), np.float32(0.0), np.float32(0.0), np.float32(1.0), np.float32(1.0)]",0.0,99616.0,31
2025-08-14_08-18-36,2224,"[np.float32(0.0), np.float32(0.0), np.float32(0.0), np.float32(1.0), np.float32(1.0), np.float32(0.0), np.float32(1.0), np.float32(1.0), np.float32(1.0), np.float32(0.0), np.float32(0.0), np.float32(1.0), np.float32(0.0), np.float32(1.0), np.float32(0.0), np.float32(0.0)]",6.0,99622.0,3
2025-08-14_08-18-36,2225,"[np.float32(0.0), np.float32(1.0), np.float32(1.0), np.float32(1.0), np.float32(0.0), np.float32(1.0), np.float32(0.0), np.float32(1.0), np.float32(1.0), np.float32(0.0), np.float32(0.0), np.float32(1.0), np.float32(1.0), np.float32(1.0), np.float32(0.0), np.float32(0.0)]",1.0,99623.0,25
2025-08-14_08-18-36,2226,"[np.float32(1.0), np.float32(1.0), np.float32(1.0), np.float32(0.0), np.float32(0.0), np.float32(0.0), np.float32(1.0), np.float32(1.0), np.float32(0.0), np.float32(0.0), np.float32(1.0), np.float32(1.0), np.float32(0.0), np.float32(1.0), np.float32(0.0), np.float32(0.0)]",-1.0,99622.0,0
2025-08-14_08-18-36,2227,"[np.float32(0.0), np.float32(1.0), np.float32(0.0), np.float32(1.0), np.float32(0.0), np.float32(0.0), np.float32(0.0), np.float32(1.0), np.float32(1.0), np.float32(0.0), np.float32(1.0), np.float32(1.0), np.float32(1.0), np.float32(1.0), np.float32(0.0), np.float32(1.0)]",1.0,99623.0,33
2025-08-14_08-18-36,2228,"[np.float32(1.0), np.float32(0.0), np.float32(1.0), np.float32(1.0), np.float32(1.0), np.float32(1.0), np.float32(0.0), np.float32(1.0), np.float32(1.0), np.float32(1.0), np.float32(1.0), np.float32(0.0), np.float32(0.0), np.float32(1.0), np.float32(1.0), np.float32(1.0)]",3.0,99626.0,14
2025-08-14_08-18-36,2229,"[np.float32(1.0), np.float32(1.0), np.float32(0.0), np.float32(0.0), np.float32(0.0), np.float32(0.0), np.float32(1.0), np.float32(1.0), np.float32(1.0), np.float32(0.0), np.float32(0.0), np.float32(0.0), np.float32(0.0), np.float32(0.0), np.float32(0.0), np.float32(0.0)]",0.0,99626.0,1
2025-08-14_08-18-36,2230,"[np.float32(1.0), np.float32(0.0), np.float32(0.0), np.float32(1.0), np.float32(0.0), np.float32(1.0), np.float32(0.0), np.float32(1.0), np.float32(0.0), np.float32(0.0), np.float32(0.0), np.float32(0.0), np.float32(1.0), np.float32(0.0), np.float32(1.0), np.float32(0.0)]",1.0,99627.0,33
2025-08-14_08-18-36,2231,"[np.float32(0.0), np.float32(0.0), np.float32(1.0), np.float32(1.0), np.float32(1.0), np.float32(1.0), np.float32(1.0), np.float32(0.0), np.float32(0.0), np.float32(0.0), np.float32(1.0), np.float32(0.0), np.float32(1.0), np.float32(1.0), np.float32(0.0), np.float32(0.0)]",38.0,99665.0,7
2025-08-14_08-18-36,2232,"[np.float32(0.0), np.float32(1.0), np.float32(1.0), np.float32(0.0), np.float32(1.0), np.float32(1.0), np.float32(1.0), np.float32(0.0), np.float32(0.0), np.float32(1.0), np.float32(1.0), np.float32(1.0), np.float32(0.0), np.float32(1.0), np.float32(0.0), np.float32(1.0)]",-3.0,99662.0,13
2025-08-14_08-18-36,2233,"[np.float32(1.0), np.float32(0.0), np.float32(1.0), np.float32(1.0), np.float32(0.0), np.float32(0.0), np.float32(0.0), np.float32(0.0), np.float32(0.0), np.float32(1.0), np.float32(1.0), np.float32(1.0), np.float32(0.0), np.float32(0.0), np.float32(0.0), np.float32(1.0)]",-2.0,99660.0,10
2025-08-14_08-18-36,2234,"[np.float32(1.0), np.float32(0.0), np.float32(1.0), np.float32(0.0), np.float32(1.0), np.float32(1.0), np.float32(1.0), np.float32(1.0), np.float32(1.0), np.float32(1.0), np.float32(0.0), np.float32(1.0), np.float32(0.0), np.float32(0.0), np.float32(0.0), np.float32(0.0)]",-1.0,99659.0,31
2025-08-14_08-18-36,2235,"[np.float32(1.0), np.float32(0.0), np.float32(0.0), np.float32(1.0), np.float32(0.0), np.float32(0.0), np.float32(1.0), np.float32(0.0), np.float32(0.0), np.float32(1.0), np.float32(0.0), np.float32(1.0), np.float32(1.0), np.float32(1.0), np.float32(0.0), np.float32(1.0)]",-2.0,99657.0,2
2025-08-14_08-18-36,2236,"[np.float32(1.0), np.float32(1.0), np.float32(0.0), np.float32(1.0), np.float32(1.0), np.float32(1.0), np.float32(1.0), np.float32(0.0), np.float32(0.0), np.float32(1.0), np.float32(1.0), np.float32(0.0), np.float32(0.0), np.float32(1.0), np.float32(0.0), np.float32(0.0)]",1.0,99658.0,10
2025-08-14_08-18-36,2237,"[np.float32(1.0), np.float32(1.0), np.float32(0.0), np.float32(0.0), np.float32(1.0), np.float32(0.0), np.float32(0.0), np.float32(1.0), np.float32(0.0), np.float32(1.0), np.float32(0.0), np.float32(1.0), np.float32(1.0), np.float32(1.0), np.float32(0.0), np.float32(0.0)]",0.0,99658.0,28
2025-08-14_08-18-36,2238,"[np.float32(0.0), np.float32(0.0), np.float32(0.0), np.float32(1.0), np.float32(0.0), np.float32(0.0), np.float32(0.0), np.float32(0.0), np.float32(1.0), np.float32(0.0), np.float32(1.0), np.float32(0.0), np.float32(0.0), np.float32(1.0), np.float32(0.0), np.float32(1.0)]",-2.0,99656.0,18
2025-08-14_08-18-36,2239,"[np.float32(1.0), np.float32(0.0), np.float32(1.0), np.float32(1.0), np.float32(0.0), np.float32(1.0), np.float32(0.0), np.float32(1.0), np.float32(0.0), np.float32(1.0), np.float32(0.0), np.float32(0.0), np.float32(1.0), np.float32(0.0), np.float32(0.0), np.float32(0.0)]",-1.0,99655.0,36
2025-08-14_08-18-36,2240,"[np.float32(0.0), np.float32(1.0), np.float32(1.0), np.float32(0.0), np.float32(0.0), np.float32(0.0), np.float32(1.0), np.float32(1.0), np.float32(0.0), np.float32(0.0), np.float32(0.0), np.float32(0.0), np.float32(0.0), np.float32(1.0), np.float32(1.0), np.float32(0.0)]",1.0,99656.0,0
2025-08-14_08-18-36,2241,"[np.float32(1.0), np.float32(0.0), np.float32(0.0), np.float32(0.0), np.float32(0.0), np.float32(0.0), np.float32(0.0), np.float32(1.0), np.float32(0.0), np.float32(0.0), np.float32(0.0), np.float32(1.0), np.float32(0.0), np.float32(0.0), np.float32(0.0), np.float32(0.0)]",-3.0,99653.0,31
2025-08-14_08-18-36,2242,"[np.float32(0.0), np.float32(0.0), np.float32(0.0), np.float32(0.0), np.float32(1.0), np.float32(0.0), np.float32(0.0), np.float32(1.0), np.float32(1.0), np.float32(1.0), np.float32(0.0), np.float32(0.0), np.float32(0.0), np.float32(0.0), np.float32(1.0), np.float32(1.0)]",-4.0,99649.0,2
2025-08-14_08-18-36,2243,"[np.float32(1.0), np.float32(1.0), np.float32(1.0), np.float32(0.0), np.float32(0.0), np.float32(0.0), np.float32(1.0), np.float32(0.0), np.float32(1.0), np.float32(0.0), np.float32(1.0), np.float32(0.0), np.float32(0.0), np.float32(1.0), np.float32(0.0), np.float32(1.0)]",5.0,99654.0,26
2025-08-14_08-18-36,2244,"[np.float32(0.0), np.float32(0.0), np.float32(1.0), np.float32(1.0), np.float32(0.0), np.float32(1.0), np.float32(0.0), np.float32(0.0), np.float32(1.0), np.float32(0.0), np.float32(0.0), np.float32(1.0), np.float32(0.0), np.float32(0.0), np.float32(1.0), np.float32(1.0)]",0.0,99654.0,32
2025-08-14_08-18-36,2245,"[np.float32(0.0), np.float32(0.0), np.float32(1.0), np.float32(1.0), np.float32(1.0), np.float32(1.0), np.float32(0.0), np.float32(1.0), np.float32(1.0), np.float32(0.0), np.float32(1.0), np.float32(0.0), np.float32(0.0), np.float32(0.0), np.float32(1.0), np.float32(0.0)]",-4.0,99650.0,1
2025-08-14_08-18-36,2246,"[np.float32(1.0), np.float32(0.0), np.float32(0.0), np.float32(1.0), np.float32(0.0), np.float32(0.0), np.float32(1.0), np.float32(0.0), np.float32(0.0), np.float32(0.0), np.float32(1.0), np.float32(0.0), np.float32(0.0), np.float32(1.0), np.float32(1.0), np.float32(1.0)]",-2.0,99648.0,36
2025-08-14_08-18-36,2247,"[np.float32(1.0), np.float32(1.0), np.float32(0.0), np.float32(0.0), np.float32(1.0), np.float32(1.0), np.float32(1.0), np.float32(1.0), np.float32(1.0), np.float32(1.0), np.float32(1.0), np.float32(1.0), np.float32(0.0), np.float32(0.0), np.float32(1.0), np.float32(0.0)]",-1.0,99647.0,19
2025-08-14_08-18-36,2248,"[np.float32(0.0), np.float32(1.0), np.float32(1.0), np.float32(0.0), np.float32(0.0), np.float32(0.0), np.float32(1.0), np.float32(0.0), np.float32(0.0), np.float32(0.0), np.float32(1.0), np.float32(0.0), np.float32(1.0), np.float32(0.0), np.float32(0.0), np.float32(0.0)]",-5.0,99642.0,25
2025-08-14_08-18-36,2249,"[np.float32(1.0), np.float32(1.0), np.float32(1.0), np.float32(0.0), np.float32(0.0), np.float32(1.0), np.float32(1.0), np.float32(0.0), np.float32(0.0), np.float32(0.0), np.float32(1.0), np.float32(0.0), np.float32(0.0), np.float32(1.0), np.float32(1.0), np.float32(0.0)]",-4.0,99638.0,31
2025-08-14_08-18-36,2250,"[np.float32(0.0), np.float32(1.0), np.float32(0.0), np.float32(1.0), np.float32(0.0), np.float32(1.0), np.float32(0.0), np.float32(0.0), np.float32(0.0), np.float32(1.0), np.float32(0.0), np.float32(1.0), np.float32(0.0), np.float32(1.0), np.float32(0.0), np.float32(0.0)]",1.0,99639.0,13
2025-08-14_08-18-36,2251,"[np.float32(1.0), np.float32(0.0), np.float32(1.0), np.float32(1.0), np.float32(0.0), np.float32(1.0), np.float32(0.0), np.float32(1.0), np.float32(0.0), np.float32(0.0), np.float32(0.0), np.float32(1.0), np.float32(0.0), np.float32(1.0), np.float32(1.0), np.float32(0.0)]",-1.0,99638.0,0
2025-08-14_08-18-36,2252,"[np.float32(0.0), np.float32(1.0), np.float32(1.0), np.float32(1.0), np.float32(0.0), np.float32(1.0), np.float32(1.0), np.float32(0.0), np.float32(1.0), np.float32(0.0), np.float32(0.0), np.float32(0.0), np.float32(0.0), np.float32(0.0), np.float32(0.0), np.float32(0.0)]",-1.0,99637.0,3
2025-08-14_08-18-36,2253,"[np.float32(0.0), np.float32(1.0), np.float32(1.0), np.float32(0.0), np.float32(0.0), np.float32(1.0), np.float32(0.0), np.float32(1.0), np.float32(0.0), np.float32(0.0), np.float32(1.0), np.float32(1.0), np.float32(1.0), np.float32(0.0), np.float32(0.0), np.float32(0.0)]",-1.0,99636.0,0
2025-08-14_08-18-36,2254,"[np.float32(0.0), np.float32(1.0), np.float32(1.0), np.float32(0.0), np.float32(1.0), np.float32(1.0), np.float32(1.0), np.float32(1.0), np.float32(0.0), np.float32(0.0), np.float32(1.0), np.float32(1.0), np.float32(0.0), np.float32(1.0), np.float32(1.0), np.float32(1.0)]",0.0,99636.0,23
2025-08-14_08-18-36,2255,"[np.float32(1.0), np.float32(0.0), np.float32(1.0), np.float32(1.0), np.float32(1.0), np.float32(1.0), np.float32(1.0), np.float32(0.0), np.float32(1.0), np.float32(1.0), np.float32(0.0), np.float32(1.0), np.float32(1.0), np.float32(1.0), np.float32(1.0), np.float32(1.0)]",0.0,99636.0,6
2025-08-14_08-18-36,2256,"[np.float32(1.0), np.float32(0.0), np.float32(0.0), np.float32(0.0), np.float32(1.0), np.float32(0.0), np.float32(1.0), np.float32(1.0), np.float32(0.0), np.float32(0.0), np.float32(1.0), np.float32(0.0), np.float32(0.0), np.float32(1.0), np.float32(0.0), np.float32(1.0)]",1.0,99637.0,32
2025-08-14_08-18-36,2257,"[np.float32(0.0), np.float32(1.0), np.float32(0.0), np.float32(1.0), np.float32(0.0), np.float32(1.0), np.float32(0.0), np.float32(1.0), np.float32(1.0), np.float32(0.0), np.float32(1.0), np.float32(0.0), np.float32(1.0), np.float32(1.0), np.float32(0.0), np.float32(1.0)]",-4.0,99633.0,9
2025-08-14_08-18-36,2258,"[np.float32(1.0), np.float32(1.0), np.float32(1.0), np.float32(1.0), np.float32(0.0), np.float32(0.0), np.float32(0.0), np.float32(1.0), np.float32(0.0), np.float32(1.0), np.float32(0.0), np.float32(1.0), np.float32(1.0), np.float32(0.0), np.float32(0.0), np.float32(0.0)]",-1.0,99632.0,25
2025-08-14_08-18-36,2259,"[np.float32(0.0), np.float32(1.0), np.float32(0.0), np.float32(0.0), np.float32(1.0), np.float32(1.0), np.float32(1.0), np.float32(0.0), np.float32(0.0), np.float32(0.0), np.float32(0.0), np.float32(1.0), np.float32(1.0), np.float32(0.0), np.float32(1.0), np.float32(1.0)]",-4.0,99628.0,35
2025-08-14_08-18-36,2260,"[np.float32(0.0), np.float32(1.0), np.float32(0.0), np.float32(1.0), np.float32(1.0), np.float32(1.0), np.float32(0.0), np.float32(0.0), np.float32(1.0), np.float32(1.0), np.float32(1.0), np.float32(1.0), np.float32(1.0), np.float32(0.0), np.float32(0.0), np.float32(0.0)]",-1.0,99627.0,32
2025-08-14_08-18-36,2261,"[np.float32(1.0), np.float32(1.0), np.float32(0.0), np.float32(1.0), np.float32(0.0), np.float32(0.0), np.float32(0.0), np.float32(1.0), np.float32(0.0), np.float32(0.0), np.float32(0.0), np.float32(0.0), np.float32(0.0), np.float32(0.0), np.float32(1.0), np.float32(0.0)]",0.0,99627.0,36
2025-08-14_08-18-36,2262,"[np.float32(1.0), np.float32(0.0), np.float32(1.0), np.float32(1.0), np.float32(1.0), np.float32(0.0), np.float32(0.0), np.float32(1.0), np.float32(1.0), np.float32(1.0), np.float32(0.0), np.float32(0.0), np.float32(0.0), np.float32(1.0), np.float32(1.0), np.float32(0.0)]",6.0,99633.0,16
2025-08-14_08-18-36,2263,"[np.float32(1.0), np.float32(0.0), np.float32(0.0), np.float32(0.0), np.float32(0.0), np.float32(1.0), np.float32(1.0), np.float32(1.0), np.float32(0.0), np.float32(0.0), np.float32(1.0), np.float32(0.0), np.float32(1.0), np.float32(0.0), np.float32(1.0), np.float32(0.0)]",0.0,99633.0,30
2025-08-14_08-18-36,2264,"[np.float32(0.0), np.float32(1.0), np.float32(0.0), np.float32(1.0), np.float32(1.0), np.float32(0.0), np.float32(1.0), np.float32(1.0), np.float32(1.0), np.float32(1.0), np.float32(0.0), np.float32(0.0), np.float32(1.0), np.float32(1.0), np.float32(0.0), np.float32(0.0)]",0.0,99633.0,17
2025-08-14_08-18-36,2265,"[np.float32(1.0), np.float32(0.0), np.float32(1.0), np.float32(1.0), np.float32(0.0), np.float32(0.0), np.float32(0.0), np.float32(0.0), np.float32(1.0), np.float32(0.0), np.float32(0.0), np.float32(1.0), np.float32(1.0), np.float32(0.0), np.float32(0.0), np.float32(0.0)]",-1.0,99632.0,35
2025-08-14_08-18-36,2266,"[np.float32(0.0), np.float32(0.0), np.float32(0.0), np.float32(0.0), np.float32(0.0), np.float32(0.0), np.float32(1.0), np.float32(0.0), np.float32(1.0), np.float32(1.0), np.float32(1.0), np.float32(1.0), np.float32(1.0), np.float32(0.0), np.float32(0.0), np.float32(0.0)]",0.0,99632.0,28
2025-08-14_08-18-36,2267,"[np.float32(0.0), np.float32(0.0), np.float32(0.0), np.float32(1.0), np.float32(0.0), np.float32(1.0), np.float32(0.0), np.float32(0.0), np.float32(1.0), np.float32(0.0), np.float32(0.0), np.float32(1.0), np.float32(0.0), np.float32(0.0), np.float32(0.0), np.float32(0.0)]",-4.0,99628.0,14
2025-08-14_08-18-36,2268,"[np.float32(0.0), np.float32(0.0), np.float32(0.0), np.float32(1.0), np.float32(1.0), np.float32(0.0), np.float32(1.0), np.float32(0.0), np.float32(0.0), np.float32(1.0), np.float32(1.0), np.float32(0.0), np.float32(1.0), np.float32(0.0), np.float32(1.0), np.float32(0.0)]",39.0,99667.0,7
2025-08-14_08-18-36,2269,"[np.float32(1.0), np.float32(1.0), np.float32(0.0), np.float32(0.0), np.float32(0.0), np.float32(1.0), np.float32(0.0), np.float32(0.0), np.float32(0.0), np.float32(0.0), np.float32(1.0), np.float32(1.0), np.float32(0.0), np.float32(0.0), np.float32(1.0), np.float32(1.0)]",1.0,99668.0,9
2025-08-14_08-18-36,2270,"[np.float32(1.0), np.float32(1.0), np.float32(1.0), np.float32(1.0), np.float32(1.0), np.float32(1.0), np.float32(0.0), np.float32(0.0), np.float32(0.0), np.float32(1.0), np.float32(0.0), np.float32(0.0), np.float32(1.0), np.float32(1.0), np.float32(0.0), np.float32(1.0)]",-1.0,99667.0,18
2025-08-14_08-18-36,2271,"[np.float32(0.0), np.float32(1.0), np.float32(1.0), np.float32(1.0), np.float32(1.0), np.float32(1.0), np.float32(0.0), np.float32(1.0), np.float32(0.0), np.float32(0.0), np.float32(1.0), np.float32(0.0), np.float32(1.0), np.float32(1.0), np.float32(0.0), np.float32(1.0)]",-6.0,99661.0,27
2025-08-14_08-18-36,2272,"[np.float32(1.0), np.float32(1.0), np.float32(1.0), np.float32(0.0), np.float32(0.0), np.float32(1.0), np.float32(1.0), np.float32(1.0), np.float32(0.0), np.float32(1.0), np.float32(1.0), np.float32(0.0), np.float32(1.0), np.float32(1.0), np.float32(1.0), np.float32(0.0)]",36.0,99697.0,7
2025-08-14_08-18-36,2273,"[np.float32(0.0), np.float32(0.0), np.float32(0.0), np.float32(1.0), np.float32(1.0), np.float32(1.0), np.float32(0.0), np.float32(0.0), np.float32(0.0), np.float32(1.0), np.float32(1.0), np.float32(0.0), np.float32(1.0), np.float32(1.0), np.float32(0.0), np.float32(1.0)]",-6.0,99691.0,36
2025-08-14_08-18-36,2274,"[np.float32(0.0), np.float32(1.0), np.float32(1.0), np.float32(1.0), np.float32(1.0), np.float32(0.0), np.float32(1.0), np.float32(1.0), np.float32(1.0), np.float32(1.0), np.float32(0.0), np.float32(0.0), np.float32(0.0), np.float32(1.0), np.float32(1.0), np.float32(0.0)]",2.0,99693.0,15
2025-08-14_08-18-36,2275,"[np.float32(1.0), np.float32(1.0), np.float32(1.0), np.float32(0.0), np.float32(1.0), np.float32(0.0), np.float32(1.0), np.float32(1.0), np.float32(1.0), np.float32(0.0), np.float32(0.0), np.float32(0.0), np.float32(0.0), np.float32(0.0), np.float32(1.0), np.float32(0.0)]",-1.0,99692.0,15
2025-08-14_08-18-36,2276,"[np.float32(0.0), np.float32(1.0), np.float32(1.0), np.float32(0.0), np.float32(0.0), np.float32(0.0), np.float32(0.0), np.float32(1.0), np.float32(1.0), np.float32(1.0), np.float32(0.0), np.float32(1.0), np.float32(1.0), np.float32(0.0), np.float32(0.0), np.float32(0.0)]",1.0,99693.0,18
2025-08-14_08-18-36,2277,"[np.float32(0.0), np.float32(0.0), np.float32(1.0), np.float32(1.0), np.float32(0.0), np.float32(0.0), np.float32(0.0), np.float32(1.0), np.float32(1.0), np.float32(1.0), np.float32(0.0), np.float32(0.0), np.float32(1.0), np.float32(1.0), np.float32(0.0), np.float32(0.0)]",-2.0,99691.0,33
2025-08-14_08-18-36,2278,"[np.float32(0.0), np.float32(1.0), np.float32(1.0), np.float32(1.0), np.float32(0.0), np.float32(0.0), np.float32(0.0), np.float32(1.0), np.float32(0.0), np.float32(0.0), np.float32(1.0), np.float32(1.0), np.float32(1.0), np.float32(0.0), np.float32(0.0), np.float32(1.0)]",-4.0,99687.0,28
2025-08-14_08-18-36,2279,"[np.float32(0.0), np.float32(0.0), np.float32(0.0), np.float32(1.0), np.float32(1.0), np.float32(1.0), np.float32(0.0), np.float32(0.0), np.float32(1.0), np.float32(0.0), np.float32(1.0), np.float32(1.0), np.float32(1.0), np.float32(0.0), np.float32(1.0), np.float32(0.0)]",-3.0,99684.0,10
2025-08-14_08-18-36,2280,"[np.float32(1.0), np.float32(0.0), np.float32(0.0), np.float32(1.0), np.float32(1.0), np.float32(0.0), np.float32(1.0), np.float32(0.0), np.float32(1.0), np.float32(1.0), np.float32(0.0), np.float32(1.0), np.float32(1.0), np.float32(0.0), np.float32(0.0), np.float32(0.0)]",-5.0,99679.0,22
2025-08-14_08-18-36,2281,"[np.float32(0.0), np.float32(1.0), np.float32(1.0), np.float32(1.0), np.float32(1.0), np.float32(0.0), np.float32(0.0), np.float32(0.0), np.float32(0.0), np.float32(1.0), np.float32(1.0), np.float32(1.0), np.float32(0.0), np.float32(0.0), np.float32(1.0), np.float32(0.0)]",-1.0,99678.0,14
2025-08-14_08-18-36,2282,"[np.float32(0.0), np.float32(0.0), np.float32(0.0), np.float32(0.0), np.float32(1.0), np.float32(1.0), np.float32(0.0), np.float32(0.0), np.float32(1.0), np.float32(0.0), np.float32(1.0), np.float32(1.0), np.float32(1.0), np.float32(0.0), np.float32(1.0), np.float32(0.0)]",-2.0,99676.0,9
2025-08-14_08-18-36,2283,"[np.float32(1.0), np.float32(0.0), np.float32(1.0), np.float32(1.0), np.float32(0.0), np.float32(1.0), np.float32(0.0), np.float32(1.0), np.float32(1.0), np.float32(1.0), np.float32(1.0), np.float32(1.0), np.float32(0.0), np.float32(0.0), np.float32(0.0), np.float32(1.0)]",-5.0,99671.0,4
2025-08-14_08-18-36,2284,"[np.float32(1.0), np.float32(1.0), np.float32(1.0), np.float32(0.0), np.float32(0.0), np.float32(0.0), np.float32(1.0), np.float32(1.0), np.float32(0.0), np.float32(0.0), np.float32(0.0), np.float32(1.0), np.float32(1.0), np.float32(0.0), np.float32(1.0), np.float32(0.0)]",-3.0,99668.0,19
2025-08-14_08-18-36,2285,"[np.float32(1.0), np.float32(1.0), np.float32(0.0), np.float32(1.0), np.float32(0.0), np.float32(0.0), np.float32(0.0), np.float32(1.0), np.float32(1.0), np.float32(0.0), np.float32(0.0), np.float32(1.0), np.float32(1.0), np.float32(0.0), np.float32(0.0), np.float32(1.0)]",2.0,99670.0,15
2025-08-14_08-18-36,2286,"[np.float32(0.0), np.float32(1.0), np.float32(1.0), np.float32(1.0), np.float32(0.0), np.float32(1.0), np.float32(1.0), np.float32(0.0), np.float32(1.0), np.float32(0.0), np.float32(1.0), np.float32(0.0), np.float32(1.0), np.float32(1.0), np.float32(1.0), np.float32(0.0)]",0.0,99670.0,23
2025-08-14_08-18-36,2287,"[np.float32(1.0), np.float32(1.0), np.float32(0.0), np.float32(1.0), np.float32(0.0), np.float32(1.0), np.float32(0.0), np.float32(1.0), np.float32(0.0), np.float32(0.0), np.float32(0.0), np.float32(0.0), np.float32(0.0), np.float32(1.0), np.float32(1.0), np.float32(1.0)]",-1.0,99669.0,30
2025-08-14_08-18-36,2288,"[np.float32(1.0), np.float32(1.0), np.float32(1.0), np.float32(1.0), np.float32(0.0), np.float32(1.0), np.float32(0.0), np.float32(0.0), np.float32(1.0), np.float32(0.0), np.float32(0.0), np.float32(1.0), np.float32(0.0), np.float32(0.0), np.float32(1.0), np.float32(1.0)]",-5.0,99664.0,2
2025-08-14_08-18-36,2289,"[np.float32(0.0), np.float32(1.0), np.float32(0.0), np.float32(1.0), np.float32(1.0), np.float32(0.0), np.float32(1.0), np.float32(0.0), np.float32(1.0), np.float32(1.0), np.float32(0.0), np.float32(1.0), np.float32(0.0), np.float32(1.0), np.float32(0.0), np.float32(0.0)]",-6.0,99658.0,14
2025-08-14_08-18-36,2290,"[np.float32(0.0), np.float32(1.0), np.float32(0.0), np.float32(1.0), np.float32(0.0), np.float32(0.0), np.float32(0.0), np.float32(1.0), np.float32(1.0), np.float32(1.0), np.float32(0.0), np.float32(0.0), np.float32(1.0), np.float32(1.0), np.float32(0.0), np.float32(0.0)]",-2.0,99656.0,3
2025-08-14_08-18-36,2291,"[np.float32(1.0), np.float32(0.0), np.float32(0.0), np.float32(0.0), np.float32(0.0), np.float32(1.0), np.float32(1.0), np.float32(0.0), np.float32(1.0), np.float32(0.0), np.float32(0.0), np.float32(1.0), np.float32(1.0), np.float32(1.0), np.float32(1.0), np.float32(0.0)]",-3.0,99653.0,16
2025-08-14_08-18-36,2292,"[np.float32(0.0), np.float32(1.0), np.float32(1.0), np.float32(0.0), np.float32(0.0), np.float32(1.0), np.float32(1.0), np.float32(1.0), np.float32(1.0), np.float32(1.0), np.float32(1.0), np.float32(0.0), np.float32(0.0), np.float32(1.0), np.float32(1.0), np.float32(1.0)]",-1.0,99652.0,33
2025-08-14_08-18-36,2293,"[np.float32(0.0), np.float32(1.0), np.float32(1.0), np.float32(0.0), np.float32(1.0), np.float32(1.0), np.float32(0.0), np.float32(0.0), np.float32(1.0), np.float32(0.0), np.float32(1.0), np.float32(1.0), np.float32(1.0), np.float32(0.0), np.float32(0.0), np.float32(1.0)]",1.0,99653.0,31
2025-08-14_08-18-36,2294,"[np.float32(1.0), np.float32(1.0), np.float32(0.0), np.float32(0.0), np.float32(1.0), np.float32(1.0), np.float32(1.0), np.float32(0.0), np.float32(1.0), np.float32(0.0), np.float32(1.0), np.float32(0.0), np.float32(0.0), np.float32(0.0), np.float32(0.0), np.float32(1.0)]",-1.0,99652.0,10
2025-08-14_08-18-36,2295,"[np.float32(1.0), np.float32(1.0), np.float32(1.0), np.float32(1.0), np.float32(1.0), np.float32(0.0), np.float32(0.0), np.float32(0.0), np.float32(1.0), np.float32(1.0), np.float32(1.0), np.float32(0.0), np.float32(0.0), np.float32(0.0), np.float32(1.0), np.float32(1.0)]",-4.0,99648.0,3
2025-08-14_08-18-36,2296,"[np.float32(0.0), np.float32(0.0), np.float32(0.0), np.float32(0.0), np.float32(0.0), np.float32(1.0), np.float32(1.0), np.float32(1.0), np.float32(1.0), np.float32(0.0), np.float32(1.0), np.float32(0.0), np.float32(1.0), np.float32(1.0), np.float32(0.0), np.float32(0.0)]",1.0,99649.0,23
2025-08-14_08-18-36,2297,"[np.float32(1.0), np.float32(1.0), np.float32(0.0), np.float32(0.0), np.float32(1.0), np.float32(0.0), np.float32(0.0), np.float32(1.0), np.float32(0.0), np.float32(1.0), np.float32(1.0), np.float32(1.0), np.float32(0.0), np.float32(1.0), np.float32(1.0), np.float32(1.0)]",1.0,99650.0,22
2025-08-14_08-18-36,2298,"[np.float32(1.0), np.float32(0.0), np.float32(1.0), np.float32(0.0), np.float32(1.0), np.float32(0.0), np.float32(1.0), np.float32(0.0), np.float32(1.0), np.float32(1.0), np.float32(1.0), np.float32(1.0), np.float32(1.0), np.float32(1.0), np.float32(1.0), np.float32(0.0)]",4.0,99654.0,12
2025-08-14_08-18-36,2299,"[np.float32(0.0), np.float32(0.0), np.float32(0.0), np.float32(1.0), np.float32(1.0), np.float32(1.0), np.float32(0.0), np.float32(1.0), np.float32(1.0), np.float32(0.0), np.float32(0.0), np.float32(0.0), np.float32(0.0), np.float32(0.0), np.float32(1.0), np.float32(1.0)]",0.0,99654.0,35
2025-08-14_08-18-36,2300,"[np.float32(1.0), np.float32(0.0), np.float32(0.0), np.float32(0.0), np.float32(1.0), np.float32(0.0), np.float32(0.0), np.float32(0.0), np.float32(0.0), np.float32(1.0), np.float32(0.0), np.float32(1.0), np.float32(1.0), np.float32(0.0), np.float32(1.0), np.float32(0.0)]",1.0,99655.0,12
2025-08-14_08-18-36,2301,"[np.float32(0.0), np.float32(0.0), np.float32(0.0), np.float32(0.0), np.float32(0.0), np.float32(1.0), np.float32(0.0), np.float32(1.0), np.float32(0.0), np.float32(0.0), np.float32(0.0), np.float32(1.0), np.float32(0.0), np.float32(1.0), np.float32(0.0), np.float32(1.0)]",1.0,99656.0,12
2025-08-14_08-18-36,2302,"[np.float32(0.0), np.float32(0.0), np.float32(1.0), np.float32(1.0), np.float32(1.0), np.float32(0.0), np.float32(0.0), np.float32(1.0), np.float32(1.0), np.float32(0.0), np.float32(0.0), np.float32(0.0), np.float32(0.0), np.float32(0.0), np.float32(1.0), np.float32(1.0)]",-3.0,99653.0,4
2025-08-14_08-18-36,2303,"[np.float32(1.0), np.float32(0.0), np.float32(1.0), np.float32(0.0), np.float32(0.0), np.float32(1.0), np.float32(1.0), np.float32(0.0), np.float32(0.0), np.float32(1.0), np.float32(0.0), np.float32(1.0), np.float32(0.0), np.float32(1.0), np.float32(0.0), np.float32(1.0)]",1.0,99654.0,36
2025-08-14_08-18-36,2304,"[np.float32(1.0), np.float32(1.0), np.float32(0.0), np.float32(0.0), np.float32(1.0), np.float32(0.0), np.float32(1.0), np.float32(1.0), np.float32(1.0), np.float32(0.0), np.float32(0.0), np.float32(0.0), np.float32(0.0), np.float32(0.0), np.float32(1.0), np.float32(1.0)]",0.0,99654.0,23
2025-08-14_08-18-36,2305,"[np.float32(0.0), np.float32(1.0), np.float32(0.0), np.float32(1.0), np.float32(0.0), np.float32(1.0), np.float32(0.0), np.float32(0.0), np.float32(1.0), np.float32(0.0), np.float32(1.0), np.float32(0.0), np.float32(0.0), np.float32(0.0), np.float32(0.0), np.float32(0.0)]",-3.0,99651.0,6
2025-08-14_08-18-36,2306,"[np.float32(0.0), np.float32(0.0), np.float32(1.0), np.float32(1.0), np.float32(0.0), np.float32(0.0), np.float32(0.0), np.float32(0.0), np.float32(1.0), np.float32(1.0), np.float32(1.0), np.float32(1.0), np.float32(1.0), np.float32(1.0), np.float32(0.0), np.float32(1.0)]",-1.0,99650.0,3
2025-08-14_08-18-36,2307,"[np.float32(1.0), np.float32(0.0), np.float32(0.0), np.float32(0.0), np.float32(0.0), np.float32(0.0), np.float32(1.0), np.float32(0.0), np.float32(1.0), np.float32(1.0), np.float32(1.0), np.float32(1.0), np.float32(0.0), np.float32(0.0), np.float32(0.0), np.float32(1.0)]",-1.0,99649.0,35
2025-08-14_08-18-36,2308,"[np.float32(0.0), np.float32(1.0), np.float32(1.0), np.float32(1.0), np.float32(0.0), np.float32(1.0), np.float32(1.0), np.float32(0.0), np.float32(0.0), np.float32(0.0), np.float32(0.0), np.float32(1.0), np.float32(1.0), np.float32(1.0), np.float32(1.0), np.float32(1.0)]",1.0,99650.0,3
2025-08-14_08-18-36,2309,"[np.float32(1.0), np.float32(1.0), np.float32(0.0), np.float32(1.0), np.float32(1.0), np.float32(1.0), np.float32(1.0), np.float32(1.0), np.float32(0.0), np.float32(0.0), np.float32(0.0), np.float32(0.0), np.float32(1.0), np.float32(0.0), np.float32(0.0), np.float32(1.0)]",3.0,99653.0,17
2025-08-14_08-18-36,2310,"[np.float32(0.0), np.float32(0.0), np.float32(0.0), np.float32(1.0), np.float32(0.0), np.float32(0.0), np.float32(0.0), np.float32(1.0), np.float32(1.0), np.float32(1.0), np.float32(0.0), np.float32(1.0), np.float32(1.0), np.float32(1.0), np.float32(0.0), np.float32(1.0)]",-2.0,99651.0,24
2025-08-14_08-18-36,2311,"[np.float32(1.0), np.float32(0.0), np.float32(0.0), np.float32(1.0), np.float32(1.0), np.float32(0.0), np.float32(0.0), np.float32(1.0), np.float32(0.0), np.float32(0.0), np.float32(1.0), np.float32(0.0), np.float32(0.0), np.float32(1.0), np.float32(0.0), np.float32(1.0)]",-2.0,99649.0,31
2025-08-14_08-18-36,2312,"[np.float32(0.0), np.float32(0.0), np.float32(1.0), np.float32(1.0), np.float32(1.0), np.float32(1.0), np.float32(0.0), np.float32(1.0), np.float32(0.0), np.float32(0.0), np.float32(1.0), np.float32(1.0), np.float32(1.0), np.float32(1.0), np.float32(0.0), np.float32(1.0)]",0.0,99649.0,12
2025-08-14_08-18-36,2313,"[np.float32(1.0), np.float32(1.0), np.float32(0.0), np.float32(0.0), np.float32(1.0), np.float32(1.0), np.float32(1.0), np.float32(1.0), np.float32(1.0), np.float32(0.0), np.float32(1.0), np.float32(0.0), np.float32(0.0), np.float32(0.0), np.float32(0.0), np.float32(0.0)]",-1.0,99648.0,10
2025-08-14_08-18-36,2314,"[np.float32(0.0), np.float32(0.0), np.float32(0.0), np.float32(1.0), np.float32(0.0), np.float32(1.0), np.float32(1.0), np.float32(1.0), np.float32(1.0), np.float32(1.0), np.float32(1.0), np.float32(1.0), np.float32(1.0), np.float32(0.0), np.float32(1.0), np.float32(0.0)]",-2.0,99646.0,17
2025-08-14_08-18-36,2315,"[np.float32(0.0), np.float32(1.0), np.float32(1.0), np.float32(1.0), np.float32(0.0), np.float32(1.0), np.float32(0.0), np.float32(1.0), np.float32(1.0), np.float32(1.0), np.float32(1.0), np.float32(1.0), np.float32(1.0), np.float32(1.0), np.float32(1.0), np.float32(0.0)]",-2.0,99644.0,11
2025-08-14_08-18-36,2316,"[np.float32(1.0), np.float32(1.0), np.float32(0.0), np.float32(1.0), np.float32(1.0), np.float32(1.0), np.float32(0.0), np.float32(0.0), np.float32(0.0), np.float32(0.0), np.float32(1.0), np.float32(1.0), np.float32(0.0), np.float32(1.0), np.float32(1.0), np.float32(1.0)]",-1.0,99643.0,25
2025-08-14_08-18-36,2317,"[np.float32(0.0), np.float32(0.0), np.float32(0.0), np.float32(1.0), np.float32(1.0), np.float32(1.0), np.float32(1.0), np.float32(0.0), np.float32(1.0), np.float32(0.0), np.float32(0.0), np.float32(0.0), np.float32(0.0), np.float32(1.0), np.float32(0.0), np.float32(1.0)]",-2.0,99641.0,10
2025-08-14_08-18-36,2318,"[np.float32(0.0), np.float32(0.0), np.float32(1.0), np.float32(0.0), np.float32(1.0), np.float32(0.0), np.float32(0.0), np.float32(0.0), np.float32(1.0), np.float32(1.0), np.float32(1.0), np.float32(0.0), np.float32(1.0), np.float32(1.0), np.float32(0.0), np.float32(0.0)]",-5.0,99636.0,24
2025-08-14_08-18-36,2319,"[np.float32(0.0), np.float32(1.0), np.float32(1.0), np.float32(0.0), np.float32(0.0), np.float32(0.0), np.float32(0.0), np.float32(1.0), np.float32(0.0), np.float32(1.0), np.float32(0.0), np.float32(1.0), np.float32(1.0), np.float32(0.0), np.float32(1.0), np.float32(1.0)]",0.0,99636.0,34
2025-08-14_08-18-36,2320,"[np.float32(1.0), np.float32(0.0), np.float32(0.0), np.float32(0.0), np.float32(1.0), np.float32(1.0), np.float32(1.0), np.float32(1.0), np.float32(1.0), np.float32(1.0), np.float32(1.0), np.float32(1.0), np.float32(1.0), np.float32(0.0), np.float32(0.0), np.float32(0.0)]",-2.0,99634.0,29
2025-08-14_08-18-36,2321,"[np.float32(1.0), np.float32(0.0), np.float32(1.0), np.float32(0.0), np.float32(0.0), np.float32(1.0), np.float32(0.0), np.float32(0.0), np.float32(0.0), np.float32(0.0), np.float32(1.0), np.float32(1.0), np.float32(1.0), np.float32(0.0), np.float32(1.0), np.float32(0.0)]",-2.0,99632.0,2
2025-08-14_08-18-36,2322,"[np.float32(1.0), np.float32(0.0), np.float32(1.0), np.float32(0.0), np.float32(1.0), np.float32(1.0), np.float32(1.0), np.float32(0.0), np.float32(0.0), np.float32(1.0), np.float32(0.0), np.float32(0.0), np.float32(1.0), np.float32(1.0), np.float32(0.0), np.float32(1.0)]",-1.0,99631.0,31
2025-08-14_08-18-36,2323,"[np.float32(0.0), np.float32(1.0), np.float32(1.0), np.float32(1.0), np.float32(0.0), np.float32(0.0), np.float32(0.0), np.float32(0.0), np.float32(0.0), np.float32(0.0), np.float32(1.0), np.float32(1.0), np.float32(1.0), np.float32(1.0), np.float32(1.0), np.float32(0.0)]",2.0,99633.0,2
2025-08-14_08-18-36,2324,"[np.float32(0.0), np.float32(1.0), np.float32(1.0), np.float32(0.0), np.float32(0.0), np.float32(1.0), np.float32(0.0), np.float32(0.0), np.float32(1.0), np.float32(0.0), np.float32(1.0), np.float32(0.0), np.float32(1.0), np.float32(1.0), np.float32(1.0), np.float32(0.0)]",-1.0,99632.0,10
2025-08-14_08-18-36,2325,"[np.float32(1.0), np.float32(0.0), np.float32(0.0), np.float32(1.0), np.float32(0.0), np.float32(0.0), np.float32(0.0), np.float32(1.0), np.float32(1.0), np.float32(0.0), np.float32(0.0), np.float32(0.0), np.float32(1.0), np.float32(1.0), np.float32(0.0), np.float32(1.0)]",0.0,99632.0,23
2025-08-14_08-18-36,2326,"[np.float32(0.0), np.float32(0.0), np.float32(0.0), np.float32(0.0), np.float32(0.0), np.float32(0.0), np.float32(0.0), np.float32(0.0), np.float32(1.0), np.float32(1.0), np.float32(0.0), np.float32(0.0), np.float32(1.0), np.float32(1.0), np.float32(1.0), np.float32(1.0)]",0.0,99632.0,26
2025-08-14_08-18-36,2327,"[np.float32(0.0), np.float32(0.0), np.float32(0.0), np.float32(1.0), np.float32(1.0), np.float32(1.0), np.float32(0.0), np.float32(1.0), np.float32(0.0), np.float32(1.0), np.float32(0.0), np.float32(1.0), np.float32(1.0), np.float32(0.0), np.float32(0.0), np.float32(1.0)]",-6.0,99626.0,0
2025-08-14_08-18-36,2328,"[np.float32(1.0), np.float32(1.0), np.float32(1.0), np.float32(1.0), np.float32(1.0), np.float32(0.0), np.float32(1.0), np.float32(0.0), np.float32(0.0), np.float32(1.0), np.float32(1.0), np.float32(0.0), np.float32(1.0), np.float32(1.0), np.float32(0.0), np.float32(1.0)]",1.0,99627.0,17
2025-08-14_08-18-36,2329,"[np.float32(1.0), np.float32(1.0), np.float32(0.0), np.float32(0.0), np.float32(0.0), np.float32(1.0), np.float32(0.0), np.float32(1.0), np.float32(1.0), np.float32(0.0), np.float32(1.0), np.float32(0.0), np.float32(0.0), np.float32(0.0), np.float32(0.0), np.float32(0.0)]",1.0,99628.0,28
2025-08-14_08-18-36,2330,"[np.float32(1.0), np.float32(0.0), np.float32(1.0), np.float32(1.0), np.float32(0.0), np.float32(1.0), np.float32(1.0), np.float32(0.0), np.float32(0.0), np.float32(0.0), np.float32(0.0), np.float32(1.0), np.float32(1.0), np.float32(1.0), np.float32(0.0), np.float32(1.0)]",-2.0,99626.0,20
2025-08-14_08-18-36,2331,"[np.float32(1.0), np.float32(1.0), np.float32(1.0), np.float32(0.0), np.float32(0.0), np.float32(1.0), np.float32(1.0), np.float32(1.0), np.float32(1.0), np.float32(1.0), np.float32(1.0), np.float32(0.0), np.float32(0.0), np.float32(1.0), np.float32(1.0), np.float32(1.0)]",-3.0,99623.0,0
2025-08-14_08-18-36,2332,"[np.float32(1.0), np.float32(1.0), np.float32(1.0), np.float32(1.0), np.float32(1.0), np.float32(1.0), np.float32(1.0), np.float32(1.0), np.float32(0.0), np.float32(0.0), np.float32(0.0), np.float32(0.0), np.float32(0.0), np.float32(0.0), np.float32(1.0), np.float32(0.0)]",-3.0,99620.0,29
2025-08-14_08-18-36,2333,"[np.float32(1.0), np.float32(1.0), np.float32(0.0), np.float32(0.0), np.float32(1.0), np.float32(0.0), np.float32(1.0), np.float32(0.0), np.float32(1.0), np.float32(0.0), np.float32(0.0), np.float32(0.0), np.float32(0.0), np.float32(0.0), np.float32(1.0), np.float32(1.0)]",0.0,99620.0,7
2025-08-14_08-18-36,2334,"[np.float32(1.0), np.float32(0.0), np.float32(0.0), np.float32(1.0), np.float32(1.0), np.float32(1.0), np.float32(0.0), np.float32(0.0), np.float32(0.0), np.float32(0.0), np.float32(1.0), np.float32(1.0), np.float32(1.0), np.float32(1.0), np.float32(1.0), np.float32(0.0)]",1.0,99621.0,30
2025-08-14_08-18-36,2335,"[np.float32(0.0), np.float32(1.0), np.float32(0.0), np.float32(1.0), np.float32(0.0), np.float32(1.0), np.float32(1.0), np.float32(1.0), np.float32(0.0), np.float32(1.0), np.float32(0.0), np.float32(0.0), np.float32(1.0), np.float32(1.0), np.float32(1.0), np.float32(1.0)]",3.0,99624.0,13
2025-08-14_08-18-36,2336,"[np.float32(0.0), np.float32(1.0), np.float32(0.0), np.float32(1.0), np.float32(1.0), np.float32(0.0), np.float32(0.0), np.float32(1.0), np.float32(1.0), np.float32(1.0), np.float32(1.0), np.float32(0.0), np.float32(0.0), np.float32(1.0), np.float32(1.0), np.float32(0.0)]",3.0,99627.0,11
2025-08-14_08-18-36,2337,"[np.float32(0.0), np.float32(0.0), np.float32(0.0), np.float32(0.0), np.float32(1.0), np.float32(1.0), np.float32(1.0), np.float32(0.0), np.float32(0.0), np.float32(0.0), np.float32(0.0), np.float32(0.0), np.float32(1.0), np.float32(1.0), np.float32(0.0), np.float32(0.0)]",0.0,99627.0,0
2025-08-14_08-18-36,2338,"[np.float32(1.0), np.float32(0.0), np.float32(1.0), np.float32(1.0), np.float32(1.0), np.float32(1.0), np.float32(0.0), np.float32(0.0), np.float32(0.0), np.float32(0.0), np.float32(1.0), np.float32(1.0), np.float32(0.0), np.float32(1.0), np.float32(0.0), np.float32(0.0)]",-1.0,99626.0,24
2025-08-14_08-18-36,2339,"[np.float32(1.0), np.float32(1.0), np.float32(0.0), np.float32(1.0), np.float32(0.0), np.float32(1.0), np.float32(1.0), np.float32(1.0), np.float32(1.0), np.float32(1.0), np.float32(0.0), np.float32(0.0), np.float32(0.0), np.float32(1.0), np.float32(1.0), np.float32(1.0)]",2.0,99628.0,7
2025-08-14_08-18-36,2340,"[np.float32(0.0), np.float32(0.0), np.float32(1.0), np.float32(1.0), np.float32(0.0), np.float32(1.0), np.float32(1.0), np.float32(1.0), np.float32(1.0), np.float32(0.0), np.float32(1.0), np.float32(0.0), np.float32(0.0), np.float32(1.0), np.float32(1.0), np.float32(1.0)]",1.0,99629.0,17
2025-08-14_08-18-36,2341,"[np.float32(0.0), np.float32(1.0), np.float32(0.0), np.float32(1.0), np.float32(1.0), np.float32(1.0), np.float32(1.0), np.float32(1.0), np.float32(1.0), np.float32(1.0), np.float32(1.0), np.float32(1.0), np.float32(0.0), np.float32(1.0), np.float32(1.0), np.float32(0.0)]",1.0,99630.0,7
2025-08-14_08-18-36,2342,"[np.float32(1.0), np.float32(0.0), np.float32(0.0), np.float32(1.0), np.float32(0.0), np.float32(1.0), np.float32(1.0), np.float32(0.0), np.float32(1.0), np.float32(1.0), np.float32(1.0), np.float32(1.0), np.float32(1.0), np.float32(0.0), np.float32(0.0), np.float32(0.0)]",-7.0,99623.0,0
2025-08-14_08-18-36,2343,"[np.float32(0.0), np.float32(1.0), np.float32(0.0), np.float32(0.0), np.float32(1.0), np.float32(1.0), np.float32(0.0), np.float32(1.0), np.float32(0.0), np.float32(0.0), np.float32(1.0), np.float32(1.0), np.float32(1.0), np.float32(0.0), np.float32(0.0), np.float32(1.0)]",-3.0,99620.0,30
2025-08-14_08-18-36,2344,"[np.float32(0.0), np.float32(1.0), np.float32(0.0), np.float32(0.0), np.float32(0.0), np.float32(0.0), np.float32(1.0), np.float32(0.0), np.float32(1.0), np.float32(1.0), np.float32(1.0), np.float32(1.0), np.float32(0.0), np.float32(0.0), np.float32(0.0), np.float32(0.0)]",2.0,99622.0,35
2025-08-14_08-18-36,2345,"[np.float32(0.0), np.float32(0.0), np.float32(1.0), np.float32(1.0), np.float32(0.0), np.float32(0.0), np.float32(0.0), np.float32(1.0), np.float32(0.0), np.float32(0.0), np.float32(0.0), np.float32(0.0), np.float32(0.0), np.float32(1.0), np.float32(1.0), np.float32(0.0)]",-3.0,99619.0,6
2025-08-14_08-18-36,2346,"[np.float32(0.0), np.float32(0.0), np.float32(1.0), np.float32(1.0), np.float32(0.0), np.float32(1.0), np.float32(1.0), np.float32(1.0), np.float32(1.0), np.float32(0.0), np.float32(1.0), np.float32(1.0), np.float32(0.0), np.float32(1.0), np.float32(1.0), np.float32(0.0)]",3.0,99622.0,29
2025-08-14_08-18-36,2347,"[np.float32(1.0), np.float32(0.0), np.float32(1.0), np.float32(1.0), np.float32(0.0), np.float32(0.0), np.float32(1.0), np.float32(1.0), np.float32(1.0), np.float32(0.0), np.float32(0.0), np.float32(1.0), np.float32(0.0), np.float32(0.0), np.float32(1.0), np.float32(0.0)]",0.0,99622.0,6
2025-08-14_08-18-36,2348,"[np.float32(0.0), np.float32(0.0), np.float32(0.0), np.float32(1.0), np.float32(1.0), np.float32(0.0), np.float32(1.0), np.float32(0.0), np.float32(0.0), np.float32(0.0), np.float32(0.0), np.float32(1.0), np.float32(0.0), np.float32(1.0), np.float32(0.0), np.float32(0.0)]",-1.0,99621.0,17
2025-08-14_08-18-36,2349,"[np.float32(0.0), np.float32(0.0), np.float32(1.0), np.float32(0.0), np.float32(1.0), np.float32(0.0), np.float32(1.0), np.float32(1.0), np.float32(1.0), np.float32(1.0), np.float32(0.0), np.float32(1.0), np.float32(1.0), np.float32(0.0), np.float32(0.0), np.float32(0.0)]",-3.0,99618.0,26
2025-08-14_08-18-36,2350,"[np.float32(1.0), np.float32(0.0), np.float32(1.0), np.float32(0.0), np.float32(1.0), np.float32(0.0), np.float32(1.0), np.float32(1.0), np.float32(1.0), np.float32(1.0), np.float32(0.0), np.float32(0.0), np.float32(0.0), np.float32(1.0), np.float32(0.0), np.float32(0.0)]",3.0,99621.0,28
2025-08-14_08-18-36,2351,"[np.float32(0.0), np.float32(0.0), np.float32(0.0), np.float32(1.0), np.float32(1.0), np.float32(0.0), np.float32(0.0), np.float32(1.0), np.float32(0.0), np.float32(1.0), np.float32(1.0), np.float32(1.0), np.float32(0.0), np.float32(1.0), np.float32(0.0), np.float32(0.0)]",1.0,99622.0,23
2025-08-14_08-18-36,2352,"[np.float32(1.0), np.float32(1.0), np.float32(1.0), np.float32(0.0), np.float32(1.0), np.float32(0.0), np.float32(1.0), np.float32(0.0), np.float32(1.0), np.float32(1.0), np.float32(0.0), np.float32(1.0), np.float32(1.0), np.float32(1.0), np.float32(0.0), np.float32(0.0)]",5.0,99627.0,4
2025-08-14_08-18-36,2353,"[np.float32(1.0), np.float32(1.0), np.float32(0.0), np.float32(0.0), np.float32(1.0), np.float32(0.0), np.float32(0.0), np.float32(1.0), np.float32(0.0), np.float32(0.0), np.float32(1.0), np.float32(1.0), np.float32(0.0), np.float32(1.0), np.float32(1.0), np.float32(0.0)]",3.0,99630.0,21
2025-08-14_08-18-36,2354,"[np.float32(1.0), np.float32(0.0), np.float32(0.0), np.float32(1.0), np.float32(0.0), np.float32(1.0), np.float32(0.0), np.float32(0.0), np.float32(0.0), np.float32(0.0), np.float32(0.0), np.float32(1.0), np.float32(0.0), np.float32(1.0), np.float32(0.0), np.float32(0.0)]",1.0,99631.0,23
2025-08-14_08-18-36,2355,"[np.float32(0.0), np.float32(1.0), np.float32(0.0), np.float32(0.0), np.float32(0.0), np.float32(1.0), np.float32(0.0), np.float32(0.0), np.float32(1.0), np.float32(0.0), np.float32(0.0), np.float32(0.0), np.float32(0.0), np.float32(1.0), np.float32(1.0), np.float32(0.0)]",0.0,99631.0,4
2025-08-14_08-18-36,2356,"[np.float32(1.0), np.float32(0.0), np.float32(1.0), np.float32(1.0), np.float32(0.0), np.float32(0.0), np.float32(1.0), np.float32(1.0), np.float32(1.0), np.float32(0.0), np.float32(0.0), np.float32(1.0), np.float32(1.0), np.float32(0.0), np.float32(1.0), np.float32(1.0)]",3.0,99634.0,27
2025-08-14_08-18-36,2357,"[np.float32(0.0), np.float32(1.0), np.float32(0.0), np.float32(0.0), np.float32(0.0), np.float32(0.0), np.float32(0.0), np.float32(1.0), np.float32(0.0), np.float32(1.0), np.float32(1.0), np.float32(0.0), np.float32(1.0), np.float32(0.0), np.float32(0.0), np.float32(1.0)]",5.0,99639.0,20
2025-08-14_08-18-36,2358,"[np.float32(1.0), np.float32(0.0), np.float32(1.0), np.float32(1.0), np.float32(1.0), np.float32(0.0), np.float32(0.0), np.float32(0.0), np.float32(1.0), np.float32(1.0), np.float32(1.0), np.float32(1.0), np.float32(0.0), np.float32(0.0), np.float32(0.0), np.float32(0.0)]",0.0,99639.0,28
2025-08-14_08-18-36,2359,"[np.float32(1.0), np.float32(0.0), np.float32(0.0), np.float32(1.0), np.float32(0.0), np.float32(0.0), np.float32(1.0), np.float32(1.0), np.float32(0.0), np.float32(0.0), np.float32(0.0), np.float32(1.0), np.float32(0.0), np.float32(1.0), np.float32(0.0), np.float32(0.0)]",-4.0,99635.0,34
2025-08-14_08-18-36,2360,"[np.float32(1.0), np.float32(1.0), np.float32(0.0), np.float32(1.0), np.float32(1.0), np.float32(0.0), np.float32(0.0), np.float32(0.0), np.float32(1.0), np.float32(1.0), np.float32(0.0), np.float32(0.0), np.float32(1.0), np.float32(0.0), np.float32(0.0), np.float32(1.0)]",-1.0,99634.0,19
2025-08-14_08-18-36,2361,"[np.float32(1.0), np.float32(1.0), np.float32(0.0), np.float32(1.0), np.float32(0.0), np.float32(0.0), np.float32(0.0), np.float32(1.0), np.float32(0.0), np.float32(0.0), np.float32(0.0), np.float32(1.0), np.float32(1.0), np.float32(1.0), np.float32(0.0), np.float32(1.0)]",-3.0,99631.0,26
2025-08-14_08-18-36,2362,"[np.float32(0.0), np.float32(0.0), np.float32(0.0), np.float32(1.0), np.float32(0.0), np.float32(0.0), np.float32(0.0), np.float32(1.0), np.float32(1.0), np.float32(1.0), np.float32(1.0), np.float32(0.0), np.float32(1.0), np.float32(0.0), np.float32(1.0), np.float32(0.0)]",1.0,99632.0,19
2025-08-14_08-18-36,2363,"[np.float32(0.0), np.float32(0.0), np.float32(1.0), np.float32(1.0), np.float32(0.0), np.float32(1.0), np.float32(1.0), np.float32(1.0), np.float32(1.0), np.float32(1.0), np.float32(1.0), np.float32(0.0), np.float32(0.0), np.float32(0.0), np.float32(0.0), np.float32(0.0)]",0.0,99632.0,17
2025-08-14_08-18-36,2364,"[np.float32(0.0), np.float32(0.0), np.float32(1.0), np.float32(0.0), np.float32(0.0), np.float32(1.0), np.float32(1.0), np.float32(0.0), np.float32(1.0), np.float32(0.0), np.float32(0.0), np.float32(1.0), np.float32(0.0), np.float32(0.0), np.float32(0.0), np.float32(0.0)]",0.0,99632.0,2
2025-08-14_08-18-36,2365,"[np.float32(1.0), np.float32(0.0), np.float32(1.0), np.float32(0.0), np.float32(0.0), np.float32(0.0), np.float32(0.0), np.float32(1.0), np.float32(0.0), np.float32(1.0), np.float32(0.0), np.float32(0.0), np.float32(1.0), np.float32(1.0), np.float32(1.0), np.float32(0.0)]",-2.0,99630.0,27
2025-08-14_08-18-36,2366,"[np.float32(1.0), np.float32(1.0), np.float32(0.0), np.float32(1.0), np.float32(1.0), np.float32(1.0), np.float32(0.0), np.float32(1.0), np.float32(1.0), np.float32(0.0), np.float32(1.0), np.float32(0.0), np.float32(1.0), np.float32(1.0), np.float32(0.0), np.float32(1.0)]",-4.0,99626.0,8
2025-08-14_08-18-36,2367,"[np.float32(1.0), np.float32(1.0), np.float32(1.0), np.float32(1.0), np.float32(0.0), np.float32(1.0), np.float32(0.0), np.float32(1.0), np.float32(1.0), np.float32(1.0), np.float32(1.0), np.float32(1.0), np.float32(1.0), np.float32(0.0), np.float32(1.0), np.float32(0.0)]",-5.0,99621.0,12
2025-08-14_08-18-36,2368,"[np.float32(1.0), np.float32(0.0), np.float32(1.0), np.float32(1.0), np.float32(0.0), np.float32(0.0), np.float32(1.0), np.float32(1.0), np.float32(1.0), np.float32(0.0), np.float32(0.0), np.float32(1.0), np.float32(1.0), np.float32(0.0), np.float32(1.0), np.float32(1.0)]",-5.0,99616.0,35
2025-08-14_08-18-36,2369,"[np.float32(0.0), np.float32(0.0), np.float32(0.0), np.float32(0.0), np.float32(0.0), np.float32(1.0), np.float32(0.0), np.float32(0.0), np.float32(1.0), np.float32(0.0), np.float32(1.0), np.float32(0.0), np.float32(0.0), np.float32(0.0), np.float32(1.0), np.float32(1.0)]",3.0,99619.0,33
2025-08-14_08-18-36,2370,"[np.float32(1.0), np.float32(0.0), np.float32(1.0), np.float32(1.0), np.float32(1.0), np.float32(0.0), np.float32(1.0), np.float32(1.0), np.float32(0.0), np.float32(1.0), np.float32(0.0), np.float32(0.0), np.float32(0.0), np.float32(1.0), np.float32(0.0), np.float32(0.0)]",4.0,99623.0,3
2025-08-14_08-18-36,2371,"[np.float32(0.0), np.float32(0.0), np.float32(0.0), np.float32(1.0), np.float32(0.0), np.float32(0.0), np.float32(0.0), np.float32(0.0), np.float32(0.0), np.float32(0.0), np.float32(0.0), np.float32(0.0), np.float32(0.0), np.float32(0.0), np.float32(1.0), np.float32(1.0)]",0.0,99623.0,34
2025-08-14_08-18-36,2372,"[np.float32(1.0), np.float32(0.0), np.float32(0.0), np.float32(0.0), np.float32(1.0), np.float32(0.0), np.float32(1.0), np.float32(0.0), np.float32(1.0), np.float32(0.0), np.float32(1.0), np.float32(0.0), np.float32(1.0), np.float32(0.0), np.float32(1.0), np.float32(0.0)]",0.0,99623.0,3
2025-08-14_08-18-36,2373,"[np.float32(0.0), np.float32(0.0), np.float32(0.0), np.float32(0.0), np.float32(0.0), np.float32(0.0), np.float32(0.0), np.float32(1.0), np.float32(0.0), np.float32(0.0), np.float32(1.0), np.float32(1.0), np.float32(0.0), np.float32(0.0), np.float32(0.0), np.float32(1.0)]",-1.0,99622.0,27
2025-08-14_08-18-36,2374,"[np.float32(0.0), np.float32(0.0), np.float32(0.0), np.float32(0.0), np.float32(0.0), np.float32(0.0), np.float32(0.0), np.float32(0.0), np.float32(0.0), np.float32(1.0), np.float32(0.0), np.float32(0.0), np.float32(0.0), np.float32(1.0), np.float32(1.0), np.float32(1.0)]",-1.0,99621.0,3
2025-08-14_08-18-36,2375,"[np.float32(1.0), np.float32(1.0), np.float32(0.0), np.float32(0.0), np.float32(0.0), np.float32(1.0), np.float32(1.0), np.float32(1.0), np.float32(0.0), np.float32(0.0), np.float32(0.0), np.float32(0.0), np.float32(1.0), np.float32(1.0), np.float32(1.0), np.float32(0.0)]",-4.0,99617.0,34
2025-08-14_08-18-36,2376,"[np.float32(1.0), np.float32(0.0), np.float32(1.0), np.float32(1.0), np.float32(1.0), np.float32(0.0), np.float32(1.0), np.float32(1.0), np.float32(0.0), np.float32(0.0), np.float32(1.0), np.float32(1.0), np.float32(1.0), np.float32(1.0), np.float32(0.0), np.float32(1.0)]",2.0,99619.0,2
2025-08-14_08-18-36,2377,"[np.float32(0.0), np.float32(1.0), np.float32(1.0), np.float32(1.0), np.float32(0.0), np.float32(0.0), np.float32(0.0), np.float32(1.0), np.float32(0.0), np.float32(1.0), np.float32(0.0), np.float32(1.0), np.float32(1.0), np.float32(0.0), np.float32(0.0), np.float32(1.0)]",-6.0,99613.0,5
2025-08-14_08-18-36,2378,"[np.float32(0.0), np.float32(0.0), np.float32(0.0), np.float32(1.0), np.float32(1.0), np.float32(0.0), np.float32(1.0), np.float32(1.0), np.float32(1.0), np.float32(0.0), np.float32(0.0), np.float32(1.0), np.float32(1.0), np.float32(1.0), np.float32(0.0), np.float32(0.0)]",0.0,99613.0,4
2025-08-14_08-18-36,2379,"[np.float32(1.0), np.float32(1.0), np.float32(1.0), np.float32(1.0), np.float32(0.0), np.float32(0.0), np.float32(1.0), np.float32(1.0), np.float32(0.0), np.float32(1.0), np.float32(1.0), np.float32(0.0), np.float32(1.0), np.float32(1.0), np.float32(0.0), np.float32(1.0)]",-1.0,99612.0,12
2025-08-14_08-18-36,2380,"[np.float32(0.0), np.float32(1.0), np.float32(1.0), np.float32(1.0), np.float32(1.0), np.float32(0.0), np.float32(0.0), np.float32(1.0), np.float32(1.0), np.float32(0.0), np.float32(0.0), np.float32(0.0), np.float32(1.0), np.float32(1.0), np.float32(0.0), np.float32(0.0)]",0.0,99612.0,21
2025-08-14_08-18-36,2381,"[np.float32(1.0), np.float32(0.0), np.float32(0.0), np.float32(0.0), np.float32(1.0), np.float32(0.0), np.float32(1.0), np.float32(0.0), np.float32(0.0), np.float32(1.0), np.float32(1.0), np.float32(1.0), np.float32(0.0), np.float32(1.0), np.float32(1.0), np.float32(0.0)]",3.0,99615.0,10
2025-08-14_08-18-36,2382,"[np.float32(0.0), np.float32(1.0), np.float32(0.0), np.float32(0.0), np.float32(0.0), np.float32(1.0), np.float32(1.0), np.float32(1.0), np.float32(0.0), np.float32(1.0), np.float32(1.0), np.float32(1.0), np.float32(0.0), np.float32(0.0), np.float32(0.0), np.float32(0.0)]",-2.0,99613.0,36
2025-08-14_08-18-36,2383,"[np.float32(1.0), np.float32(0.0), np.float32(1.0), np.float32(1.0), np.float32(1.0), np.float32(0.0), np.float32(1.0), np.float32(0.0), np.float32(1.0), np.float32(0.0), np.float32(0.0), np.float32(1.0), np.float32(0.0), np.float32(0.0), np.float32(0.0), np.float32(1.0)]",4.0,99617.0,1
2025-08-14_08-18-36,2384,"[np.float32(1.0), np.float32(1.0), np.float32(0.0), np.float32(1.0), np.float32(1.0), np.float32(0.0), np.float32(0.0), np.float32(1.0), np.float32(0.0), np.float32(1.0), np.float32(0.0), np.float32(1.0), np.float32(1.0), np.float32(0.0), np.float32(0.0), np.float32(0.0)]",37.0,99654.0,7
2025-08-14_08-18-36,2385,"[np.float32(1.0), np.float32(1.0), np.float32(1.0), np.float32(1.0), np.float32(0.0), np.float32(1.0), np.float32(1.0), np.float32(1.0), np.float32(0.0), np.float32(1.0), np.float32(0.0), np.float32(0.0), np.float32(1.0), np.float32(1.0), np.float32(1.0), np.float32(1.0)]",-2.0,99652.0,12
2025-08-14_08-18-36,2386,"[np.float32(0.0), np.float32(0.0), np.float32(1.0), np.float32(0.0), np.float32(0.0), np.float32(1.0), np.float32(0.0), np.float32(0.0), np.float32(0.0), np.float32(1.0), np.float32(0.0), np.float32(0.0), np.float32(1.0), np.float32(0.0), np.float32(0.0), np.float32(1.0)]",-2.0,99650.0,13
2025-08-14_08-18-36,2387,"[np.float32(0.0), np.float32(0.0), np.float32(1.0), np.float32(0.0), np.float32(0.0), np.float32(1.0), np.float32(0.0), np.float32(0.0), np.float32(0.0), np.float32(1.0), np.float32(1.0), np.float32(1.0), np.float32(0.0), np.float32(0.0), np.float32(1.0), np.float32(0.0)]",-3.0,99647.0,7
2025-08-14_08-18-36,2388,"[np.float32(0.0), np.float32(0.0), np.float32(1.0), np.float32(1.0), np.float32(0.0), np.float32(1.0), np.float32(1.0), np.float32(0.0), np.float32(0.0), np.float32(0.0), np.float32(0.0), np.float32(1.0), np.float32(1.0), np.float32(1.0), np.float32(0.0), np.float32(1.0)]",-6.0,99641.0,16
2025-08-14_08-18-36,2389,"[np.float32(0.0), np.float32(0.0), np.float32(1.0), np.float32(0.0), np.float32(1.0), np.float32(0.0), np.float32(0.0), np.float32(1.0), np.float32(0.0), np.float32(0.0), np.float32(0.0), np.float32(1.0), np.float32(1.0), np.float32(1.0), np.float32(0.0), np.float32(0.0)]",-4.0,99637.0,1
2025-08-14_08-18-36,2390,"[np.float32(0.0), np.float32(1.0), np.float32(0.0), np.float32(1.0), np.float32(0.0), np.float32(1.0), np.float32(0.0), np.float32(1.0), np.float32(0.0), np.float32(1.0), np.float32(0.0), np.float32(1.0), np.float32(1.0), np.float32(1.0), np.float32(0.0), np.float32(0.0)]",0.0,99637.0,3
2025-08-14_08-18-36,2391,"[np.float32(0.0), np.float32(1.0), np.float32(0.0), np.float32(0.0), np.float32(1.0), np.float32(1.0), np.float32(0.0), np.float32(1.0), np.float32(1.0), np.float32(1.0), np.float32(0.0), np.float32(1.0), np.float32(0.0), np.float32(0.0), np.float32(1.0), np.float32(0.0)]",-1.0,99636.0,26
2025-08-14_08-18-36,2392,"[np.float32(0.0), np.float32(0.0), np.float32(1.0), np.float32(1.0), np.float32(0.0), np.float32(0.0), np.float32(1.0), np.float32(1.0), np.float32(0.0), np.float32(1.0), np.float32(0.0), np.float32(0.0), np.float32(1.0), np.float32(1.0), np.float32(1.0), np.float32(0.0)]",3.0,99639.0,13
2025-08-14_08-18-36,2393,"[np.float32(1.0), np.float32(1.0), np.float32(0.0), np.float32(1.0), np.float32(1.0), np.float32(0.0), np.float32(0.0), np.float32(0.0), np.float32(0.0), np.float32(1.0), np.float32(1.0), np.float32(1.0), np.float32(1.0), np.float32(1.0), np.float32(0.0), np.float32(1.0)]",-3.0,99636.0,23
2025-08-14_08-18-36,2394,"[np.float32(0.0), np.float32(0.0), np.float32(1.0), np.float32(0.0), np.float32(0.0), np.float32(1.0), np.float32(0.0), np.float32(1.0), np.float32(1.0), np.float32(1.0), np.float32(1.0), np.float32(1.0), np.float32(0.0), np.float32(0.0), np.float32(0.0), np.float32(0.0)]",1.0,99637.0,16
2025-08-14_08-18-36,2395,"[np.float32(0.0), np.float32(1.0), np.float32(0.0), np.float32(1.0), np.float32(0.0), np.float32(0.0), np.float32(0.0), np.float32(0.0), np.float32(0.0), np.float32(1.0), np.float32(1.0), np.float32(1.0), np.float32(0.0), np.float32(0.0), np.float32(1.0), np.float32(0.0)]",-1.0,99636.0,7
2025-08-14_08-18-36,2396,"[np.float32(0.0), np.float32(1.0), np.float32(1.0), np.float32(0.0), np.float32(1.0), np.float32(1.0), np.float32(1.0), np.float32(0.0), np.float32(1.0), np.float32(1.0), np.float32(0.0), np.float32(0.0), np.float32(1.0), np.float32(1.0), np.float32(0.0), np.float32(1.0)]",2.0,99638.0,10
2025-08-14_08-18-36,2397,"[np.float32(0.0), np.float32(1.0), np.float32(1.0), np.float32(0.0), np.float32(0.0), np.float32(0.0), np.float32(0.0), np.float32(1.0), np.float32(1.0), np.float32(1.0), np.float32(1.0), np.float32(1.0), np.float32(0.0), np.float32(1.0), np.float32(1.0), np.float32(1.0)]",1.0,99639.0,32
2025-08-14_08-18-36,2398,"[np.float32(0.0), np.float32(1.0), np.float32(0.0), np.float32(0.0), np.float32(0.0), np.float32(1.0), np.float32(0.0), np.float32(1.0), np.float32(1.0), np.float32(0.0), np.float32(0.0), np.float32(0.0), np.float32(1.0), np.float32(1.0), np.float32(1.0), np.float32(1.0)]",-5.0,99634.0,3
2025-08-14_08-18-36,2399,"[np.float32(1.0), np.float32(1.0), np.float32(1.0), np.float32(1.0), np.float32(0.0), np.float32(0.0), np.float32(0.0), np.float32(1.0), np.float32(0.0), np.float32(0.0), np.float32(0.0), np.float32(0.0), np.float32(0.0), np.float32(0.0), np.float32(1.0), np.float32(0.0)]",-2.0,99632.0,0
2025-08-14_08-18-36,2400,"[np.float32(1.0), np.float32(1.0), np.float32(1.0), np.float32(0.0), np.float32(0.0), np.float32(0.0), np.float32(1.0), np.float32(1.0), np.float32(1.0), np.float32(0.0), np.float32(0.0), np.float32(0.0), np.float32(1.0), np.float32(0.0), np.float32(0.0), np.float32(1.0)]",2.0,99634.0,20
2025-08-14_08-18-36,2401,"[np.float32(1.0), np.float32(1.0), np.float32(0.0), np.float32(0.0), np.float32(1.0), np.float32(1.0), np.float32(1.0), np.float32(0.0), np.float32(1.0), np.float32(1.0), np.float32(0.0), np.float32(1.0), np.float32(1.0), np.float32(1.0), np.float32(0.0), np.float32(1.0)]",2.0,99636.0,34
2025-08-14_08-18-36,2402,"[np.float32(1.0), np.float32(0.0), np.float32(0.0), np.float32(0.0), np.float32(0.0), np.float32(0.0), np.float32(0.0), np.float32(1.0), np.float32(0.0), np.float32(1.0), np.float32(1.0), np.float32(0.0), np.float32(1.0), np.float32(0.0), np.float32(0.0), np.float32(0.0)]",-2.0,99634.0,28
2025-08-14_08-18-36,2403,"[np.float32(1.0), np.float32(1.0), np.float32(0.0), np.float32(0.0), np.float32(0.0), np.float32(1.0), np.float32(0.0), np.float32(0.0), np.float32(1.0), np.float32(1.0), np.float32(1.0), np.float32(1.0), np.float32(1.0), np.float32(0.0), np.float32(0.0), np.float32(0.0)]",-1.0,99633.0,23
2025-08-14_08-18-36,2404,"[np.float32(0.0), np.float32(0.0), np.float32(0.0), np.float32(1.0), np.float32(0.0), np.float32(0.0), np.float32(1.0), np.float32(1.0), np.float32(1.0), np.float32(0.0), np.float32(1.0), np.float32(0.0), np.float32(1.0), np.float32(1.0), np.float32(0.0), np.float32(0.0)]",-1.0,99632.0,14
2025-08-14_08-18-36,2405,"[np.float32(1.0), np.float32(1.0), np.float32(0.0), np.float32(0.0), np.float32(1.0), np.float32(0.0), np.float32(0.0), np.float32(0.0), np.float32(1.0), np.float32(1.0), np.float32(1.0), np.float32(0.0), np.float32(0.0), np.float32(1.0), np.float32(1.0), np.float32(0.0)]",3.0,99635.0,35
2025-08-14_08-18-36,2406,"[np.float32(1.0), np.float32(0.0), np.float32(1.0), np.float32(0.0), np.float32(1.0), np.float32(1.0), np.float32(1.0), np.float32(0.0), np.float32(0.0), np.float32(0.0), np.float32(1.0), np.float32(0.0), np.float32(0.0), np.float32(1.0), np.float32(0.0), np.float32(0.0)]",-5.0,99630.0,31
2025-08-14_08-18-36,2407,"[np.float32(0.0), np.float32(1.0), np.float32(0.0), np.float32(1.0), np.float32(1.0), np.float32(0.0), np.float32(0.0), np.float32(0.0), np.float32(0.0), np.float32(1.0), np.float32(1.0), np.float32(1.0), np.float32(1.0), np.float32(1.0), np.float32(1.0), np.float32(1.0)]",-2.0,99628.0,14
2025-08-14_08-18-36,2408,"[np.float32(0.0), np.float32(0.0), np.float32(1.0), np.float32(1.0), np.float32(1.0), np.float32(0.0), np.float32(1.0), np.float32(0.0), np.float32(1.0), np.float32(0.0), np.float32(1.0), np.float32(0.0), np.float32(0.0), np.float32(0.0), np.float32(0.0), np.float32(1.0)]",0.0,99628.0,10
2025-08-14_08-18-36,2409,"[np.float32(0.0), np.float32(1.0), np.float32(1.0), np.float32(0.0), np.float32(1.0), np.float32(1.0), np.float32(0.0), np.float32(1.0), np.float32(0.0), np.float32(1.0), np.float32(1.0), np.float32(1.0), np.float32(0.0), np.float32(1.0), np.float32(1.0), np.float32(0.0)]",1.0,99629.0,21
2025-08-14_08-18-36,2410,"[np.float32(1.0), np.float32(0.0), np.float32(0.0), np.float32(0.0), np.float32(0.0), np.float32(1.0), np.float32(0.0), np.float32(0.0), np.float32(1.0), np.float32(0.0), np.float32(0.0), np.float32(1.0), np.float32(0.0), np.float32(0.0), np.float32(1.0), np.float32(1.0)]",-4.0,99625.0,7
2025-08-14_08-18-36,2411,"[np.float32(1.0), np.float32(0.0), np.float32(0.0), np.float32(0.0), np.float32(1.0), np.float32(0.0), np.float32(0.0), np.float32(0.0), np.float32(1.0), np.float32(1.0), np.float32(1.0), np.float32(0.0), np.float32(1.0), np.float32(0.0), np.float32(1.0), np.float32(1.0)]",-4.0,99621.0,3
2025-08-14_08-18-36,2412,"[np.float32(1.0), np.float32(0.0), np.float32(0.0), np.float32(0.0), np.float32(0.0), np.float32(1.0), np.float32(0.0), np.float32(0.0), np.float32(1.0), np.float32(1.0), np.float32(1.0), np.float32(1.0), np.float32(1.0), np.float32(0.0), np.float32(0.0), np.float32(0.0)]",0.0,99621.0,23
2025-08-14_08-18-36,2413,"[np.float32(0.0), np.float32(0.0), np.float32(0.0), np.float32(1.0), np.float32(0.0), np.float32(1.0), np.float32(1.0), np.float32(0.0), np.float32(0.0), np.float32(1.0), np.float32(0.0), np.float32(1.0), np.float32(0.0), np.float32(1.0), np.float32(1.0), np.float32(1.0)]",2.0,99623.0,31
2025-08-14_08-18-36,2414,"[np.float32(1.0), np.float32(0.0), np.float32(1.0), np.float32(0.0), np.float32(0.0), np.float32(1.0), np.float32(0.0), np.float32(0.0), np.float32(1.0), np.float32(0.0), np.float32(1.0), np.float32(0.0), np.float32(1.0), np.float32(0.0), np.float32(1.0), np.float32(0.0)]",31.0,99654.0,7
2025-08-14_08-18-36,2415,"[np.float32(1.0), np.float32(0.0), np.float32(0.0), np.float32(0.0), np.float32(1.0), np.float32(0.0), np.float32(0.0), np.float32(1.0), np.float32(1.0), np.float32(1.0), np.float32(0.0), np.float32(0.0), np.float32(0.0), np.float32(0.0), np.float32(0.0), np.float32(1.0)]",-3.0,99651.0,35
2025-08-14_08-18-36,2416,"[np.float32(0.0), np.float32(1.0), np.float32(1.0), np.float32(1.0), np.float32(1.0), np.float32(1.0), np.float32(0.0), np.float32(0.0), np.float32(1.0), np.float32(1.0), np.float32(0.0), np.float32(1.0), np.float32(0.0), np.float32(1.0), np.float32(0.0), np.float32(0.0)]",0.0,99651.0,24
2025-08-14_08-18-36,2417,"[np.float32(0.0), np.float32(0.0), np.float32(0.0), np.float32(0.0), np.float32(0.0), np.float32(1.0), np.float32(0.0), np.float32(0.0), np.float32(1.0), np.float32(1.0), np.float32(0.0), np.float32(0.0), np.float32(1.0), np.float32(1.0), np.float32(0.0), np.float32(0.0)]",3.0,99654.0,35
2025-08-14_08-18-36,2418,"[np.float32(1.0), np.float32(0.0), np.float32(1.0), np.float32(1.0), np.float32(0.0), np.float32(1.0), np.float32(0.0), np.float32(1.0), np.float32(0.0), np.float32(0.0), np.float32(0.0), np.float32(1.0), np.float32(0.0), np.float32(1.0), np.float32(1.0), np.float32(0.0)]",-3.0,99651.0,17
2025-08-14_08-18-36,2419,"[np.float32(1.0), np.float32(0.0), np.float32(1.0), np.float32(1.0), np.float32(1.0), np.float32(0.0), np.float32(0.0), np.float32(0.0), np.float32(1.0), np.float32(1.0), np.float32(0.0), np.float32(1.0), np.float32(1.0), np.float32(0.0), np.float32(1.0), np.float32(0.0)]",-2.0,99649.0,8
2025-08-14_08-18-36,2420,"[np.float32(0.0), np.float32(0.0), np.float32(1.0), np.float32(0.0), np.float32(1.0), np.float32(0.0), np.float32(0.0), np.float32(0.0), np.float32(1.0), np.float32(0.0), np.float32(0.0), np.float32(0.0), np.float32(1.0), np.float32(0.0), np.float32(0.0), np.float32(0.0)]",-1.0,99648.0,25
2025-08-14_08-18-36,2421,"[np.float32(0.0), np.float32(1.0), np.float32(1.0), np.float32(1.0), np.float32(0.0), np.float32(0.0), np.float32(0.0), np.float32(0.0), np.float32(1.0), np.float32(1.0), np.float32(0.0), np.float32(0.0), np.float32(1.0), np.float32(1.0), np.float32(1.0), np.float32(0.0)]",2.0,99650.0,4
2025-08-14_08-18-36,2422,"[np.float32(1.0), np.float32(0.0), np.float32(1.0), np.float32(0.0), np.float32(1.0), np.float32(1.0), np.float32(1.0), np.float32(1.0), np.float32(1.0), np.float32(0.0), np.float32(0.0), np.float32(1.0), np.float32(0.0), np.float32(0.0), np.float32(0.0), np.float32(1.0)]",-2.0,99648.0,26
2025-08-14_08-18-36,2423,"[np.float32(1.0), np.float32(1.0), np.float32(1.0), np.float32(1.0), np.float32(0.0), np.float32(0.0), np.float32(1.0), np.float32(1.0), np.float32(0.0), np.float32(1.0), np.float32(1.0), np.float32(0.0), np.float32(1.0), np.float32(1.0), np.float32(0.0), np.float32(1.0)]",-1.0,99647.0,29
2025-08-14_08-18-36,2424,"[np.float32(1.0), np.float32(0.0), np.float32(0.0), np.float32(1.0), np.float32(1.0), np.float32(1.0), np.float32(0.0), np.float32(0.0), np.float32(0.0), np.float32(0.0), np.float32(1.0), np.float32(1.0), np.float32(1.0), np.float32(1.0), np.float32(0.0), np.float32(0.0)]",2.0,99649.0,15
2025-08-14_08-18-36,2425,"[np.float32(0.0), np.float32(0.0), np.float32(1.0), np.float32(1.0), np.float32(0.0), np.float32(1.0), np.float32(0.0), np.float32(0.0), np.float32(0.0), np.float32(1.0), np.float32(1.0), np.float32(0.0), np.float32(1.0), np.float32(1.0), np.float32(1.0), np.float32(0.0)]",-6.0,99643.0,9
2025-08-14_08-18-36,2426,"[np.float32(1.0), np.float32(0.0), np.float32(0.0), np.float32(0.0), np.float32(1.0), np.float32(0.0), np.float32(0.0), np.float32(0.0), np.float32(0.0), np.float32(0.0), np.float32(0.0), np.float32(0.0), np.float32(0.0), np.float32(0.0), np.float32(0.0), np.float32(0.0)]",0.0,99643.0,10
2025-08-14_08-18-36,2427,"[np.float32(1.0), np.float32(0.0), np.float32(0.0), np.float32(1.0), np.float32(1.0), np.float32(1.0), np.float32(0.0), np.float32(1.0), np.float32(0.0), np.float32(1.0), np.float32(0.0), np.float32(0.0), np.float32(0.0), np.float32(0.0), np.float32(0.0), np.float32(0.0)]",-4.0,99639.0,8
2025-08-14_08-18-36,2428,"[np.float32(0.0), np.float32(0.0), np.float32(0.0), np.float32(1.0), np.float32(0.0), np.float32(1.0), np.float32(1.0), np.float32(1.0), np.float32(0.0), np.float32(1.0), np.float32(1.0), np.float32(1.0), np.float32(0.0), np.float32(0.0), np.float32(0.0), np.float32(1.0)]",-3.0,99636.0,30
2025-08-14_08-18-36,2429,"[np.float32(0.0), np.float32(0.0), np.float32(0.0), np.float32(0.0), np.float32(1.0), np.float32(0.0), np.float32(1.0), np.float32(0.0), np.float32(1.0), np.float32(0.0), np.float32(0.0), np.float32(1.0), np.float32(0.0), np.float32(0.0), np.float32(0.0), np.float32(1.0)]",-2.0,99634.0,32
2025-08-14_08-18-36,2430,"[np.float32(1.0), np.float32(0.0), np.float32(1.0), np.float32(0.0), np.float32(1.0), np.float32(1.0), np.float32(0.0), np.float32(0.0), np.float32(0.0), np.float32(1.0), np.float32(1.0), np.float32(0.0), np.float32(1.0), np.float32(0.0), np.float32(1.0), np.float32(0.0)]",-4.0,99630.0,0
2025-08-14_08-18-36,2431,"[np.float32(0.0), np.float32(0.0), np.float32(0.0), np.float32(1.0), np.float32(0.0), np.float32(1.0), np.float32(0.0), np.float32(1.0), np.float32(1.0), np.float32(1.0), np.float32(0.0), np.float32(0.0), np.float32(0.0), np.float32(1.0), np.float32(1.0), np.float32(0.0)]",1.0,99631.0,30
2025-08-14_08-18-36,2432,"[np.float32(1.0), np.float32(0.0), np.float32(0.0), np.float32(1.0), np.float32(0.0), np.float32(0.0), np.float32(0.0), np.float32(1.0), np.float32(0.0), np.float32(0.0), np.float32(0.0), np.float32(0.0), np.float32(1.0), np.float32(1.0), np.float32(1.0), np.float32(1.0)]",-4.0,99627.0,0
2025-08-14_08-18-36,2433,"[np.float32(0.0), np.float32(0.0), np.float32(1.0), np.float32(1.0), np.float32(0.0), np.float32(1.0), np.float32(1.0), np.float32(1.0), np.float32(0.0), np.float32(0.0), np.float32(1.0), np.float32(0.0), np.float32(0.0), np.float32(1.0), np.float32(1.0), np.float32(0.0)]",2.0,99629.0,20
2025-08-14_08-18-36,2434,"[np.float32(1.0), np.float32(0.0), np.float32(0.0), np.float32(1.0), np.float32(1.0), np.float32(1.0), np.float32(1.0), np.float32(1.0), np.float32(0.0), np.float32(0.0), np.float32(0.0), np.float32(1.0), np.float32(0.0), np.float32(1.0), np.float32(0.0), np.float32(1.0)]",6.0,99635.0,9
2025-08-14_08-18-36,2435,"[np.float32(0.0), np.float32(0.0), np.float32(0.0), np.float32(1.0), np.float32(0.0), np.float32(0.0), np.float32(1.0), np.float32(0.0), np.float32(0.0), np.float32(1.0), np.float32(1.0), np.float32(1.0), np.float32(1.0), np.float32(1.0), np.float32(0.0), np.float32(0.0)]",4.0,99639.0,3
2025-08-14_08-18-36,2436,"[np.float32(0.0), np.float32(0.0), np.float32(0.0), np.float32(0.0), np.float32(0.0), np.float32(1.0), np.float32(0.0), np.float32(1.0), np.float32(0.0), np.float32(1.0), np.float32(0.0), np.float32(0.0), np.float32(1.0), np.float32(1.0), np.float32(0.0), np.float32(1.0)]",2.0,99641.0,28
2025-08-14_08-18-36,2437,"[np.float32(1.0), np.float32(1.0), np.float32(1.0), np.float32(0.0), np.float32(1.0), np.float32(0.0), np.float32(1.0), np.float32(1.0), np.float32(1.0), np.float32(1.0), np.float32(0.0), np.float32(1.0), np.float32(0.0), np.float32(1.0), np.float32(1.0), np.float32(0.0)]",4.0,99645.0,4
2025-08-14_08-18-36,2438,"[np.float32(0.0), np.float32(0.0), np.float32(0.0), np.float32(0.0), np.float32(1.0), np.float32(0.0), np.float32(0.0), np.float32(0.0), np.float32(1.0), np.float32(0.0), np.float32(0.0), np.float32(1.0), np.float32(1.0), np.float32(1.0), np.float32(1.0), np.float32(1.0)]",-4.0,99641.0,19
2025-08-14_08-18-36,2439,"[np.float32(1.0), np.float32(0.0), np.float32(0.0), np.float32(1.0), np.float32(1.0), np.float32(0.0), np.float32(1.0), np.float32(0.0), np.float32(0.0), np.float32(1.0), np.float32(1.0), np.float32(0.0), np.float32(0.0), np.float32(0.0), np.float32(1.0), np.float32(1.0)]",2.0,99643.0,14
2025-08-14_08-18-36,2440,"[np.float32(1.0), np.float32(1.0), np.float32(1.0), np.float32(1.0), np.float32(1.0), np.float32(1.0), np.float32(1.0), np.float32(1.0), np.float32(0.0), np.float32(1.0), np.float32(1.0), np.float32(1.0), np.float32(1.0), np.float32(1.0), np.float32(0.0), np.float32(1.0)]",-2.0,99641.0,10
2025-08-14_08-18-36,2441,"[np.float32(1.0), np.float32(1.0), np.float32(1.0), np.float32(1.0), np.float32(0.0), np.float32(0.0), np.float32(0.0), np.float32(1.0), np.float32(0.0), np.float32(0.0), np.float32(0.0), np.float32(1.0), np.float32(1.0), np.float32(1.0), np.float32(1.0), np.float32(1.0)]",0.0,99641.0,23
2025-08-14_08-18-36,2442,"[np.float32(0.0), np.float32(1.0), np.float32(1.0), np.float32(1.0), np.float32(0.0), np.float32(1.0), np.float32(1.0), np.float32(1.0), np.float32(1.0), np.float32(1.0), np.float32(1.0), np.float32(1.0), np.float32(1.0), np.float32(1.0), np.float32(1.0), np.float32(0.0)]",-3.0,99638.0,6
2025-08-14_08-18-36,2443,"[np.float32(1.0), np.float32(0.0), np.float32(1.0), np.float32(1.0), np.float32(1.0), np.float32(0.0), np.float32(0.0), np.float32(1.0), np.float32(0.0), np.float32(1.0), np.float32(1.0), np.float32(1.0), np.float32(0.0), np.float32(0.0), np.float32(0.0), np.float32(0.0)]",4.0,99642.0,16
2025-08-14_08-18-36,2444,"[np.float32(0.0), np.float32(0.0), np.float32(0.0), np.float32(0.0), np.float32(0.0), np.float32(0.0), np.float32(0.0), np.float32(1.0), np.float32(1.0), np.float32(1.0), np.float32(0.0), np.float32(1.0), np.float32(1.0), np.float32(0.0), np.float32(0.0), np.float32(0.0)]",1.0,99643.0,27
2025-08-14_08-18-36,2445,"[np.float32(1.0), np.float32(1.0), np.float32(1.0), np.float32(1.0), np.float32(0.0), np.float32(1.0), np.float32(0.0), np.float32(1.0), np.float32(1.0), np.float32(1.0), np.float32(1.0), np.float32(0.0), np.float32(1.0), np.float32(0.0), np.float32(0.0), np.float32(0.0)]",2.0,99645.0,29
2025-08-14_08-18-36,2446,"[np.float32(1.0), np.float32(0.0), np.float32(0.0), np.float32(0.0), np.float32(1.0), np.float32(0.0), np.float32(0.0), np.float32(1.0), np.float32(0.0), np.float32(0.0), np.float32(0.0), np.float32(0.0), np.float32(0.0), np.float32(0.0), np.float32(0.0), np.float32(1.0)]",-2.0,99643.0,4
2025-08-14_08-18-36,2447,"[np.float32(0.0), np.float32(0.0), np.float32(1.0), np.float32(1.0), np.float32(1.0), np.float32(1.0), np.float32(1.0), np.float32(1.0), np.float32(1.0), np.float32(0.0), np.float32(1.0), np.float32(1.0), np.float32(0.0), np.float32(1.0), np.float32(0.0), np.float32(0.0)]",-3.0,99640.0,10
2025-08-14_08-18-36,2448,"[np.float32(0.0), np.float32(0.0), np.float32(0.0), np.float32(0.0), np.float32(0.0), np.float32(0.0), np.float32(0.0), np.float32(1.0), np.float32(1.0), np.float32(0.0), np.float32(0.0), np.float32(0.0), np.float32(0.0), np.float32(0.0), np.float32(1.0), np.float32(0.0)]",3.0,99643.0,30
2025-08-14_08-18-36,2449,"[np.float32(1.0), np.float32(0.0), np.float32(1.0), np.float32(0.0), np.float32(0.0), np.float32(1.0), np.float32(1.0), np.float32(1.0), np.float32(1.0), np.float32(0.0), np.float32(1.0), np.float32(1.0), np.float32(1.0), np.float32(1.0), np.float32(1.0), np.float32(1.0)]",-1.0,99642.0,3
2025-08-14_08-18-36,2450,"[np.float32(1.0), np.float32(1.0), np.float32(1.0), np.float32(1.0), np.float32(0.0), np.float32(0.0), np.float32(0.0), np.float32(1.0), np.float32(1.0), np.float32(0.0), np.float32(1.0), np.float32(0.0), np.float32(1.0), np.float32(0.0), np.float32(0.0), np.float32(1.0)]",-2.0,99640.0,30
2025-08-14_08-18-36,2451,"[np.float32(0.0), np.float32(1.0), np.float32(1.0), np.float32(0.0), np.float32(1.0), np.float32(0.0), np.float32(1.0), np.float32(1.0), np.float32(1.0), np.float32(1.0), np.float32(1.0), np.float32(0.0), np.float32(1.0), np.float32(1.0), np.float32(1.0), np.float32(1.0)]",-4.0,99636.0,3
2025-08-14_08-18-36,2452,"[np.float32(1.0), np.float32(1.0), np.float32(0.0), np.float32(0.0), np.float32(0.0), np.float32(1.0), np.float32(0.0), np.float32(1.0), np.float32(1.0), np.float32(1.0), np.float32(0.0), np.float32(0.0), np.float32(0.0), np.float32(1.0), np.float32(0.0), np.float32(1.0)]",-1.0,99635.0,30
2025-08-14_08-18-36,2453,"[np.float32(1.0), np.float32(0.0), np.float32(1.0), np.float32(1.0), np.float32(1.0), np.float32(0.0), np.float32(0.0), np.float32(0.0), np.float32(0.0), np.float32(0.0), np.float32(0.0), np.float32(1.0), np.float32(0.0), np.float32(0.0), np.float32(0.0), np.float32(1.0)]",-1.0,99634.0,24
2025-08-14_08-18-36,2454,"[np.float32(1.0), np.float32(0.0), np.float32(0.0), np.float32(0.0), np.float32(1.0), np.float32(1.0), np.float32(0.0), np.float32(0.0), np.float32(0.0), np.float32(0.0), np.float32(1.0), np.float32(0.0), np.float32(0.0), np.float32(1.0), np.float32(0.0), np.float32(1.0)]",-2.0,99632.0,30
2025-08-14_08-18-36,2455,"[np.float32(1.0), np.float32(1.0), np.float32(0.0), np.float32(1.0), np.float32(1.0), np.float32(0.0), np.float32(0.0), np.float32(1.0), np.float32(0.0), np.float32(0.0), np.float32(0.0), np.float32(1.0), np.float32(0.0), np.float32(1.0), np.float32(1.0), np.float32(1.0)]",-2.0,99630.0,2
2025-08-14_08-18-36,2456,"[np.float32(0.0), np.float32(0.0), np.float32(1.0), np.float32(1.0), np.float32(1.0), np.float32(0.0), np.float32(0.0), np.float32(1.0), np.float32(1.0), np.float32(0.0), np.float32(0.0), np.float32(1.0), np.float32(0.0), np.float32(1.0), np.float32(0.0), np.float32(0.0)]",1.0,99631.0,19
2025-08-14_08-18-36,2457,"[np.float32(1.0), np.float32(1.0), np.float32(0.0), np.float32(1.0), np.float32(0.0), np.float32(1.0), np.float32(0.0), np.float32(1.0), np.float32(1.0), np.float32(1.0), np.float32(1.0), np.float32(1.0), np.float32(0.0), np.float32(1.0), np.float32(0.0), np.float32(0.0)]",-2.0,99629.0,12
2025-08-14_08-18-36,2458,"[np.float32(1.0), np.float32(0.0), np.float32(0.0), np.float32(1.0), np.float32(0.0), np.float32(1.0), np.float32(1.0), np.float32(1.0), np.float32(1.0), np.float32(1.0), np.float32(0.0), np.float32(0.0), np.float32(0.0), np.float32(1.0), np.float32(0.0), np.float32(0.0)]",0.0,99629.0,15
2025-08-14_08-18-36,2459,"[np.float32(0.0), np.float32(0.0), np.float32(1.0), np.float32(1.0), np.float32(1.0), np.float32(0.0), np.float32(1.0), np.float32(1.0), np.float32(0.0), np.float32(1.0), np.float32(0.0), np.float32(0.0), np.float32(0.0), np.float32(1.0), np.float32(1.0), np.float32(0.0)]",-3.0,99626.0,0
2025-08-14_08-18-36,2460,"[np.float32(1.0), np.float32(1.0), np.float32(0.0), np.float32(0.0), np.float32(1.0), np.float32(0.0), np.float32(0.0), np.float32(1.0), np.float32(1.0), np.float32(0.0), np.float32(0.0), np.float32(0.0), np.float32(1.0), np.float32(0.0), np.float32(0.0), np.float32(0.0)]",-2.0,99624.0,2
2025-08-14_08-18-36,2461,"[np.float32(0.0), np.float32(0.0), np.float32(0.0), np.float32(1.0), np.float32(1.0), np.float32(1.0), np.float32(0.0), np.float32(1.0), np.float32(1.0), np.float32(1.0), np.float32(1.0), np.float32(0.0), np.float32(1.0), np.float32(0.0), np.float32(0.0), np.float32(0.0)]",-1.0,99623.0,5
2025-08-14_08-18-36,2462,"[np.float32(1.0), np.float32(0.0), np.float32(0.0), np.float32(0.0), np.float32(0.0), np.float32(1.0), np.float32(0.0), np.float32(0.0), np.float32(1.0), np.float32(1.0), np.float32(1.0), np.float32(1.0), np.float32(0.0), np.float32(0.0), np.float32(1.0), np.float32(0.0)]",-2.0,99621.0,20
2025-08-14_08-18-36,2463,"[np.float32(1.0), np.float32(0.0), np.float32(1.0), np.float32(1.0), np.float32(0.0), np.float32(1.0), np.float32(1.0), np.float32(1.0), np.float32(0.0), np.float32(0.0), np.float32(1.0), np.float32(0.0), np.float32(1.0), np.float32(0.0), np.float32(1.0), np.float32(1.0)]",1.0,99622.0,8
2025-08-14_08-18-36,2464,"[np.float32(0.0), np.float32(1.0), np.float32(0.0), np.float32(1.0), np.float32(0.0), np.float32(1.0), np.float32(0.0), np.float32(1.0), np.float32(1.0), np.float32(0.0), np.float32(0.0), np.float32(1.0), np.float32(0.0), np.float32(0.0), np.float32(0.0), np.float32(1.0)]",2.0,99624.0,29
2025-08-14_08-18-36,2465,"[np.float32(0.0), np.float32(0.0), np.float32(0.0), np.float32(0.0), np.float32(0.0), np.float32(1.0), np.float32(1.0), np.float32(1.0), np.float32(1.0), np.float32(0.0), np.float32(0.0), np.float32(1.0), np.float32(0.0), np.float32(0.0), np.float32(1.0), np.float32(0.0)]",5.0,99629.0,27
2025-08-14_08-18-36,2466,"[np.float32(1.0), np.float32(1.0), np.float32(1.0), np.float32(0.0), np.float32(1.0), np.float32(0.0), np.float32(1.0), np.float32(1.0), np.float32(0.0), np.float32(0.0), np.float32(0.0), np.float32(1.0), np.float32(0.0), np.float32(1.0), np.float32(1.0), np.float32(1.0)]",-2.0,99627.0,19
2025-08-14_08-18-36,2467,"[np.float32(0.0), np.float32(0.0), np.float32(0.0), np.float32(1.0), np.float32(0.0), np.float32(1.0), np.float32(0.0), np.float32(1.0), np.float32(1.0), np.float32(1.0), np.float32(1.0), np.float32(0.0), np.float32(1.0), np.float32(0.0), np.float32(0.0), np.float32(1.0)]",0.0,99627.0,1
2025-08-14_08-18-36,2468,"[np.float32(0.0), np.float32(1.0), np.float32(1.0), np.float32(1.0), np.float32(1.0), np.float32(1.0), np.float32(0.0), np.float32(1.0), np.float32(0.0), np.float32(0.0), np.float32(0.0), np.float32(1.0), np.float32(0.0), np.float32(1.0), np.float32(1.0), np.float32(1.0)]",0.0,99627.0,14
2025-08-14_08-18-36,2469,"[np.float32(0.0), np.float32(0.0), np.float32(0.0), np.float32(1.0), np.float32(0.0), np.float32(1.0), np.float32(1.0), np.float32(0.0), np.float32(1.0), np.float32(0.0), np.float32(0.0), np.float32(1.0), np.float32(0.0), np.float32(0.0), np.float32(0.0), np.float32(0.0)]",0.0,99627.0,34
2025-08-14_08-18-36,2470,"[np.float32(0.0), np.float32(0.0), np.float32(1.0), np.float32(0.0), np.float32(1.0), np.float32(1.0), np.float32(0.0), np.float32(0.0), np.float32(1.0), np.float32(0.0), np.float32(0.0), np.float32(0.0), np.float32(1.0), np.float32(1.0), np.float32(0.0), np.float32(0.0)]",-2.0,99625.0,8
2025-08-14_08-18-36,2471,"[np.float32(0.0), np.float32(1.0), np.float32(0.0), np.float32(1.0), np.float32(1.0), np.float32(1.0), np.float32(1.0), np.float32(1.0), np.float32(1.0), np.float32(0.0), np.float32(1.0), np.float32(1.0), np.float32(1.0), np.float32(0.0), np.float32(0.0), np.float32(0.0)]",-5.0,99620.0,34
2025-08-14_08-18-36,2472,"[np.float32(0.0), np.float32(1.0), np.float32(1.0), np.float32(0.0), np.float32(0.0), np.float32(1.0), np.float32(1.0), np.float32(0.0), np.float32(1.0), np.float32(0.0), np.float32(1.0), np.float32(1.0), np.float32(1.0), np.float32(1.0), np.float32(0.0), np.float32(0.0)]",1.0,99621.0,8
2025-08-14_08-18-36,2473,"[np.float32(1.0), np.float32(1.0), np.float32(1.0), np.float32(1.0), np.float32(0.0), np.float32(0.0), np.float32(0.0), np.float32(0.0), np.float32(1.0), np.float32(1.0), np.float32(0.0), np.float32(1.0), np.float32(1.0), np.float32(0.0), np.float32(0.0), np.float32(1.0)]",-2.0,99619.0,19
2025-08-14_08-18-36,2474,"[np.float32(0.0), np.float32(1.0), np.float32(0.0), np.float32(1.0), np.float32(1.0), np.float32(1.0), np.float32(0.0), np.float32(1.0), np.float32(1.0), np.float32(1.0), np.float32(0.0), np.float32(1.0), np.float32(1.0), np.float32(1.0), np.float32(1.0), np.float32(1.0)]",-2.0,99617.0,1
2025-08-14_08-18-36,2475,"[np.float32(0.0), np.float32(0.0), np.float32(1.0), np.float32(0.0), np.float32(0.0), np.float32(0.0), np.float32(1.0), np.float32(1.0), np.float32(1.0), np.float32(0.0), np.float32(1.0), np.float32(1.0), np.float32(0.0), np.float32(0.0), np.float32(0.0), np.float32(0.0)]",0.0,99617.0,27
2025-08-14_08-18-36,2476,"[np.float32(0.0), np.float32(1.0), np.float32(0.0), np.float32(1.0), np.float32(0.0), np.float32(0.0), np.float32(0.0), np.float32(1.0), np.float32(1.0), np.float32(1.0), np.float32(1.0), np.float32(0.0), np.float32(0.0), np.float32(1.0), np.float32(0.0), np.float32(1.0)]",3.0,99620.0,25
2025-08-14_08-18-36,2477,"[np.float32(0.0), np.float32(0.0), np.float32(1.0), np.float32(0.0), np.float32(0.0), np.float32(0.0), np.float32(1.0), np.float32(1.0), np.float32(0.0), np.float32(1.0), np.float32(0.0), np.float32(0.0), np.float32(0.0), np.float32(0.0), np.float32(1.0), np.float32(1.0)]",-1.0,99619.0,30
2025-08-14_08-18-36,2478,"[np.float32(1.0), np.float32(1.0), np.float32(1.0), np.float32(0.0), np.float32(0.0), np.float32(0.0), np.float32(0.0), np.float32(1.0), np.float32(1.0), np.float32(0.0), np.float32(0.0), np.float32(0.0), np.float32(0.0), np.float32(1.0), np.float32(0.0), np.float32(0.0)]",-1.0,99618.0,31
2025-08-14_08-18-36,2479,"[np.float32(1.0), np.float32(1.0), np.float32(0.0), np.float32(0.0), np.float32(0.0), np.float32(1.0), np.float32(0.0), np.float32(1.0), np.float32(1.0), np.float32(1.0), np.float32(1.0), np.float32(1.0), np.float32(0.0), np.float32(1.0), np.float32(1.0), np.float32(0.0)]",-2.0,99616.0,17
2025-08-14_08-18-36,2480,"[np.float32(1.0), np.float32(1.0), np.float32(0.0), np.float32(1.0), np.float32(0.0), np.float32(0.0), np.float32(1.0), np.float32(1.0), np.float32(0.0), np.float32(1.0), np.float32(0.0), np.float32(1.0), np.float32(1.0), np.float32(0.0), np.float32(0.0), np.float32(1.0)]",-1.0,99615.0,34
2025-08-14_08-18-36,2481,"[np.float32(0.0), np.float32(1.0), np.float32(0.0), np.float32(0.0), np.float32(0.0), np.float32(1.0), np.float32(0.0), np.float32(1.0), np.float32(0.0), np.float32(0.0), np.float32(1.0), np.float32(0.0), np.float32(1.0), np.float32(1.0), np.float32(0.0), np.float32(0.0)]",1.0,99616.0,0
2025-08-14_08-18-36,2482,"[np.float32(0.0), np.float32(0.0), np.float32(1.0), np.float32(0.0), np.float32(0.0), np.float32(1.0), np.float32(1.0), np.float32(0.0), np.float32(0.0), np.float32(0.0), np.float32(0.0), np.float32(1.0), np.float32(0.0), np.float32(0.0), np.float32(0.0), np.float32(0.0)]",-1.0,99615.0,15
2025-08-14_08-18-36,2483,"[np.float32(1.0), np.float32(0.0), np.float32(0.0), np.float32(0.0), np.float32(0.0), np.float32(1.0), np.float32(1.0), np.float32(0.0), np.float32(0.0), np.float32(0.0), np.float32(1.0), np.float32(0.0), np.float32(1.0), np.float32(0.0), np.float32(1.0), np.float32(1.0)]",2.0,99617.0,8
2025-08-14_08-18-36,2484,"[np.float32(1.0), np.float32(0.0), np.float32(0.0), np.float32(1.0), np.float32(0.0), np.float32(1.0), np.float32(0.0), np.float32(0.0), np.float32(1.0), np.float32(1.0), np.float32(0.0), np.float32(1.0), np.float32(1.0), np.float32(0.0), np.float32(1.0), np.float32(0.0)]",-1.0,99616.0,5
2025-08-14_08-18-36,2485,"[np.float32(0.0), np.float32(0.0), np.float32(0.0), np.float32(1.0), np.float32(1.0), np.float32(0.0), np.float32(1.0), np.float32(0.0), np.float32(1.0), np.float32(0.0), np.float32(1.0), np.float32(1.0), np.float32(1.0), np.float32(0.0), np.float32(0.0), np.float32(0.0)]",-2.0,99614.0,21
2025-08-14_08-18-36,2486,"[np.float32(0.0), np.float32(0.0), np.float32(1.0), np.float32(1.0), np.float32(1.0), np.float32(1.0), np.float32(0.0), np.float32(0.0), np.float32(0.0), np.float32(1.0), np.float32(1.0), np.float32(0.0), np.float32(1.0), np.float32(0.0), np.float32(1.0), np.float32(1.0)]",-2.0,99612.0,9
2025-08-14_08-18-36,2487,"[np.float32(1.0), np.float32(0.0), np.float32(1.0), np.float32(0.0), np.float32(0.0), np.float32(0.0), np.float32(0.0), np.float32(0.0), np.float32(1.0), np.float32(1.0), np.float32(1.0), np.float32(1.0), np.float32(0.0), np.float32(1.0), np.float32(1.0), np.float32(0.0)]",1.0,99613.0,33
2025-08-14_08-18-36,2488,"[np.float32(0.0), np.float32(0.0), np.float32(1.0), np.float32(1.0), np.float32(0.0), np.float32(1.0), np.float32(1.0), np.float32(0.0), np.float32(0.0), np.float32(0.0), np.float32(1.0), np.float32(0.0), np.float32(1.0), np.float32(1.0), np.float32(1.0), np.float32(1.0)]",-2.0,99611.0,19
2025-08-14_08-18-36,2489,"[np.float32(0.0), np.float32(1.0), np.float32(1.0), np.float32(0.0), np.float32(1.0), np.float32(1.0), np.float32(1.0), np.float32(1.0), np.float32(0.0), np.float32(1.0), np.float32(0.0), np.float32(0.0), np.float32(1.0), np.float32(1.0), np.float32(1.0), np.float32(0.0)]",-5.0,99606.0,27
2025-08-14_08-18-36,2490,"[np.float32(0.0), np.float32(1.0), np.float32(1.0), np.float32(1.0), np.float32(0.0), np.float32(0.0), np.float32(0.0), np.float32(1.0), np.float32(0.0), np.float32(0.0), np.float32(1.0), np.float32(0.0), np.float32(1.0), np.float32(1.0), np.float32(0.0), np.float32(1.0)]",0.0,99606.0,32
2025-08-14_08-18-36,2491,"[np.float32(1.0), np.float32(1.0), np.float32(1.0), np.float32(0.0), np.float32(0.0), np.float32(1.0), np.float32(0.0), np.float32(0.0), np.float32(1.0), np.float32(0.0), np.float32(1.0), np.float32(0.0), np.float32(0.0), np.float32(1.0), np.float32(0.0), np.float32(0.0)]",-5.0,99601.0,9
2025-08-14_08-18-36,2492,"[np.float32(1.0), np.float32(0.0), np.float32(1.0), np.float32(1.0), np.float32(1.0), np.float32(0.0), np.float32(1.0), np.float32(0.0), np.float32(0.0), np.float32(0.0), np.float32(1.0), np.float32(0.0), np.float32(1.0), np.float32(0.0), np.float32(1.0), np.float32(0.0)]",-1.0,99600.0,17
2025-08-14_08-18-36,2493,"[np.float32(0.0), np.float32(1.0), np.float32(0.0), np.float32(1.0), np.float32(1.0), np.float32(1.0), np.float32(0.0), np.float32(0.0), np.float32(1.0), np.float32(1.0), np.float32(0.0), np.float32(1.0), np.float32(1.0), np.float32(0.0), np.float32(1.0), np.float32(0.0)]",-2.0,99598.0,26
2025-08-14_08-18-36,2494,"[np.float32(1.0), np.float32(1.0), np.float32(0.0), np.float32(0.0), np.float32(0.0), np.float32(0.0), np.float32(0.0), np.float32(0.0), np.float32(0.0), np.float32(1.0), np.float32(0.0), np.float32(0.0), np.float32(1.0), np.float32(1.0), np.float32(0.0), np.float32(0.0)]",-3.0,99595.0,9
2025-08-14_08-18-36,2495,"[np.float32(1.0), np.float32(0.0), np.float32(0.0), np.float32(1.0), np.float32(1.0), np.float32(0.0), np.float32(1.0), np.float32(1.0), np.float32(0.0), np.float32(1.0), np.float32(1.0), np.float32(0.0), np.float32(0.0), np.float32(1.0), np.float32(1.0), np.float32(1.0)]",-2.0,99593.0,31
2025-08-14_08-18-36,2496,"[np.float32(1.0), np.float32(1.0), np.float32(0.0), np.float32(1.0), np.float32(0.0), np.float32(1.0), np.float32(0.0), np.float32(1.0), np.float32(1.0), np.float32(0.0), np.float32(1.0), np.float32(0.0), np.float32(0.0), np.float32(1.0), np.float32(0.0), np.float32(0.0)]",-3.0,99590.0,12
2025-08-14_08-18-36,2497,"[np.float32(0.0), np.float32(0.0), np.float32(1.0), np.float32(0.0), np.float32(0.0), np.float32(0.0), np.float32(0.0), np.float32(0.0), np.float32(1.0), np.float32(0.0), np.float32(0.0), np.float32(1.0), np.float32(0.0), np.float32(0.0), np.float32(1.0), np.float32(0.0)]",1.0,99591.0,34
2025-08-14_08-18-36,2498,"[np.float32(1.0), np.float32(1.0), np.float32(1.0), np.float32(1.0), np.float32(0.0), np.float32(1.0), np.float32(1.0), np.float32(0.0), np.float32(0.0), np.float32(0.0), np.float32(1.0), np.float32(1.0), np.float32(0.0), np.float32(1.0), np.float32(0.0), np.float32(1.0)]",-1.0,99590.0,36
2025-08-14_08-18-36,2499,"[np.float32(1.0), np.float32(1.0), np.float32(0.0), np.float32(1.0), np.float32(1.0), np.float32(1.0), np.float32(0.0), np.float32(0.0), np.float32(0.0), np.float32(1.0), np.float32(0.0), np.float32(0.0), np.float32(0.0), np.float32(0.0), np.float32(1.0), np.float32(1.0)]",-1.0,99589.0,30
2025-08-14_08-18-36,2500,"[np.float32(0.0), np.float32(1.0), np.float32(1.0), np.float32(1.0), np.float32(0.0), np.float32(1.0), np.float32(1.0), np.float32(0.0), np.float32(1.0), np.float32(1.0), np.float32(1.0), np.float32(0.0), np.float32(1.0), np.float32(1.0), np.float32(1.0), np.float32(1.0)]",-1.0,99588.0,1
2025-08-14_08-18-36,2501,"[np.float32(1.0), np.float32(0.0), np.float32(0.0), np.float32(0.0), np.float32(0.0), np.float32(1.0), np.float32(0.0), np.float32(1.0), np.float32(0.0), np.float32(0.0), np.float32(1.0), np.float32(1.0), np.float32(1.0), np.float32(0.0), np.float32(0.0), np.float32(0.0)]",-3.0,99585.0,13
2025-08-14_08-18-36,2502,"[np.float32(0.0), np.float32(1.0), np.float32(1.0), np.float32(0.0), np.float32(0.0), np.float32(0.0), np.float32(0.0), np.float32(1.0), np.float32(0.0), np.float32(1.0), np.float32(0.0), np.float32(1.0), np.float32(1.0), np.float32(1.0), np.float32(0.0), np.float32(1.0)]",-1.0,99584.0,10
2025-08-14_08-18-36,2503,"[np.float32(1.0), np.float32(0.0), np.float32(0.0), np.float32(1.0), np.float32(0.0), np.float32(1.0), np.float32(1.0), np.float32(0.0), np.float32(0.0), np.float32(1.0), np.float32(0.0), np.float32(1.0), np.float32(1.0), np.float32(0.0), np.float32(0.0), np.float32(0.0)]",39.0,99623.0,7
2025-08-14_08-18-36,2504,"[np.float32(1.0), np.float32(0.0), np.float32(1.0), np.float32(1.0), np.float32(1.0), np.float32(0.0), np.float32(1.0), np.float32(1.0), np.float32(0.0), np.float32(0.0), np.float32(1.0), np.float32(0.0), np.float32(0.0), np.float32(0.0), np.float32(1.0), np.float32(0.0)]",1.0,99624.0,7
2025-08-14_08-18-36,2505,"[np.float32(0.0), np.float32(0.0), np.float32(1.0), np.float32(0.0), np.float32(0.0), np.float32(0.0), np.float32(0.0), np.float32(0.0), np.float32(0.0), np.float32(0.0), np.float32(1.0), np.float32(0.0), np.float32(1.0), np.float32(0.0), np.float32(0.0), np.float32(0.0)]",-3.0,99621.0,15
2025-08-14_08-18-36,2506,"[np.float32(0.0), np.float32(0.0), np.float32(0.0), np.float32(0.0), np.float32(0.0), np.float32(0.0), np.float32(1.0), np.float32(0.0), np.float32(1.0), np.float32(1.0), np.float32(1.0), np.float32(0.0), np.float32(0.0), np.float32(0.0), np.float32(1.0), np.float32(1.0)]",3.0,99624.0,11
2025-08-14_08-18-36,2507,"[np.float32(0.0), np.float32(0.0), np.float32(1.0), np.float32(1.0), np.float32(1.0), np.float32(1.0), np.float32(1.0), np.float32(0.0), np.float32(0.0), np.float32(1.0), np.float32(1.0), np.float32(0.0), np.float32(0.0), np.float32(0.0), np.float32(0.0), np.float32(1.0)]",-4.0,99620.0,24
2025-08-14_08-18-36,2508,"[np.float32(1.0), np.float32(1.0), np.float32(0.0), np.float32(1.0), np.float32(1.0), np.float32(0.0), np.float32(1.0), np.float32(1.0), np.float32(0.0), np.float32(1.0), np.float32(1.0), np.float32(0.0), np.float32(0.0), np.float32(1.0), np.float32(1.0), np.float32(1.0)]",2.0,99622.0,4
2025-08-14_08-18-36,2509,"[np.float32(0.0), np.float32(0.0), np.float32(1.0), np.float32(0.0), np.float32(0.0), np.float32(1.0), np.float32(1.0), np.float32(1.0), np.float32(1.0), np.float32(0.0), np.float32(0.0), np.float32(0.0), np.float32(1.0), np.float32(1.0), np.float32(0.0), np.float32(1.0)]",-1.0,99621.0,30
2025-08-14_08-18-36,2510,"[np.float32(1.0), np.float32(0.0), np.float32(1.0), np.float32(0.0), np.float32(1.0), np.float32(0.0), np.float32(0.0), np.float32(1.0), np.float32(1.0), np.float32(0.0), np.float32(0.0), np.float32(0.0), np.float32(1.0), np.float32(0.0), np.float32(1.0), np.float32(0.0)]",33.0,99654.0,7
2025-08-14_08-18-36,2511,"[np.float32(1.0), np.float32(0.0), np.float32(0.0), np.float32(1.0), np.float32(0.0), np.float32(1.0), np.float32(1.0), np.float32(1.0), np.float32(1.0), np.float32(0.0), np.float32(0.0), np.float32(1.0), np.float32(1.0), np.float32(0.0), np.float32(1.0), np.float32(0.0)]",-4.0,99650.0,20
2025-08-14_08-18-36,2512,"[np.float32(0.0), np.float32(0.0), np.float32(1.0), np.float32(0.0), np.float32(1.0), np.float32(1.0), np.float32(1.0), np.float32(1.0), np.float32(0.0), np.float32(1.0), np.float32(1.0), np.float32(0.0), np.float32(1.0), np.float32(0.0), np.float32(0.0), np.float32(1.0)]",-7.0,99643.0,27
2025-08-14_08-18-36,2513,"[np.float32(0.0), np.float32(0.0), np.float32(1.0), np.float32(1.0), np.float32(1.0), np.float32(0.0), np.float32(0.0), np.float32(1.0), np.float32(1.0), np.float32(1.0), np.float32(0.0), np.float32(1.0), np.float32(1.0), np.float32(0.0), np.float32(1.0), np.float32(0.0)]",-2.0,99641.0,6
2025-08-14_08-18-36,2514,"[np.float32(1.0), np.float32(1.0), np.float32(1.0), np.float32(0.0), np.float32(1.0), np.float32(0.0), np.float32(0.0), np.float32(1.0), np.float32(1.0), np.float32(0.0), np.float32(1.0), np.float32(0.0), np.float32(1.0), np.float32(0.0), np.float32(0.0), np.float32(1.0)]",-2.0,99639.0,15
2025-08-14_08-18-36,2515,"[np.float32(0.0), np.float32(0.0), np.float32(0.0), np.float32(0.0), np.float32(0.0), np.float32(0.0), np.float32(1.0), np.float32(1.0), np.float32(0.0), np.float32(1.0), np.float32(1.0), np.float32(0.0), np.float32(0.0), np.float32(1.0), np.float32(0.0), np.float32(0.0)]",-5.0,99634.0,27
2025-08-14_08-18-36,2516,"[np.float32(1.0), np.float32(1.0), np.float32(0.0), np.float32(0.0), np.float32(0.0), np.float32(1.0), np.float32(1.0), np.float32(0.0), np.float32(0.0), np.float32(0.0), np.float32(0.0), np.float32(0.0), np.float32(1.0), np.float32(1.0), np.float32(1.0), np.float32(1.0)]",0.0,99634.0,4
2025-08-14_08-18-36,2517,"[np.float32(0.0), np.float32(0.0), np.float32(0.0), np.float32(0.0), np.float32(0.0), np.float32(1.0), np.float32(0.0), np.float32(1.0), np.float32(1.0), np.float32(1.0), np.float32(0.0), np.float32(0.0), np.float32(1.0), np.float32(1.0), np.float32(1.0), np.float32(0.0)]",-1.0,99633.0,15
2025-08-14_08-18-36,2518,"[np.float32(1.0), np.float32(1.0), np.float32(0.0), np.float32(0.0), np.float32(0.0), np.float32(1.0), np.float32(0.0), np.float32(0.0), np.float32(0.0), np.float32(0.0), np.float32(1.0), np.float32(1.0), np.float32(1.0), np.float32(1.0), np.float32(1.0), np.float32(0.0)]",0.0,99633.0,18
2025-08-14_08-18-36,2519,"[np.float32(1.0), np.float32(1.0), np.float32(0.0), np.float32(1.0), np.float32(0.0), np.float32(0.0), np.float32(0.0), np.float32(0.0), np.float32(1.0), np.float32(1.0), np.float32(1.0), np.float32(1.0), np.float32(0.0), np.float32(1.0), np.float32(1.0), np.float32(0.0)]",-1.0,99632.0,24
2025-08-14_08-18-36,2520,"[np.float32(1.0), np.float32(1.0), np.float32(1.0), np.float32(1.0), np.float32(0.0), np.float32(0.0), np.float32(0.0), np.float32(0.0), np.float32(1.0), np.float32(1.0), np.float32(0.0), np.float32(1.0), np.float32(0.0), np.float32(1.0), np.float32(1.0), np.float32(0.0)]",1.0,99633.0,12
2025-08-14_08-18-36,2521,"[np.float32(1.0), np.float32(1.0), np.float32(0.0), np.float32(0.0), np.float32(1.0), np.float32(1.0), np.float32(0.0), np.float32(0.0), np.float32(0.0), np.float32(1.0), np.float32(1.0), np.float32(1.0), np.float32(1.0), np.float32(0.0), np.float32(0.0), np.float32(0.0)]",-1.0,99632.0,10
2025-08-14_08-18-36,2522,"[np.float32(1.0), np.float32(0.0), np.float32(1.0), np.float32(1.0), np.float32(0.0), np.float32(1.0), np.float32(1.0), np.float32(0.0), np.float32(1.0), np.float32(0.0), np.float32(0.0), np.float32(0.0), np.float32(0.0), np.float32(0.0), np.float32(1.0), np.float32(0.0)]",5.0,99637.0,36
2025-08-14_08-18-36,2523,"[np.float32(1.0), np.float32(0.0), np.float32(1.0), np.float32(1.0), np.float32(0.0), np.float32(0.0), np.float32(1.0), np.float32(0.0), np.float32(1.0), np.float32(0.0), np.float32(1.0), np.float32(1.0), np.float32(0.0), np.float32(1.0), np.float32(1.0), np.float32(0.0)]",-4.0,99633.0,20
2025-08-14_08-18-36,2524,"[np.float32(0.0), np.float32(1.0), np.float32(0.0), np.float32(0.0), np.float32(0.0), np.float32(0.0), np.float32(0.0), np.float32(0.0), np.float32(1.0), np.float32(0.0), np.float32(1.0), np.float32(1.0), np.float32(0.0), np.float32(1.0), np.float32(0.0), np.float32(0.0)]",-2.0,99631.0,34
2025-08-14_08-18-36,2525,"[np.float32(0.0), np.float32(0.0), np.float32(0.0), np.float32(1.0), np.float32(0.0), np.float32(0.0), np.float32(1.0), np.float32(0.0), np.float32(0.0), np.float32(0.0), np.float32(1.0), np.float32(0.0), np.float32(1.0), np.float32(0.0), np.float32(0.0), np.float32(0.0)]",-2.0,99629.0,31
2025-08-14_08-18-36,2526,"[np.float32(1.0), np.float32(1.0), np.float32(1.0), np.float32(1.0), np.float32(0.0), np.float32(1.0), np.float32(1.0), np.float32(0.0), np.float32(0.0), np.float32(0.0), np.float32(0.0), np.float32(1.0), np.float32(1.0), np.float32(1.0), np.float32(1.0), np.float32(0.0)]",2.0,99631.0,24
2025-08-14_08-18-36,2527,"[np.float32(1.0), np.float32(0.0), np.float32(0.0), np.float32(0.0), np.float32(1.0), np.float32(1.0), np.float32(0.0), np.float32(1.0), np.float32(0.0), np.float32(1.0), np.float32(0.0), np.float32(0.0), np.float32(1.0), np.float32(1.0), np.float32(1.0), np.float32(1.0)]",1.0,99632.0,18
2025-08-14_08-18-36,2528,"[np.float32(0.0), np.float32(1.0), np.float32(1.0), np.float32(1.0), np.float32(0.0), np.float32(1.0), np.float32(1.0), np.float32(1.0), np.float32(0.0), np.float32(1.0), np.float32(0.0), np.float32(0.0), np.float32(0.0), np.float32(0.0), np.float32(1.0), np.float32(0.0)]",-3.0,99629.0,18
2025-08-14_08-18-36,2529,"[np.float32(0.0), np.float32(0.0), np.float32(0.0), np.float32(1.0), np.float32(0.0), np.float32(1.0), np.float32(0.0), np.float32(0.0), np.float32(1.0), np.float32(0.0), np.float32(0.0), np.float32(0.0), np.float32(0.0), np.float32(1.0), np.float32(1.0), np.float32(0.0)]",-2.0,99627.0,10
2025-08-14_08-18-36,2530,"[np.float32(0.0), np.float32(1.0), np.float32(0.0), np.float32(1.0), np.float32(1.0), np.float32(1.0), np.float32(0.0), np.float32(0.0), np.float32(0.0), np.float32(0.0), np.float32(1.0), np.float32(1.0), np.float32(0.0), np.float32(1.0), np.float32(1.0), np.float32(0.0)]",-6.0,99621.0,34
2025-08-14_08-18-36,2531,"[np.float32(0.0), np.float32(1.0), np.float32(1.0), np.float32(0.0), np.float32(1.0), np.float32(1.0), np.float32(1.0), np.float32(0.0), np.float32(1.0), np.float32(0.0), np.float32(0.0), np.float32(1.0), np.float32(0.0), np.float32(1.0), np.float32(1.0), np.float32(0.0)]",1.0,99622.0,32
2025-08-14_08-18-36,2532,"[np.float32(0.0), np.float32(1.0), np.float32(1.0), np.float32(0.0), np.float32(0.0), np.float32(1.0), np.float32(1.0), np.float32(0.0), np.float32(1.0), np.float32(1.0), np.float32(0.0), np.float32(0.0), np.float32(0.0), np.float32(0.0), np.float32(1.0), np.float32(0.0)]",-5.0,99617.0,14
2025-08-14_08-18-36,2533,"[np.float32(0.0), np.float32(1.0), np.float32(0.0), np.float32(1.0), np.float32(1.0), np.float32(1.0), np.float32(0.0), np.float32(1.0), np.float32(1.0), np.float32(1.0), np.float32(1.0), np.float32(1.0), np.float32(0.0), np.float32(0.0), np.float32(0.0), np.float32(0.0)]",1.0,99618.0,26
2025-08-14_08-18-36,2534,"[np.float32(1.0), np.float32(1.0), np.float32(0.0), np.float32(1.0), np.float32(1.0), np.float32(1.0), np.float32(0.0), np.float32(0.0), np.float32(1.0), np.float32(1.0), np.float32(0.0), np.float32(0.0), np.float32(0.0), np.float32(1.0), np.float32(0.0), np.float32(0.0)]",7.0,99625.0,25
2025-08-14_08-18-36,2535,"[np.float32(0.0), np.float32(0.0), np.float32(0.0), np.float32(0.0), np.float32(1.0), np.float32(0.0), np.float32(0.0), np.float32(0.0), np.float32(1.0), np.float32(0.0), np.float32(0.0), np.float32(1.0), np.float32(1.0), np.float32(0.0), np.float32(1.0), np.float32(0.0)]",4.0,99629.0,30
2025-08-14_08-18-36,2536,"[np.float32(0.0), np.float32(0.0), np.float32(1.0), np.float32(1.0), np.float32(1.0), np.float32(0.0), np.float32(0.0), np.float32(1.0), np.float32(0.0), np.float32(1.0), np.float32(1.0), np.float32(1.0), np.float32(0.0), np.float32(1.0), np.float32(0.0), np.float32(0.0)]",2.0,99631.0,7
2025-08-14_08-18-36,2537,"[np.float32(1.0), np.float32(0.0), np.float32(0.0), np.float32(0.0), np.float32(0.0), np.float32(0.0), np.float32(0.0), np.float32(1.0), np.float32(1.0), np.float32(0.0), np.float32(1.0), np.float32(1.0), np.float32(1.0), np.float32(1.0), np.float32(1.0), np.float32(0.0)]",0.0,99631.0,16
2025-08-14_08-18-36,2538,"[np.float32(0.0), np.float32(0.0), np.float32(1.0), np.float32(0.0), np.float32(0.0), np.float32(1.0), np.float32(0.0), np.float32(0.0), np.float32(1.0), np.float32(1.0), np.float32(1.0), np.float32(0.0), np.float32(1.0), np.float32(1.0), np.float32(0.0), np.float32(1.0)]",-5.0,99626.0,3
2025-08-14_08-18-36,2539,"[np.float32(0.0), np.float32(0.0), np.float32(1.0), np.float32(1.0), np.float32(1.0), np.float32(0.0), np.float32(1.0), np.float32(0.0), np.float32(1.0), np.float32(1.0), np.float32(0.0), np.float32(1.0), np.float32(0.0), np.float32(0.0), np.float32(1.0), np.float32(0.0)]",2.0,99628.0,3
2025-08-14_08-18-36,2540,"[np.float32(0.0), np.float32(0.0), np.float32(0.0), np.float32(0.0), np.float32(0.0), np.float32(1.0), np.float32(0.0), np.float32(1.0), np.float32(1.0), np.float32(0.0), np.float32(0.0), np.float32(0.0), np.float32(0.0), np.float32(1.0), np.float32(1.0), np.float32(1.0)]",2.0,99630.0,27
2025-08-14_08-18-36,2541,"[np.float32(0.0), np.float32(0.0), np.float32(1.0), np.float32(1.0), np.float32(0.0), np.float32(0.0), np.float32(1.0), np.float32(1.0), np.float32(0.0), np.float32(0.0), np.float32(0.0), np.float32(1.0), np.float32(0.0), np.float32(1.0), np.float32(0.0), np.float32(0.0)]",-1.0,99629.0,35
2025-08-14_08-18-36,2542,"[np.float32(1.0), np.float32(0.0), np.float32(0.0), np.float32(1.0), np.float32(0.0), np.float32(1.0), np.float32(0.0), np.float32(1.0), np.float32(1.0), np.float32(0.0), np.float32(0.0), np.float32(0.0), np.float32(0.0), np.float32(0.0), np.float32(0.0), np.float32(1.0)]",-1.0,99628.0,15
2025-08-14_08-18-36,2543,"[np.float32(1.0), np.float32(1.0), np.float32(0.0), np.float32(0.0), np.float32(0.0), np.float32(1.0), np.float32(0.0), np.float32(0.0), np.float32(1.0), np.float32(0.0), np.float32(1.0), np.float32(1.0), np.float32(1.0), np.float32(0.0), np.float32(0.0), np.float32(1.0)]",-3.0,99625.0,12
2025-08-14_08-18-36,2544,"[np.float32(1.0), np.float32(0.0), np.float32(1.0), np.float32(1.0), np.float32(1.0), np.float32(1.0), np.float32(1.0), np.float32(0.0), np.float32(1.0), np.float32(0.0), np.float32(1.0), np.float32(0.0), np.float32(0.0), np.float32(1.0), np.float32(1.0), np.float32(0.0)]",-3.0,99622.0,17
2025-08-14_08-18-36,2545,"[np.float32(0.0), np.float32(0.0), np.float32(0.0), np.float32(1.0), np.float32(1.0), np.float32(1.0), np.float32(1.0), np.float32(0.0), np.float32(0.0), np.float32(0.0), np.float32(1.0), np.float32(0.0), np.float32(1.0), np.float32(0.0), np.float32(1.0), np.float32(0.0)]",-2.0,99620.0,16
2025-08-14_08-18-36,2546,"[np.float32(0.0), np.float32(0.0), np.float32(1.0), np.float32(0.0), np.float32(0.0), np.float32(0.0), np.float32(0.0), np.float32(0.0), np.float32(0.0), np.float32(1.0), np.float32(1.0), np.float32(1.0), np.float32(1.0), np.float32(1.0), np.float32(0.0), np.float32(0.0)]",0.0,99620.0,29
2025-08-14_08-18-36,2547,"[np.float32(0.0), np.float32(0.0), np.float32(0.0), np.float32(1.0), np.float32(1.0), np.float32(1.0), np.float32(0.0), np.float32(0.0), np.float32(1.0), np.float32(0.0), np.float32(1.0), np.float32(1.0), np.float32(1.0), np.float32(0.0), np.float32(1.0), np.float32(0.0)]",-3.0,99617.0,16
2025-08-14_08-18-36,2548,"[np.float32(0.0), np.float32(1.0), np.float32(1.0), np.float32(0.0), np.float32(0.0), np.float32(0.0), np.float32(1.0), np.float32(1.0), np.float32(1.0), np.float32(1.0), np.float32(1.0), np.float32(0.0), np.float32(1.0), np.float32(0.0), np.float32(0.0), np.float32(0.0)]",0.0,99617.0,14
2025-08-14_08-18-36,2549,"[np.float32(0.0), np.float32(1.0), np.float32(1.0), np.float32(0.0), np.float32(0.0), np.float32(0.0), np.float32(1.0), np.float32(0.0), np.float32(0.0), np.float32(0.0), np.float32(0.0), np.float32(1.0), np.float32(0.0), np.float32(0.0), np.float32(1.0), np.float32(0.0)]",-2.0,99615.0,1
2025-08-14_08-18-36,2550,"[np.float32(1.0), np.float32(1.0), np.float32(0.0), np.float32(0.0), np.float32(0.0), np.float32(1.0), np.float32(0.0), np.float32(1.0), np.float32(1.0), np.float32(1.0), np.float32(0.0), np.float32(1.0), np.float32(0.0), np.float32(0.0), np.float32(1.0), np.float32(1.0)]",-4.0,99611.0,4
2025-08-14_08-18-36,2551,"[np.float32(1.0), np.float32(0.0), np.float32(0.0), np.float32(0.0), np.float32(0.0), np.float32(1.0), np.float32(0.0), np.float32(1.0), np.float32(0.0), np.float32(1.0), np.float32(0.0), np.float32(0.0), np.float32(0.0), np.float32(1.0), np.float32(0.0), np.float32(1.0)]",-1.0,99610.0,35
2025-08-14_08-18-36,2552,"[np.float32(1.0), np.float32(1.0), np.float32(0.0), np.float32(1.0), np.float32(0.0), np.float32(0.0), np.float32(1.0), np.float32(1.0), np.float32(1.0), np.float32(0.0), np.float32(0.0), np.float32(1.0), np.float32(0.0), np.float32(0.0), np.float32(1.0), np.float32(0.0)]",-1.0,99609.0,25
2025-08-14_08-18-36,2553,"[np.float32(1.0), np.float32(1.0), np.float32(0.0), np.float32(1.0), np.float32(1.0), np.float32(1.0), np.float32(1.0), np.float32(1.0), np.float32(1.0), np.float32(0.0), np.float32(1.0), np.float32(1.0), np.float32(0.0), np.float32(0.0), np.float32(0.0), np.float32(1.0)]",-1.0,99608.0,30
2025-08-14_08-18-36,2554,"[np.float32(0.0), np.float32(1.0), np.float32(0.0), np.float32(0.0), np.float32(0.0), np.float32(1.0), np.float32(0.0), np.float32(0.0), np.float32(0.0), np.float32(0.0), np.float32(0.0), np.float32(1.0), np.float32(0.0), np.float32(1.0), np.float32(0.0), np.float32(0.0)]",-2.0,99606.0,23
2025-08-14_08-18-36,2555,"[np.float32(1.0), np.float32(0.0), np.float32(1.0), np.float32(1.0), np.float32(1.0), np.float32(1.0), np.float32(0.0), np.float32(1.0), np.float32(1.0), np.float32(1.0), np.float32(1.0), np.float32(0.0), np.float32(0.0), np.float32(1.0), np.float32(1.0), np.float32(1.0)]",1.0,99607.0,22
2025-08-14_08-18-36,2556,"[np.float32(1.0), np.float32(0.0), np.float32(0.0), np.float32(1.0), np.float32(1.0), np.float32(0.0), np.float32(0.0), np.float32(0.0), np.float32(1.0), np.float32(0.0), np.float32(0.0), np.float32(0.0), np.float32(0.0), np.float32(0.0), np.float32(0.0), np.float32(1.0)]",-1.0,99606.0,21
2025-08-14_08-18-36,2557,"[np.float32(1.0), np.float32(0.0), np.float32(1.0), np.float32(0.0), np.float32(0.0), np.float32(1.0), np.float32(0.0), np.float32(0.0), np.float32(0.0), np.float32(1.0), np.float32(0.0), np.float32(0.0), np.float32(0.0), np.float32(1.0), np.float32(0.0), np.float32(1.0)]",4.0,99610.0,25
2025-08-14_08-18-36,2558,"[np.float32(1.0), np.float32(0.0), np.float32(0.0), np.float32(1.0), np.float32(1.0), np.float32(1.0), np.float32(0.0), np.float32(1.0), np.float32(0.0), np.float32(0.0), np.float32(0.0), np.float32(0.0), np.float32(0.0), np.float32(1.0), np.float32(0.0), np.float32(0.0)]",4.0,99614.0,18
2025-08-14_08-18-36,2559,"[np.float32(0.0), np.float32(1.0), np.float32(0.0), np.float32(0.0), np.float32(0.0), np.float32(1.0), np.float32(0.0), np.float32(1.0), np.float32(0.0), np.float32(1.0), np.float32(1.0), np.float32(1.0), np.float32(1.0), np.float32(0.0), np.float32(1.0), np.float32(0.0)]",2.0,99616.0,33
2025-08-14_08-18-36,2560,"[np.float32(0.0), np.float32(1.0), np.float32(1.0), np.float32(1.0), np.float32(0.0), np.float32(0.0), np.float32(0.0), np.float32(1.0), np.float32(0.0), np.float32(1.0), np.float32(1.0), np.float32(1.0), np.float32(0.0), np.float32(1.0), np.float32(1.0), np.float32(0.0)]",-1.0,99615.0,27
2025-08-14_08-18-36,2561,"[np.float32(1.0), np.float32(0.0), np.float32(0.0), np.float32(1.0), np.float32(0.0), np.float32(1.0), np.float32(0.0), np.float32(0.0), np.float32(0.0), np.float32(0.0), np.float32(1.0), np.float32(0.0), np.float32(0.0), np.float32(1.0), np.float32(1.0), np.float32(1.0)]",0.0,99615.0,36
2025-08-14_08-18-36,2562,"[np.float32(1.0), np.float32(1.0), np.float32(0.0), np.float32(0.0), np.float32(1.0), np.float32(0.0), np.float32(0.0), np.float32(1.0), np.float32(1.0), np.float32(0.0), np.float32(0.0), np.float32(1.0), np.float32(0.0), np.float32(1.0), np.float32(1.0), np.float32(0.0)]",3.0,99618.0,33
2025-08-14_08-18-36,2563,"[np.float32(1.0), np.float32(1.0), np.float32(1.0), np.float32(0.0), np.float32(0.0), np.float32(1.0), np.float32(0.0), np.float32(0.0), np.float32(1.0), np.float32(0.0), np.float32(0.0), np.float32(1.0), np.float32(0.0), np.float32(0.0), np.float32(0.0), np.float32(0.0)]",3.0,99621.0,32
2025-08-14_08-18-36,2564,"[np.float32(1.0), np.float32(1.0), np.float32(1.0), np.float32(0.0), np.float32(0.0), np.float32(1.0), np.float32(1.0), np.float32(0.0), np.float32(0.0), np.float32(1.0), np.float32(0.0), np.float32(1.0), np.float32(0.0), np.float32(0.0), np.float32(0.0), np.float32(0.0)]",1.0,99622.0,7
2025-08-14_08-18-36,2565,"[np.float32(0.0), np.float32(1.0), np.float32(1.0), np.float32(0.0), np.float32(1.0), np.float32(0.0), np.float32(0.0), np.float32(1.0), np.float32(1.0), np.float32(1.0), np.float32(1.0), np.float32(0.0), np.float32(0.0), np.float32(0.0), np.float32(0.0), np.float32(1.0)]",2.0,99624.0,26
2025-08-14_08-18-36,2566,"[np.float32(1.0), np.float32(0.0), np.float32(0.0), np.float32(1.0), np.float32(1.0), np.float32(1.0), np.float32(0.0), np.float32(1.0), np.float32(1.0), np.float32(1.0), np.float32(1.0), np.float32(1.0), np.float32(0.0), np.float32(0.0), np.float32(1.0), np.float32(0.0)]",0.0,99624.0,11
2025-08-14_08-18-36,2567,"[np.float32(0.0), np.float32(0.0), np.float32(0.0), np.float32(0.0), np.float32(1.0), np.float32(0.0), np.float32(1.0), np.float32(0.0), np.float32(1.0), np.float32(0.0), np.float32(0.0), np.float32(1.0), np.float32(0.0), np.float32(1.0), np.float32(1.0), np.float32(0.0)]",2.0,99626.0,15
2025-08-14_08-18-36,2568,"[np.float32(1.0), np.float32(1.0), np.float32(0.0), np.float32(0.0), np.float32(1.0), np.float32(1.0), np.float32(0.0), np.float32(1.0), np.float32(0.0), np.float32(0.0), np.float32(1.0), np.float32(1.0), np.float32(0.0), np.float32(0.0), np.float32(0.0), np.float32(0.0)]",3.0,99629.0,15
2025-08-14_08-18-36,2569,"[np.float32(0.0), np.float32(1.0), np.float32(0.0), np.float32(1.0), np.float32(1.0), np.float32(1.0), np.float32(0.0), np.float32(1.0), np.float32(1.0), np.float32(1.0), np.float32(0.0), np.float32(0.0), np.float32(1.0), np.float32(0.0), np.float32(0.0), np.float32(1.0)]",-5.0,99624.0,3
2025-08-14_08-18-36,2570,"[np.float32(0.0), np.float32(0.0), np.float32(1.0), np.float32(0.0), np.float32(0.0), np.float32(1.0), np.float32(1.0), np.float32(1.0), np.float32(1.0), np.float32(1.0), np.float32(0.0), np.float32(1.0), np.float32(1.0), np.float32(1.0), np.float32(1.0), np.float32(1.0)]",-2.0,99622.0,9
2025-08-14_08-18-36,2571,"[np.float32(0.0), np.float32(1.0), np.float32(1.0), np.float32(0.0), np.float32(0.0), np.float32(0.0), np.float32(0.0), np.float32(1.0), np.float32(0.0), np.float32(0.0), np.float32(1.0), np.float32(1.0), np.float32(0.0), np.float32(0.0), np.float32(1.0), np.float32(1.0)]",1.0,99623.0,36
2025-08-14_08-18-36,2572,"[np.float32(1.0), np.float32(1.0), np.float32(0.0), np.float32(1.0), np.float32(1.0), np.float32(1.0), np.float32(0.0), np.float32(0.0), np.float32(0.0), np.float32(1.0), np.float32(1.0), np.float32(0.0), np.float32(0.0), np.float32(1.0), np.float32(1.0), np.float32(0.0)]",-3.0,99620.0,9
2025-08-14_08-18-36,2573,"[np.float32(1.0), np.float32(1.0), np.float32(1.0), np.float32(1.0), np.float32(0.0), np.float32(0.0), np.float32(0.0), np.float32(1.0), np.float32(0.0), np.float32(1.0), np.float32(0.0), np.float32(0.0), np.float32(1.0), np.float32(0.0), np.float32(0.0), np.float32(0.0)]",-3.0,99617.0,2
2025-08-14_08-18-36,2574,"[np.float32(1.0), np.float32(0.0), np.float32(1.0), np.float32(1.0), np.float32(1.0), np.float32(0.0), np.float32(1.0), np.float32(1.0), np.float32(0.0), np.float32(1.0), np.float32(0.0), np.float32(1.0), np.float32(1.0), np.float32(1.0), np.float32(1.0), np.float32(0.0)]",-1.0,99616.0,8
2025-08-14_08-18-36,2575,"[np.float32(0.0), np.float32(0.0), np.float32(1.0), np.float32(0.0), np.float32(1.0), np.float32(0.0), np.float32(0.0), np.float32(0.0), np.float32(1.0), np.float32(0.0), np.float32(1.0), np.float32(1.0), np.float32(1.0), np.float32(0.0), np.float32(1.0), np.float32(0.0)]",-2.0,99614.0,20
2025-08-14_08-18-36,2576,"[np.float32(0.0), np.float32(1.0), np.float32(0.0), np.float32(0.0), np.float32(0.0), np.float32(0.0), np.float32(0.0), np.float32(0.0), np.float32(0.0), np.float32(0.0), np.float32(0.0), np.float32(0.0), np.float32(1.0), np.float32(1.0), np.float32(1.0), np.float32(0.0)]",-4.0,99610.0,34
2025-08-14_08-18-36,2577,"[np.float32(1.0), np.float32(1.0), np.float32(1.0), np.float32(1.0), np.float32(1.0), np.float32(1.0), np.float32(0.0), np.float32(0.0), np.float32(1.0), np.float32(1.0), np.float32(0.0), np.float32(1.0), np.float32(1.0), np.float32(0.0), np.float32(1.0), np.float32(0.0)]",-5.0,99605.0,0
2025-08-14_08-18-36,2578,"[np.float32(0.0), np.float32(1.0), np.float32(1.0), np.float32(1.0), np.float32(0.0), np.float32(0.0), np.float32(0.0), np.float32(1.0), np.float32(0.0), np.float32(0.0), np.float32(0.0), np.float32(0.0), np.float32(1.0), np.float32(1.0), np.float32(0.0), np.float32(0.0)]",-4.0,99601.0,5
2025-08-14_08-18-36,2579,"[np.float32(0.0), np.float32(1.0), np.float32(1.0), np.float32(0.0), np.float32(0.0), np.float32(1.0), np.float32(1.0), np.float32(1.0), np.float32(1.0), np.float32(0.0), np.float32(0.0), np.float32(0.0), np.float32(1.0), np.float32(0.0), np.float32(1.0), np.float32(1.0)]",-2.0,99599.0,29
2025-08-14_08-18-36,2580,"[np.float32(1.0), np.float32(0.0), np.float32(0.0), np.float32(1.0), np.float32(1.0), np.float32(0.0), np.float32(1.0), np.float32(0.0), np.float32(1.0), np.float32(1.0), np.float32(1.0), np.float32(1.0), np.float32(1.0), np.float32(0.0), np.float32(1.0), np.float32(0.0)]",1.0,99600.0,30
2025-08-14_08-18-36,2581,"[np.float32(0.0), np.float32(1.0), np.float32(1.0), np.float32(0.0), np.float32(0.0), np.float32(0.0), np.float32(1.0), np.float32(0.0), np.float32(0.0), np.float32(1.0), np.float32(1.0), np.float32(1.0), np.float32(0.0), np.float32(1.0), np.float32(1.0), np.float32(0.0)]",0.0,99600.0,32
2025-08-14_08-18-36,2582,"[np.float32(1.0), np.float32(0.0), np.float32(1.0), np.float32(0.0), np.float32(1.0), np.float32(1.0), np.float32(0.0), np.float32(1.0), np.float32(1.0), np.float32(1.0), np.float32(1.0), np.float32(0.0), np.float32(1.0), np.float32(0.0), np.float32(1.0), np.float32(1.0)]",-2.0,99598.0,18
2025-08-14_08-18-36,2583,"[np.float32(1.0), np.float32(1.0), np.float32(0.0), np.float32(1.0), np.float32(0.0), np.float32(0.0), np.float32(0.0), np.float32(1.0), np.float32(0.0), np.float32(1.0), np.float32(0.0), np.float32(1.0), np.float32(0.0), np.float32(0.0), np.float32(1.0), np.float32(0.0)]",3.0,99601.0,33
2025-08-14_08-18-36,2584,"[np.float32(0.0), np.float32(0.0), np.float32(1.0), np.float32(1.0), np.float32(0.0), np.float32(1.0), np.float32(0.0), np.float32(0.0), np.float32(0.0), np.float32(0.0), np.float32(1.0), np.float32(0.0), np.float32(0.0), np.float32(1.0), np.float32(0.0), np.float32(0.0)]",-3.0,99598.0,16
2025-08-14_08-18-36,2585,"[np.float32(1.0), np.float32(1.0), np.float32(1.0), np.float32(0.0), np.float32(0.0), np.float32(0.0), np.float32(1.0), np.float32(0.0), np.float32(0.0), np.float32(0.0), np.float32(0.0), np.float32(0.0), np.float32(1.0), np.float32(0.0), np.float32(0.0), np.float32(0.0)]",-3.0,99595.0,17
2025-08-14_08-18-36,2586,"[np.float32(1.0), np.float32(1.0), np.float32(1.0), np.float32(0.0), np.float32(0.0), np.float32(1.0), np.float32(1.0), np.float32(0.0), np.float32(1.0), np.float32(1.0), np.float32(1.0), np.float32(1.0), np.float32(0.0), np.float32(0.0), np.float32(0.0), np.float32(0.0)]",1.0,99596.0,33
2025-08-14_08-18-36,2587,"[np.float32(0.0), np.float32(0.0), np.float32(0.0), np.float32(1.0), np.float32(0.0), np.float32(1.0), np.float32(1.0), np.float32(1.0), np.float32(1.0), np.float32(1.0), np.float32(0.0), np.float32(1.0), np.float32(0.0), np.float32(1.0), np.float32(0.0), np.float32(0.0)]",5.0,99601.0,21
2025-08-14_08-18-36,2588,"[np.float32(1.0), np.float32(1.0), np.float32(0.0), np.float32(0.0), np.float32(1.0), np.float32(1.0), np.float32(1.0), np.float32(0.0), np.float32(1.0), np.float32(0.0), np.float32(1.0), np.float32(1.0), np.float32(0.0), np.float32(0.0), np.float32(0.0), np.float32(0.0)]",-1.0,99600.0,17
2025-08-14_08-18-36,2589,"[np.float32(0.0), np.float32(1.0), np.float32(0.0), np.float32(1.0), np.float32(0.0), np.float32(0.0), np.float32(1.0), np.float32(1.0), np.float32(0.0), np.float32(0.0), np.float32(0.0), np.float32(1.0), np.float32(0.0), np.float32(1.0), np.float32(1.0), np.float32(1.0)]",-1.0,99599.0,31
2025-08-14_08-18-36,2590,"[np.float32(1.0), np.float32(1.0), np.float32(0.0), np.float32(0.0), np.float32(0.0), np.float32(0.0), np.float32(0.0), np.float32(1.0), np.float32(1.0), np.float32(0.0), np.float32(1.0), np.float32(0.0), np.float32(0.0), np.float32(0.0), np.float32(1.0), np.float32(1.0)]",-2.0,99597.0,1
2025-08-14_08-18-36,2591,"[np.float32(0.0), np.float32(0.0), np.float32(0.0), np.float32(1.0), np.float32(0.0), np.float32(0.0), np.float32(1.0), np.float32(1.0), np.float32(1.0), np.float32(0.0), np.float32(0.0), np.float32(1.0), np.float32(1.0), np.float32(0.0), np.float32(1.0), np.float32(0.0)]",1.0,99598.0,21
2025-08-14_08-18-36,2592,"[np.float32(1.0), np.float32(1.0), np.float32(1.0), np.float32(1.0), np.float32(0.0), np.float32(1.0), np.float32(0.0), np.float32(1.0), np.float32(1.0), np.float32(0.0), np.float32(0.0), np.float32(1.0), np.float32(1.0), np.float32(1.0), np.float32(0.0), np.float32(1.0)]",1.0,99599.0,35
2025-08-14_08-18-36,2593,"[np.float32(1.0), np.float32(0.0), np.float32(1.0), np.float32(0.0), np.float32(0.0), np.float32(0.0), np.float32(0.0), np.float32(1.0), np.float32(0.0), np.float32(0.0), np.float32(1.0), np.float32(1.0), np.float32(0.0), np.float32(0.0), np.float32(1.0), np.float32(1.0)]",3.0,99602.0,18
2025-08-14_08-18-36,2594,"[np.float32(1.0), np.float32(0.0), np.float32(1.0), np.float32(0.0), np.float32(0.0), np.float32(0.0), np.float32(0.0), np.float32(0.0), np.float32(0.0), np.float32(1.0), np.float32(1.0), np.float32(0.0), np.float32(1.0), np.float32(0.0), np.float32(1.0), np.float32(0.0)]",-3.0,99599.0,35
2025-08-14_08-18-36,2595,"[np.float32(1.0), np.float32(1.0), np.float32(0.0), np.float32(1.0), np.float32(0.0), np.float32(1.0), np.float32(0.0), np.float32(0.0), np.float32(1.0), np.float32(0.0), np.float32(1.0), np.float32(0.0), np.float32(1.0), np.float32(0.0), np.float32(0.0), np.float32(0.0)]",-3.0,99596.0,15
2025-08-14_08-18-36,2596,"[np.float32(1.0), np.float32(1.0), np.float32(0.0), np.float32(0.0), np.float32(0.0), np.float32(0.0), np.float32(1.0), np.float32(0.0), np.float32(0.0), np.float32(1.0), np.float32(0.0), np.float32(1.0), np.float32(1.0), np.float32(0.0), np.float32(1.0), np.float32(0.0)]",1.0,99597.0,24
2025-08-14_08-18-36,2597,"[np.float32(0.0), np.float32(1.0), np.float32(0.0), np.float32(0.0), np.float32(1.0), np.float32(1.0), np.float32(0.0), np.float32(0.0), np.float32(0.0), np.float32(1.0), np.float32(0.0), np.float32(1.0), np.float32(0.0), np.float32(1.0), np.float32(0.0), np.float32(0.0)]",-1.0,99596.0,30
2025-08-14_08-18-36,2598,"[np.float32(0.0), np.float32(0.0), np.float32(0.0), np.float32(1.0), np.float32(1.0), np.float32(1.0), np.float32(1.0), np.float32(1.0), np.float32(1.0), np.float32(1.0), np.float32(1.0), np.float32(0.0), np.float32(0.0), np.float32(1.0), np.float32(0.0), np.float32(1.0)]",1.0,99597.0,32
2025-08-14_08-18-36,2599,"[np.float32(0.0), np.float32(0.0), np.float32(0.0), np.float32(1.0), np.float32(0.0), np.float32(1.0), np.float32(0.0), np.float32(1.0), np.float32(1.0), np.float32(1.0), np.float32(1.0), np.float32(0.0), np.float32(0.0), np.float32(0.0), np.float32(0.0), np.float32(1.0)]",-2.0,99595.0,15
2025-08-14_08-18-36,2600,"[np.float32(0.0), np.float32(1.0), np.float32(1.0), np.float32(1.0), np.float32(1.0), np.float32(0.0), np.float32(1.0), np.float32(1.0), np.float32(0.0), np.float32(0.0), np.float32(1.0), np.float32(1.0), np.float32(0.0), np.float32(0.0), np.float32(0.0), np.float32(1.0)]",-2.0,99593.0,16
2025-08-14_08-18-36,2601,"[np.float32(1.0), np.float32(1.0), np.float32(1.0), np.float32(0.0), np.float32(1.0), np.float32(1.0), np.float32(1.0), np.float32(1.0), np.float32(0.0), np.float32(0.0), np.float32(0.0), np.float32(0.0), np.float32(1.0), np.float32(0.0), np.float32(1.0), np.float32(0.0)]",-2.0,99591.0,3
2025-08-14_08-18-36,2602,"[np.float32(1.0), np.float32(1.0), np.float32(0.0), np.float32(1.0), np.float32(1.0), np.float32(1.0), np.float32(0.0), np.float32(1.0), np.float32(0.0), np.float32(0.0), np.float32(1.0), np.float32(1.0), np.float32(1.0), np.float32(1.0), np.float32(1.0), np.float32(0.0)]",-4.0,99587.0,0
2025-08-14_08-18-36,2603,"[np.float32(0.0), np.float32(0.0), np.float32(1.0), np.float32(1.0), np.float32(1.0), np.float32(1.0), np.float32(0.0), np.float32(1.0), np.float32(0.0), np.float32(1.0), np.float32(0.0), np.float32(0.0), np.float32(0.0), np.float32(1.0), np.float32(1.0), np.float32(1.0)]",1.0,99588.0,20
2025-08-14_08-18-36,2604,"[np.float32(0.0), np.float32(0.0), np.float32(1.0), np.float32(0.0), np.float32(0.0), np.float32(0.0), np.float32(1.0), np.float32(1.0), np.float32(0.0), np.float32(1.0), np.float32(0.0), np.float32(0.0), np.float32(1.0), np.float32(0.0), np.float32(0.0), np.float32(0.0)]",-2.0,99586.0,21
2025-08-14_08-18-36,2605,"[np.float32(0.0), np.float32(1.0), np.float32(1.0), np.float32(1.0), np.float32(1.0), np.float32(1.0), np.float32(0.0), np.float32(1.0), np.float32(0.0), np.float32(0.0), np.float32(1.0), np.float32(1.0), np.float32(1.0), np.float32(0.0), np.float32(0.0), np.float32(0.0)]",3.0,99589.0,20
2025-08-14_08-18-36,2606,"[np.float32(1.0), np.float32(1.0), np.float32(1.0), np.float32(0.0), np.float32(0.0), np.float32(0.0), np.float32(0.0), np.float32(1.0), np.float32(0.0), np.float32(0.0), np.float32(0.0), np.float32(1.0), np.float32(1.0), np.float32(0.0), np.float32(0.0), np.float32(1.0)]",1.0,99590.0,21
2025-08-14_08-18-36,2607,"[np.float32(0.0), np.float32(0.0), np.float32(1.0), np.float32(0.0), np.float32(0.0), np.float32(0.0), np.float32(1.0), np.float32(0.0), np.float32(0.0), np.float32(0.0), np.float32(0.0), np.float32(1.0), np.float32(1.0), np.float32(1.0), np.float32(0.0), np.float32(0.0)]",0.0,99590.0,0
2025-08-14_08-18-36,2608,"[np.float32(0.0), np.float32(0.0), np.float32(1.0), np.float32(1.0), np.float32(0.0), np.float32(1.0), np.float32(1.0), np.float32(0.0), np.float32(1.0), np.float32(1.0), np.float32(0.0), np.float32(0.0), np.float32(1.0), np.float32(0.0), np.float32(0.0), np.float32(0.0)]",3.0,99593.0,28
2025-08-14_08-18-36,2609,"[np.float32(1.0), np.float32(0.0), np.float32(1.0), np.float32(1.0), np.float32(1.0), np.float32(1.0), np.float32(1.0), np.float32(1.0), np.float32(0.0), np.float32(0.0), np.float32(0.0), np.float32(1.0), np.float32(0.0), np.float32(0.0), np.float32(0.0), np.float32(0.0)]",4.0,99597.0,18
2025-08-14_08-18-36,2610,"[np.float32(0.0), np.float32(0.0), np.float32(0.0), np.float32(1.0), np.float32(1.0), np.float32(0.0), np.float32(0.0), np.float32(1.0), np.float32(0.0), np.float32(1.0), np.float32(0.0), np.float32(1.0), np.float32(0.0), np.float32(1.0), np.float32(0.0), np.float32(1.0)]",1.0,99598.0,16
2025-08-14_08-18-36,2611,"[np.float32(1.0), np.float32(0.0), np.float32(0.0), np.float32(0.0), np.float32(1.0), np.float32(0.0), np.float32(0.0), np.float32(0.0), np.float32(1.0), np.float32(1.0), np.float32(1.0), np.float32(1.0), np.float32(1.0), np.float32(1.0), np.float32(1.0), np.float32(1.0)]",-2.0,99596.0,10
2025-08-14_08-18-36,2612,"[np.float32(1.0), np.float32(0.0), np.float32(1.0), np.float32(1.0), np.float32(1.0), np.float32(0.0), np.float32(0.0), np.float32(1.0), np.float32(1.0), np.float32(0.0), np.float32(0.0), np.float32(0.0), np.float32(0.0), np.float32(0.0), np.float32(1.0), np.float32(1.0)]",-1.0,99595.0,32
2025-08-14_08-18-36,2613,"[np.float32(1.0), np.float32(0.0), np.float32(1.0), np.float32(1.0), np.float32(0.0), np.float32(0.0), np.float32(0.0), np.float32(0.0), np.float32(0.0), np.float32(0.0), np.float32(1.0), np.float32(0.0), np.float32(1.0), np.float32(0.0), np.float32(0.0), np.float32(1.0)]",1.0,99596.0,5
2025-08-14_08-18-36,2614,"[np.float32(1.0), np.float32(0.0), np.float32(1.0), np.float32(1.0), np.float32(0.0), np.float32(1.0), np.float32(1.0), np.float32(0.0), np.float32(0.0), np.float32(1.0), np.float32(1.0), np.float32(0.0), np.float32(1.0), np.float32(0.0), np.float32(1.0), np.float32(0.0)]",-2.0,99594.0,24
2025-08-14_08-18-36,2615,"[np.float32(1.0), np.float32(0.0), np.float32(0.0), np.float32(0.0), np.float32(0.0), np.float32(1.0), np.float32(1.0), np.float32(1.0), np.float32(0.0), np.float32(1.0), np.float32(0.0), np.float32(1.0), np.float32(1.0), np.float32(0.0), np.float32(0.0), np.float32(1.0)]",2.0,99596.0,34
2025-08-14_08-18-36,2616,"[np.float32(0.0), np.float32(1.0), np.float32(0.0), np.float32(1.0), np.float32(0.0), np.float32(0.0), np.float32(1.0), np.float32(1.0), np.float32(0.0), np.float32(0.0), np.float32(0.0), np.float32(0.0), np.float32(1.0), np.float32(0.0), np.float32(1.0), np.float32(0.0)]",0.0,99596.0,16
2025-08-14_08-18-36,2617,"[np.float32(1.0), np.float32(1.0), np.float32(0.0), np.float32(1.0), np.float32(0.0), np.float32(1.0), np.float32(1.0), np.float32(1.0), np.float32(1.0), np.float32(0.0), np.float32(0.0), np.float32(0.0), np.float32(1.0), np.float32(0.0), np.float32(0.0), np.float32(0.0)]",-1.0,99595.0,32
2025-08-14_08-18-36,2618,"[np.float32(1.0), np.float32(0.0), np.float32(0.0), np.float32(0.0), np.float32(1.0), np.float32(0.0), np.float32(1.0), np.float32(1.0), np.float32(0.0), np.float32(1.0), np.float32(1.0), np.float32(0.0), np.float32(0.0), np.float32(1.0), np.float32(0.0), np.float32(0.0)]",-4.0,99591.0,24
2025-08-14_08-18-36,2619,"[np.float32(1.0), np.float32(0.0), np.float32(0.0), np.float32(0.0), np.float32(0.0), np.float32(1.0), np.float32(1.0), np.float32(0.0), np.float32(0.0), np.float32(0.0), np.float32(1.0), np.float32(0.0), np.float32(0.0), np.float32(0.0), np.float32(0.0), np.float32(0.0)]",4.0,99595.0,5
2025-08-14_08-18-36,2620,"[np.float32(1.0), np.float32(0.0), np.float32(0.0), np.float32(0.0), np.float32(0.0), np.float32(1.0), np.float32(1.0), np.float32(0.0), np.float32(1.0), np.float32(1.0), np.float32(0.0), np.float32(0.0), np.float32(1.0), np.float32(1.0), np.float32(0.0), np.float32(0.0)]",0.0,99595.0,36
2025-08-14_08-18-36,2621,"[np.float32(0.0), np.float32(1.0), np.float32(0.0), np.float32(1.0), np.float32(1.0), np.float32(1.0), np.float32(1.0), np.float32(0.0), np.float32(1.0), np.float32(1.0), np.float32(1.0), np.float32(1.0), np.float32(1.0), np.float32(1.0), np.float32(0.0), np.float32(0.0)]",2.0,99597.0,26
2025-08-14_08-18-36,2622,"[np.float32(1.0), np.float32(1.0), np.float32(1.0), np.float32(1.0), np.float32(0.0), np.float32(1.0), np.float32(1.0), np.float32(0.0), np.float32(0.0), np.float32(0.0), np.float32(0.0), np.float32(0.0), np.float32(0.0), np.float32(1.0), np.float32(1.0), np.float32(0.0)]",1.0,99598.0,29
2025-08-14_08-18-36,2623,"[np.float32(0.0), np.float32(0.0), np.float32(0.0), np.float32(1.0), np.float32(1.0), np.float32(0.0), np.float32(0.0), np.float32(1.0), np.float32(1.0), np.float32(1.0), np.float32(1.0), np.float32(0.0), np.float32(0.0), np.float32(0.0), np.float32(1.0), np.float32(0.0)]",-1.0,99597.0,26
2025-08-14_08-18-36,2624,"[np.float32(1.0), np.float32(1.0), np.float32(1.0), np.float32(1.0), np.float32(1.0), np.float32(0.0), np.float32(1.0), np.float32(0.0), np.float32(1.0), np.float32(1.0), np.float32(1.0), np.float32(1.0), np.float32(1.0), np.float32(1.0), np.float32(0.0), np.float32(0.0)]",-2.0,99595.0,30
2025-08-14_08-18-36,2625,"[np.float32(0.0), np.float32(0.0), np.float32(1.0), np.float32(1.0), np.float32(0.0), np.float32(1.0), np.float32(0.0), np.float32(0.0), np.float32(1.0), np.float32(1.0), np.float32(0.0), np.float32(1.0), np.float32(0.0), np.float32(0.0), np.float32(1.0), np.float32(1.0)]",0.0,99595.0,10
2025-08-14_08-18-36,2626,"[np.float32(0.0), np.float32(1.0), np.float32(1.0), np.float32(1.0), np.float32(0.0), np.float32(1.0), np.float32(0.0), np.float32(0.0), np.float32(0.0), np.float32(0.0), np.float32(0.0), np.float32(0.0), np.float32(0.0), np.float32(1.0), np.float32(0.0), np.float32(1.0)]",0.0,99595.0,24
2025-08-14_08-18-36,2627,"[np.float32(1.0), np.float32(1.0), np.float32(1.0), np.float32(0.0), np.float32(1.0), np.float32(0.0), np.float32(0.0), np.float32(1.0), np.float32(0.0), np.float32(1.0), np.float32(0.0), np.float32(0.0), np.float32(1.0), np.float32(0.0), np.float32(1.0), np.float32(0.0)]",35.0,99630.0,7
2025-08-14_08-18-36,2628,"[np.float32(0.0), np.float32(1.0), np.float32(0.0), np.float32(1.0), np.float32(1.0), np.float32(1.0), np.float32(1.0), np.float32(1.0), np.float32(0.0), np.float32(1.0), np.float32(0.0), np.float32(0.0), np.float32(1.0), np.float32(1.0), np.float32(1.0), np.float32(0.0)]",0.0,99630.0,24
2025-08-14_08-18-36,2629,"[np.float32(0.0), np.float32(1.0), np.float32(0.0), np.float32(1.0), np.float32(0.0), np.float32(1.0), np.float32(0.0), np.float32(0.0), np.float32(0.0), np.float32(0.0), np.float32(0.0), np.float32(1.0), np.float32(0.0), np.float32(1.0), np.float32(0.0), np.float32(0.0)]",-5.0,99625.0,16
2025-08-14_08-18-36,2630,"[np.float32(0.0), np.float32(0.0), np.float32(1.0), np.float32(0.0), np.float32(1.0), np.float32(0.0), np.float32(1.0), np.float32(1.0), np.float32(1.0), np.float32(1.0), np.float32(1.0), np.float32(0.0), np.float32(1.0), np.float32(1.0), np.float32(0.0), np.float32(0.0)]",-2.0,99623.0,6
2025-08-14_08-18-36,2631,"[np.float32(0.0), np.float32(1.0), np.float32(1.0), np.float32(0.0), np.float32(0.0), np.float32(0.0), np.float32(0.0), np.float32(1.0), np.float32(1.0), np.float32(0.0), np.float32(0.0), np.float32(0.0), np.float32(1.0), np.float32(0.0), np.float32(1.0), np.float32(0.0)]",30.0,99653.0,7
2025-08-14_08-18-36,2632,"[np.float32(0.0), np.float32(0.0), np.float32(0.0), np.float32(1.0), np.float32(1.0), np.float32(1.0), np.float32(0.0), np.float32(0.0), np.float32(1.0), np.float32(1.0), np.float32(0.0), np.float32(0.0), np.float32(1.0), np.float32(1.0), np.float32(1.0), np.float32(1.0)]",1.0,99654.0,1
2025-08-14_08-18-36,2633,"[np.float32(1.0), np.float32(0.0), np.float32(0.0), np.float32(1.0), np.float32(0.0), np.float32(0.0), np.float32(1.0), np.float32(0.0), np.float32(1.0), np.float32(0.0), np.float32(1.0), np.float32(0.0), np.float32(0.0), np.float32(0.0), np.float32(1.0), np.float32(0.0)]",0.0,99654.0,26
2025-08-14_08-18-36,2634,"[np.float32(0.0), np.float32(0.0), np.float32(1.0), np.float32(1.0), np.float32(0.0), np.float32(1.0), np.float32(0.0), np.float32(1.0), np.float32(1.0), np.float32(1.0), np.float32(0.0), np.float32(0.0), np.float32(1.0), np.float32(0.0), np.float32(1.0), np.float32(1.0)]",1.0,99655.0,24
2025-08-14_08-18-36,2635,"[np.float32(1.0), np.float32(0.0), np.float32(0.0), np.float32(1.0), np.float32(1.0), np.float32(1.0), np.float32(0.0), np.float32(0.0), np.float32(0.0), np.float32(1.0), np.float32(1.0), np.float32(1.0), np.float32(0.0), np.float32(0.0), np.float32(0.0), np.float32(0.0)]",2.0,99657.0,7
2025-08-14_08-18-36,2636,"[np.float32(0.0), np.float32(0.0), np.float32(0.0), np.float32(1.0), np.float32(1.0), np.float32(0.0), np.float32(0.0), np.float32(1.0), np.float32(0.0), np.float32(0.0), np.float32(1.0), np.float32(1.0), np.float32(0.0), np.float32(1.0), np.float32(1.0), np.float32(0.0)]",1.0,99658.0,16
2025-08-14_08-18-36,2637,"[np.float32(1.0), np.float32(0.0), np.float32(0.0), np.float32(1.0), np.float32(0.0), np.float32(1.0), np.float32(0.0), np.float32(0.0), np.float32(0.0), np.float32(1.0), np.float32(0.0), np.float32(0.0), np.float32(1.0), np.float32(0.0), np.float32(0.0), np.float32(1.0)]",4.0,99662.0,31
2025-08-14_08-18-36,2638,"[np.float32(1.0), np.float32(0.0), np.float32(1.0), np.float32(1.0), np.float32(0.0), np.float32(0.0), np.float32(0.0), np.float32(0.0), np.float32(0.0), np.float32(0.0), np.float32(0.0), np.float32(1.0), np.float32(1.0), np.float32(1.0), np.float32(0.0), np.float32(0.0)]",4.0,99666.0,18
2025-08-14_08-18-36,2639,"[np.float32(0.0), np.float32(0.0), np.float32(1.0), np.float32(0.0), np.float32(0.0), np.float32(0.0), np.float32(1.0), np.float32(0.0), np.float32(1.0), np.float32(0.0), np.float32(1.0), np.float32(1.0), np.float32(0.0), np.float32(1.0), np.float32(1.0), np.float32(1.0)]",3.0,99669.0,6
2025-08-14_08-18-36,2640,"[np.float32(0.0), np.float32(0.0), np.float32(1.0), np.float32(0.0), np.float32(0.0), np.float32(1.0), np.float32(0.0), np.float32(1.0), np.float32(1.0), np.float32(0.0), np.float32(1.0), np.float32(1.0), np.float32(0.0), np.float32(1.0), np.float32(1.0), np.float32(1.0)]",-1.0,99668.0,31
2025-08-14_08-18-36,2641,"[np.float32(0.0), np.float32(0.0), np.float32(1.0), np.float32(1.0), np.float32(1.0), np.float32(1.0), np.float32(0.0), np.float32(0.0), np.float32(0.0), np.float32(1.0), np.float32(1.0), np.float32(0.0), np.float32(1.0), np.float32(0.0), np.float32(0.0), np.float32(0.0)]",0.0,99668.0,29
2025-08-14_08-18-36,2642,"[np.float32(0.0), np.float32(0.0), np.float32(1.0), np.float32(0.0), np.float32(0.0), np.float32(1.0), np.float32(0.0), np.float32(1.0), np.float32(0.0), np.float32(0.0), np.float32(1.0), np.float32(0.0), np.float32(1.0), np.float32(1.0), np.float32(0.0), np.float32(0.0)]",-6.0,99662.0,1
2025-08-14_08-18-36,2643,"[np.float32(1.0), np.float32(1.0), np.float32(0.0), np.float32(0.0), np.float32(1.0), np.float32(1.0), np.float32(0.0), np.float32(0.0), np.float32(1.0), np.float32(1.0), np.float32(1.0), np.float32(0.0), np.float32(1.0), np.float32(0.0), np.float32(1.0), np.float32(0.0)]",1.0,99663.0,35
2025-08-14_08-18-36,2644,"[np.float32(0.0), np.float32(0.0), np.float32(1.0), np.float32(1.0), np.float32(1.0), np.float32(1.0), np.float32(0.0), np.float32(1.0), np.float32(1.0), np.float32(0.0), np.float32(1.0), np.float32(0.0), np.float32(1.0), np.float32(0.0), np.float32(0.0), np.float32(1.0)]",-2.0,99661.0,8
2025-08-14_08-18-36,2645,"[np.float32(1.0), np.float32(0.0), np.float32(1.0), np.float32(1.0), np.float32(0.0), np.float32(1.0), np.float32(0.0), np.float32(0.0), np.float32(0.0), np.float32(0.0), np.float32(0.0), np.float32(0.0), np.float32(0.0), np.float32(0.0), np.float32(1.0), np.float32(0.0)]",1.0,99662.0,34
2025-08-14_08-18-36,2646,"[np.float32(1.0), np.float32(0.0), np.float32(1.0), np.float32(1.0), np.float32(0.0), np.float32(0.0), np.float32(0.0), np.float32(1.0), np.float32(1.0), np.float32(0.0), np.float32(0.0), np.float32(0.0), np.float32(0.0), np.float32(1.0), np.float32(0.0), np.float32(1.0)]",-2.0,99660.0,0
2025-08-14_08-18-36,2647,"[np.float32(0.0), np.float32(0.0), np.float32(0.0), np.float32(1.0), np.float32(0.0), np.float32(0.0), np.float32(0.0), np.float32(1.0), np.float32(0.0), np.float32(1.0), np.float32(0.0), np.float32(0.0), np.float32(1.0), np.float32(0.0), np.float32(0.0), np.float32(0.0)]",-1.0,99659.0,24
2025-08-14_08-18-36,2648,"[np.float32(0.0), np.float32(0.0), np.float32(1.0), np.float32(1.0), np.float32(0.0), np.float32(1.0), np.float32(0.0), np.float32(0.0), np.float32(1.0), np.float32(0.0), np.float32(1.0), np.float32(0.0), np.float32(0.0), np.float32(0.0), np.float32(0.0), np.float32(1.0)]",-1.0,99658.0,9
2025-08-14_08-18-36,2649,"[np.float32(1.0), np.float32(0.0), np.float32(0.0), np.float32(1.0), np.float32(1.0), np.float32(0.0), np.float32(1.0), np.float32(0.0), np.float32(0.0), np.float32(1.0), np.float32(0.0), np.float32(0.0), np.float32(1.0), np.float32(1.0), np.float32(0.0), np.float32(0.0)]",4.0,99662.0,4
2025-08-14_08-18-36,2650,"[np.float32(0.0), np.float32(0.0), np.float32(0.0), np.float32(1.0), np.float32(0.0), np.float32(0.0), np.float32(0.0), np.float32(1.0), np.float32(1.0), np.float32(1.0), np.float32(0.0), np.float32(1.0), np.float32(0.0), np.float32(1.0), np.float32(0.0), np.float32(0.0)]",-1.0,99661.0,17
2025-08-14_08-18-36,2651,"[np.float32(0.0), np.float32(1.0), np.float32(1.0), np.float32(1.0), np.float32(0.0), np.float32(1.0), np.float32(0.0), np.float32(0.0), np.float32(0.0), np.float32(1.0), np.float32(0.0), np.float32(0.0), np.float32(1.0), np.float32(0.0), np.float32(1.0), np.float32(0.0)]",1.0,99662.0,16
2025-08-14_08-18-36,2652,"[np.float32(1.0), np.float32(1.0), np.float32(0.0), np.float32(0.0), np.float32(0.0), np.float32(1.0), np.float32(0.0), np.float32(1.0), np.float32(1.0), np.float32(0.0), np.float32(0.0), np.float32(0.0), np.float32(0.0), np.float32(0.0), np.float32(0.0), np.float32(0.0)]",0.0,99662.0,16
2025-08-14_08-18-36,2653,"[np.float32(1.0), np.float32(1.0), np.float32(0.0), np.float32(0.0), np.float32(0.0), np.float32(0.0), np.float32(0.0), np.float32(0.0), np.float32(1.0), np.float32(0.0), np.float32(1.0), np.float32(1.0), np.float32(0.0), np.float32(0.0), np.float32(1.0), np.float32(0.0)]",-4.0,99658.0,4
2025-08-14_08-18-36,2654,"[np.float32(0.0), np.float32(1.0), np.float32(1.0), np.float32(1.0), np.float32(1.0), np.float32(0.0), np.float32(0.0), np.float32(1.0), np.float32(0.0), np.float32(0.0), np.float32(0.0), np.float32(0.0), np.float32(1.0), np.float32(1.0), np.float32(1.0), np.float32(0.0)]",-1.0,99657.0,33
2025-08-14_08-18-36,2655,"[np.float32(0.0), np.float32(0.0), np.float32(1.0), np.float32(1.0), np.float32(1.0), np.float32(1.0), np.float32(0.0), np.float32(1.0), np.float32(1.0), np.float32(0.0), np.float32(1.0), np.float32(0.0), np.float32(1.0), np.float32(0.0), np.float32(0.0), np.float32(0.0)]",-4.0,99653.0,4
2025-08-14_08-18-36,2656,"[np.float32(1.0), np.float32(0.0), np.float32(1.0), np.float32(1.0), np.float32(0.0), np.float32(1.0), np.float32(0.0), np.float32(0.0), np.float32(0.0), np.float32(1.0), np.float32(1.0), np.float32(0.0), np.float32(1.0), np.float32(1.0), np.float32(1.0), np.float32(1.0)]",0.0,99653.0,31
2025-08-14_08-18-36,2657,"[np.float32(1.0), np.float32(1.0), np.float32(0.0), np.float32(0.0), np.float32(0.0), np.float32(0.0), np.float32(0.0), np.float32(1.0), np.float32(1.0), np.float32(1.0), np.float32(1.0), np.float32(0.0), np.float32(1.0), np.float32(1.0), np.float32(1.0), np.float32(1.0)]",1.0,99654.0,23
2025-08-14_08-18-36,2658,"[np.float32(0.0), np.float32(0.0), np.float32(1.0), np.float32(0.0), np.float32(1.0), np.float32(1.0), np.float32(1.0), np.float32(0.0), np.float32(0.0), np.float32(0.0), np.float32(1.0), np.float32(0.0), np.float32(1.0), np.float32(0.0), np.float32(1.0), np.float32(0.0)]",-3.0,99651.0,22
2025-08-14_08-18-36,2659,"[np.float32(0.0), np.float32(0.0), np.float32(0.0), np.float32(0.0), np.float32(0.0), np.float32(1.0), np.float32(0.0), np.float32(0.0), np.float32(0.0), np.float32(1.0), np.float32(1.0), np.float32(0.0), np.float32(1.0), np.float32(0.0), np.float32(1.0), np.float32(0.0)]",-5.0,99646.0,3
2025-08-14_08-18-36,2660,"[np.float32(1.0), np.float32(1.0), np.float32(1.0), np.float32(0.0), np.float32(0.0), np.float32(1.0), np.float32(0.0), np.float32(1.0), np.float32(0.0), np.float32(1.0), np.float32(0.0), np.float32(1.0), np.float32(1.0), np.float32(1.0), np.float32(0.0), np.float32(1.0)]",34.0,99680.0,7
2025-08-14_08-18-36,2661,"[np.float32(1.0), np.float32(1.0), np.float32(0.0), np.float32(1.0), np.float32(0.0), np.float32(0.0), np.float32(1.0), np.float32(1.0), np.float32(1.0), np.float32(1.0), np.float32(0.0), np.float32(1.0), np.float32(1.0), np.float32(0.0), np.float32(0.0), np.float32(0.0)]",37.0,99717.0,7
2025-08-14_08-18-36,2662,"[np.float32(1.0), np.float32(0.0), np.float32(0.0), np.float32(0.0), np.float32(0.0), np.float32(0.0), np.float32(1.0), np.float32(1.0), np.float32(0.0), np.float32(1.0), np.float32(1.0), np.float32(1.0), np.float32(0.0), np.float32(0.0), np.float32(0.0), np.float32(0.0)]",-1.0,99716.0,30
2025-08-14_08-18-36,2663,"[np.float32(0.0), np.float32(0.0), np.float32(0.0), np.float32(0.0), np.float32(0.0), np.float32(1.0), np.float32(1.0), np.float32(1.0), np.float32(1.0), np.float32(0.0), np.float32(1.0), np.float32(0.0), np.float32(0.0), np.float32(0.0), np.float32(1.0), np.float32(0.0)]",2.0,99718.0,29
2025-08-14_08-18-36,2664,"[np.float32(0.0), np.float32(0.0), np.float32(1.0), np.float32(1.0), np.float32(0.0), np.float32(1.0), np.float32(0.0), np.float32(0.0), np.float32(1.0), np.float32(0.0), np.float32(1.0), np.float32(0.0), np.float32(0.0), np.float32(0.0), np.float32(0.0), np.float32(1.0)]",-1.0,99717.0,11
2025-08-14_08-18-36,2665,"[np.float32(1.0), np.float32(1.0), np.float32(1.0), np.float32(1.0), np.float32(0.0), np.float32(1.0), np.float32(0.0), np.float32(0.0), np.float32(1.0), np.float32(1.0), np.float32(1.0), np.float32(1.0), np.float32(1.0), np.float32(1.0), np.float32(0.0), np.float32(0.0)]",-1.0,99716.0,4
2025-08-14_08-18-36,2666,"[np.float32(1.0), np.float32(1.0), np.float32(0.0), np.float32(1.0), np.float32(0.0), np.float32(1.0), np.float32(1.0), np.float32(0.0), np.float32(1.0), np.float32(0.0), np.float32(1.0), np.float32(1.0), np.float32(1.0), np.float32(1.0), np.float32(0.0), np.float32(0.0)]",-3.0,99713.0,1
2025-08-14_08-18-36,2667,"[np.float32(1.0), np.float32(1.0), np.float32(1.0), np.float32(1.0), np.float32(0.0), np.float32(1.0), np.float32(0.0), np.float32(1.0), np.float32(1.0), np.float32(1.0), np.float32(0.0), np.float32(1.0), np.float32(1.0), np.float32(1.0), np.float32(0.0), np.float32(1.0)]",-5.0,99708.0,10
2025-08-14_08-18-36,2668,"[np.float32(0.0), np.float32(0.0), np.float32(0.0), np.float32(1.0), np.float32(1.0), np.float32(1.0), np.float32(0.0), np.float32(0.0), np.float32(1.0), np.float32(1.0), np.float32(0.0), np.float32(0.0), np.float32(0.0), np.float32(0.0), np.float32(1.0), np.float32(1.0)]",3.0,99711.0,13
2025-08-14_08-18-36,2669,"[np.float32(1.0), np.float32(1.0), np.float32(1.0), np.float32(0.0), np.float32(0.0), np.float32(1.0), np.float32(0.0), np.float32(1.0), np.float32(0.0), np.float32(0.0), np.float32(0.0), np.float32(0.0), np.float32(0.0), np.float32(0.0), np.float32(0.0), np.float32(0.0)]",4.0,99715.0,24
2025-08-14_08-18-36,2670,"[np.float32(0.0), np.float32(1.0), np.float32(1.0), np.float32(1.0), np.float32(1.0), np.float32(1.0), np.float32(0.0), np.float32(0.0), np.float32(0.0), np.float32(0.0), np.float32(0.0), np.float32(0.0), np.float32(0.0), np.float32(1.0), np.float32(0.0), np.float32(0.0)]",1.0,99716.0,18
2025-08-14_08-18-36,2671,"[np.float32(1.0), np.float32(1.0), np.float32(0.0), np.float32(0.0), np.float32(0.0), np.float32(1.0), np.float32(1.0), np.float32(1.0), np.float32(1.0), np.float32(1.0), np.float32(0.0), np.float32(1.0), np.float32(0.0), np.float32(0.0), np.float32(1.0), np.float32(0.0)]",-1.0,99715.0,9
2025-08-14_08-18-36,2672,"[np.float32(0.0), np.float32(1.0), np.float32(0.0), np.float32(1.0), np.float32(1.0), np.float32(0.0), np.float32(1.0), np.float32(0.0), np.float32(0.0), np.float32(1.0), np.float32(0.0), np.float32(0.0), np.float32(0.0), np.float32(0.0), np.float32(0.0), np.float32(0.0)]",0.0,99715.0,19
2025-08-14_08-18-36,2673,"[np.float32(1.0), np.float32(0.0), np.float32(1.0), np.float32(0.0), np.float32(0.0), np.float32(0.0), np.float32(1.0), np.float32(0.0), np.float32(1.0), np.float32(1.0), np.float32(0.0), np.float32(0.0), np.float32(1.0), np.float32(0.0), np.float32(0.0), np.float32(0.0)]",-1.0,99714.0,22
2025-08-14_08-18-36,2674,"[np.float32(1.0), np.float32(0.0), np.float32(1.0), np.float32(0.0), np.float32(1.0), np.float32(0.0), np.float32(1.0), np.float32(1.0), np.float32(1.0), np.float32(1.0), np.float32(0.0), np.float32(0.0), np.float32(1.0), np.float32(1.0), np.float32(1.0), np.float32(0.0)]",1.0,99715.0,19
2025-08-14_08-18-36,2675,"[np.float32(1.0), np.float32(1.0), np.float32(0.0), np.float32(0.0), np.float32(0.0), np.float32(0.0), np.float32(1.0), np.float32(1.0), np.float32(0.0), np.float32(1.0), np.float32(1.0), np.float32(0.0), np.float32(0.0), np.float32(1.0), np.float32(0.0), np.float32(1.0)]",-6.0,99709.0,27
2025-08-14_08-18-36,2676,"[np.float32(0.0), np.float32(1.0), np.float32(0.0), np.float32(0.0), np.float32(0.0), np.float32(0.0), np.float32(0.0), np.float32(1.0), np.float32(0.0), np.float32(0.0), np.float32(1.0), np.float32(1.0), np.float32(1.0), np.float32(1.0), np.float32(1.0), np.float32(0.0)]",-7.0,99702.0,1
2025-08-14_08-18-36,2677,"[np.float32(1.0), np.float32(1.0), np.float32(0.0), np.float32(1.0), np.float32(1.0), np.float32(1.0), np.float32(1.0), np.float32(0.0), np.float32(1.0), np.float32(0.0), np.float32(0.0), np.float32(0.0), np.float32(1.0), np.float32(1.0), np.float32(1.0), np.float32(1.0)]",1.0,99703.0,9
2025-08-14_08-18-36,2678,"[np.float32(0.0), np.float32(0.0), np.float32(1.0), np.float32(1.0), np.float32(1.0), np.float32(0.0), np.float32(1.0), np.float32(1.0), np.float32(1.0), np.float32(1.0), np.float32(1.0), np.float32(0.0), np.float32(1.0), np.float32(1.0), np.float32(1.0), np.float32(0.0)]",-1.0,99702.0,15
2025-08-14_08-18-36,2679,"[np.float32(1.0), np.float32(1.0), np.float32(1.0), np.float32(0.0), np.float32(0.0), np.float32(1.0), np.float32(0.0), np.float32(1.0), np.float32(1.0), np.float32(0.0), np.float32(0.0), np.float32(1.0), np.float32(0.0), np.float32(0.0), np.float32(0.0), np.float32(0.0)]",0.0,99702.0,35
2025-08-14_08-18-36,2680,"[np.float32(0.0), np.float32(0.0), np.float32(1.0), np.float32(0.0), np.float32(0.0), np.float32(1.0), np.float32(1.0), np.float32(0.0), np.float32(1.0), np.float32(0.0), np.float32(1.0), np.float32(0.0), np.float32(1.0), np.float32(1.0), np.float32(0.0), np.float32(0.0)]",-2.0,99700.0,19
2025-08-14_08-18-36,2681,"[np.float32(0.0), np.float32(0.0), np.float32(1.0), np.float32(0.0), np.float32(0.0), np.float32(1.0), np.float32(0.0), np.float32(1.0), np.float32(0.0), np.float32(0.0), np.float32(1.0), np.float32(0.0), np.float32(1.0), np.float32(0.0), np.float32(1.0), np.float32(0.0)]",1.0,99701.0,26
2025-08-14_08-18-36,2682,"[np.float32(0.0), np.float32(1.0), np.float32(0.0), np.float32(0.0), np.float32(1.0), np.float32(0.0), np.float32(1.0), np.float32(1.0), np.float32(0.0), np.float32(1.0), np.float32(0.0), np.float32(0.0), np.float32(0.0), np.float32(0.0), np.float32(0.0), np.float32(1.0)]",4.0,99705.0,4
2025-08-14_08-18-36,2683,"[np.float32(0.0), np.float32(0.0), np.float32(0.0), np.float32(0.0), np.float32(0.0), np.float32(1.0), np.float32(1.0), np.float32(0.0), np.float32(0.0), np.float32(0.0), np.float32(1.0), np.float32(0.0), np.float32(0.0), np.float32(1.0), np.float32(0.0), np.float32(0.0)]",1.0,99706.0,0
2025-08-14_08-18-36,2684,"[np.float32(1.0), np.float32(0.0), np.float32(1.0), np.float32(1.0), np.float32(0.0), np.float32(0.0), np.float32(0.0), np.float32(0.0), np.float32(0.0), np.float32(0.0), np.float32(0.0), np.float32(1.0), np.float32(0.0), np.float32(0.0), np.float32(0.0), np.float32(1.0)]",2.0,99708.0,30
2025-08-14_08-18-36,2685,"[np.float32(1.0), np.float32(1.0), np.float32(1.0), np.float32(1.0), np.float32(0.0), np.float32(1.0), np.float32(0.0), np.float32(0.0), np.float32(0.0), np.float32(0.0), np.float32(0.0), np.float32(1.0), np.float32(1.0), np.float32(0.0), np.float32(0.0), np.float32(1.0)]",-1.0,99707.0,17
2025-08-14_08-18-36,2686,"[np.float32(0.0), np.float32(1.0), np.float32(0.0), np.float32(0.0), np.float32(1.0), np.float32(0.0), np.float32(0.0), np.float32(0.0), np.float32(1.0), np.float32(0.0), np.float32(0.0), np.float32(0.0), np.float32(1.0), np.float32(1.0), np.float32(1.0), np.float32(1.0)]",1.0,99708.0,26
2025-08-14_08-18-36,2687,"[np.float32(1.0), np.float32(0.0), np.float32(1.0), np.float32(1.0), np.float32(1.0), np.float32(0.0), np.float32(1.0), np.float32(1.0), np.float32(1.0), np.float32(0.0), np.float32(1.0), np.float32(0.0), np.float32(0.0), np.float32(0.0), np.float32(1.0), np.float32(0.0)]",-1.0,99707.0,29
2025-08-14_08-18-36,2688,"[np.float32(1.0), np.float32(1.0), np.float32(1.0), np.float32(1.0), np.float32(0.0), np.float32(1.0), np.float32(0.0), np.float32(0.0), np.float32(1.0), np.float32(0.0), np.float32(1.0), np.float32(0.0), np.float32(0.0), np.float32(1.0), np.float32(1.0), np.float32(1.0)]",-1.0,99706.0,0
2025-08-14_08-18-36,2689,"[np.float32(1.0), np.float32(1.0), np.float32(0.0), np.float32(0.0), np.float32(1.0), np.float32(0.0), np.float32(0.0), np.float32(1.0), np.float32(1.0), np.float32(0.0), np.float32(0.0), np.float32(0.0), np.float32(1.0), np.float32(1.0), np.float32(1.0), np.float32(0.0)]",0.0,99706.0,24
2025-08-14_08-18-36,2690,"[np.float32(0.0), np.float32(1.0), np.float32(1.0), np.float32(1.0), np.float32(1.0), np.float32(1.0), np.float32(0.0), np.float32(0.0), np.float32(1.0), np.float32(0.0), np.float32(0.0), np.float32(0.0), np.float32(0.0), np.float32(0.0), np.float32(0.0), np.float32(0.0)]",1.0,99707.0,27
2025-08-14_08-18-36,2691,"[np.float32(0.0), np.float32(0.0), np.float32(0.0), np.float32(1.0), np.float32(0.0), np.float32(0.0), np.float32(0.0), np.float32(0.0), np.float32(1.0), np.float32(0.0), np.float32(1.0), np.float32(1.0), np.float32(0.0), np.float32(0.0), np.float32(0.0), np.float32(1.0)]",3.0,99710.0,31
2025-08-14_08-18-36,2692,"[np.float32(0.0), np.float32(0.0), np.float32(1.0), np.float32(1.0), np.float32(0.0), np.float32(0.0), np.float32(0.0), np.float32(0.0), np.float32(0.0), np.float32(1.0), np.float32(1.0), np.float32(1.0), np.float32(1.0), np.float32(1.0), np.float32(0.0), np.float32(1.0)]",0.0,99710.0,14
2025-08-14_08-18-36,2693,"[np.float32(0.0), np.float32(0.0), np.float32(0.0), np.float32(1.0), np.float32(0.0), np.float32(0.0), np.float32(0.0), np.float32(1.0), np.float32(1.0), np.float32(0.0), np.float32(0.0), np.float32(0.0), np.float32(0.0), np.float32(0.0), np.float32(0.0), np.float32(1.0)]",2.0,99712.0,20
2025-08-14_08-18-36,2694,"[np.float32(0.0), np.float32(0.0), np.float32(0.0), np.float32(0.0), np.float32(0.0), np.float32(0.0), np.float32(0.0), np.float32(1.0), np.float32(1.0), np.float32(1.0), np.float32(0.0), np.float32(0.0), np.float32(0.0), np.float32(1.0), np.float32(0.0), np.float32(1.0)]",-2.0,99710.0,30
2025-08-14_08-18-36,2695,"[np.float32(1.0), np.float32(1.0), np.float32(0.0), np.float32(0.0), np.float32(1.0), np.float32(1.0), np.float32(0.0), np.float32(0.0), np.float32(0.0), np.float32(1.0), np.float32(1.0), np.float32(1.0), np.float32(1.0), np.float32(0.0), np.float32(1.0), np.float32(1.0)]",0.0,99710.0,20
2025-08-14_08-18-36,2696,"[np.float32(1.0), np.float32(1.0), np.float32(1.0), np.float32(1.0), np.float32(0.0), np.float32(1.0), np.float32(0.0), np.float32(0.0), np.float32(1.0), np.float32(0.0), np.float32(0.0), np.float32(1.0), np.float32(0.0), np.float32(1.0), np.float32(1.0), np.float32(1.0)]",5.0,99715.0,30
2025-08-14_08-18-36,2697,"[np.float32(0.0), np.float32(0.0), np.float32(1.0), np.float32(1.0), np.float32(0.0), np.float32(1.0), np.float32(1.0), np.float32(0.0), np.float32(1.0), np.float32(1.0), np.float32(1.0), np.float32(0.0), np.float32(0.0), np.float32(0.0), np.float32(1.0), np.float32(0.0)]",2.0,99717.0,32
2025-08-14_08-18-36,2698,"[np.float32(0.0), np.float32(1.0), np.float32(0.0), np.float32(1.0), np.float32(1.0), np.float32(0.0), np.float32(1.0), np.float32(1.0), np.float32(1.0), np.float32(0.0), np.float32(1.0), np.float32(1.0), np.float32(1.0), np.float32(1.0), np.float32(0.0), np.float32(1.0)]",-1.0,99716.0,1
2025-08-14_08-18-36,2699,"[np.float32(1.0), np.float32(0.0), np.float32(1.0), np.float32(1.0), np.float32(0.0), np.float32(0.0), np.float32(1.0), np.float32(0.0), np.float32(1.0), np.float32(0.0), np.float32(0.0), np.float32(1.0), np.float32(1.0), np.float32(1.0), np.float32(0.0), np.float32(0.0)]",2.0,99718.0,32
2025-08-14_08-18-36,2700,"[np.float32(0.0), np.float32(1.0), np.float32(1.0), np.float32(1.0), np.float32(1.0), np.float32(1.0), np.float32(1.0), np.float32(1.0), np.float32(1.0), np.float32(0.0), np.float32(1.0), np.float32(0.0), np.float32(1.0), np.float32(1.0), np.float32(0.0), np.float32(0.0)]",4.0,99722.0,35
2025-08-14_08-18-36,2701,"[np.float32(1.0), np.float32(1.0), np.float32(0.0), np.float32(0.0), np.float32(1.0), np.float32(0.0), np.float32(0.0), np.float32(1.0), np.float32(1.0), np.float32(0.0), np.float32(0.0), np.float32(0.0), np.float32(0.0), np.float32(1.0), np.float32(1.0), np.float32(1.0)]",-1.0,99721.0,10
2025-08-14_08-18-36,2702,"[np.float32(1.0), np.float32(0.0), np.float32(0.0), np.float32(1.0), np.float32(1.0), np.float32(1.0), np.float32(1.0), np.float32(0.0), np.float32(1.0), np.float32(1.0), np.float32(1.0), np.float32(0.0), np.float32(1.0), np.float32(0.0), np.float32(0.0), np.float32(0.0)]",-2.0,99719.0,30
2025-08-14_08-18-36,2703,"[np.float32(1.0), np.float32(1.0), np.float32(0.0), np.float32(0.0), np.float32(1.0), np.float32(1.0), np.float32(0.0), np.float32(1.0), np.float32(1.0), np.float32(1.0), np.float32(0.0), np.float32(1.0), np.float32(0.0), np.float32(0.0), np.float32(0.0), np.float32(1.0)]",1.0,99720.0,28
2025-08-14_08-18-36,2704,"[np.float32(1.0), np.float32(0.0), np.float32(0.0), np.float32(1.0), np.float32(0.0), np.float32(1.0), np.float32(1.0), np.float32(0.0), np.float32(1.0), np.float32(0.0), np.float32(1.0), np.float32(0.0), np.float32(1.0), np.float32(0.0), np.float32(0.0), np.float32(1.0)]",-3.0,99717.0,12
2025-08-14_08-18-36,2705,"[np.float32(1.0), np.float32(1.0), np.float32(1.0), np.float32(0.0), np.float32(1.0), np.float32(0.0), np.float32(0.0), np.float32(1.0), np.float32(1.0), np.float32(1.0), np.float32(1.0), np.float32(0.0), np.float32(0.0), np.float32(0.0), np.float32(0.0), np.float32(1.0)]",6.0,99723.0,14
2025-08-14_08-18-36,2706,"[np.float32(0.0), np.float32(1.0), np.float32(0.0), np.float32(0.0), np.float32(1.0), np.float32(0.0), np.float32(0.0), np.float32(0.0), np.float32(0.0), np.float32(0.0), np.float32(1.0), np.float32(0.0), np.float32(1.0), np.float32(1.0), np.float32(1.0), np.float32(0.0)]",2.0,99725.0,26
2025-08-14_08-18-36,2707,"[np.float32(0.0), np.float32(0.0), np.float32(1.0), np.float32(1.0), np.float32(1.0), np.float32(1.0), np.float32(1.0), np.float32(1.0), np.float32(0.0), np.float32(0.0), np.float32(0.0), np.float32(0.0), np.float32(0.0), np.float32(0.0), np.float32(0.0), np.float32(0.0)]",1.0,99726.0,5
2025-08-14_08-18-36,2708,"[np.float32(0.0), np.float32(1.0), np.float32(0.0), np.float32(1.0), np.float32(0.0), np.float32(1.0), np.float32(0.0), np.float32(1.0), np.float32(1.0), np.float32(0.0), np.float32(1.0), np.float32(0.0), np.float32(1.0), np.float32(0.0), np.float32(1.0), np.float32(1.0)]",-4.0,99722.0,1
2025-08-14_08-18-36,2709,"[np.float32(1.0), np.float32(0.0), np.float32(0.0), np.float32(1.0), np.float32(1.0), np.float32(1.0), np.float32(0.0), np.float32(1.0), np.float32(0.0), np.float32(0.0), np.float32(1.0), np.float32(1.0), np.float32(0.0), np.float32(0.0), np.float32(0.0), np.float32(1.0)]",0.0,99722.0,6
2025-08-14_08-18-36,2710,"[np.float32(1.0), np.float32(1.0), np.float32(1.0), np.float32(0.0), np.float32(0.0), np.float32(1.0), np.float32(1.0), np.float32(1.0), np.float32(1.0), np.float32(0.0), np.float32(1.0), np.float32(0.0), np.float32(0.0), np.float32(1.0), np.float32(0.0), np.float32(1.0)]",3.0,99725.0,29
2025-08-14_08-18-36,2711,"[np.float32(0.0), np.float32(0.0), np.float32(0.0), np.float32(0.0), np.float32(0.0), np.float32(0.0), np.float32(0.0), np.float32(0.0), np.float32(0.0), np.float32(0.0), np.float32(1.0), np.float32(1.0), np.float32(0.0), np.float32(1.0), np.float32(0.0), np.float32(1.0)]",-1.0,99724.0,19
2025-08-14_08-18-36,2712,"[np.float32(0.0), np.float32(0.0), np.float32(1.0), np.float32(1.0), np.float32(1.0), np.float32(0.0), np.float32(1.0), np.float32(0.0), np.float32(1.0), np.float32(1.0), np.float32(1.0), np.float32(0.0), np.float32(0.0), np.float32(0.0), np.float32(0.0), np.float32(1.0)]",-6.0,99718.0,0
2025-08-14_08-18-36,2713,"[np.float32(1.0), np.float32(0.0), np.float32(0.0), np.float32(0.0), np.float32(0.0), np.float32(0.0), np.float32(1.0), np.float32(1.0), np.float32(1.0), np.float32(0.0), np.float32(1.0), np.float32(0.0), np.float32(1.0), np.float32(0.0), np.float32(1.0), np.float32(0.0)]",34.0,99752.0,7
2025-08-14_08-18-36,2714,"[np.float32(1.0), np.float32(1.0), np.float32(0.0), np.float32(0.0), np.float32(1.0), np.float32(0.0), np.float32(0.0), np.float32(0.0), np.float32(1.0), np.float32(1.0), np.float32(1.0), np.float32(1.0), np.float32(1.0), np.float32(1.0), np.float32(0.0), np.float32(1.0)]",-3.0,99749.0,16
2025-08-14_08-18-36,2715,"[np.float32(1.0), np.float32(0.0), np.float32(1.0), np.float32(0.0), np.float32(1.0), np.float32(0.0), np.float32(1.0), np.float32(0.0), np.float32(1.0), np.float32(1.0), np.float32(0.0), np.float32(1.0), np.float32(1.0), np.float32(1.0), np.float32(0.0), np.float32(0.0)]",-1.0,99748.0,19
2025-08-14_08-18-36,2716,"[np.float32(0.0), np.float32(0.0), np.float32(1.0), np.float32(1.0), np.float32(1.0), np.float32(1.0), np.float32(0.0), np.float32(1.0), np.float32(0.0), np.float32(1.0), np.float32(0.0), np.float32(1.0), np.float32(0.0), np.float32(1.0), np.float32(0.0), np.float32(0.0)]",5.0,99753.0,15
2025-08-14_08-18-36,2717,"[np.float32(1.0), np.float32(0.0), np.float32(0.0), np.float32(1.0), np.float32(0.0), np.float32(1.0), np.float32(0.0), np.float32(1.0), np.float32(1.0), np.float32(0.0), np.float32(0.0), np.float32(0.0), np.float32(1.0), np.float32(1.0), np.float32(1.0), np.float32(0.0)]",-4.0,99749.0,9
2025-08-14_08-18-36,2718,"[np.float32(0.0), np.float32(0.0), np.float32(0.0), np.float32(1.0), np.float32(0.0), np.float32(1.0), np.float32(1.0), np.float32(1.0), np.float32(1.0), np.float32(0.0), np.float32(1.0), np.float32(1.0), np.float32(1.0), np.float32(1.0), np.float32(0.0), np.float32(0.0)]",4.0,99753.0,21
2025-08-14_08-18-36,2719,"[np.float32(0.0), np.float32(1.0), np.float32(1.0), np.float32(0.0), np.float32(1.0), np.float32(1.0), np.float32(0.0), np.float32(0.0), np.float32(0.0), np.float32(1.0), np.float32(1.0), np.float32(0.0), np.float32(1.0), np.float32(0.0), np.float32(0.0), np.float32(0.0)]",0.0,99753.0,31
2025-08-14_08-18-36,2720,"[np.float32(1.0), np.float32(1.0), np.float32(1.0), np.float32(0.0), np.float32(1.0), np.float32(0.0), np.float32(0.0), np.float32(0.0), np.float32(1.0), np.float32(0.0), np.float32(1.0), np.float32(0.0), np.float32(1.0), np.float32(0.0), np.float32(0.0), np.float32(0.0)]",0.0,99753.0,30
2025-08-14_08-18-36,2721,"[np.float32(0.0), np.float32(1.0), np.float32(0.0), np.float32(0.0), np.float32(0.0), np.float32(1.0), np.float32(1.0), np.float32(1.0), np.float32(1.0), np.float32(1.0), np.float32(1.0), np.float32(0.0), np.float32(1.0), np.float32(1.0), np.float32(0.0), np.float32(0.0)]",4.0,99757.0,26
2025-08-14_08-18-36,2722,"[np.float32(0.0), np.float32(0.0), np.float32(1.0), np.float32(1.0), np.float32(1.0), np.float32(1.0), np.float32(0.0), np.float32(1.0), np.float32(0.0), np.float32(0.0), np.float32(0.0), np.float32(1.0), np.float32(1.0), np.float32(1.0), np.float32(0.0), np.float32(1.0)]",4.0,99761.0,15
2025-08-14_08-18-36,2723,"[np.float32(0.0), np.float32(0.0), np.float32(1.0), np.float32(0.0), np.float32(0.0), np.float32(0.0), np.float32(0.0), np.float32(1.0), np.float32(0.0), np.float32(0.0), np.float32(0.0), np.float32(0.0), np.float32(0.0), np.float32(0.0), np.float32(0.0), np.float32(0.0)]",3.0,99764.0,20
2025-08-14_08-18-36,2724,"[np.float32(0.0), np.float32(0.0), np.float32(0.0), np.float32(1.0), np.float32(0.0), np.float32(1.0), np.float32(1.0), np.float32(1.0), np.float32(0.0), np.float32(0.0), np.float32(0.0), np.float32(1.0), np.float32(0.0), np.float32(0.0), np.float32(0.0), np.float32(0.0)]",-2.0,99762.0,10
2025-08-14_08-18-36,2725,"[np.float32(1.0), np.float32(0.0), np.float32(0.0), np.float32(0.0), np.float32(1.0), np.float32(0.0), np.float32(1.0), np.float32(0.0), np.float32(0.0), np.float32(0.0), np.float32(0.0), np.float32(1.0), np.float32(1.0), np.float32(1.0), np.float32(0.0), np.float32(0.0)]",-4.0,99758.0,23
2025-08-14_08-18-36,2726,"[np.float32(1.0), np.float32(1.0), np.float32(1.0), np.float32(1.0), np.float32(1.0), np.float32(0.0), np.float32(1.0), np.float32(1.0), np.float32(1.0), np.float32(1.0), np.float32(0.0), np.float32(0.0), np.float32(1.0), np.float32(0.0), np.float32(1.0), np.float32(0.0)]",-1.0,99757.0,30
2025-08-14_08-18-36,2727,"[np.float32(1.0), np.float32(0.0), np.float32(1.0), np.float32(0.0), np.float32(0.0), np.float32(0.0), np.float32(0.0), np.float32(0.0), np.float32(1.0), np.float32(1.0), np.float32(1.0), np.float32(1.0), np.float32(0.0), np.float32(0.0), np.float32(0.0), np.float32(1.0)]",6.0,99763.0,34
2025-08-14_08-18-36,2728,"[np.float32(1.0), np.float32(1.0), np.float32(1.0), np.float32(0.0), np.float32(0.0), np.float32(0.0), np.float32(1.0), np.float32(1.0), np.float32(1.0), np.float32(1.0), np.float32(1.0), np.float32(1.0), np.float32(0.0), np.float32(1.0), np.float32(0.0), np.float32(0.0)]",1.0,99764.0,35
2025-08-14_08-18-36,2729,"[np.float32(0.0), np.float32(1.0), np.float32(0.0), np.float32(0.0), np.float32(0.0), np.float32(1.0), np.float32(0.0), np.float32(0.0), np.float32(1.0), np.float32(1.0), np.float32(0.0), np.float32(1.0), np.float32(0.0), np.float32(0.0), np.float32(0.0), np.float32(1.0)]",7.0,99771.0,31
2025-08-14_08-18-36,2730,"[np.float32(1.0), np.float32(1.0), np.float32(1.0), np.float32(1.0), np.float32(0.0), np.float32(0.0), np.float32(0.0), np.float32(1.0), np.float32(0.0), np.float32(1.0), np.float32(0.0), np.float32(1.0), np.float32(0.0), np.float32(1.0), np.float32(1.0), np.float32(1.0)]",0.0,99771.0,33
2025-08-14_08-18-36,2731,"[np.float32(1.0), np.float32(1.0), np.float32(0.0), np.float32(0.0), np.float32(0.0), np.float32(1.0), np.float32(1.0), np.float32(0.0), np.float32(1.0), np.float32(0.0), np.float32(1.0), np.float32(1.0), np.float32(0.0), np.float32(1.0), np.float32(1.0), np.float32(1.0)]",1.0,99772.0,11
2025-08-14_08-18-36,2732,"[np.float32(0.0), np.float32(0.0), np.float32(1.0), np.float32(1.0), np.float32(1.0), np.float32(1.0), np.float32(0.0), np.float32(0.0), np.float32(0.0), np.float32(1.0), np.float32(0.0), np.float32(1.0), np.float32(0.0), np.float32(1.0), np.float32(0.0), np.float32(0.0)]",0.0,99772.0,16
2025-08-14_08-18-36,2733,"[np.float32(0.0), np.float32(1.0), np.float32(1.0), np.float32(0.0), np.float32(0.0), np.float32(1.0), np.float32(0.0), np.float32(1.0), np.float32(0.0), np.float32(1.0), np.float32(0.0), np.float32(1.0), np.float32(0.0), np.float32(0.0), np.float32(1.0), np.float32(0.0)]",0.0,99772.0,4
2025-08-14_08-18-36,2734,"[np.float32(0.0), np.float32(1.0), np.float32(0.0), np.float32(0.0), np.float32(0.0), np.float32(0.0), np.float32(0.0), np.float32(0.0), np.float32(1.0), np.float32(1.0), np.float32(0.0), np.float32(1.0), np.float32(1.0), np.float32(0.0), np.float32(1.0), np.float32(0.0)]",3.0,99775.0,27
2025-08-14_08-18-36,2735,"[np.float32(1.0), np.float32(1.0), np.float32(0.0), np.float32(1.0), np.float32(0.0), np.float32(0.0), np.float32(1.0), np.float32(0.0), np.float32(1.0), np.float32(0.0), np.float32(1.0), np.float32(0.0), np.float32(0.0), np.float32(0.0), np.float32(0.0), np.float32(0.0)]",1.0,99776.0,7
2025-08-14_08-18-36,2736,"[np.float32(0.0), np.float32(1.0), np.float32(1.0), np.float32(1.0), np.float32(0.0), np.float32(1.0), np.float32(0.0), np.float32(0.0), np.float32(0.0), np.float32(1.0), np.float32(0.0), np.float32(0.0), np.float32(1.0), np.float32(0.0), np.float32(0.0), np.float32(0.0)]",3.0,99779.0,28
2025-08-14_08-18-36,2737,"[np.float32(0.0), np.float32(1.0), np.float32(0.0), np.float32(0.0), np.float32(0.0), np.float32(1.0), np.float32(1.0), np.float32(1.0), np.float32(1.0), np.float32(0.0), np.float32(1.0), np.float32(1.0), np.float32(0.0), np.float32(0.0), np.float32(1.0), np.float32(1.0)]",-4.0,99775.0,25
2025-08-14_08-18-36,2738,"[np.float32(0.0), np.float32(0.0), np.float32(1.0), np.float32(0.0), np.float32(0.0), np.float32(1.0), np.float32(0.0), np.float32(0.0), np.float32(0.0), np.float32(1.0), np.float32(1.0), np.float32(0.0), np.float32(1.0), np.float32(1.0), np.float32(1.0), np.float32(0.0)]",-2.0,99773.0,27
2025-08-14_08-18-36,2739,"[np.float32(0.0), np.float32(0.0), np.float32(1.0), np.float32(1.0), np.float32(0.0), np.float32(0.0), np.float32(1.0), np.float32(0.0), np.float32(1.0), np.float32(1.0), np.float32(1.0), np.float32(1.0), np.float32(0.0), np.float32(1.0), np.float32(1.0), np.float32(0.0)]",-1.0,99772.0,13
2025-08-14_08-18-36,2740,"[np.float32(1.0), np.float32(1.0), np.float32(0.0), np.float32(1.0), np.float32(1.0), np.float32(0.0), np.float32(0.0), np.float32(0.0), np.float32(0.0), np.float32(1.0), np.float32(1.0), np.float32(0.0), np.float32(1.0), np.float32(1.0), np.float32(1.0), np.float32(1.0)]",0.0,99772.0,4
2025-08-14_08-18-36,2741,"[np.float32(1.0), np.float32(0.0), np.float32(0.0), np.float32(0.0), np.float32(1.0), np.float32(1.0), np.float32(0.0), np.float32(0.0), np.float32(1.0), np.float32(0.0), np.float32(0.0), np.float32(0.0), np.float32(0.0), np.float32(1.0), np.float32(0.0), np.float32(0.0)]",-3.0,99769.0,8
2025-08-14_08-18-36,2742,"[np.float32(0.0), np.float32(0.0), np.float32(1.0), np.float32(1.0), np.float32(0.0), np.float32(0.0), np.float32(1.0), np.float32(0.0), np.float32(1.0), np.float32(0.0), np.float32(0.0), np.float32(0.0), np.float32(1.0), np.float32(1.0), np.float32(0.0), np.float32(1.0)]",-2.0,99767.0,30
2025-08-14_08-18-36,2743,"[np.float32(0.0), np.float32(0.0), np.float32(1.0), np.float32(0.0), np.float32(0.0), np.float32(0.0), np.float32(0.0), np.float32(1.0), np.float32(1.0), np.float32(1.0), np.float32(0.0), np.float32(1.0), np.float32(0.0), np.float32(1.0), np.float32(0.0), np.float32(1.0)]",1.0,99768.0,36
2025-08-14_08-18-36,2744,"[np.float32(1.0), np.float32(0.0), np.float32(1.0), np.float32(0.0), np.float32(0.0), np.float32(1.0), np.float32(0.0), np.float32(1.0), np.float32(0.0), np.float32(1.0), np.float32(0.0), np.float32(1.0), np.float32(1.0), np.float32(1.0), np.float32(0.0), np.float32(1.0)]",1.0,99769.0,28
2025-08-14_08-18-36,2745,"[np.float32(1.0), np.float32(0.0), np.float32(1.0), np.float32(1.0), np.float32(1.0), np.float32(1.0), np.float32(0.0), np.float32(0.0), np.float32(0.0), np.float32(0.0), np.float32(0.0), np.float32(0.0), np.float32(1.0), np.float32(0.0), np.float32(0.0), np.float32(0.0)]",36.0,99805.0,7
2025-08-14_08-18-36,2746,"[np.float32(1.0), np.float32(1.0), np.float32(0.0), np.float32(1.0), np.float32(1.0), np.float32(1.0), np.float32(1.0), np.float32(1.0), np.float32(0.0), np.float32(1.0), np.float32(0.0), np.float32(1.0), np.float32(1.0), np.float32(0.0), np.float32(1.0), np.float32(0.0)]",-4.0,99801.0,34
2025-08-14_08-18-36,2747,"[np.float32(0.0), np.float32(1.0), np.float32(1.0), np.float32(1.0), np.float32(0.0), np.float32(0.0), np.float32(1.0), np.float32(1.0), np.float32(1.0), np.float32(0.0), np.float32(1.0), np.float32(1.0), np.float32(0.0), np.float32(1.0), np.float32(1.0), np.float32(1.0)]",2.0,99803.0,35
2025-08-14_08-18-36,2748,"[np.float32(0.0), np.float32(0.0), np.float32(1.0), np.float32(0.0), np.float32(1.0), np.float32(1.0), np.float32(1.0), np.float32(1.0), np.float32(1.0), np.float32(1.0), np.float32(1.0), np.float32(0.0), np.float32(0.0), np.float32(1.0), np.float32(0.0), np.float32(1.0)]",0.0,99803.0,12
2025-08-14_08-18-36,2749,"[np.float32(0.0), np.float32(0.0), np.float32(0.0), np.float32(0.0), np.float32(1.0), np.float32(1.0), np.float32(0.0), np.float32(0.0), np.float32(1.0), np.float32(0.0), np.float32(0.0), np.float32(1.0), np.float32(0.0), np.float32(0.0), np.float32(0.0), np.float32(0.0)]",-2.0,99801.0,17
2025-08-14_08-18-36,2750,"[np.float32(0.0), np.float32(1.0), np.float32(1.0), np.float32(0.0), np.float32(1.0), np.float32(0.0), np.float32(0.0), np.float32(1.0), np.float32(1.0), np.float32(1.0), np.float32(1.0), np.float32(1.0), np.float32(0.0), np.float32(0.0), np.float32(0.0), np.float32(1.0)]",1.0,99802.0,26
2025-08-14_08-18-36,2751,"[np.float32(1.0), np.float32(1.0), np.float32(0.0), np.float32(1.0), np.float32(0.0), np.float32(1.0), np.float32(0.0), np.float32(0.0), np.float32(0.0), np.float32(1.0), np.float32(1.0), np.float32(0.0), np.float32(1.0), np.float32(0.0), np.float32(0.0), np.float32(1.0)]",1.0,99803.0,19
2025-08-14_08-18-36,2752,"[np.float32(1.0), np.float32(1.0), np.float32(1.0), np.float32(0.0), np.float32(0.0), np.float32(1.0), np.float32(0.0), np.float32(1.0), np.float32(1.0), np.float32(1.0), np.float32(0.0), np.float32(1.0), np.float32(0.0), np.float32(0.0), np.float32(0.0), np.float32(1.0)]",-2.0,99801.0,10
2025-08-14_08-18-36,2753,"[np.float32(1.0), np.float32(0.0), np.float32(0.0), np.float32(1.0), np.float32(0.0), np.float32(0.0), np.float32(0.0), np.float32(1.0), np.float32(1.0), np.float32(1.0), np.float32(0.0), np.float32(1.0), np.float32(1.0), np.float32(0.0), np.float32(0.0), np.float32(0.0)]",1.0,99802.0,31
2025-08-14_08-18-36,2754,"[np.float32(0.0), np.float32(0.0), np.float32(0.0), np.float32(1.0), np.float32(0.0), np.float32(1.0), np.float32(1.0), np.float32(1.0), np.float32(0.0), np.float32(1.0), np.float32(0.0), np.float32(0.0), np.float32(0.0), np.float32(1.0), np.float32(0.0), np.float32(1.0)]",1.0,99803.0,28
2025-08-14_08-18-36,2755,"[np.float32(0.0), np.float32(1.0), np.float32(1.0), np.float32(1.0), np.float32(0.0), np.float32(1.0), np.float32(0.0), np.float32(1.0), np.float32(0.0), np.float32(0.0), np.float32(0.0), np.float32(0.0), np.float32(1.0), np.float32(0.0), np.float32(0.0), np.float32(1.0)]",0.0,99803.0,15
2025-08-14_08-18-36,2756,"[np.float32(0.0), np.float32(1.0), np.float32(0.0), np.float32(0.0), np.float32(0.0), np.float32(0.0), np.float32(0.0), np.float32(0.0), np.float32(0.0), np.float32(1.0), np.float32(1.0), np.float32(1.0), np.float32(0.0), np.float32(1.0), np.float32(0.0), np.float32(0.0)]",1.0,99804.0,12
2025-08-14_08-18-36,2757,"[np.float32(0.0), np.float32(1.0), np.float32(1.0), np.float32(0.0), np.float32(1.0), np.float32(1.0), np.float32(1.0), np.float32(1.0), np.float32(1.0), np.float32(0.0), np.float32(0.0), np.float32(0.0), np.float32(1.0), np.float32(0.0), np.float32(0.0), np.float32(0.0)]",-3.0,99801.0,27
2025-08-14_08-18-36,2758,"[np.float32(1.0), np.float32(1.0), np.float32(0.0), np.float32(0.0), np.float32(1.0), np.float32(1.0), np.float32(0.0), np.float32(0.0), np.float32(0.0), np.float32(1.0), np.float32(1.0), np.float32(0.0), np.float32(0.0), np.float32(1.0), np.float32(0.0), np.float32(0.0)]",3.0,99804.0,7
2025-08-14_08-18-36,2759,"[np.float32(0.0), np.float32(1.0), np.float32(1.0), np.float32(1.0), np.float32(1.0), np.float32(1.0), np.float32(1.0), np.float32(0.0), np.float32(1.0), np.float32(1.0), np.float32(1.0), np.float32(1.0), np.float32(1.0), np.float32(1.0), np.float32(1.0), np.float32(1.0)]",-2.0,99802.0,22
2025-08-14_08-18-36,2760,"[np.float32(0.0), np.float32(1.0), np.float32(0.0), np.float32(0.0), np.float32(1.0), np.float32(1.0), np.float32(1.0), np.float32(0.0), np.float32(1.0), np.float32(1.0), np.float32(0.0), np.float32(1.0), np.float32(1.0), np.float32(0.0), np.float32(1.0), np.float32(0.0)]",2.0,99804.0,36
2025-08-14_08-18-36,2761,"[np.float32(0.0), np.float32(0.0), np.float32(0.0), np.float32(0.0), np.float32(0.0), np.float32(1.0), np.float32(0.0), np.float32(1.0), np.float32(1.0), np.float32(1.0), np.float32(0.0), np.float32(1.0), np.float32(0.0), np.float32(0.0), np.float32(0.0), np.float32(1.0)]",0.0,99804.0,9
2025-08-14_08-18-36,2762,"[np.float32(0.0), np.float32(0.0), np.float32(1.0), np.float32(0.0), np.float32(1.0), np.float32(1.0), np.float32(0.0), np.float32(1.0), np.float32(1.0), np.float32(1.0), np.float32(1.0), np.float32(0.0), np.float32(1.0), np.float32(1.0), np.float32(0.0), np.float32(0.0)]",-2.0,99802.0,10
2025-08-14_08-18-36,2763,"[np.float32(0.0), np.float32(0.0), np.float32(0.0), np.float32(0.0), np.float32(1.0), np.float32(1.0), np.float32(1.0), np.float32(1.0), np.float32(1.0), np.float32(0.0), np.float32(0.0), np.float32(0.0), np.float32(0.0), np.float32(0.0), np.float32(1.0), np.float32(0.0)]",-1.0,99801.0,17
2025-08-14_08-18-36,2764,"[np.float32(1.0), np.float32(1.0), np.float32(1.0), np.float32(1.0), np.float32(0.0), np.float32(0.0), np.float32(1.0), np.float32(1.0), np.float32(0.0), np.float32(0.0), np.float32(1.0), np.float32(1.0), np.float32(1.0), np.float32(0.0), np.float32(0.0), np.float32(0.0)]",1.0,99802.0,12
2025-08-14_08-18-36,2765,"[np.float32(1.0), np.float32(0.0), np.float32(1.0), np.float32(0.0), np.float32(0.0), np.float32(1.0), np.float32(0.0), np.float32(1.0), np.float32(1.0), np.float32(0.0), np.float32(0.0), np.float32(1.0), np.float32(1.0), np.float32(1.0), np.float32(1.0), np.float32(0.0)]",6.0,99808.0,36
2025-08-14_08-18-36,2766,"[np.float32(0.0), np.float32(1.0), np.float32(0.0), np.float32(1.0), np.float32(1.0), np.float32(0.0), np.float32(1.0), np.float32(0.0), np.float32(1.0), np.float32(1.0), np.float32(1.0), np.float32(1.0), np.float32(0.0), np.float32(1.0), np.float32(1.0), np.float32(1.0)]",2.0,99810.0,33
2025-08-14_08-18-36,2767,"[np.float32(0.0), np.float32(1.0), np.float32(1.0), np.float32(0.0), np.float32(1.0), np.float32(1.0), np.float32(0.0), np.float32(1.0), np.float32(0.0), np.float32(0.0), np.float32(0.0), np.float32(0.0), np.float32(1.0), np.float32(1.0), np.float32(1.0), np.float32(0.0)]",0.0,99810.0,19
2025-08-14_08-18-36,2768,"[np.float32(0.0), np.float32(1.0), np.float32(0.0), np.float32(0.0), np.float32(0.0), np.float32(0.0), np.float32(0.0), np.float32(1.0), np.float32(1.0), np.float32(0.0), np.float32(1.0), np.float32(1.0), np.float32(1.0), np.float32(0.0), np.float32(0.0), np.float32(1.0)]",-1.0,99809.0,36
2025-08-14_08-18-36,2769,"[np.float32(1.0), np.float32(1.0), np.float32(1.0), np.float32(0.0), np.float32(0.0), np.float32(0.0), np.float32(0.0), np.float32(0.0), np.float32(0.0), np.float32(1.0), np.float32(1.0), np.float32(1.0), np.float32(1.0), np.float32(0.0), np.float32(1.0), np.float32(1.0)]",-1.0,99808.0,13
2025-08-14_08-18-36,2770,"[np.float32(1.0), np.float32(1.0), np.float32(1.0), np.float32(1.0), np.float32(0.0), np.float32(1.0), np.float32(0.0), np.float32(1.0), np.float32(1.0), np.float32(0.0), np.float32(0.0), np.float32(1.0), np.float32(0.0), np.float32(1.0), np.float32(0.0), np.float32(0.0)]",-2.0,99806.0,6
2025-08-14_08-18-36,2771,"[np.float32(0.0), np.float32(0.0), np.float32(0.0), np.float32(1.0), np.float32(1.0), np.float32(1.0), np.float32(1.0), np.float32(0.0), np.float32(0.0), np.float32(0.0), np.float32(0.0), np.float32(0.0), np.float32(1.0), np.float32(1.0), np.float32(0.0), np.float32(0.0)]",-4.0,99802.0,20
2025-08-14_08-18-36,2772,"[np.float32(0.0), np.float32(1.0), np.float32(1.0), np.float32(1.0), np.float32(1.0), np.float32(0.0), np.float32(0.0), np.float32(1.0), np.float32(0.0), np.float32(0.0), np.float32(0.0), np.float32(1.0), np.float32(0.0), np.float32(1.0), np.float32(0.0), np.float32(1.0)]",-3.0,99799.0,36
2025-08-14_08-18-36,2773,"[np.float32(0.0), np.float32(0.0), np.float32(1.0), np.float32(0.0), np.float32(0.0), np.float32(1.0), np.float32(1.0), np.float32(0.0), np.float32(1.0), np.float32(0.0), np.float32(0.0), np.float32(0.0), np.float32(1.0), np.float32(1.0), np.float32(0.0), np.float32(0.0)]",-1.0,99798.0,6
2025-08-14_08-18-36,2774,"[np.float32(0.0), np.float32(0.0), np.float32(0.0), np.float32(0.0), np.float32(0.0), np.float32(1.0), np.float32(0.0), np.float32(1.0), np.float32(1.0), np.float32(1.0), np.float32(1.0), np.float32(0.0), np.float32(1.0), np.float32(0.0), np.float32(0.0), np.float32(1.0)]",4.0,99802.0,34
2025-08-14_08-18-36,2775,"[np.float32(1.0), np.float32(0.0), np.float32(1.0), np.float32(0.0), np.float32(1.0), np.float32(0.0), np.float32(0.0), np.float32(1.0), np.float32(1.0), np.float32(0.0), np.float32(1.0), np.float32(1.0), np.float32(1.0), np.float32(0.0), np.float32(1.0), np.float32(0.0)]",2.0,99804.0,23
2025-08-14_08-18-36,2776,"[np.float32(1.0), np.float32(1.0), np.float32(1.0), np.float32(1.0), np.float32(0.0), np.float32(1.0), np.float32(1.0), np.float32(1.0), np.float32(1.0), np.float32(1.0), np.float32(0.0), np.float32(0.0), np.float32(0.0), np.float32(1.0), np.float32(1.0), np.float32(1.0)]",0.0,99804.0,36
2025-08-14_08-18-36,2777,"[np.float32(0.0), np.float32(0.0), np.float32(0.0), np.float32(0.0), np.float32(1.0), np.float32(0.0), np.float32(1.0), np.float32(1.0), np.float32(1.0), np.float32(0.0), np.float32(1.0), np.float32(1.0), np.float32(1.0), np.float32(0.0), np.float32(0.0), np.float32(0.0)]",1.0,99805.0,2
2025-08-14_08-18-36,2778,"[np.float32(1.0), np.float32(0.0), np.float32(0.0), np.float32(1.0), np.float32(1.0), np.float32(0.0), np.float32(1.0), np.float32(0.0), np.float32(0.0), np.float32(0.0), np.float32(1.0), np.float32(0.0), np.float32(0.0), np.float32(0.0), np.float32(0.0), np.float32(0.0)]",2.0,99807.0,14
2025-08-14_08-18-36,2779,"[np.float32(0.0), np.float32(1.0), np.float32(1.0), np.float32(1.0), np.float32(1.0), np.float32(1.0), np.float32(1.0), np.float32(0.0), np.float32(0.0), np.float32(1.0), np.float32(1.0), np.float32(1.0), np.float32(0.0), np.float32(1.0), np.float32(1.0), np.float32(0.0)]",2.0,99809.0,3
2025-08-14_08-18-36,2780,"[np.float32(1.0), np.float32(1.0), np.float32(1.0), np.float32(1.0), np.float32(0.0), np.float32(1.0), np.float32(1.0), np.float32(0.0), np.float32(1.0), np.float32(1.0), np.float32(1.0), np.float32(0.0), np.float32(0.0), np.float32(0.0), np.float32(1.0), np.float32(1.0)]",1.0,99810.0,36
2025-08-14_08-18-36,2781,"[np.float32(0.0), np.float32(0.0), np.float32(0.0), np.float32(0.0), np.float32(1.0), np.float32(1.0), np.float32(0.0), np.float32(1.0), np.float32(1.0), np.float32(1.0), np.float32(0.0), np.float32(1.0), np.float32(0.0), np.float32(1.0), np.float32(0.0), np.float32(0.0)]",-2.0,99808.0,2
2025-08-14_08-18-36,2782,"[np.float32(0.0), np.float32(1.0), np.float32(0.0), np.float32(1.0), np.float32(0.0), np.float32(1.0), np.float32(0.0), np.float32(0.0), np.float32(0.0), np.float32(1.0), np.float32(0.0), np.float32(1.0), np.float32(0.0), np.float32(0.0), np.float32(1.0), np.float32(0.0)]",-4.0,99804.0,32
2025-08-14_08-18-36,2783,"[np.float32(0.0), np.float32(0.0), np.float32(1.0), np.float32(0.0), np.float32(0.0), np.float32(0.0), np.float32(0.0), np.float32(0.0), np.float32(1.0), np.float32(0.0), np.float32(1.0), np.float32(0.0), np.float32(1.0), np.float32(0.0), np.float32(0.0), np.float32(1.0)]",-2.0,99802.0,1
2025-08-14_08-18-36,2784,"[np.float32(1.0), np.float32(1.0), np.float32(0.0), np.float32(0.0), np.float32(0.0), np.float32(1.0), np.float32(1.0), np.float32(1.0), np.float32(1.0), np.float32(0.0), np.float32(0.0), np.float32(1.0), np.float32(1.0), np.float32(1.0), np.float32(1.0), np.float32(0.0)]",-5.0,99797.0,17
2025-08-14_08-18-36,2785,"[np.float32(1.0), np.float32(1.0), np.float32(1.0), np.float32(0.0), np.float32(0.0), np.float32(1.0), np.float32(0.0), np.float32(0.0), np.float32(1.0), np.float32(1.0), np.float32(1.0), np.float32(0.0), np.float32(1.0), np.float32(1.0), np.float32(0.0), np.float32(0.0)]",1.0,99798.0,2
2025-08-14_08-18-36,2786,"[np.float32(1.0), np.float32(0.0), np.float32(0.0), np.float32(1.0), np.float32(0.0), np.float32(0.0), np.float32(1.0), np.float32(0.0), np.float32(1.0), np.float32(1.0), np.float32(1.0), np.float32(1.0), np.float32(1.0), np.float32(1.0), np.float32(0.0), np.float32(0.0)]",-2.0,99796.0,23
2025-08-14_08-18-36,2787,"[np.float32(1.0), np.float32(0.0), np.float32(0.0), np.float32(0.0), np.float32(0.0), np.float32(0.0), np.float32(1.0), np.float32(1.0), np.float32(0.0), np.float32(0.0), np.float32(0.0), np.float32(0.0), np.float32(1.0), np.float32(1.0), np.float32(0.0), np.float32(1.0)]",-4.0,99792.0,30
2025-08-14_08-18-36,2788,"[np.float32(0.0), np.float32(0.0), np.float32(0.0), np.float32(1.0), np.float32(1.0), np.float32(0.0), np.float32(0.0), np.float32(1.0), np.float32(0.0), np.float32(0.0), np.float32(1.0), np.float32(0.0), np.float32(1.0), np.float32(1.0), np.float32(0.0), np.float32(0.0)]",-4.0,99788.0,6
2025-08-14_08-18-36,2789,"[np.float32(1.0), np.float32(0.0), np.float32(1.0), np.float32(0.0), np.float32(0.0), np.float32(1.0), np.float32(1.0), np.float32(0.0), np.float32(1.0), np.float32(0.0), np.float32(1.0), np.float32(0.0), np.float32(1.0), np.float32(0.0), np.float32(1.0), np.float32(1.0)]",-5.0,99783.0,21
2025-08-14_08-18-36,2790,"[np.float32(1.0), np.float32(0.0), np.float32(1.0), np.float32(0.0), np.float32(0.0), np.float32(1.0), np.float32(1.0), np.float32(1.0), np.float32(1.0), np.float32(0.0), np.float32(0.0), np.float32(0.0), np.float32(1.0), np.float32(1.0), np.float32(0.0), np.float32(0.0)]",1.0,99784.0,34
2025-08-14_08-18-36,2791,"[np.float32(0.0), np.float32(0.0), np.float32(0.0), np.float32(0.0), np.float32(0.0), np.float32(0.0), np.float32(0.0), np.float32(1.0), np.float32(1.0), np.float32(0.0), np.float32(0.0), np.float32(1.0), np.float32(1.0), np.float32(0.0), np.float32(0.0), np.float32(1.0)]",-2.0,99782.0,13
2025-08-14_08-18-36,2792,"[np.float32(1.0), np.float32(1.0), np.float32(0.0), np.float32(0.0), np.float32(0.0), np.float32(1.0), np.float32(1.0), np.float32(1.0), np.float32(1.0), np.float32(1.0), np.float32(1.0), np.float32(0.0), np.float32(1.0), np.float32(1.0), np.float32(0.0), np.float32(0.0)]",-2.0,99780.0,12
2025-08-14_08-18-36,2793,"[np.float32(0.0), np.float32(1.0), np.float32(1.0), np.float32(1.0), np.float32(0.0), np.float32(0.0), np.float32(0.0), np.float32(0.0), np.float32(0.0), np.float32(0.0), np.float32(1.0), np.float32(1.0), np.float32(1.0), np.float32(0.0), np.float32(0.0), np.float32(1.0)]",-5.0,99775.0,16
2025-08-14_08-18-36,2794,"[np.float32(0.0), np.float32(1.0), np.float32(0.0), np.float32(0.0), np.float32(0.0), np.float32(1.0), np.float32(0.0), np.float32(0.0), np.float32(1.0), np.float32(0.0), np.float32(1.0), np.float32(0.0), np.float32(0.0), np.float32(1.0), np.float32(1.0), np.float32(1.0)]",-1.0,99774.0,14
2025-08-14_08-18-36,2795,"[np.float32(1.0), np.float32(0.0), np.float32(1.0), np.float32(1.0), np.float32(0.0), np.float32(1.0), np.float32(0.0), np.float32(0.0), np.float32(1.0), np.float32(0.0), np.float32(1.0), np.float32(0.0), np.float32(0.0), np.float32(0.0), np.float32(0.0), np.float32(1.0)]",-5.0,99769.0,4
2025-08-14_08-18-36,2796,"[np.float32(0.0), np.float32(1.0), np.float32(1.0), np.float32(0.0), np.float32(0.0), np.float32(0.0), np.float32(1.0), np.float32(1.0), np.float32(1.0), np.float32(0.0), np.float32(0.0), np.float32(1.0), np.float32(1.0), np.float32(0.0), np.float32(1.0), np.float32(0.0)]",-1.0,99768.0,4
2025-08-14_08-18-36,2797,"[np.float32(1.0), np.float32(0.0), np.float32(0.0), np.float32(0.0), np.float32(0.0), np.float32(0.0), np.float32(1.0), np.float32(0.0), np.float32(0.0), np.float32(1.0), np.float32(0.0), np.float32(1.0), np.float32(1.0), np.float32(1.0), np.float32(0.0), np.float32(1.0)]",-2.0,99766.0,32
2025-08-14_08-18-36,2798,"[np.float32(0.0), np.float32(1.0), np.float32(0.0), np.float32(1.0), np.float32(0.0), np.float32(1.0), np.float32(1.0), np.float32(1.0), np.float32(0.0), np.float32(0.0), np.float32(0.0), np.float32(0.0), np.float32(1.0), np.float32(0.0), np.float32(1.0), np.float32(0.0)]",-2.0,99764.0,2
2025-08-14_08-18-36,2799,"[np.float32(0.0), np.float32(1.0), np.float32(0.0), np.float32(1.0), np.float32(0.0), np.float32(0.0), np.float32(1.0), np.float32(1.0), np.float32(0.0), np.float32(1.0), np.float32(0.0), np.float32(0.0), np.float32(1.0), np.float32(1.0), np.float32(1.0), np.float32(0.0)]",0.0,99764.0,8
2025-08-14_08-18-36,2800,"[np.float32(1.0), np.float32(0.0), np.float32(1.0), np.float32(0.0), np.float32(0.0), np.float32(1.0), np.float32(0.0), np.float32(1.0), np.float32(0.0), np.float32(0.0), np.float32(1.0), np.float32(0.0), np.float32(0.0), np.float32(0.0), np.float32(0.0), np.float32(1.0)]",-1.0,99763.0,8
2025-08-14_08-18-36,2801,"[np.float32(1.0), np.float32(1.0), np.float32(1.0), np.float32(0.0), np.float32(1.0), np.float32(0.0), np.float32(1.0), np.float32(1.0), np.float32(0.0), np.float32(1.0), np.float32(1.0), np.float32(1.0), np.float32(1.0), np.float32(0.0), np.float32(0.0), np.float32(0.0)]",0.0,99763.0,24
2025-08-14_08-18-36,2802,"[np.float32(1.0), np.float32(1.0), np.float32(0.0), np.float32(0.0), np.float32(1.0), np.float32(0.0), np.float32(0.0), np.float32(1.0), np.float32(1.0), np.float32(0.0), np.float32(1.0), np.float32(1.0), np.float32(0.0), np.float32(0.0), np.float32(0.0), np.float32(0.0)]",1.0,99764.0,35
2025-08-14_08-18-36,2803,"[np.float32(0.0), np.float32(1.0), np.float32(0.0), np.float32(1.0), np.float32(1.0), np.float32(0.0), np.float32(0.0), np.float32(0.0), np.float32(1.0), np.float32(1.0), np.float32(0.0), np.float32(0.0), np.float32(0.0), np.float32(0.0), np.float32(1.0), np.float32(1.0)]",-2.0,99762.0,26
2025-08-14_08-18-36,2804,"[np.float32(0.0), np.float32(1.0), np.float32(1.0), np.float32(1.0), np.float32(0.0), np.float32(0.0), np.float32(1.0), np.float32(0.0), np.float32(0.0), np.float32(0.0), np.float32(0.0), np.float32(0.0), np.float32(0.0), np.float32(1.0), np.float32(0.0), np.float32(0.0)]",-3.0,99759.0,34
2025-08-14_08-18-36,2805,"[np.float32(1.0), np.float32(0.0), np.float32(1.0), np.float32(1.0), np.float32(1.0), np.float32(1.0), np.float32(1.0), np.float32(1.0), np.float32(0.0), np.float32(0.0), np.float32(1.0), np.float32(0.0), np.float32(1.0), np.float32(1.0), np.float32(1.0), np.float32(0.0)]",-2.0,99757.0,36
2025-08-14_08-18-36,2806,"[np.float32(1.0), np.float32(1.0), np.float32(1.0), np.float32(0.0), np.float32(0.0), np.float32(0.0), np.float32(0.0), np.float32(1.0), np.float32(1.0), np.float32(0.0), np.float32(1.0), np.float32(1.0), np.float32(0.0), np.float32(0.0), np.float32(0.0), np.float32(0.0)]",-2.0,99755.0,25
2025-08-14_08-18-36,2807,"[np.float32(1.0), np.float32(0.0), np.float32(1.0), np.float32(0.0), np.float32(1.0), np.float32(1.0), np.float32(1.0), np.float32(1.0), np.float32(0.0), np.float32(0.0), np.float32(1.0), np.float32(0.0), np.float32(1.0), np.float32(0.0), np.float32(0.0), np.float32(1.0)]",-4.0,99751.0,29
2025-08-14_08-18-36,2808,"[np.float32(0.0), np.float32(1.0), np.float32(0.0), np.float32(1.0), np.float32(1.0), np.float32(1.0), np.float32(1.0), np.float32(1.0), np.float32(1.0), np.float32(1.0), np.float32(0.0), np.float32(0.0), np.float32(1.0), np.float32(1.0), np.float32(0.0), np.float32(1.0)]",2.0,99753.0,19
2025-08-14_08-18-36,2809,"[np.float32(0.0), np.float32(0.0), np.float32(0.0), np.float32(1.0), np.float32(0.0), np.float32(1.0), np.float32(1.0), np.float32(1.0), np.float32(1.0), np.float32(0.0), np.float32(0.0), np.float32(1.0), np.float32(1.0), np.float32(1.0), np.float32(1.0), np.float32(1.0)]",0.0,99753.0,31
2025-08-14_08-18-36,2810,"[np.float32(0.0), np.float32(0.0), np.float32(0.0), np.float32(1.0), np.float32(1.0), np.float32(0.0), np.float32(1.0), np.float32(1.0), np.float32(1.0), np.float32(1.0), np.float32(1.0), np.float32(0.0), np.float32(1.0), np.float32(1.0), np.float32(0.0), np.float32(0.0)]",-6.0,99747.0,30
2025-08-14_08-18-36,2811,"[np.float32(0.0), np.float32(0.0), np.float32(1.0), np.float32(0.0), np.float32(0.0), np.float32(0.0), np.float32(1.0), np.float32(0.0), np.float32(0.0), np.float32(1.0), np.float32(1.0), np.float32(0.0), np.float32(1.0), np.float32(1.0), np.float32(0.0), np.float32(0.0)]",2.0,99749.0,22
2025-08-14_08-18-36,2812,"[np.float32(1.0), np.float32(1.0), np.float32(0.0), np.float32(1.0), np.float32(0.0), np.float32(0.0), np.float32(0.0), np.float32(0.0), np.float32(0.0), np.float32(0.0), np.float32(1.0), np.float32(0.0), np.float32(1.0), np.float32(1.0), np.float32(0.0), np.float32(1.0)]",-5.0,99744.0,36
2025-08-14_08-18-36,2813,"[np.float32(1.0), np.float32(0.0), np.float32(1.0), np.float32(1.0), np.float32(1.0), np.float32(1.0), np.float32(1.0), np.float32(1.0), np.float32(1.0), np.float32(1.0), np.float32(0.0), np.float32(1.0), np.float32(1.0), np.float32(1.0), np.float32(1.0), np.float32(0.0)]",2.0,99746.0,25
2025-08-14_08-18-36,2814,"[np.float32(0.0), np.float32(0.0), np.float32(0.0), np.float32(0.0), np.float32(0.0), np.float32(0.0), np.float32(1.0), np.float32(1.0), np.float32(0.0), np.float32(1.0), np.float32(0.0), np.float32(0.0), np.float32(0.0), np.float32(1.0), np.float32(0.0), np.float32(0.0)]",2.0,99748.0,10
2025-08-14_08-18-36,2815,"[np.float32(0.0), np.float32(1.0), np.float32(1.0), np.float32(1.0), np.float32(0.0), np.float32(0.0), np.float32(1.0), np.float32(1.0), np.float32(1.0), np.float32(1.0), np.float32(0.0), np.float32(1.0), np.float32(1.0), np.float32(0.0), np.float32(1.0), np.float32(1.0)]",0.0,99748.0,27
2025-08-14_08-18-36,2816,"[np.float32(0.0), np.float32(1.0), np.float32(1.0), np.float32(1.0), np.float32(1.0), np.float32(0.0), np.float32(1.0), np.float32(1.0), np.float32(0.0), np.float32(0.0), np.float32(1.0), np.float32(1.0), np.float32(0.0), np.float32(0.0), np.float32(1.0), np.float32(1.0)]",-2.0,99746.0,27
2025-08-14_08-18-36,2817,"[np.float32(0.0), np.float32(0.0), np.float32(0.0), np.float32(0.0), np.float32(1.0), np.float32(0.0), np.float32(0.0), np.float32(1.0), np.float32(0.0), np.float32(1.0), np.float32(1.0), np.float32(0.0), np.float32(0.0), np.float32(1.0), np.float32(0.0), np.float32(1.0)]",0.0,99746.0,32
2025-08-14_08-18-36,2818,"[np.float32(1.0), np.float32(0.0), np.float32(1.0), np.float32(0.0), np.float32(0.0), np.float32(1.0), np.float32(0.0), np.float32(0.0), np.float32(0.0), np.float32(0.0), np.float32(0.0), np.float32(0.0), np.float32(0.0), np.float32(0.0), np.float32(1.0), np.float32(0.0)]",0.0,99746.0,0
2025-08-14_08-18-36,2819,"[np.float32(0.0), np.float32(1.0), np.float32(1.0), np.float32(0.0), np.float32(1.0), np.float32(0.0), np.float32(1.0), np.float32(0.0), np.float32(0.0), np.float32(1.0), np.float32(1.0), np.float32(0.0), np.float32(1.0), np.float32(1.0), np.float32(0.0), np.float32(0.0)]",39.0,99785.0,7
2025-08-14_08-18-36,2820,"[np.float32(0.0), np.float32(0.0), np.float32(1.0), np.float32(1.0), np.float32(1.0), np.float32(1.0), np.float32(0.0), np.float32(0.0), np.float32(0.0), np.float32(1.0), np.float32(0.0), np.float32(1.0), np.float32(0.0), np.float32(1.0), np.float32(0.0), np.float32(1.0)]",-1.0,99784.0,35
2025-08-14_08-18-36,2821,"[np.float32(0.0), np.float32(0.0), np.float32(0.0), np.float32(0.0), np.float32(1.0), np.float32(0.0), np.float32(1.0), np.float32(1.0), np.float32(0.0), np.float32(0.0), np.float32(0.0), np.float32(0.0), np.float32(1.0), np.float32(0.0), np.float32(0.0), np.float32(0.0)]",1.0,99785.0,3
2025-08-14_08-18-36,2822,"[np.float32(0.0), np.float32(1.0), np.float32(1.0), np.float32(0.0), np.float32(1.0), np.float32(1.0), np.float32(0.0), np.float32(0.0), np.float32(0.0), np.float32(1.0), np.float32(1.0), np.float32(0.0), np.float32(1.0), np.float32(1.0), np.float32(0.0), np.float32(0.0)]",-4.0,99781.0,33
2025-08-14_08-18-36,2823,"[np.float32(0.0), np.float32(0.0), np.float32(0.0), np.float32(0.0), np.float32(0.0), np.float32(1.0), np.float32(1.0), np.float32(0.0), np.float32(1.0), np.float32(0.0), np.float32(0.0), np.float32(0.0), np.float32(1.0), np.float32(0.0), np.float32(1.0), np.float32(0.0)]",-2.0,99779.0,16
2025-08-14_08-18-36,2824,"[np.float32(1.0), np.float32(0.0), np.float32(0.0), np.float32(1.0), np.float32(0.0), np.float32(0.0), np.float32(1.0), np.float32(1.0), np.float32(1.0), np.float32(1.0), np.float32(0.0), np.float32(1.0), np.float32(1.0), np.float32(0.0), np.float32(0.0), np.float32(0.0)]",2.0,99781.0,3
2025-08-14_08-18-36,2825,"[np.float32(0.0), np.float32(0.0), np.float32(1.0), np.float32(0.0), np.float32(1.0), np.float32(1.0), np.float32(0.0), np.float32(1.0), np.float32(1.0), np.float32(1.0), np.float32(0.0), np.float32(0.0), np.float32(1.0), np.float32(1.0), np.float32(1.0), np.float32(0.0)]",-2.0,99779.0,2
2025-08-14_08-18-36,2826,"[np.float32(1.0), np.float32(0.0), np.float32(0.0), np.float32(1.0), np.float32(0.0), np.float32(1.0), np.float32(1.0), np.float32(1.0), np.float32(0.0), np.float32(1.0), np.float32(1.0), np.float32(1.0), np.float32(0.0), np.float32(1.0), np.float32(0.0), np.float32(0.0)]",1.0,99780.0,5
2025-08-14_08-18-36,2827,"[np.float32(0.0), np.float32(0.0), np.float32(0.0), np.float32(1.0), np.float32(0.0), np.float32(0.0), np.float32(1.0), np.float32(1.0), np.float32(0.0), np.float32(0.0), np.float32(0.0), np.float32(1.0), np.float32(1.0), np.float32(0.0), np.float32(1.0), np.float32(1.0)]",1.0,99781.0,11
2025-08-14_08-18-36,2828,"[np.float32(0.0), np.float32(0.0), np.float32(0.0), np.float32(0.0), np.float32(0.0), np.float32(1.0), np.float32(1.0), np.float32(1.0), np.float32(1.0), np.float32(0.0), np.float32(1.0), np.float32(1.0), np.float32(1.0), np.float32(1.0), np.float32(1.0), np.float32(0.0)]",-1.0,99780.0,19
2025-08-14_08-18-36,2829,"[np.float32(0.0), np.float32(1.0), np.float32(0.0), np.float32(1.0), np.float32(1.0), np.float32(0.0), np.float32(0.0), np.float32(0.0), np.float32(1.0), np.float32(0.0), np.float32(1.0), np.float32(1.0), np.float32(0.0), np.float32(1.0), np.float32(1.0), np.float32(1.0)]",-1.0,99779.0,25
2025-08-14_08-18-36,2830,"[np.float32(0.0), np.float32(1.0), np.float32(1.0), np.float32(0.0), np.float32(1.0), np.float32(1.0), np.float32(1.0), np.float32(1.0), np.float32(1.0), np.float32(0.0), np.float32(1.0), np.float32(0.0), np.float32(0.0), np.float32(1.0), np.float32(0.0), np.float32(0.0)]",-4.0,99775.0,27
2025-08-14_08-18-36,2831,"[np.float32(1.0), np.float32(0.0), np.float32(1.0), np.float32(1.0), np.float32(1.0), np.float32(1.0), np.float32(0.0), np.float32(0.0), np.float32(0.0), np.float32(0.0), np.float32(1.0), np.float32(0.0), np.float32(0.0), np.float32(1.0), np.float32(0.0), np.float32(0.0)]",3.0,99778.0,2
2025-08-14_08-18-36,2832,"[np.float32(1.0), np.float32(1.0), np.float32(0.0), np.float32(0.0), np.float32(0.0), np.float32(0.0), np.float32(1.0), np.float32(0.0), np.float32(1.0), np.float32(0.0), np.float32(0.0), np.float32(0.0), np.float32(0.0), np.float32(0.0), np.float32(0.0), np.float32(0.0)]",1.0,99779.0,10
2025-08-14_08-18-36,2833,"[np.float32(1.0), np.float32(1.0), np.float32(1.0), np.float32(1.0), np.float32(0.0), np.float32(1.0), np.float32(1.0), np.float32(1.0), np.float32(1.0), np.float32(1.0), np.float32(0.0), np.float32(1.0), np.float32(0.0), np.float32(1.0), np.float32(1.0), np.float32(0.0)]",3.0,99782.0,24
2025-08-14_08-18-36,2834,"[np.float32(1.0), np.float32(0.0), np.float32(0.0), np.float32(0.0), np.float32(1.0), np.float32(1.0), np.float32(1.0), np.float32(0.0), np.float32(1.0), np.float32(1.0), np.float32(0.0), np.float32(0.0), np.float32(1.0), np.float32(0.0), np.float32(1.0), np.float32(1.0)]",2.0,99784.0,31
2025-08-14_08-18-36,2835,"[np.float32(1.0), np.float32(0.0), np.float32(0.0), np.float32(0.0), np.float32(1.0), np.float32(1.0), np.float32(1.0), np.float32(0.0), np.float32(0.0), np.float32(1.0), np.float32(1.0), np.float32(0.0), np.float32(0.0), np.float32(1.0), np.float32(1.0), np.float32(0.0)]",0.0,99784.0,13
2025-08-14_08-18-36,2836,"[np.float32(1.0), np.float32(1.0), np.float32(0.0), np.float32(0.0), np.float32(1.0), np.float32(1.0), np.float32(0.0), np.float32(0.0), np.float32(1.0), np.float32(1.0), np.float32(1.0), np.float32(0.0), np.float32(0.0), np.float32(1.0), np.float32(1.0), np.float32(1.0)]",3.0,99787.0,25
2025-08-14_08-18-36,2837,"[np.float32(0.0), np.float32(1.0), np.float32(0.0), np.float32(0.0), np.float32(1.0), np.float32(1.0), np.float32(0.0), np.float32(0.0), np.float32(1.0), np.float32(1.0), np.float32(1.0), np.float32(0.0), np.float32(0.0), np.float32(1.0), np.float32(0.0), np.float32(0.0)]",3.0,99790.0,22
2025-08-14_08-18-36,2838,"[np.float32(0.0), np.float32(0.0), np.float32(1.0), np.float32(1.0), np.float32(0.0), np.float32(1.0), np.float32(0.0), np.float32(0.0), np.float32(1.0), np.float32(1.0), np.float32(1.0), np.float32(0.0), np.float32(0.0), np.float32(1.0), np.float32(0.0), np.float32(0.0)]",-5.0,99785.0,9
2025-08-14_08-18-36,2839,"[np.float32(1.0), np.float32(1.0), np.float32(1.0), np.float32(0.0), np.float32(0.0), np.float32(0.0), np.float32(0.0), np.float32(0.0), np.float32(1.0), np.float32(0.0), np.float32(0.0), np.float32(0.0), np.float32(0.0), np.float32(1.0), np.float32(1.0), np.float32(0.0)]",2.0,99787.0,35
2025-08-14_08-18-36,2840,"[np.float32(0.0), np.float32(0.0), np.float32(1.0), np.float32(0.0), np.float32(1.0), np.float32(1.0), np.float32(0.0), np.float32(1.0), np.float32(0.0), np.float32(1.0), np.float32(0.0), np.float32(1.0), np.float32(1.0), np.float32(1.0), np.float32(0.0), np.float32(0.0)]",2.0,99789.0,24
2025-08-14_08-18-36,2841,"[np.float32(0.0), np.float32(1.0), np.float32(1.0), np.float32(0.0), np.float32(1.0), np.float32(1.0), np.float32(0.0), np.float32(0.0), np.float32(0.0), np.float32(0.0), np.float32(0.0), np.float32(0.0), np.float32(1.0), np.float32(1.0), np.float32(1.0), np.float32(1.0)]",-1.0,99788.0,11
2025-08-14_08-18-36,2842,"[np.float32(1.0), np.float32(0.0), np.float32(0.0), np.float32(0.0), np.float32(0.0), np.float32(0.0), np.float32(1.0), np.float32(1.0), np.float32(1.0), np.float32(0.0), np.float32(1.0), np.float32(0.0), np.float32(0.0), np.float32(1.0), np.float32(1.0), np.float32(0.0)]",1.0,99789.0,3
2025-08-14_08-18-36,2843,"[np.float32(1.0), np.float32(1.0), np.float32(1.0), np.float32(0.0), np.float32(1.0), np.float32(1.0), np.float32(0.0), np.float32(1.0), np.float32(1.0), np.float32(0.0), np.float32(0.0), np.float32(0.0), np.float32(1.0), np.float32(0.0), np.float32(1.0), np.float32(0.0)]",1.0,99790.0,33
2025-08-14_08-18-36,2844,"[np.float32(1.0), np.float32(1.0), np.float32(0.0), np.float32(0.0), np.float32(1.0), np.float32(0.0), np.float32(1.0), np.float32(1.0), np.float32(0.0), np.float32(0.0), np.float32(1.0), np.float32(1.0), np.float32(0.0), np.float32(0.0), np.float32(1.0), np.float32(0.0)]",-3.0,99787.0,19
2025-08-14_08-18-36,2845,"[np.float32(1.0), np.float32(1.0), np.float32(0.0), np.float32(0.0), np.float32(0.0), np.float32(0.0), np.float32(1.0), np.float32(0.0), np.float32(1.0), np.float32(0.0), np.float32(0.0), np.float32(1.0), np.float32(1.0), np.float32(0.0), np.float32(0.0), np.float32(0.0)]",-4.0,99783.0,20
2025-08-14_08-18-36,2846,"[np.float32(0.0), np.float32(1.0), np.float32(1.0), np.float32(1.0), np.float32(0.0), np.float32(0.0), np.float32(0.0), np.float32(1.0), np.float32(1.0), np.float32(0.0), np.float32(0.0), np.float32(1.0), np.float32(0.0), np.float32(0.0), np.float32(1.0), np.float32(0.0)]",0.0,99783.0,22
2025-08-14_08-18-36,2847,"[np.float32(0.0), np.float32(0.0), np.float32(0.0), np.float32(1.0), np.float32(1.0), np.float32(0.0), np.float32(1.0), np.float32(0.0), np.float32(0.0), np.float32(1.0), np.float32(1.0), np.float32(0.0), np.float32(0.0), np.float32(1.0), np.float32(1.0), np.float32(0.0)]",6.0,99789.0,7
2025-08-14_08-18-36,2848,"[np.float32(0.0), np.float32(0.0), np.float32(0.0), np.float32(0.0), np.float32(0.0), np.float32(1.0), np.float32(0.0), np.float32(1.0), np.float32(1.0), np.float32(1.0), np.float32(1.0), np.float32(0.0), np.float32(1.0), np.float32(0.0), np.float32(0.0), np.float32(0.0)]",-3.0,99786.0,10
2025-08-14_08-18-36,2849,"[np.float32(1.0), np.float32(1.0), np.float32(0.0), np.float32(0.0), np.float32(0.0), np.float32(1.0), np.float32(0.0), np.float32(1.0), np.float32(1.0), np.float32(0.0), np.float32(1.0), np.float32(0.0), np.float32(0.0), np.float32(1.0), np.float32(0.0), np.float32(0.0)]",1.0,99787.0,18
2025-08-14_08-18-36,2850,"[np.float32(1.0), np.float32(1.0), np.float32(0.0), np.float32(0.0), np.float32(0.0), np.float32(1.0), np.float32(1.0), np.float32(1.0), np.float32(0.0), np.float32(0.0), np.float32(0.0), np.float32(1.0), np.float32(1.0), np.float32(0.0), np.float32(0.0), np.float32(1.0)]",-3.0,99784.0,2
2025-08-14_08-18-36,2851,"[np.float32(0.0), np.float32(0.0), np.float32(1.0), np.float32(1.0), np.float32(0.0), np.float32(1.0), np.float32(1.0), np.float32(1.0), np.float32(0.0), np.float32(1.0), np.float32(1.0), np.float32(0.0), np.float32(0.0), np.float32(0.0), np.float32(0.0), np.float32(0.0)]",-3.0,99781.0,33
2025-08-14_08-18-36,2852,"[np.float32(0.0), np.float32(0.0), np.float32(1.0), np.float32(1.0), np.float32(0.0), np.float32(0.0), np.float32(0.0), np.float32(0.0), np.float32(0.0), np.float32(1.0), np.float32(1.0), np.float32(0.0), np.float32(1.0), np.float32(0.0), np.float32(0.0), np.float32(0.0)]",-3.0,99778.0,12
2025-08-14_08-18-36,2853,"[np.float32(0.0), np.float32(0.0), np.float32(0.0), np.float32(0.0), np.float32(1.0), np.float32(1.0), np.float32(0.0), np.float32(1.0), np.float32(1.0), np.float32(0.0), np.float32(0.0), np.float32(0.0), np.float32(1.0), np.float32(0.0), np.float32(1.0), np.float32(0.0)]",-1.0,99777.0,34
2025-08-14_08-18-36,2854,"[np.float32(1.0), np.float32(1.0), np.float32(0.0), np.float32(0.0), np.float32(0.0), np.float32(0.0), np.float32(1.0), np.float32(1.0), np.float32(0.0), np.float32(0.0), np.float32(0.0), np.float32(1.0), np.float32(1.0), np.float32(1.0), np.float32(1.0), np.float32(0.0)]",-3.0,99774.0,0
2025-08-14_08-18-36,2855,"[np.float32(1.0), np.float32(0.0), np.float32(1.0), np.float32(1.0), np.float32(0.0), np.float32(0.0), np.float32(1.0), np.float32(1.0), np.float32(1.0), np.float32(1.0), np.float32(1.0), np.float32(1.0), np.float32(0.0), np.float32(1.0), np.float32(0.0), np.float32(0.0)]",-2.0,99772.0,31
2025-08-14_08-18-36,2856,"[np.float32(1.0), np.float32(0.0), np.float32(0.0), np.float32(1.0), np.float32(0.0), np.float32(0.0), np.float32(1.0), np.float32(0.0), np.float32(0.0), np.float32(0.0), np.float32(0.0), np.float32(0.0), np.float32(0.0), np.float32(1.0), np.float32(1.0), np.float32(0.0)]",2.0,99774.0,19
2025-08-14_08-18-36,2857,"[np.float32(0.0), np.float32(0.0), np.float32(1.0), np.float32(1.0), np.float32(0.0), np.float32(1.0), np.float32(0.0), np.float32(0.0), np.float32(0.0), np.float32(0.0), np.float32(1.0), np.float32(0.0), np.float32(0.0), np.float32(1.0), np.float32(1.0), np.float32(1.0)]",0.0,99774.0,21
2025-08-14_08-18-36,2858,"[np.float32(1.0), np.float32(1.0), np.float32(0.0), np.float32(1.0), np.float32(0.0), np.float32(1.0), np.float32(1.0), np.float32(1.0), np.float32(0.0), np.float32(1.0), np.float32(0.0), np.float32(0.0), np.float32(0.0), np.float32(1.0), np.float32(0.0), np.float32(0.0)]",-4.0,99770.0,30
2025-08-14_08-18-36,2859,"[np.float32(1.0), np.float32(0.0), np.float32(0.0), np.float32(0.0), np.float32(1.0), np.float32(0.0), np.float32(1.0), np.float32(0.0), np.float32(1.0), np.float32(0.0), np.float32(0.0), np.float32(1.0), np.float32(1.0), np.float32(0.0), np.float32(1.0), np.float32(0.0)]",0.0,99770.0,16
2025-08-14_08-18-36,2860,"[np.float32(0.0), np.float32(0.0), np.float32(1.0), np.float32(1.0), np.float32(1.0), np.float32(0.0), np.float32(0.0), np.float32(1.0), np.float32(1.0), np.float32(1.0), np.float32(1.0), np.float32(0.0), np.float32(0.0), np.float32(0.0), np.float32(1.0), np.float32(0.0)]",0.0,99770.0,26
2025-08-14_08-18-36,2861,"[np.float32(1.0), np.float32(1.0), np.float32(0.0), np.float32(1.0), np.float32(1.0), np.float32(0.0), np.float32(0.0), np.float32(1.0), np.float32(1.0), np.float32(1.0), np.float32(0.0), np.float32(1.0), np.float32(0.0), np.float32(1.0), np.float32(1.0), np.float32(0.0)]",-5.0,99765.0,0
2025-08-14_08-18-36,2862,"[np.float32(0.0), np.float32(0.0), np.float32(1.0), np.float32(1.0), np.float32(0.0), np.float32(1.0), np.float32(0.0), np.float32(1.0), np.float32(1.0), np.float32(1.0), np.float32(1.0), np.float32(0.0), np.float32(0.0), np.float32(1.0), np.float32(0.0), np.float32(0.0)]",5.0,99770.0,35
2025-08-14_08-18-36,2863,"[np.float32(0.0), np.float32(0.0), np.float32(0.0), np.float32(1.0), np.float32(0.0), np.float32(1.0), np.float32(0.0), np.float32(0.0), np.float32(0.0), np.float32(0.0), np.float32(0.0), np.float32(1.0), np.float32(1.0), np.float32(1.0), np.float32(1.0), np.float32(0.0)]",-1.0,99769.0,13
2025-08-14_08-18-36,2864,"[np.float32(1.0), np.float32(1.0), np.float32(1.0), np.float32(0.0), np.float32(0.0), np.float32(1.0), np.float32(0.0), np.float32(0.0), np.float32(0.0), np.float32(1.0), np.float32(0.0), np.float32(1.0), np.float32(1.0), np.float32(1.0), np.float32(1.0), np.float32(1.0)]",-1.0,99768.0,0
2025-08-14_08-18-36,2865,"[np.float32(0.0), np.float32(0.0), np.float32(0.0), np.float32(1.0), np.float32(1.0), np.float32(0.0), np.float32(0.0), np.float32(1.0), np.float32(1.0), np.float32(1.0), np.float32(1.0), np.float32(0.0), np.float32(1.0), np.float32(0.0), np.float32(1.0), np.float32(1.0)]",-3.0,99765.0,36
2025-08-14_08-18-36,2866,"[np.float32(0.0), np.float32(1.0), np.float32(0.0), np.float32(1.0), np.float32(1.0), np.float32(0.0), np.float32(0.0), np.float32(1.0), np.float32(0.0), np.float32(1.0), np.float32(0.0), np.float32(1.0), np.float32(0.0), np.float32(1.0), np.float32(0.0), np.float32(0.0)]",-4.0,99761.0,32
2025-08-14_08-18-36,2867,"[np.float32(0.0), np.float32(0.0), np.float32(0.0), np.float32(1.0), np.float32(1.0), np.float32(1.0), np.float32(1.0), np.float32(1.0), np.float32(0.0), np.float32(0.0), np.float32(1.0), np.float32(0.0), np.float32(0.0), np.float32(0.0), np.float32(1.0), np.float32(0.0)]",0.0,99761.0,27
2025-08-14_08-18-36,2868,"[np.float32(0.0), np.float32(1.0), np.float32(1.0), np.float32(0.0), np.float32(0.0), np.float32(0.0), np.float32(1.0), np.float32(0.0), np.float32(0.0), np.float32(1.0), np.float32(0.0), np.float32(1.0), np.float32(0.0), np.float32(1.0), np.float32(0.0), np.float32(0.0)]",4.0,99765.0,6
2025-08-14_08-18-36,2869,"[np.float32(0.0), np.float32(0.0), np.float32(0.0), np.float32(1.0), np.float32(1.0), np.float32(0.0), np.float32(1.0), np.float32(1.0), np.float32(0.0), np.float32(1.0), np.float32(1.0), np.float32(0.0), np.float32(1.0), np.float32(0.0), np.float32(0.0), np.float32(0.0)]",-4.0,99761.0,32
2025-08-14_08-18-36,2870,"[np.float32(0.0), np.float32(1.0), np.float32(0.0), np.float32(1.0), np.float32(0.0), np.float32(0.0), np.float32(1.0), np.float32(0.0), np.float32(1.0), np.float32(0.0), np.float32(1.0), np.float32(0.0), np.float32(1.0), np.float32(0.0), np.float32(1.0), np.float32(0.0)]",3.0,99764.0,29
2025-08-14_08-18-36,2871,"[np.float32(0.0), np.float32(0.0), np.float32(0.0), np.float32(1.0), np.float32(0.0), np.float32(0.0), np.float32(0.0), np.float32(0.0), np.float32(1.0), np.float32(0.0), np.float32(0.0), np.float32(1.0), np.float32(0.0), np.float32(1.0), np.float32(0.0), np.float32(0.0)]",2.0,99766.0,12
2025-08-14_08-18-36,2872,"[np.float32(0.0), np.float32(1.0), np.float32(1.0), np.float32(0.0), np.float32(1.0), np.float32(0.0), np.float32(0.0), np.float32(1.0), np.float32(1.0), np.float32(0.0), np.float32(0.0), np.float32(1.0), np.float32(0.0), np.float32(1.0), np.float32(1.0), np.float32(0.0)]",-2.0,99764.0,25
2025-08-14_08-18-36,2873,"[np.float32(0.0), np.float32(0.0), np.float32(1.0), np.float32(1.0), np.float32(1.0), np.float32(1.0), np.float32(0.0), np.float32(0.0), np.float32(1.0), np.float32(1.0), np.float32(1.0), np.float32(1.0), np.float32(1.0), np.float32(1.0), np.float32(0.0), np.float32(1.0)]",2.0,99766.0,31
2025-08-14_08-18-36,2874,"[np.float32(1.0), np.float32(1.0), np.float32(1.0), np.float32(0.0), np.float32(1.0), np.float32(1.0), np.float32(0.0), np.float32(0.0), np.float32(1.0), np.float32(1.0), np.float32(0.0), np.float32(1.0), np.float32(0.0), np.float32(1.0), np.float32(0.0), np.float32(0.0)]",-3.0,99763.0,8
2025-08-14_08-18-36,2875,"[np.float32(1.0), np.float32(0.0), np.float32(1.0), np.float32(0.0), np.float32(0.0), np.float32(1.0), np.float32(0.0), np.float32(1.0), np.float32(0.0), np.float32(0.0), np.float32(0.0), np.float32(1.0), np.float32(1.0), np.float32(0.0), np.float32(1.0), np.float32(0.0)]",0.0,99763.0,14
2025-08-14_08-18-36,2876,"[np.float32(0.0), np.float32(1.0), np.float32(1.0), np.float32(1.0), np.float32(0.0), np.float32(0.0), np.float32(1.0), np.float32(1.0), np.float32(0.0), np.float32(0.0), np.float32(0.0), np.float32(0.0), np.float32(1.0), np.float32(0.0), np.float32(1.0), np.float32(0.0)]",0.0,99763.0,4
2025-08-14_08-18-36,2877,"[np.float32(1.0), np.float32(0.0), np.float32(1.0), np.float32(1.0), np.float32(0.0), np.float32(0.0), np.float32(1.0), np.float32(1.0), np.float32(0.0), np.float32(0.0), np.float32(0.0), np.float32(1.0), np.float32(1.0), np.float32(0.0), np.float32(1.0), np.float32(1.0)]",1.0,99764.0,12
2025-08-14_08-18-36,2878,"[np.float32(1.0), np.float32(1.0), np.float32(1.0), np.float32(1.0), np.float32(1.0), np.float32(0.0), np.float32(1.0), np.float32(1.0), np.float32(0.0), np.float32(0.0), np.float32(1.0), np.float32(0.0), np.float32(1.0), np.float32(1.0), np.float32(0.0), np.float32(1.0)]",-1.0,99763.0,32
2025-08-14_08-18-36,2879,"[np.float32(0.0), np.float32(0.0), np.float32(1.0), np.float32(0.0), np.float32(1.0), np.float32(1.0), np.float32(0.0), np.float32(1.0), np.float32(1.0), np.float32(1.0), np.float32(1.0), np.float32(0.0), np.float32(1.0), np.float32(1.0), np.float32(1.0), np.float32(0.0)]",0.0,99763.0,36
2025-08-14_08-18-36,2880,"[np.float32(1.0), np.float32(0.0), np.float32(1.0), np.float32(0.0), np.float32(1.0), np.float32(1.0), np.float32(0.0), np.float32(0.0), np.float32(0.0), np.float32(1.0), np.float32(1.0), np.float32(1.0), np.float32(1.0), np.float32(1.0), np.float32(0.0), np.float32(1.0)]",-5.0,99758.0,33
2025-08-14_08-18-36,2881,"[np.float32(0.0), np.float32(0.0), np.float32(1.0), np.float32(0.0), np.float32(1.0), np.float32(1.0), np.float32(0.0), np.float32(1.0), np.float32(0.0), np.float32(1.0), np.float32(0.0), np.float32(0.0), np.float32(1.0), np.float32(1.0), np.float32(1.0), np.float32(0.0)]",-6.0,99752.0,9
2025-08-14_08-18-36,2882,"[np.float32(0.0), np.float32(0.0), np.float32(1.0), np.float32(1.0), np.float32(0.0), np.float32(1.0), np.float32(0.0), np.float32(1.0), np.float32(1.0), np.float32(0.0), np.float32(1.0), np.float32(1.0), np.float32(1.0), np.float32(0.0), np.float32(1.0), np.float32(0.0)]",4.0,99756.0,33
2025-08-14_08-18-36,2883,"[np.float32(0.0), np.float32(1.0), np.float32(1.0), np.float32(0.0), np.float32(0.0), np.float32(1.0), np.float32(1.0), np.float32(1.0), np.float32(0.0), np.float32(1.0), np.float32(1.0), np.float32(0.0), np.float32(1.0), np.float32(0.0), np.float32(0.0), np.float32(0.0)]",-3.0,99753.0,18
2025-08-14_08-18-36,2884,"[np.float32(1.0), np.float32(0.0), np.float32(0.0), np.float32(1.0), np.float32(1.0), np.float32(1.0), np.float32(1.0), np.float32(1.0), np.float32(0.0), np.float32(0.0), np.float32(0.0), np.float32(1.0), np.float32(0.0), np.float32(0.0), np.float32(1.0), np.float32(1.0)]",-4.0,99749.0,4
2025-08-14_08-18-36,2885,"[np.float32(1.0), np.float32(0.0), np.float32(0.0), np.float32(0.0), np.float32(0.0), np.float32(1.0), np.float32(0.0), np.float32(0.0), np.float32(1.0), np.float32(0.0), np.float32(1.0), np.float32(0.0), np.float32(0.0), np.float32(1.0), np.float32(1.0), np.float32(1.0)]",-2.0,99747.0,1
2025-08-14_08-18-36,2886,"[np.float32(0.0), np.float32(1.0), np.float32(0.0), np.float32(1.0), np.float32(0.0), np.float32(1.0), np.float32(1.0), np.float32(1.0), np.float32(0.0), np.float32(0.0), np.float32(0.0), np.float32(1.0), np.float32(1.0), np.float32(1.0), np.float32(0.0), np.float32(0.0)]",-3.0,99744.0,36
2025-08-14_08-18-36,2887,"[np.float32(0.0), np.float32(1.0), np.float32(1.0), np.float32(1.0), np.float32(1.0), np.float32(0.0), np.float32(0.0), np.float32(1.0), np.float32(1.0), np.float32(0.0), np.float32(0.0), np.float32(1.0), np.float32(1.0), np.float32(1.0), np.float32(1.0), np.float32(0.0)]",33.0,99777.0,7
2025-08-14_08-18-36,2888,"[np.float32(1.0), np.float32(1.0), np.float32(0.0), np.float32(1.0), np.float32(1.0), np.float32(1.0), np.float32(0.0), np.float32(0.0), np.float32(0.0), np.float32(1.0), np.float32(1.0), np.float32(0.0), np.float32(1.0), np.float32(1.0), np.float32(1.0), np.float32(1.0)]",1.0,99778.0,1
2025-08-14_08-18-36,2889,"[np.float32(1.0), np.float32(0.0), np.float32(1.0), np.float32(1.0), np.float32(1.0), np.float32(0.0), np.float32(0.0), np.float32(1.0), np.float32(0.0), np.float32(0.0), np.float32(1.0), np.float32(0.0), np.float32(0.0), np.float32(0.0), np.float32(1.0), np.float32(0.0)]",1.0,99779.0,20
2025-08-14_08-18-36,2890,"[np.float32(0.0), np.float32(1.0), np.float32(0.0), np.float32(1.0), np.float32(0.0), np.float32(0.0), np.float32(0.0), np.float32(1.0), np.float32(1.0), np.float32(1.0), np.float32(1.0), np.float32(1.0), np.float32(0.0), np.float32(0.0), np.float32(1.0), np.float32(0.0)]",0.0,99779.0,26
2025-08-14_08-18-36,2891,"[np.float32(1.0), np.float32(0.0), np.float32(0.0), np.float32(0.0), np.float32(0.0), np.float32(1.0), np.float32(0.0), np.float32(1.0), np.float32(0.0), np.float32(0.0), np.float32(1.0), np.float32(0.0), np.float32(0.0), np.float32(0.0), np.float32(0.0), np.float32(0.0)]",-2.0,99777.0,3
2025-08-14_08-18-36,2892,"[np.float32(1.0), np.float32(1.0), np.float32(0.0), np.float32(0.0), np.float32(0.0), np.float32(0.0), np.float32(0.0), np.float32(1.0), np.float32(0.0), np.float32(1.0), np.float32(1.0), np.float32(0.0), np.float32(1.0), np.float32(1.0), np.float32(0.0), np.float32(0.0)]",1.0,99778.0,20
2025-08-14_08-18-36,2893,"[np.float32(1.0), np.float32(0.0), np.float32(0.0), np.float32(1.0), np.float32(0.0), np.float32(1.0), np.float32(0.0), np.float32(1.0), np.float32(0.0), np.float32(0.0), np.float32(0.0), np.float32(1.0), np.float32(1.0), np.float32(1.0), np.float32(0.0), np.float32(0.0)]",4.0,99782.0,15
2025-08-14_08-18-36,2894,"[np.float32(0.0), np.float32(1.0), np.float32(1.0), np.float32(1.0), np.float32(0.0), np.float32(1.0), np.float32(1.0), np.float32(1.0), np.float32(0.0), np.float32(1.0), np.float32(0.0), np.float32(1.0), np.float32(0.0), np.float32(0.0), np.float32(1.0), np.float32(1.0)]",2.0,99784.0,20
2025-08-14_08-18-36,2895,"[np.float32(1.0), np.float32(0.0), np.float32(0.0), np.float32(1.0), np.float32(0.0), np.float32(1.0), np.float32(0.0), np.float32(1.0), np.float32(0.0), np.float32(1.0), np.float32(0.0), np.float32(1.0), np.float32(0.0), np.float32(0.0), np.float32(1.0), np.float32(1.0)]",-2.0,99782.0,10
2025-08-14_08-18-36,2896,"[np.float32(0.0), np.float32(0.0), np.float32(1.0), np.float32(0.0), np.float32(1.0), np.float32(0.0), np.float32(0.0), np.float32(0.0), np.float32(0.0), np.float32(0.0), np.float32(0.0), np.float32(0.0), np.float32(0.0), np.float32(1.0), np.float32(1.0), np.float32(0.0)]",3.0,99785.0,10
2025-08-14_08-18-36,2897,"[np.float32(0.0), np.float32(0.0), np.float32(0.0), np.float32(0.0), np.float32(0.0), np.float32(0.0), np.float32(0.0), np.float32(0.0), np.float32(0.0), np.float32(0.0), np.float32(1.0), np.float32(0.0), np.float32(1.0), np.float32(0.0), np.float32(1.0), np.float32(0.0)]",-3.0,99782.0,6
2025-08-14_08-18-36,2898,"[np.float32(0.0), np.float32(0.0), np.float32(1.0), np.float32(1.0), np.float32(1.0), np.float32(1.0), np.float32(0.0), np.float32(1.0), np.float32(1.0), np.float32(1.0), np.float32(1.0), np.float32(1.0), np.float32(0.0), np.float32(0.0), np.float32(1.0), np.float32(0.0)]",0.0,99782.0,11
2025-08-14_08-18-36,2899,"[np.float32(1.0), np.float32(0.0), np.float32(0.0), np.float32(1.0), np.float32(1.0), np.float32(1.0), np.float32(0.0), np.float32(0.0), np.float32(0.0), np.float32(1.0), np.float32(1.0), np.float32(0.0), np.float32(1.0), np.float32(1.0), np.float32(1.0), np.float32(0.0)]",1.0,99783.0,16
2025-08-14_08-18-36,2900,"[np.float32(0.0), np.float32(1.0), np.float32(1.0), np.float32(0.0), np.float32(0.0), np.float32(0.0), np.float32(1.0), np.float32(1.0), np.float32(0.0), np.float32(1.0), np.float32(0.0), np.float32(1.0), np.float32(0.0), np.float32(0.0), np.float32(1.0), np.float32(0.0)]",3.0,99786.0,22
2025-08-14_08-18-36,2901,"[np.float32(0.0), np.float32(0.0), np.float32(0.0), np.float32(0.0), np.float32(1.0), np.float32(0.0), np.float32(1.0), np.float32(1.0), np.float32(1.0), np.float32(1.0), np.float32(1.0), np.float32(0.0), np.float32(0.0), np.float32(1.0), np.float32(1.0), np.float32(1.0)]",0.0,99786.0,28
2025-08-14_08-18-36,2902,"[np.float32(1.0), np.float32(0.0), np.float32(0.0), np.float32(1.0), np.float32(0.0), np.float32(0.0), np.float32(1.0), np.float32(1.0), np.float32(0.0), np.float32(1.0), np.float32(1.0), np.float32(0.0), np.float32(1.0), np.float32(1.0), np.float32(0.0), np.float32(1.0)]",1.0,99787.0,3
2025-08-14_08-18-36,2903,"[np.float32(0.0), np.float32(0.0), np.float32(0.0), np.float32(0.0), np.float32(1.0), np.float32(0.0), np.float32(1.0), np.float32(1.0), np.float32(1.0), np.float32(1.0), np.float32(0.0), np.float32(1.0), np.float32(1.0), np.float32(0.0), np.float32(1.0), np.float32(1.0)]",-1.0,99786.0,14
2025-08-14_08-18-36,2904,"[np.float32(0.0), np.float32(0.0), np.float32(0.0), np.float32(1.0), np.float32(1.0), np.float32(0.0), np.float32(1.0), np.float32(1.0), np.float32(1.0), np.float32(1.0), np.float32(1.0), np.float32(0.0), np.float32(1.0), np.float32(0.0), np.float32(1.0), np.float32(0.0)]",-1.0,99785.0,31
2025-08-14_08-18-36,2905,"[np.float32(1.0), np.float32(0.0), np.float32(0.0), np.float32(0.0), np.float32(0.0), np.float32(0.0), np.float32(1.0), np.float32(0.0), np.float32(1.0), np.float32(0.0), np.float32(1.0), np.float32(0.0), np.float32(1.0), np.float32(0.0), np.float32(0.0), np.float32(0.0)]",3.0,99788.0,5
2025-08-14_08-18-36,2906,"[np.float32(0.0), np.float32(1.0), np.float32(0.0), np.float32(1.0), np.float32(0.0), np.float32(1.0), np.float32(0.0), np.float32(0.0), np.float32(1.0), np.float32(1.0), np.float32(1.0), np.float32(1.0), np.float32(0.0), np.float32(1.0), np.float32(1.0), np.float32(0.0)]",4.0,99792.0,27
2025-08-14_08-18-36,2907,"[np.float32(0.0), np.float32(0.0), np.float32(1.0), np.float32(1.0), np.float32(1.0), np.float32(1.0), np.float32(0.0), np.float32(0.0), np.float32(1.0), np.float32(1.0), np.float32(1.0), np.float32(0.0), np.float32(0.0), np.float32(1.0), np.float32(0.0), np.float32(0.0)]",2.0,99794.0,7
2025-08-14_08-18-36,2908,"[np.float32(1.0), np.float32(1.0), np.float32(0.0), np.float32(0.0), np.float32(1.0), np.float32(1.0), np.float32(1.0), np.float32(0.0), np.float32(0.0), np.float32(1.0), np.float32(0.0), np.float32(1.0), np.float32(0.0), np.float32(0.0), np.float32(0.0), np.float32(1.0)]",-1.0,99793.0,20
2025-08-14_08-18-36,2909,"[np.float32(1.0), np.float32(0.0), np.float32(0.0), np.float32(0.0), np.float32(0.0), np.float32(1.0), np.float32(0.0), np.float32(1.0), np.float32(1.0), np.float32(0.0), np.float32(1.0), np.float32(1.0), np.float32(1.0), np.float32(0.0), np.float32(1.0), np.float32(0.0)]",-3.0,99790.0,22
2025-08-14_08-18-36,2910,"[np.float32(1.0), np.float32(1.0), np.float32(1.0), np.float32(0.0), np.float32(1.0), np.float32(1.0), np.float32(1.0), np.float32(0.0), np.float32(1.0), np.float32(1.0), np.float32(1.0), np.float32(1.0), np.float32(1.0), np.float32(0.0), np.float32(0.0), np.float32(0.0)]",-1.0,99789.0,27
2025-08-14_08-18-36,2911,"[np.float32(1.0), np.float32(0.0), np.float32(0.0), np.float32(0.0), np.float32(0.0), np.float32(0.0), np.float32(0.0), np.float32(0.0), np.float32(0.0), np.float32(1.0), np.float32(1.0), np.float32(1.0), np.float32(0.0), np.float32(1.0), np.float32(1.0), np.float32(1.0)]",1.0,99790.0,1
2025-08-14_08-18-36,2912,"[np.float32(1.0), np.float32(0.0), np.float32(0.0), np.float32(1.0), np.float32(0.0), np.float32(0.0), np.float32(1.0), np.float32(0.0), np.float32(0.0), np.float32(1.0), np.float32(1.0), np.float32(0.0), np.float32(1.0), np.float32(1.0), np.float32(1.0), np.float32(0.0)]",1.0,99791.0,8
2025-08-14_08-18-36,2913,"[np.float32(1.0), np.float32(0.0), np.float32(0.0), np.float32(1.0), np.float32(1.0), np.float32(1.0), np.float32(1.0), np.float32(1.0), np.float32(0.0), np.float32(0.0), np.float32(0.0), np.float32(1.0), np.float32(0.0), np.float32(1.0), np.float32(0.0), np.float32(0.0)]",5.0,99796.0,12
2025-08-14_08-18-36,2914,"[np.float32(1.0), np.float32(0.0), np.float32(1.0), np.float32(1.0), np.float32(1.0), np.float32(1.0), np.float32(1.0), np.float32(0.0), np.float32(1.0), np.float32(1.0), np.float32(0.0), np.float32(0.0), np.float32(1.0), np.float32(0.0), np.float32(1.0), np.float32(0.0)]",-1.0,99795.0,32
2025-08-14_08-18-36,2915,"[np.float32(0.0), np.float32(0.0), np.float32(0.0), np.float32(0.0), np.float32(0.0), np.float32(1.0), np.float32(1.0), np.float32(1.0), np.float32(0.0), np.float32(1.0), np.float32(0.0), np.float32(0.0), np.float32(1.0), np.float32(0.0), np.float32(1.0), np.float32(0.0)]",-1.0,99794.0,25
2025-08-14_08-18-36,2916,"[np.float32(1.0), np.float32(0.0), np.float32(1.0), np.float32(0.0), np.float32(0.0), np.float32(1.0), np.float32(1.0), np.float32(1.0), np.float32(1.0), np.float32(0.0), np.float32(0.0), np.float32(0.0), np.float32(1.0), np.float32(0.0), np.float32(1.0), np.float32(0.0)]",33.0,99827.0,7
2025-08-14_08-18-36,2917,"[np.float32(1.0), np.float32(0.0), np.float32(1.0), np.float32(0.0), np.float32(1.0), np.float32(0.0), np.float32(0.0), np.float32(0.0), np.float32(0.0), np.float32(1.0), np.float32(0.0), np.float32(1.0), np.float32(1.0), np.float32(1.0), np.float32(1.0), np.float32(1.0)]",1.0,99828.0,30
2025-08-14_08-18-36,2918,"[np.float32(0.0), np.float32(0.0), np.float32(1.0), np.float32(1.0), np.float32(1.0), np.float32(1.0), np.float32(0.0), np.float32(0.0), np.float32(1.0), np.float32(0.0), np.float32(1.0), np.float32(1.0), np.float32(1.0), np.float32(1.0), np.float32(0.0), np.float32(0.0)]",1.0,99829.0,12
2025-08-14_08-18-36,2919,"[np.float32(1.0), np.float32(0.0), np.float32(1.0), np.float32(0.0), np.float32(0.0), np.float32(0.0), np.float32(0.0), np.float32(0.0), np.float32(1.0), np.float32(0.0), np.float32(0.0), np.float32(0.0), np.float32(1.0), np.float32(0.0), np.float32(0.0), np.float32(1.0)]",-5.0,99824.0,15
2025-08-14_08-18-36,2920,"[np.float32(1.0), np.float32(1.0), np.float32(1.0), np.float32(0.0), np.float32(0.0), np.float32(0.0), np.float32(1.0), np.float32(0.0), np.float32(0.0), np.float32(1.0), np.float32(1.0), np.float32(1.0), np.float32(1.0), np.float32(0.0), np.float32(1.0), np.float32(0.0)]",-4.0,99820.0,35
2025-08-14_08-18-36,2921,"[np.float32(0.0), np.float32(1.0), np.float32(0.0), np.float32(0.0), np.float32(0.0), np.float32(1.0), np.float32(0.0), np.float32(1.0), np.float32(0.0), np.float32(1.0), np.float32(1.0), np.float32(0.0), np.float32(0.0), np.float32(0.0), np.float32(0.0), np.float32(1.0)]",-1.0,99819.0,11
2025-08-14_08-18-36,2922,"[np.float32(0.0), np.float32(0.0), np.float32(0.0), np.float32(0.0), np.float32(0.0), np.float32(1.0), np.float32(1.0), np.float32(0.0), np.float32(0.0), np.float32(0.0), np.float32(0.0), np.float32(1.0), np.float32(0.0), np.float32(0.0), np.float32(1.0), np.float32(1.0)]",0.0,99819.0,21
2025-08-14_08-18-36,2923,"[np.float32(0.0), np.float32(0.0), np.float32(0.0), np.float32(1.0), np.float32(1.0), np.float32(1.0), np.float32(0.0), np.float32(1.0), np.float32(0.0), np.float32(1.0), np.float32(1.0), np.float32(1.0), np.float32(0.0), np.float32(0.0), np.float32(1.0), np.float32(1.0)]",-1.0,99818.0,8
2025-08-14_08-18-36,2924,"[np.float32(0.0), np.float32(1.0), np.float32(1.0), np.float32(1.0), np.float32(0.0), np.float32(0.0), np.float32(0.0), np.float32(1.0), np.float32(0.0), np.float32(1.0), np.float32(0.0), np.float32(1.0), np.float32(1.0), np.float32(0.0), np.float32(0.0), np.float32(0.0)]",-3.0,99815.0,8
2025-08-14_08-18-36,2925,"[np.float32(1.0), np.float32(0.0), np.float32(0.0), np.float32(1.0), np.float32(0.0), np.float32(1.0), np.float32(0.0), np.float32(1.0), np.float32(1.0), np.float32(1.0), np.float32(1.0), np.float32(0.0), np.float32(0.0), np.float32(0.0), np.float32(0.0), np.float32(0.0)]",-5.0,99810.0,0
2025-08-14_08-18-36,2926,"[np.float32(1.0), np.float32(1.0), np.float32(0.0), np.float32(1.0), np.float32(0.0), np.float32(1.0), np.float32(1.0), np.float32(1.0), np.float32(1.0), np.float32(1.0), np.float32(1.0), np.float32(0.0), np.float32(1.0), np.float32(0.0), np.float32(1.0), np.float32(0.0)]",-3.0,99807.0,14
2025-08-14_08-18-36,2927,"[np.float32(1.0), np.float32(1.0), np.float32(1.0), np.float32(0.0), np.float32(1.0), np.float32(0.0), np.float32(1.0), np.float32(0.0), np.float32(0.0), np.float32(0.0), np.float32(1.0), np.float32(0.0), np.float32(0.0), np.float32(0.0), np.float32(0.0), np.float32(1.0)]",-2.0,99805.0,23
2025-08-14_08-18-36,2928,"[np.float32(1.0), np.float32(1.0), np.float32(1.0), np.float32(1.0), np.float32(1.0), np.float32(0.0), np.float32(0.0), np.float32(1.0), np.float32(1.0), np.float32(0.0), np.float32(0.0), np.float32(1.0), np.float32(1.0), np.float32(0.0), np.float32(0.0), np.float32(0.0)]",-2.0,99803.0,28
2025-08-14_08-18-36,2929,"[np.float32(1.0), np.float32(0.0), np.float32(1.0), np.float32(0.0), np.float32(1.0), np.float32(1.0), np.float32(0.0), np.float32(1.0), np.float32(0.0), np.float32(0.0), np.float32(1.0), np.float32(0.0), np.float32(0.0), np.float32(0.0), np.float32(1.0), np.float32(1.0)]",0.0,99803.0,11
2025-08-14_08-18-36,2930,"[np.float32(1.0), np.float32(0.0), np.float32(0.0), np.float32(1.0), np.float32(1.0), np.float32(0.0), np.float32(1.0), np.float32(1.0), np.float32(0.0), np.float32(0.0), np.float32(1.0), np.float32(1.0), np.float32(1.0), np.float32(0.0), np.float32(1.0), np.float32(1.0)]",5.0,99808.0,5
2025-08-14_08-18-36,2931,"[np.float32(0.0), np.float32(1.0), np.float32(1.0), np.float32(1.0), np.float32(1.0), np.float32(1.0), np.float32(1.0), np.float32(0.0), np.float32(0.0), np.float32(0.0), np.float32(0.0), np.float32(1.0), np.float32(0.0), np.float32(0.0), np.float32(1.0), np.float32(0.0)]",4.0,99812.0,6
2025-08-14_08-18-36,2932,"[np.float32(1.0), np.float32(1.0), np.float32(0.0), np.float32(0.0), np.float32(1.0), np.float32(1.0), np.float32(1.0), np.float32(1.0), np.float32(1.0), np.float32(1.0), np.float32(0.0), np.float32(1.0), np.float32(1.0), np.float32(1.0), np.float32(1.0), np.float32(1.0)]",-3.0,99809.0,17
2025-08-14_08-18-36,2933,"[np.float32(1.0), np.float32(0.0), np.float32(1.0), np.float32(0.0), np.float32(0.0), np.float32(0.0), np.float32(1.0), np.float32(1.0), np.float32(0.0), np.float32(0.0), np.float32(1.0), np.float32(1.0), np.float32(0.0), np.float32(0.0), np.float32(0.0), np.float32(0.0)]",2.0,99811.0,3
2025-08-14_08-18-36,2934,"[np.float32(0.0), np.float32(1.0), np.float32(1.0), np.float32(1.0), np.float32(1.0), np.float32(1.0), np.float32(0.0), np.float32(1.0), np.float32(0.0), np.float32(1.0), np.float32(0.0), np.float32(1.0), np.float32(0.0), np.float32(1.0), np.float32(1.0), np.float32(1.0)]",2.0,99813.0,19
2025-08-14_08-18-36,2935,"[np.float32(1.0), np.float32(1.0), np.float32(0.0), np.float32(0.0), np.float32(0.0), np.float32(0.0), np.float32(0.0), np.float32(1.0), np.float32(0.0), np.float32(1.0), np.float32(0.0), np.float32(1.0), np.float32(0.0), np.float32(1.0), np.float32(0.0), np.float32(0.0)]",2.0,99815.0,12
2025-08-14_08-18-36,2936,"[np.float32(0.0), np.float32(1.0), np.float32(0.0), np.float32(1.0), np.float32(0.0), np.float32(1.0), np.float32(0.0), np.float32(0.0), np.float32(1.0), np.float32(0.0), np.float32(1.0), np.float32(0.0), np.float32(0.0), np.float32(0.0), np.float32(0.0), np.float32(0.0)]",2.0,99817.0,11
2025-08-14_08-18-36,2937,"[np.float32(0.0), np.float32(0.0), np.float32(0.0), np.float32(0.0), np.float32(0.0), np.float32(0.0), np.float32(1.0), np.float32(1.0), np.float32(0.0), np.float32(1.0), np.float32(1.0), np.float32(0.0), np.float32(0.0), np.float32(1.0), np.float32(0.0), np.float32(1.0)]",-3.0,99814.0,0
2025-08-14_08-18-36,2938,"[np.float32(1.0), np.float32(1.0), np.float32(1.0), np.float32(1.0), np.float32(0.0), np.float32(1.0), np.float32(0.0), np.float32(0.0), np.float32(0.0), np.float32(1.0), np.float32(0.0), np.float32(1.0), np.float32(1.0), np.float32(0.0), np.float32(0.0), np.float32(0.0)]",-2.0,99812.0,29
2025-08-14_08-18-36,2939,"[np.float32(1.0), np.float32(1.0), np.float32(1.0), np.float32(0.0), np.float32(1.0), np.float32(1.0), np.float32(1.0), np.float32(1.0), np.float32(1.0), np.float32(1.0), np.float32(1.0), np.float32(0.0), np.float32(0.0), np.float32(1.0), np.float32(1.0), np.float32(1.0)]",0.0,99812.0,35
2025-08-14_08-18-36,2940,"[np.float32(1.0), np.float32(0.0), np.float32(1.0), np.float32(1.0), np.float32(1.0), np.float32(1.0), np.float32(0.0), np.float32(0.0), np.float32(1.0), np.float32(0.0), np.float32(0.0), np.float32(1.0), np.float32(0.0), np.float32(1.0), np.float32(1.0), np.float32(1.0)]",0.0,99812.0,29
2025-08-14_08-18-36,2941,"[np.float32(0.0), np.float32(1.0), np.float32(0.0), np.float32(0.0), np.float32(0.0), np.float32(1.0), np.float32(0.0), np.float32(1.0), np.float32(0.0), np.float32(1.0), np.float32(1.0), np.float32(1.0), np.float32(1.0), np.float32(0.0), np.float32(0.0), np.float32(1.0)]",-2.0,99810.0,1
2025-08-14_08-18-36,2942,"[np.float32(1.0), np.float32(1.0), np.float32(1.0), np.float32(1.0), np.float32(0.0), np.float32(0.0), np.float32(0.0), np.float32(1.0), np.float32(1.0), np.float32(0.0), np.float32(1.0), np.float32(0.0), np.float32(0.0), np.float32(1.0), np.float32(0.0), np.float32(0.0)]",-1.0,99809.0,11
2025-08-14_08-18-36,2943,"[np.float32(1.0), np.float32(1.0), np.float32(1.0), np.float32(0.0), np.float32(0.0), np.float32(0.0), np.float32(0.0), np.float32(1.0), np.float32(0.0), np.float32(0.0), np.float32(0.0), np.float32(0.0), np.float32(0.0), np.float32(0.0), np.float32(0.0), np.float32(0.0)]",3.0,99812.0,20
2025-08-14_08-18-36,2944,"[np.float32(0.0), np.float32(0.0), np.float32(0.0), np.float32(1.0), np.float32(0.0), np.float32(0.0), np.float32(1.0), np.float32(1.0), np.float32(1.0), np.float32(1.0), np.float32(1.0), np.float32(1.0), np.float32(0.0), np.float32(1.0), np.float32(1.0), np.float32(0.0)]",0.0,99812.0,12
2025-08-14_08-18-36,2945,"[np.float32(1.0), np.float32(1.0), np.float32(1.0), np.float32(0.0), np.float32(0.0), np.float32(0.0), np.float32(0.0), np.float32(1.0), np.float32(0.0), np.float32(0.0), np.float32(1.0), np.float32(0.0), np.float32(1.0), np.float32(0.0), np.float32(1.0), np.float32(0.0)]",3.0,99815.0,24
2025-08-14_08-18-36,2946,"[np.float32(1.0), np.float32(1.0), np.float32(1.0), np.float32(1.0), np.float32(1.0), np.float32(1.0), np.float32(0.0), np.float32(0.0), np.float32(0.0), np.float32(1.0), np.float32(0.0), np.float32(0.0), np.float32(1.0), np.float32(0.0), np.float32(0.0), np.float32(0.0)]",1.0,99816.0,1
2025-08-14_08-18-36,2947,"[np.float32(0.0), np.float32(0.0), np.float32(1.0), np.float32(1.0), np.float32(1.0), np.float32(1.0), np.float32(1.0), np.float32(0.0), np.float32(0.0), np.float32(1.0), np.float32(1.0), np.float32(1.0), np.float32(1.0), np.float32(1.0), np.float32(0.0), np.float32(0.0)]",-3.0,99813.0,23
2025-08-14_08-18-36,2948,"[np.float32(0.0), np.float32(1.0), np.float32(1.0), np.float32(1.0), np.float32(0.0), np.float32(0.0), np.float32(0.0), np.float32(1.0), np.float32(1.0), np.float32(1.0), np.float32(0.0), np.float32(0.0), np.float32(1.0), np.float32(0.0), np.float32(1.0), np.float32(1.0)]",-5.0,99808.0,2
2025-08-14_08-18-36,2949,"[np.float32(0.0), np.float32(1.0), np.float32(1.0), np.float32(1.0), np.float32(0.0), np.float32(0.0), np.float32(0.0), np.float32(1.0), np.float32(0.0), np.float32(0.0), np.float32(0.0), np.float32(0.0), np.float32(0.0), np.float32(0.0), np.float32(0.0), np.float32(1.0)]",0.0,99808.0,19
2025-08-14_08-18-36,2950,"[np.float32(0.0), np.float32(0.0), np.float32(1.0), np.float32(0.0), np.float32(1.0), np.float32(1.0), np.float32(0.0), np.float32(1.0), np.float32(1.0), np.float32(1.0), np.float32(1.0), np.float32(0.0), np.float32(0.0), np.float32(1.0), np.float32(0.0), np.float32(0.0)]",-3.0,99805.0,3
2025-08-14_08-18-36,2951,"[np.float32(1.0), np.float32(0.0), np.float32(0.0), np.float32(1.0), np.float32(1.0), np.float32(0.0), np.float32(1.0), np.float32(1.0), np.float32(0.0), np.float32(1.0), np.float32(0.0), np.float32(0.0), np.float32(1.0), np.float32(0.0), np.float32(0.0), np.float32(0.0)]",-3.0,99802.0,27
2025-08-14_08-18-36,2952,"[np.float32(1.0), np.float32(0.0), np.float32(1.0), np.float32(0.0), np.float32(0.0), np.float32(1.0), np.float32(0.0), np.float32(1.0), np.float32(0.0), np.float32(0.0), np.float32(0.0), np.float32(0.0), np.float32(0.0), np.float32(0.0), np.float32(1.0), np.float32(0.0)]",-1.0,99801.0,25
2025-08-14_08-18-36,2953,"[np.float32(0.0), np.float32(0.0), np.float32(1.0), np.float32(0.0), np.float32(0.0), np.float32(0.0), np.float32(1.0), np.float32(1.0), np.float32(1.0), np.float32(1.0), np.float32(0.0), np.float32(0.0), np.float32(1.0), np.float32(1.0), np.float32(0.0), np.float32(1.0)]",0.0,99801.0,6
2025-08-14_08-18-36,2954,"[np.float32(1.0), np.float32(0.0), np.float32(1.0), np.float32(0.0), np.float32(0.0), np.float32(1.0), np.float32(0.0), np.float32(0.0), np.float32(0.0), np.float32(1.0), np.float32(1.0), np.float32(1.0), np.float32(0.0), np.float32(0.0), np.float32(0.0), np.float32(1.0)]",2.0,99803.0,36
2025-08-14_08-18-36,2955,"[np.float32(0.0), np.float32(1.0), np.float32(0.0), np.float32(1.0), np.float32(0.0), np.float32(0.0), np.float32(1.0), np.float32(1.0), np.float32(1.0), np.float32(0.0), np.float32(0.0), np.float32(0.0), np.float32(1.0), np.float32(1.0), np.float32(0.0), np.float32(1.0)]",-5.0,99798.0,30
2025-08-14_08-18-36,2956,"[np.float32(1.0), np.float32(0.0), np.float32(0.0), np.float32(0.0), np.float32(0.0), np.float32(1.0), np.float32(1.0), np.float32(1.0), np.float32(0.0), np.float32(1.0), np.float32(1.0), np.float32(0.0), np.float32(0.0), np.float32(0.0), np.float32(0.0), np.float32(1.0)]",1.0,99799.0,22
2025-08-14_08-18-36,2957,"[np.float32(1.0), np.float32(1.0), np.float32(1.0), np.float32(1.0), np.float32(1.0), np.float32(1.0), np.float32(0.0), np.float32(1.0), np.float32(0.0), np.float32(1.0), np.float32(0.0), np.float32(1.0), np.float32(0.0), np.float32(0.0), np.float32(0.0), np.float32(1.0)]",2.0,99801.0,9
2025-08-14_08-18-36,2958,"[np.float32(1.0), np.float32(1.0), np.float32(0.0), np.float32(1.0), np.float32(1.0), np.float32(1.0), np.float32(0.0), np.float32(0.0), np.float32(1.0), np.float32(1.0), np.float32(1.0), np.float32(0.0), np.float32(0.0), np.float32(1.0), np.float32(0.0), np.float32(0.0)]",-5.0,99796.0,24
2025-08-14_08-18-36,2959,"[np.float32(1.0), np.float32(0.0), np.float32(0.0), np.float32(0.0), np.float32(0.0), np.float32(1.0), np.float32(0.0), np.float32(1.0), np.float32(0.0), np.float32(1.0), np.float32(0.0), np.float32(1.0), np.float32(1.0), np.float32(1.0), np.float32(1.0), np.float32(1.0)]",-1.0,99795.0,12
2025-08-14_08-18-36,2960,"[np.float32(1.0), np.float32(0.0), np.float32(1.0), np.float32(1.0), np.float32(0.0), np.float32(0.0), np.float32(1.0), np.float32(1.0), np.float32(0.0), np.float32(0.0), np.float32(1.0), np.float32(0.0), np.float32(0.0), np.float32(1.0), np.float32(0.0), np.float32(0.0)]",4.0,99799.0,2
2025-08-14_08-18-36,2961,"[np.float32(1.0), np.float32(1.0), np.float32(0.0), np.float32(1.0), np.float32(1.0), np.float32(0.0), np.float32(0.0), np.float32(1.0), np.float32(0.0), np.float32(0.0), np.float32(1.0), np.float32(0.0), np.float32(1.0), np.float32(0.0), np.float32(0.0), np.float32(0.0)]",-2.0,99797.0,22
2025-08-14_08-18-36,2962,"[np.float32(0.0), np.float32(1.0), np.float32(1.0), np.float32(1.0), np.float32(0.0), np.float32(1.0), np.float32(0.0), np.float32(1.0), np.float32(0.0), np.float32(0.0), np.float32(1.0), np.float32(0.0), np.float32(1.0), np.float32(0.0), np.float32(0.0), np.float32(0.0)]",2.0,99799.0,35
2025-08-14_08-18-36,2963,"[np.float32(1.0), np.float32(0.0), np.float32(0.0), np.float32(1.0), np.float32(1.0), np.float32(0.0), np.float32(1.0), np.float32(0.0), np.float32(0.0), np.float32(0.0), np.float32(0.0), np.float32(0.0), np.float32(1.0), np.float32(0.0), np.float32(1.0), np.float32(0.0)]",-4.0,99795.0,34
2025-08-14_08-18-36,2964,"[np.float32(1.0), np.float32(0.0), np.float32(1.0), np.float32(1.0), np.float32(0.0), np.float32(1.0), np.float32(0.0), np.float32(0.0), np.float32(1.0), np.float32(0.0), np.float32(1.0), np.float32(0.0), np.float32(0.0), np.float32(1.0), np.float32(0.0), np.float32(0.0)]",2.0,99797.0,30
2025-08-14_08-18-36,2965,"[np.float32(1.0), np.float32(1.0), np.float32(0.0), np.float32(1.0), np.float32(0.0), np.float32(1.0), np.float32(1.0), np.float32(1.0), np.float32(0.0), np.float32(1.0), np.float32(0.0), np.float32(1.0), np.float32(1.0), np.float32(1.0), np.float32(0.0), np.float32(0.0)]",3.0,99800.0,22
2025-08-14_08-18-36,2966,"[np.float32(1.0), np.float32(1.0), np.float32(1.0), np.float32(1.0), np.float32(0.0), np.float32(0.0), np.float32(1.0), np.float32(1.0), np.float32(0.0), np.float32(1.0), np.float32(0.0), np.float32(0.0), np.float32(1.0), np.float32(0.0), np.float32(0.0), np.float32(1.0)]",-5.0,99795.0,36
2025-08-14_08-18-36,2967,"[np.float32(1.0), np.float32(1.0), np.float32(1.0), np.float32(1.0), np.float32(0.0), np.float32(1.0), np.float32(0.0), np.float32(1.0), np.float32(1.0), np.float32(0.0), np.float32(1.0), np.float32(0.0), np.float32(0.0), np.float32(0.0), np.float32(1.0), np.float32(1.0)]",3.0,99798.0,14
2025-08-14_08-18-36,2968,"[np.float32(1.0), np.float32(1.0), np.float32(1.0), np.float32(0.0), np.float32(0.0), np.float32(0.0), np.float32(0.0), np.float32(0.0), np.float32(1.0), np.float32(1.0), np.float32(1.0), np.float32(1.0), np.float32(1.0), np.float32(0.0), np.float32(0.0), np.float32(0.0)]",2.0,99800.0,34
2025-08-14_08-18-36,2969,"[np.float32(1.0), np.float32(0.0), np.float32(0.0), np.float32(1.0), np.float32(0.0), np.float32(1.0), np.float32(1.0), np.float32(1.0), np.float32(0.0), np.float32(0.0), np.float32(0.0), np.float32(1.0), np.float32(1.0), np.float32(0.0), np.float32(0.0), np.float32(0.0)]",5.0,99805.0,21
2025-08-14_08-18-36,2970,"[np.float32(0.0), np.float32(0.0), np.float32(1.0), np.float32(0.0), np.float32(0.0), np.float32(1.0), np.float32(1.0), np.float32(1.0), np.float32(0.0), np.float32(1.0), np.float32(0.0), np.float32(1.0), np.float32(0.0), np.float32(1.0), np.float32(0.0), np.float32(0.0)]",1.0,99806.0,6
2025-08-14_08-18-36,2971,"[np.float32(1.0), np.float32(1.0), np.float32(1.0), np.float32(1.0), np.float32(0.0), np.float32(0.0), np.float32(0.0), np.float32(0.0), np.float32(1.0), np.float32(1.0), np.float32(0.0), np.float32(0.0), np.float32(1.0), np.float32(1.0), np.float32(1.0), np.float32(1.0)]",-3.0,99803.0,24
2025-08-14_08-18-36,2972,"[np.float32(1.0), np.float32(0.0), np.float32(0.0), np.float32(0.0), np.float32(0.0), np.float32(0.0), np.float32(0.0), np.float32(0.0), np.float32(1.0), np.float32(1.0), np.float32(1.0), np.float32(0.0), np.float32(1.0), np.float32(1.0), np.float32(0.0), np.float32(1.0)]",-4.0,99799.0,8
2025-08-14_08-18-36,2973,"[np.float32(0.0), np.float32(1.0), np.float32(0.0), np.float32(0.0), np.float32(0.0), np.float32(1.0), np.float32(0.0), np.float32(0.0), np.float32(1.0), np.float32(0.0), np.float32(0.0), np.float32(1.0), np.float32(0.0), np.float32(1.0), np.float32(0.0), np.float32(0.0)]",2.0,99801.0,31
2025-08-14_08-18-36,2974,"[np.float32(1.0), np.float32(0.0), np.float32(0.0), np.float32(1.0), np.float32(1.0), np.float32(1.0), np.float32(1.0), np.float32(1.0), np.float32(0.0), np.float32(1.0), np.float32(1.0), np.float32(0.0), np.float32(0.0), np.float32(0.0), np.float32(0.0), np.float32(1.0)]",3.0,99804.0,7
2025-08-14_08-18-36,2975,"[np.float32(1.0), np.float32(0.0), np.float32(1.0), np.float32(0.0), np.float32(0.0), np.float32(0.0), np.float32(1.0), np.float32(0.0), np.float32(1.0), np.float32(0.0), np.float32(0.0), np.float32(1.0), np.float32(0.0), np.float32(1.0), np.float32(0.0), np.float32(1.0)]",1.0,99805.0,21
2025-08-14_08-18-36,2976,"[np.float32(1.0), np.float32(1.0), np.float32(0.0), np.float32(0.0), np.float32(0.0), np.float32(1.0), np.float32(0.0), np.float32(1.0), np.float32(0.0), np.float32(1.0), np.float32(0.0), np.float32(0.0), np.float32(1.0), np.float32(1.0), np.float32(0.0), np.float32(0.0)]",-3.0,99802.0,36
2025-08-14_08-18-36,2977,"[np.float32(0.0), np.float32(0.0), np.float32(1.0), np.float32(1.0), np.float32(0.0), np.float32(0.0), np.float32(1.0), np.float32(1.0), np.float32(1.0), np.float32(0.0), np.float32(1.0), np.float32(0.0), np.float32(1.0), np.float32(1.0), np.float32(1.0), np.float32(0.0)]",-1.0,99801.0,17
2025-08-14_08-18-36,2978,"[np.float32(0.0), np.float32(0.0), np.float32(1.0), np.float32(1.0), np.float32(0.0), np.float32(1.0), np.float32(1.0), np.float32(1.0), np.float32(0.0), np.float32(0.0), np.float32(1.0), np.float32(0.0), np.float32(0.0), np.float32(1.0), np.float32(0.0), np.float32(1.0)]",3.0,99804.0,14
2025-08-14_08-18-36,2979,"[np.float32(1.0), np.float32(0.0), np.float32(0.0), np.float32(0.0), np.float32(0.0), np.float32(0.0), np.float32(1.0), np.float32(1.0), np.float32(0.0), np.float32(0.0), np.float32(0.0), np.float32(1.0), np.float32(0.0), np.float32(0.0), np.float32(0.0), np.float32(1.0)]",-5.0,99799.0,28
2025-08-14_08-18-36,2980,"[np.float32(0.0), np.float32(0.0), np.float32(1.0), np.float32(0.0), np.float32(0.0), np.float32(1.0), np.float32(0.0), np.float32(1.0), np.float32(1.0), np.float32(1.0), np.float32(0.0), np.float32(0.0), np.float32(1.0), np.float32(1.0), np.float32(0.0), np.float32(1.0)]",-3.0,99796.0,6
2025-08-14_08-18-36,2981,"[np.float32(1.0), np.float32(0.0), np.float32(1.0), np.float32(0.0), np.float32(0.0), np.float32(0.0), np.float32(0.0), np.float32(1.0), np.float32(1.0), np.float32(1.0), np.float32(0.0), np.float32(1.0), np.float32(1.0), np.float32(1.0), np.float32(1.0), np.float32(1.0)]",-2.0,99794.0,6
2025-08-14_08-18-36,2982,"[np.float32(0.0), np.float32(1.0), np.float32(1.0), np.float32(0.0), np.float32(0.0), np.float32(1.0), np.float32(1.0), np.float32(1.0), np.float32(0.0), np.float32(1.0), np.float32(0.0), np.float32(1.0), np.float32(1.0), np.float32(1.0), np.float32(0.0), np.float32(0.0)]",-2.0,99792.0,30
2025-08-14_08-18-36,2983,"[np.float32(0.0), np.float32(0.0), np.float32(0.0), np.float32(1.0), np.float32(0.0), np.float32(1.0), np.float32(0.0), np.float32(1.0), np.float32(0.0), np.float32(1.0), np.float32(1.0), np.float32(1.0), np.float32(1.0), np.float32(0.0), np.float32(0.0), np.float32(0.0)]",0.0,99792.0,33
2025-08-14_08-18-36,2984,"[np.float32(1.0), np.float32(1.0), np.float32(0.0), np.float32(0.0), np.float32(1.0), np.float32(1.0), np.float32(0.0), np.float32(1.0), np.float32(1.0), np.float32(1.0), np.float32(0.0), np.float32(0.0), np.float32(1.0), np.float32(0.0), np.float32(1.0), np.float32(0.0)]",1.0,99793.0,27
2025-08-14_08-18-36,2985,"[np.float32(1.0), np.float32(0.0), np.float32(0.0), np.float32(1.0), np.float32(0.0), np.float32(1.0), np.float32(1.0), np.float32(1.0), np.float32(1.0), np.float32(0.0), np.float32(0.0), np.float32(1.0), np.float32(0.0), np.float32(0.0), np.float32(1.0), np.float32(1.0)]",1.0,99794.0,5
2025-08-14_08-18-36,2986,"[np.float32(0.0), np.float32(1.0), np.float32(0.0), np.float32(1.0), np.float32(1.0), np.float32(0.0), np.float32(1.0), np.float32(1.0), np.float32(1.0), np.float32(0.0), np.float32(1.0), np.float32(0.0), np.float32(1.0), np.float32(1.0), np.float32(0.0), np.float32(1.0)]",-1.0,99793.0,13
2025-08-14_08-18-36,2987,"[np.float32(1.0), np.float32(0.0), np.float32(1.0), np.float32(0.0), np.float32(1.0), np.float32(1.0), np.float32(1.0), np.float32(1.0), np.float32(1.0), np.float32(1.0), np.float32(0.0), np.float32(1.0), np.float32(0.0), np.float32(1.0), np.float32(1.0), np.float32(0.0)]",2.0,99795.0,28
2025-08-14_08-18-36,2988,"[np.float32(0.0), np.float32(1.0), np.float32(0.0), np.float32(1.0), np.float32(1.0), np.float32(0.0), np.float32(1.0), np.float32(0.0), np.float32(0.0), np.float32(1.0), np.float32(0.0), np.float32(0.0), np.float32(0.0), np.float32(0.0), np.float32(1.0), np.float32(0.0)]",7.0,99802.0,10
2025-08-14_08-18-36,2989,"[np.float32(0.0), np.float32(1.0), np.float32(1.0), np.float32(0.0), np.float32(1.0), np.float32(1.0), np.float32(1.0), np.float32(1.0), np.float32(1.0), np.float32(1.0), np.float32(1.0), np.float32(1.0), np.float32(1.0), np.float32(0.0), np.float32(1.0), np.float32(0.0)]",-2.0,99800.0,34
2025-08-14_08-18-36,2990,"[np.float32(0.0), np.float32(1.0), np.float32(1.0), np.float32(0.0), np.float32(0.0), np.float32(0.0), np.float32(0.0), np.float32(0.0), np.float32(1.0), np.float32(1.0), np.float32(1.0), np.float32(1.0), np.float32(0.0), np.float32(1.0), np.float32(1.0), np.float32(0.0)]",-2.0,99798.0,19
2025-08-14_08-18-36,2991,"[np.float32(1.0), np.float32(0.0), np.float32(0.0), np.float32(1.0), np.float32(1.0), np.float32(1.0), np.float32(1.0), np.float32(0.0), np.float32(0.0), np.float32(1.0), np.float32(0.0), np.float32(1.0), np.float32(1.0), np.float32(1.0), np.float32(0.0), np.float32(0.0)]",-2.0,99796.0,32
2025-08-14_08-18-36,2992,"[np.float32(1.0), np.float32(1.0), np.float32(0.0), np.float32(1.0), np.float32(1.0), np.float32(1.0), np.float32(0.0), np.float32(1.0), np.float32(1.0), np.float32(1.0), np.float32(0.0), np.float32(1.0), np.float32(0.0), np.float32(1.0), np.float32(0.0), np.float32(0.0)]",0.0,99796.0,32
2025-08-14_08-18-36,2993,"[np.float32(0.0), np.float32(0.0), np.float32(1.0), np.float32(1.0), np.float32(1.0), np.float32(0.0), np.float32(1.0), np.float32(1.0), np.float32(1.0), np.float32(0.0), np.float32(0.0), np.float32(1.0), np.float32(1.0), np.float32(0.0), np.float32(0.0), np.float32(1.0)]",-1.0,99795.0,34
2025-08-14_08-18-36,2994,"[np.float32(0.0), np.float32(0.0), np.float32(1.0), np.float32(0.0), np.float32(0.0), np.float32(1.0), np.float32(1.0), np.float32(1.0), np.float32(0.0), np.float32(0.0), np.float32(1.0), np.float32(0.0), np.float32(1.0), np.float32(1.0), np.float32(1.0), np.float32(1.0)]",2.0,99797.0,8
2025-08-14_08-18-36,2995,"[np.float32(1.0), np.float32(1.0), np.float32(0.0), np.float32(1.0), np.float32(1.0), np.float32(0.0), np.float32(1.0), np.float32(0.0), np.float32(1.0), np.float32(0.0), np.float32(0.0), np.float32(0.0), np.float32(0.0), np.float32(1.0), np.float32(0.0), np.float32(0.0)]",3.0,99800.0,25
2025-08-14_08-18-36,2996,"[np.float32(0.0), np.float32(0.0), np.float32(1.0), np.float32(1.0), np.float32(1.0), np.float32(0.0), np.float32(1.0), np.float32(1.0), np.float32(0.0), np.float32(0.0), np.float32(0.0), np.float32(0.0), np.float32(0.0), np.float32(0.0), np.float32(1.0), np.float32(0.0)]",1.0,99801.0,18
2025-08-14_08-18-36,2997,"[np.float32(1.0), np.float32(0.0), np.float32(1.0), np.float32(1.0), np.float32(0.0), np.float32(0.0), np.float32(1.0), np.float32(0.0), np.float32(0.0), np.float32(0.0), np.float32(1.0), np.float32(1.0), np.float32(0.0), np.float32(1.0), np.float32(0.0), np.float32(0.0)]",6.0,99807.0,12
2025-08-14_08-18-36,2998,"[np.float32(0.0), np.float32(0.0), np.float32(1.0), np.float32(1.0), np.float32(0.0), np.float32(1.0), np.float32(0.0), np.float32(1.0), np.float32(0.0), np.float32(1.0), np.float32(0.0), np.float32(1.0), np.float32(0.0), np.float32(1.0), np.float32(1.0), np.float32(0.0)]",3.0,99810.0,13
2025-08-14_08-18-36,2999,"[np.float32(1.0), np.float32(0.0), np.float32(0.0), np.float32(0.0), np.float32(0.0), np.float32(0.0), np.float32(0.0), np.float32(0.0), np.float32(0.0), np.float32(0.0), np.float32(1.0), np.float32(1.0), np.float32(0.0), np.float32(0.0), np.float32(1.0), np.float32(0.0)]",1.0,99811.0,3
2025-08-14_08-18-36,3000,"[np.float32(1.0), np.float32(0.0), np.float32(1.0), np.float32(1.0), np.float32(1.0), np.float32(0.0), np.float32(1.0), np.float32(1.0), np.float32(1.0), np.float32(1.0), np.float32(0.0), np.float32(0.0), np.float32(1.0), np.float32(0.0), np.float32(0.0), np.float32(0.0)]",-2.0,99809.0,6
2025-08-14_08-18-36,3001,"[np.float32(0.0), np.float32(1.0), np.float32(0.0), np.float32(1.0), np.float32(1.0), np.float32(0.0), np.float32(1.0), np.float32(1.0), np.float32(1.0), np.float32(1.0), np.float32(0.0), np.float32(1.0), np.float32(0.0), np.float32(0.0), np.float32(0.0), np.float32(0.0)]",0.0,99838.0,12
2025-08-14_08-18-36,3002,"[np.float32(0.0), np.float32(0.0), np.float32(1.0), np.float32(1.0), np.float32(1.0), np.float32(1.0), np.float32(1.0), np.float32(0.0), np.float32(0.0), np.float32(1.0), np.float32(0.0), np.float32(0.0), np.float32(0.0), np.float32(0.0), np.float32(1.0), np.float32(1.0)]",-1.0,99837.0,33
2025-08-14_08-18-36,3003,"[np.float32(0.0), np.float32(1.0), np.float32(0.0), np.float32(0.0), np.float32(0.0), np.float32(1.0), np.float32(1.0), np.float32(0.0), np.float32(1.0), np.float32(0.0), np.float32(1.0), np.float32(0.0), np.float32(1.0), np.float32(0.0), np.float32(0.0), np.float32(0.0)]",-1.0,99836.0,6
2025-08-14_08-18-36,3004,"[np.float32(0.0), np.float32(0.0), np.float32(0.0), np.float32(1.0), np.float32(0.0), np.float32(1.0), np.float32(1.0), np.float32(0.0), np.float32(1.0), np.float32(0.0), np.float32(0.0), np.float32(1.0), np.float32(0.0), np.float32(1.0), np.float32(0.0), np.float32(0.0)]",-4.0,99832.0,17
2025-08-14_08-18-36,3005,"[np.float32(0.0), np.float32(1.0), np.float32(1.0), np.float32(0.0), np.float32(0.0), np.float32(1.0), np.float32(1.0), np.float32(0.0), np.float32(0.0), np.float32(1.0), np.float32(0.0), np.float32(1.0), np.float32(0.0), np.float32(0.0), np.float32(1.0), np.float32(0.0)]",2.0,99834.0,22
2025-08-14_08-18-36,3006,"[np.float32(1.0), np.float32(0.0), np.float32(0.0), np.float32(1.0), np.float32(1.0), np.float32(0.0), np.float32(1.0), np.float32(1.0), np.float32(1.0), np.float32(1.0), np.float32(0.0), np.float32(1.0), np.float32(0.0), np.float32(1.0), np.float32(0.0), np.float32(0.0)]",-2.0,99832.0,23
2025-08-14_08-18-36,3007,"[np.float32(1.0), np.float32(1.0), np.float32(0.0), np.float32(1.0), np.float32(1.0), np.float32(1.0), np.float32(0.0), np.float32(1.0), np.float32(1.0), np.float32(0.0), np.float32(1.0), np.float32(0.0), np.float32(1.0), np.float32(1.0), np.float32(0.0), np.float32(0.0)]",-4.0,99828.0,1
2025-08-14_08-18-36,3008,"[np.float32(1.0), np.float32(0.0), np.float32(1.0), np.float32(0.0), np.float32(1.0), np.float32(1.0), np.float32(1.0), np.float32(0.0), np.float32(0.0), np.float32(0.0), np.float32(0.0), np.float32(0.0), np.float32(0.0), np.float32(0.0), np.float32(0.0), np.float32(0.0)]",2.0,99830.0,7
2025-08-14_08-18-36,3009,"[np.float32(1.0), np.float32(0.0), np.float32(1.0), np.float32(1.0), np.float32(0.0), np.float32(1.0), np.float32(0.0), np.float32(1.0), np.float32(0.0), np.float32(1.0), np.float32(1.0), np.float32(1.0), np.float32(1.0), np.float32(0.0), np.float32(1.0), np.float32(1.0)]",2.0,99832.0,24
2025-08-14_08-18-36,3010,"[np.float32(0.0), np.float32(0.0), np.float32(0.0), np.float32(0.0), np.float32(1.0), np.float32(1.0), np.float32(0.0), np.float32(0.0), np.float32(1.0), np.float32(0.0), np.float32(0.0), np.float32(1.0), np.float32(0.0), np.float32(1.0), np.float32(0.0), np.float32(1.0)]",2.0,99834.0,29
2025-08-14_08-18-36,3011,"[np.float32(0.0), np.float32(1.0), np.float32(1.0), np.float32(0.0), np.float32(1.0), np.float32(1.0), np.float32(0.0), np.float32(1.0), np.float32(1.0), np.float32(1.0), np.float32(0.0), np.float32(1.0), np.float32(1.0), np.float32(0.0), np.float32(0.0), np.float32(0.0)]",1.0,99835.0,16
2025-08-14_08-18-36,3012,"[np.float32(1.0), np.float32(0.0), np.float32(1.0), np.float32(1.0), np.float32(0.0), np.float32(1.0), np.float32(0.0), np.float32(0.0), np.float32(0.0), np.float32(0.0), np.float32(1.0), np.float32(1.0), np.float32(0.0), np.float32(0.0), np.float32(0.0), np.float32(1.0)]",0.0,99835.0,5
2025-08-14_08-18-36,3013,"[np.float32(0.0), np.float32(0.0), np.float32(1.0), np.float32(0.0), np.float32(1.0), np.float32(1.0), np.float32(0.0), np.float32(0.0), np.float32(1.0), np.float32(0.0), np.float32(1.0), np.float32(0.0), np.float32(1.0), np.float32(1.0), np.float32(1.0), np.float32(0.0)]",-1.0,99834.0,14
2025-08-14_08-18-36,3014,"[np.float32(0.0), np.float32(1.0), np.float32(1.0), np.float32(1.0), np.float32(1.0), np.float32(0.0), np.float32(1.0), np.float32(0.0), np.float32(0.0), np.float32(0.0), np.float32(1.0), np.float32(0.0), np.float32(1.0), np.float32(0.0), np.float32(0.0), np.float32(1.0)]",-3.0,99831.0,34
2025-08-14_08-18-36,3015,"[np.float32(0.0), np.float32(1.0), np.float32(1.0), np.float32(0.0), np.float32(1.0), np.float32(1.0), np.float32(0.0), np.float32(1.0), np.float32(0.0), np.float32(1.0), np.float32(1.0), np.float32(0.0), np.float32(0.0), np.float32(1.0), np.float32(0.0), np.float32(0.0)]",0.0,99831.0,25
2025-08-14_08-18-36,3016,"[np.float32(1.0), np.float32(0.0), np.float32(1.0), np.float32(1.0), np.float32(0.0), np.float32(1.0), np.float32(0.0), np.float32(0.0), np.float32(1.0), np.float32(1.0), np.float32(1.0), np.float32(0.0), np.float32(1.0), np.float32(1.0), np.float32(0.0), np.float32(0.0)]",0.0,99831.0,23
2025-08-14_08-18-36,3017,"[np.float32(0.0), np.float32(1.0), np.float32(1.0), np.float32(0.0), np.float32(0.0), np.float32(0.0), np.float32(1.0), np.float32(1.0), np.float32(0.0), np.float32(0.0), np.float32(1.0), np.float32(0.0), np.float32(0.0), np.float32(1.0), np.float32(0.0), np.float32(0.0)]",0.0,99831.0,19
2025-08-14_08-18-36,3018,"[np.float32(0.0), np.float32(1.0), np.float32(0.0), np.float32(1.0), np.float32(1.0), np.float32(0.0), np.float32(0.0), np.float32(0.0), np.float32(1.0), np.float32(0.0), np.float32(1.0), np.float32(0.0), np.float32(0.0), np.float32(0.0), np.float32(0.0), np.float32(0.0)]",-3.0,99828.0,21
2025-08-14_08-18-36,3019,"[np.float32(0.0), np.float32(1.0), np.float32(0.0), np.float32(0.0), np.float32(1.0), np.float32(0.0), np.float32(0.0), np.float32(1.0), np.float32(0.0), np.float32(1.0), np.float32(0.0), np.float32(0.0), np.float32(0.0), np.float32(1.0), np.float32(0.0), np.float32(1.0)]",-1.0,99827.0,24
2025-08-14_08-18-36,3020,"[np.float32(1.0), np.float32(1.0), np.float32(0.0), np.float32(1.0), np.float32(0.0), np.float32(0.0), np.float32(0.0), np.float32(1.0), np.float32(1.0), np.float32(0.0), np.float32(1.0), np.float32(1.0), np.float32(1.0), np.float32(0.0), np.float32(0.0), np.float32(0.0)]",-1.0,99826.0,31
2025-08-14_08-18-36,3021,"[np.float32(0.0), np.float32(1.0), np.float32(1.0), np.float32(0.0), np.float32(0.0), np.float32(1.0), np.float32(1.0), np.float32(1.0), np.float32(1.0), np.float32(1.0), np.float32(1.0), np.float32(0.0), np.float32(1.0), np.float32(0.0), np.float32(1.0), np.float32(0.0)]",0.0,99826.0,36
2025-08-14_08-18-36,3022,"[np.float32(0.0), np.float32(1.0), np.float32(0.0), np.float32(1.0), np.float32(0.0), np.float32(1.0), np.float32(0.0), np.float32(0.0), np.float32(1.0), np.float32(1.0), np.float32(1.0), np.float32(1.0), np.float32(0.0), np.float32(0.0), np.float32(1.0), np.float32(0.0)]",2.0,99828.0,13
2025-08-14_08-18-36,3023,"[np.float32(1.0), np.float32(0.0), np.float32(1.0), np.float32(0.0), np.float32(1.0), np.float32(0.0), np.float32(1.0), np.float32(0.0), np.float32(1.0), np.float32(1.0), np.float32(0.0), np.float32(1.0), np.float32(0.0), np.float32(1.0), np.float32(0.0), np.float32(0.0)]",0.0,99828.0,21
2025-08-14_08-18-36,3024,"[np.float32(1.0), np.float32(0.0), np.float32(1.0), np.float32(1.0), np.float32(0.0), np.float32(1.0), np.float32(1.0), np.float32(1.0), np.float32(1.0), np.float32(0.0), np.float32(0.0), np.float32(0.0), np.float32(1.0), np.float32(1.0), np.float32(0.0), np.float32(0.0)]",-4.0,99824.0,13
2025-08-14_08-18-36,3025,"[np.float32(1.0), np.float32(0.0), np.float32(1.0), np.float32(0.0), np.float32(0.0), np.float32(1.0), np.float32(0.0), np.float32(1.0), np.float32(1.0), np.float32(0.0), np.float32(1.0), np.float32(0.0), np.float32(0.0), np.float32(1.0), np.float32(0.0), np.float32(1.0)]",-5.0,99819.0,11
2025-08-14_08-18-36,3026,"[np.float32(0.0), np.float32(1.0), np.float32(0.0), np.float32(0.0), np.float32(0.0), np.float32(0.0), np.float32(1.0), np.float32(1.0), np.float32(0.0), np.float32(1.0), np.float32(1.0), np.float32(1.0), np.float32(0.0), np.float32(0.0), np.float32(1.0), np.float32(0.0)]",4.0,99823.0,11
2025-08-14_08-18-36,3027,"[np.float32(1.0), np.float32(0.0), np.float32(0.0), np.float32(1.0), np.float32(1.0), np.float32(1.0), np.float32(1.0), np.float32(1.0), np.float32(1.0), np.float32(1.0), np.float32(0.0), np.float32(0.0), np.float32(0.0), np.float32(0.0), np.float32(0.0), np.float32(1.0)]",-4.0,99819.0,26
2025-08-14_08-18-36,3028,"[np.float32(0.0), np.float32(0.0), np.float32(0.0), np.float32(1.0), np.float32(0.0), np.float32(1.0), np.float32(0.0), np.float32(0.0), np.float32(0.0), np.float32(1.0), np.float32(0.0), np.float32(1.0), np.float32(0.0), np.float32(1.0), np.float32(0.0), np.float32(1.0)]",-1.0,99818.0,17
2025-08-14_08-18-36,3029,"[np.float32(1.0), np.float32(1.0), np.float32(0.0), np.float32(1.0), np.float32(0.0), np.float32(0.0), np.float32(1.0), np.float32(1.0), np.float32(1.0), np.float32(1.0), np.float32(0.0), np.float32(1.0), np.float32(1.0), np.float32(0.0), np.float32(0.0), np.float32(1.0)]",-2.0,99816.0,4
2025-08-14_08-18-36,3030,"[np.float32(1.0), np.float32(0.0), np.float32(0.0), np.float32(0.0), np.float32(0.0), np.float32(0.0), np.float32(0.0), np.float32(1.0), np.float32(0.0), np.float32(1.0), np.float32(0.0), np.float32(1.0), np.float32(0.0), np.float32(1.0), np.float32(1.0), np.float32(0.0)]",3.0,99819.0,22
2025-08-14_08-18-36,3031,"[np.float32(0.0), np.float32(1.0), np.float32(0.0), np.float32(0.0), np.float32(0.0), np.float32(0.0), np.float32(0.0), np.float32(0.0), np.float32(0.0), np.float32(1.0), np.float32(1.0), np.float32(0.0), np.float32(1.0), np.float32(0.0), np.float32(0.0), np.float32(0.0)]",35.0,99854.0,7
2025-08-14_08-18-36,3032,"[np.float32(0.0), np.float32(1.0), np.float32(1.0), np.float32(1.0), np.float32(0.0), np.float32(1.0), np.float32(0.0), np.float32(1.0), np.float32(1.0), np.float32(1.0), np.float32(0.0), np.float32(0.0), np.float32(0.0), np.float32(0.0), np.float32(1.0), np.float32(0.0)]",-1.0,99853.0,15
2025-08-14_08-18-36,3033,"[np.float32(0.0), np.float32(1.0), np.float32(0.0), np.float32(1.0), np.float32(1.0), np.float32(0.0), np.float32(1.0), np.float32(0.0), np.float32(1.0), np.float32(0.0), np.float32(0.0), np.float32(0.0), np.float32(0.0), np.float32(0.0), np.float32(0.0), np.float32(0.0)]",2.0,99855.0,4
2025-08-14_08-18-36,3034,"[np.float32(0.0), np.float32(0.0), np.float32(1.0), np.float32(1.0), np.float32(0.0), np.float32(0.0), np.float32(1.0), np.float32(0.0), np.float32(1.0), np.float32(1.0), np.float32(1.0), np.float32(1.0), np.float32(1.0), np.float32(1.0), np.float32(0.0), np.float32(0.0)]",-1.0,99854.0,9
2025-08-14_08-18-36,3035,"[np.float32(1.0), np.float32(0.0), np.float32(1.0), np.float32(0.0), np.float32(1.0), np.float32(1.0), np.float32(0.0), np.float32(0.0), np.float32(0.0), np.float32(0.0), np.float32(1.0), np.float32(0.0), np.float32(1.0), np.float32(1.0), np.float32(0.0), np.float32(1.0)]",-2.0,99852.0,16
2025-08-14_08-18-36,3036,"[np.float32(0.0), np.float32(0.0), np.float32(0.0), np.float32(0.0), np.float32(1.0), np.float32(1.0), np.float32(0.0), np.float32(1.0), np.float32(1.0), np.float32(0.0), np.float32(1.0), np.float32(0.0), np.float32(1.0), np.float32(0.0), np.float32(1.0), np.float32(1.0)]",0.0,99852.0,24
2025-08-14_08-18-36,3037,"[np.float32(0.0), np.float32(0.0), np.float32(1.0), np.float32(0.0), np.float32(0.0), np.float32(0.0), np.float32(1.0), np.float32(1.0), np.float32(0.0), np.float32(0.0), np.float32(0.0), np.float32(0.0), np.float32(1.0), np.float32(0.0), np.float32(1.0), np.float32(0.0)]",-5.0,99847.0,29
2025-08-14_08-18-36,3038,"[np.float32(0.0), np.float32(0.0), np.float32(0.0), np.float32(1.0), np.float32(0.0), np.float32(1.0), np.float32(0.0), np.float32(0.0), np.float32(0.0), np.float32(0.0), np.float32(0.0), np.float32(1.0), np.float32(1.0), np.float32(0.0), np.float32(1.0), np.float32(1.0)]",2.0,99849.0,30
2025-08-14_08-18-36,3039,"[np.float32(0.0), np.float32(0.0), np.float32(1.0), np.float32(1.0), np.float32(0.0), np.float32(1.0), np.float32(1.0), np.float32(0.0), np.float32(1.0), np.float32(1.0), np.float32(1.0), np.float32(1.0), np.float32(0.0), np.float32(0.0), np.float32(1.0), np.float32(1.0)]",0.0,99849.0,20
2025-08-14_08-18-36,3040,"[np.float32(1.0), np.float32(1.0), np.float32(1.0), np.float32(1.0), np.float32(0.0), np.float32(0.0), np.float32(1.0), np.float32(1.0), np.float32(0.0), np.float32(0.0), np.float32(0.0), np.float32(0.0), np.float32(0.0), np.float32(1.0), np.float32(1.0), np.float32(1.0)]",1.0,99850.0,10
2025-08-14_08-18-36,3041,"[np.float32(1.0), np.float32(1.0), np.float32(0.0), np.float32(1.0), np.float32(1.0), np.float32(0.0), np.float32(0.0), np.float32(0.0), np.float32(0.0), np.float32(0.0), np.float32(1.0), np.float32(1.0), np.float32(1.0), np.float32(0.0), np.float32(0.0), np.float32(0.0)]",0.0,99850.0,27
2025-08-14_08-18-36,3042,"[np.float32(1.0), np.float32(1.0), np.float32(0.0), np.float32(1.0), np.float32(0.0), np.float32(1.0), np.float32(1.0), np.float32(0.0), np.float32(0.0), np.float32(0.0), np.float32(0.0), np.float32(1.0), np.float32(1.0), np.float32(0.0), np.float32(0.0), np.float32(0.0)]",-3.0,99847.0,34
2025-08-14_08-18-36,3043,"[np.float32(1.0), np.float32(0.0), np.float32(1.0), np.float32(1.0), np.float32(0.0), np.float32(1.0), np.float32(1.0), np.float32(1.0), np.float32(0.0), np.float32(0.0), np.float32(1.0), np.float32(1.0), np.float32(0.0), np.float32(0.0), np.float32(0.0), np.float32(1.0)]",-5.0,99842.0,28
2025-08-14_08-18-36,3044,"[np.float32(1.0), np.float32(0.0), np.float32(0.0), np.float32(0.0), np.float32(1.0), np.float32(0.0), np.float32(0.0), np.float32(1.0), np.float32(1.0), np.float32(1.0), np.float32(0.0), np.float32(0.0), np.float32(1.0), np.float32(0.0), np.float32(1.0), np.float32(1.0)]",-2.0,99840.0,20
2025-08-14_08-18-36,3045,"[np.float32(1.0), np.float32(1.0), np.float32(0.0), np.float32(1.0), np.float32(1.0), np.float32(1.0), np.float32(0.0), np.float32(1.0), np.float32(0.0), np.float32(1.0), np.float32(0.0), np.float32(0.0), np.float32(0.0), np.float32(1.0), np.float32(1.0), np.float32(0.0)]",1.0,99841.0,4
2025-08-14_08-18-36,3046,"[np.float32(1.0), np.float32(1.0), np.float32(0.0), np.float32(1.0), np.float32(0.0), np.float32(0.0), np.float32(1.0), np.float32(1.0), np.float32(0.0), np.float32(0.0), np.float32(0.0), np.float32(1.0), np.float32(0.0), np.float32(1.0), np.float32(0.0), np.float32(0.0)]",-2.0,99839.0,0
2025-08-14_08-18-36,3047,"[np.float32(0.0), np.float32(1.0), np.float32(1.0), np.float32(1.0), np.float32(0.0), np.float32(0.0), np.float32(0.0), np.float32(0.0), np.float32(1.0), np.float32(1.0), np.float32(0.0), np.float32(0.0), np.float32(1.0), np.float32(1.0), np.float32(0.0), np.float32(0.0)]",-3.0,99836.0,20
2025-08-14_08-18-36,3048,"[np.float32(0.0), np.float32(1.0), np.float32(0.0), np.float32(0.0), np.float32(0.0), np.float32(0.0), np.float32(1.0), np.float32(0.0), np.float32(1.0), np.float32(0.0), np.float32(1.0), np.float32(0.0), np.float32(1.0), np.float32(1.0), np.float32(1.0), np.float32(0.0)]",-4.0,99832.0,1
2025-08-14_08-18-36,3049,"[np.float32(0.0), np.float32(0.0), np.float32(0.0), np.float32(0.0), np.float32(1.0), np.float32(0.0), np.float32(0.0), np.float32(0.0), np.float32(0.0), np.float32(1.0), np.float32(0.0), np.float32(0.0), np.float32(1.0), np.float32(0.0), np.float32(1.0), np.float32(0.0)]",-1.0,99831.0,19
2025-08-14_08-18-36,3050,"[np.float32(1.0), np.float32(1.0), np.float32(1.0), np.float32(1.0), np.float32(0.0), np.float32(0.0), np.float32(0.0), np.float32(0.0), np.float32(0.0), np.float32(1.0), np.float32(1.0), np.float32(1.0), np.float32(0.0), np.float32(1.0), np.float32(0.0), np.float32(0.0)]",-1.0,99830.0,23
2025-08-14_08-18-36,3051,"[np.float32(1.0), np.float32(0.0), np.float32(1.0), np.float32(0.0), np.float32(0.0), np.float32(0.0), np.float32(0.0), np.float32(0.0), np.float32(1.0), np.float32(0.0), np.float32(0.0), np.float32(1.0), np.float32(1.0), np.float32(1.0), np.float32(0.0), np.float32(1.0)]",-5.0,99825.0,10
2025-08-14_08-18-36,3052,"[np.float32(1.0), np.float32(0.0), np.float32(0.0), np.float32(0.0), np.float32(0.0), np.float32(1.0), np.float32(0.0), np.float32(1.0), np.float32(0.0), np.float32(1.0), np.float32(1.0), np.float32(1.0), np.float32(0.0), np.float32(1.0), np.float32(1.0), np.float32(0.0)]",-1.0,99824.0,34
2025-08-14_08-18-36,3053,"[np.float32(1.0), np.float32(0.0), np.float32(1.0), np.float32(0.0), np.float32(0.0), np.float32(0.0), np.float32(1.0), np.float32(0.0), np.float32(1.0), np.float32(1.0), np.float32(0.0), np.float32(1.0), np.float32(1.0), np.float32(1.0), np.float32(0.0), np.float32(0.0)]",3.0,99827.0,25
2025-08-14_08-18-36,3054,"[np.float32(1.0), np.float32(0.0), np.float32(1.0), np.float32(0.0), np.float32(0.0), np.float32(0.0), np.float32(1.0), np.float32(1.0), np.float32(1.0), np.float32(0.0), np.float32(0.0), np.float32(1.0), np.float32(0.0), np.float32(0.0), np.float32(1.0), np.float32(1.0)]",-5.0,99822.0,29
2025-08-14_08-18-36,3055,"[np.float32(1.0), np.float32(0.0), np.float32(0.0), np.float32(0.0), np.float32(1.0), np.float32(1.0), np.float32(1.0), np.float32(1.0), np.float32(0.0), np.float32(1.0), np.float32(1.0), np.float32(1.0), np.float32(0.0), np.float32(1.0), np.float32(1.0), np.float32(1.0)]",2.0,99824.0,1
2025-08-14_08-18-36,3056,"[np.float32(1.0), np.float32(0.0), np.float32(0.0), np.float32(1.0), np.float32(1.0), np.float32(1.0), np.float32(1.0), np.float32(1.0), np.float32(1.0), np.float32(1.0), np.float32(0.0), np.float32(1.0), np.float32(1.0), np.float32(0.0), np.float32(0.0), np.float32(0.0)]",-5.0,99819.0,2
2025-08-14_08-18-36,3057,"[np.float32(1.0), np.float32(0.0), np.float32(0.0), np.float32(0.0), np.float32(1.0), np.float32(0.0), np.float32(0.0), np.float32(0.0), np.float32(0.0), np.float32(1.0), np.float32(0.0), np.float32(0.0), np.float32(1.0), np.float32(0.0), np.float32(0.0), np.float32(0.0)]",0.0,99819.0,5
2025-08-14_08-18-36,3058,"[np.float32(0.0), np.float32(0.0), np.float32(1.0), np.float32(1.0), np.float32(1.0), np.float32(0.0), np.float32(0.0), np.float32(1.0), np.float32(1.0), np.float32(1.0), np.float32(1.0), np.float32(0.0), np.float32(1.0), np.float32(1.0), np.float32(1.0), np.float32(1.0)]",0.0,99819.0,19
2025-08-14_08-18-36,3059,"[np.float32(1.0), np.float32(0.0), np.float32(1.0), np.float32(0.0), np.float32(0.0), np.float32(1.0), np.float32(1.0), np.float32(0.0), np.float32(0.0), np.float32(1.0), np.float32(0.0), np.float32(1.0), np.float32(1.0), np.float32(1.0), np.float32(0.0), np.float32(0.0)]",1.0,99820.0,32
2025-08-14_08-18-36,3060,"[np.float32(0.0), np.float32(1.0), np.float32(0.0), np.float32(0.0), np.float32(1.0), np.float32(1.0), np.float32(0.0), np.float32(0.0), np.float32(1.0), np.float32(0.0), np.float32(0.0), np.float32(1.0), np.float32(1.0), np.float32(1.0), np.float32(0.0), np.float32(1.0)]",-6.0,99814.0,5
2025-08-14_08-18-36,3061,"[np.float32(0.0), np.float32(0.0), np.float32(0.0), np.float32(1.0), np.float32(1.0), np.float32(1.0), np.float32(0.0), np.float32(0.0), np.float32(1.0), np.float32(1.0), np.float32(1.0), np.float32(0.0), np.float32(0.0), np.float32(1.0), np.float32(1.0), np.float32(1.0)]",-1.0,99813.0,20
2025-08-14_08-18-36,3062,"[np.float32(0.0), np.float32(1.0), np.float32(0.0), np.float32(1.0), np.float32(0.0), np.float32(0.0), np.float32(1.0), np.float32(0.0), np.float32(1.0), np.float32(0.0), np.float32(1.0), np.float32(0.0), np.float32(0.0), np.float32(0.0), np.float32(1.0), np.float32(1.0)]",1.0,99814.0,26
2025-08-14_08-18-36,3063,"[np.float32(0.0), np.float32(1.0), np.float32(0.0), np.float32(0.0), np.float32(0.0), np.float32(1.0), np.float32(0.0), np.float32(1.0), np.float32(1.0), np.float32(0.0), np.float32(0.0), np.float32(0.0), np.float32(1.0), np.float32(0.0), np.float32(1.0), np.float32(0.0)]",1.0,99815.0,26
2025-08-14_08-18-36,3064,"[np.float32(1.0), np.float32(1.0), np.float32(0.0), np.float32(0.0), np.float32(0.0), np.float32(0.0), np.float32(1.0), np.float32(1.0), np.float32(1.0), np.float32(1.0), np.float32(1.0), np.float32(1.0), np.float32(1.0), np.float32(1.0), np.float32(1.0), np.float32(0.0)]",0.0,99815.0,28
2025-08-14_08-18-36,3065,"[np.float32(1.0), np.float32(0.0), np.float32(1.0), np.float32(1.0), np.float32(1.0), np.float32(1.0), np.float32(0.0), np.float32(1.0), np.float32(1.0), np.float32(0.0), np.float32(1.0), np.float32(0.0), np.float32(0.0), np.float32(1.0), np.float32(1.0), np.float32(0.0)]",0.0,99815.0,15
2025-08-14_08-18-36,3066,"[np.float32(0.0), np.float32(0.0), np.float32(1.0), np.float32(0.0), np.float32(0.0), np.float32(0.0), np.float32(0.0), np.float32(1.0), np.float32(1.0), np.float32(1.0), np.float32(0.0), np.float32(0.0), np.float32(1.0), np.float32(0.0), np.float32(0.0), np.float32(0.0)]",-2.0,99813.0,35
2025-08-14_08-18-36,3067,"[np.float32(1.0), np.float32(0.0), np.float32(0.0), np.float32(1.0), np.float32(0.0), np.float32(1.0), np.float32(0.0), np.float32(1.0), np.float32(1.0), np.float32(0.0), np.float32(0.0), np.float32(0.0), np.float32(0.0), np.float32(1.0), np.float32(0.0), np.float32(0.0)]",1.0,99814.0,3
2025-08-14_08-18-36,3068,"[np.float32(0.0), np.float32(0.0), np.float32(0.0), np.float32(1.0), np.float32(1.0), np.float32(1.0), np.float32(1.0), np.float32(0.0), np.float32(0.0), np.float32(0.0), np.float32(1.0), np.float32(1.0), np.float32(0.0), np.float32(1.0), np.float32(1.0), np.float32(0.0)]",-3.0,99811.0,22
2025-08-14_08-18-36,3069,"[np.float32(0.0), np.float32(1.0), np.float32(0.0), np.float32(0.0), np.float32(1.0), np.float32(0.0), np.float32(0.0), np.float32(1.0), np.float32(1.0), np.float32(0.0), np.float32(1.0), np.float32(1.0), np.float32(0.0), np.float32(0.0), np.float32(0.0), np.float32(0.0)]",1.0,99812.0,11
2025-08-14_08-18-36,3070,"[np.float32(0.0), np.float32(1.0), np.float32(1.0), np.float32(0.0), np.float32(0.0), np.float32(0.0), np.float32(1.0), np.float32(0.0), np.float32(1.0), np.float32(0.0), np.float32(1.0), np.float32(0.0), np.float32(0.0), np.float32(1.0), np.float32(1.0), np.float32(1.0)]",2.0,99814.0,10
2025-08-14_08-18-36,3071,"[np.float32(0.0), np.float32(0.0), np.float32(1.0), np.float32(1.0), np.float32(1.0), np.float32(1.0), np.float32(0.0), np.float32(0.0), np.float32(1.0), np.float32(0.0), np.float32(1.0), np.float32(1.0), np.float32(1.0), np.float32(0.0), np.float32(1.0), np.float32(0.0)]",-2.0,99812.0,21
2025-08-14_08-18-36,3072,"[np.float32(1.0), np.float32(0.0), np.float32(1.0), np.float32(0.0), np.float32(1.0), np.float32(1.0), np.float32(0.0), np.float32(1.0), np.float32(0.0), np.float32(0.0), np.float32(1.0), np.float32(1.0), np.float32(0.0), np.float32(1.0), np.float32(0.0), np.float32(1.0)]",-2.0,99810.0,5
2025-08-14_08-18-36,3073,"[np.float32(1.0), np.float32(0.0), np.float32(0.0), np.float32(1.0), np.float32(0.0), np.float32(1.0), np.float32(0.0), np.float32(0.0), np.float32(1.0), np.float32(0.0), np.float32(0.0), np.float32(1.0), np.float32(0.0), np.float32(0.0), np.float32(1.0), np.float32(0.0)]",7.0,99817.0,36
2025-08-14_08-18-36,3074,"[np.float32(0.0), np.float32(1.0), np.float32(0.0), np.float32(1.0), np.float32(0.0), np.float32(0.0), np.float32(0.0), np.float32(0.0), np.float32(1.0), np.float32(0.0), np.float32(1.0), np.float32(1.0), np.float32(1.0), np.float32(1.0), np.float32(1.0), np.float32(0.0)]",-3.0,99814.0,9
2025-08-14_08-18-36,3075,"[np.float32(0.0), np.float32(0.0), np.float32(1.0), np.float32(1.0), np.float32(1.0), np.float32(1.0), np.float32(0.0), np.float32(0.0), np.float32(0.0), np.float32(0.0), np.float32(1.0), np.float32(0.0), np.float32(0.0), np.float32(0.0), np.float32(0.0), np.float32(1.0)]",1.0,99815.0,26
2025-08-14_08-18-36,3076,"[np.float32(1.0), np.float32(1.0), np.float32(0.0), np.float32(1.0), np.float32(1.0), np.float32(1.0), np.float32(0.0), np.float32(1.0), np.float32(0.0), np.float32(0.0), np.float32(1.0), np.float32(0.0), np.float32(1.0), np.float32(0.0), np.float32(0.0), np.float32(1.0)]",6.0,99821.0,17
2025-08-14_08-18-36,3077,"[np.float32(1.0), np.float32(0.0), np.float32(1.0), np.float32(1.0), np.float32(0.0), np.float32(1.0), np.float32(0.0), np.float32(0.0), np.float32(0.0), np.float32(1.0), np.float32(1.0), np.float32(1.0), np.float32(1.0), np.float32(1.0), np.float32(1.0), np.float32(1.0)]",-1.0,99820.0,14
2025-08-14_08-18-36,3078,"[np.float32(1.0), np.float32(1.0), np.float32(1.0), np.float32(1.0), np.float32(1.0), np.float32(0.0), np.float32(0.0), np.float32(1.0), np.float32(1.0), np.float32(1.0), np.float32(1.0), np.float32(1.0), np.float32(0.0), np.float32(1.0), np.float32(1.0), np.float32(0.0)]",3.0,99823.0,15
2025-08-14_08-18-36,3079,"[np.float32(1.0), np.float32(1.0), np.float32(1.0), np.float32(1.0), np.float32(0.0), np.float32(1.0), np.float32(0.0), np.float32(0.0), np.float32(0.0), np.float32(0.0), np.float32(0.0), np.float32(1.0), np.float32(1.0), np.float32(1.0), np.float32(0.0), np.float32(0.0)]",1.0,99824.0,28
2025-08-14_08-18-36,3080,"[np.float32(0.0), np.float32(0.0), np.float32(0.0), np.float32(0.0), np.float32(0.0), np.float32(1.0), np.float32(1.0), np.float32(0.0), np.float32(0.0), np.float32(0.0), np.float32(0.0), np.float32(0.0), np.float32(1.0), np.float32(1.0), np.float32(0.0), np.float32(1.0)]",-2.0,99822.0,11
2025-08-14_08-18-36,3081,"[np.float32(0.0), np.float32(1.0), np.float32(0.0), np.float32(0.0), np.float32(1.0), np.float32(0.0), np.float32(0.0), np.float32(1.0), np.float32(1.0), np.float32(1.0), np.float32(0.0), np.float32(0.0), np.float32(0.0), np.float32(0.0), np.float32(0.0), np.float32(0.0)]",-1.0,99821.0,6
2025-08-14_08-18-36,3082,"[np.float32(0.0), np.float32(1.0), np.float32(1.0), np.float32(0.0), np.float32(0.0), np.float32(1.0), np.float32(0.0), np.float32(0.0), np.float32(0.0), np.float32(1.0), np.float32(0.0), np.float32(1.0), np.float32(1.0), np.float32(1.0), np.float32(0.0), np.float32(0.0)]",35.0,99856.0,7
2025-08-14_08-18-36,3083,"[np.float32(0.0), np.float32(1.0), np.float32(0.0), np.float32(1.0), np.float32(0.0), np.float32(1.0), np.float32(0.0), np.float32(1.0), np.float32(0.0), np.float32(0.0), np.float32(1.0), np.float32(1.0), np.float32(1.0), np.float32(0.0), np.float32(0.0), np.float32(1.0)]",-1.0,99855.0,13
2025-08-14_08-18-36,3084,"[np.float32(1.0), np.float32(0.0), np.float32(1.0), np.float32(0.0), np.float32(0.0), np.float32(0.0), np.float32(1.0), np.float32(1.0), np.float32(1.0), np.float32(1.0), np.float32(0.0), np.float32(1.0), np.float32(1.0), np.float32(1.0), np.float32(1.0), np.float32(1.0)]",2.0,99857.0,36
2025-08-14_08-18-36,3085,"[np.float32(0.0), np.float32(1.0), np.float32(0.0), np.float32(1.0), np.float32(0.0), np.float32(0.0), np.float32(0.0), np.float32(1.0), np.float32(1.0), np.float32(0.0), np.float32(0.0), np.float32(1.0), np.float32(1.0), np.float32(0.0), np.float32(0.0), np.float32(1.0)]",-5.0,99852.0,10
2025-08-14_08-18-36,3086,"[np.float32(1.0), np.float32(0.0), np.float32(0.0), np.float32(0.0), np.float32(1.0), np.float32(1.0), np.float32(0.0), np.float32(0.0), np.float32(1.0), np.float32(0.0), np.float32(0.0), np.float32(0.0), np.float32(1.0), np.float32(0.0), np.float32(0.0), np.float32(1.0)]",-4.0,99848.0,2
2025-08-14_08-18-36,3087,"[np.float32(1.0), np.float32(1.0), np.float32(1.0), np.float32(0.0), np.float32(0.0), np.float32(0.0), np.float32(1.0), np.float32(0.0), np.float32(1.0), np.float32(0.0), np.float32(1.0), np.float32(1.0), np.float32(0.0), np.float32(0.0), np.float32(1.0), np.float32(0.0)]",-1.0,99847.0,18
2025-08-14_08-18-36,3088,"[np.float32(0.0), np.float32(1.0), np.float32(1.0), np.float32(1.0), np.float32(0.0), np.float32(1.0), np.float32(1.0), np.float32(1.0), np.float32(1.0), np.float32(0.0), np.float32(1.0), np.float32(1.0), np.float32(0.0), np.float32(0.0), np.float32(0.0), np.float32(0.0)]",-3.0,99844.0,0
2025-08-14_08-18-36,3089,"[np.float32(1.0), np.float32(1.0), np.float32(0.0), np.float32(0.0), np.float32(0.0), np.float32(1.0), np.float32(1.0), np.float32(0.0), np.float32(1.0), np.float32(0.0), np.float32(1.0), np.float32(0.0), np.float32(0.0), np.float32(0.0), np.float32(0.0), np.float32(0.0)]",4.0,99848.0,26
2025-08-14_08-18-36,3090,"[np.float32(1.0), np.float32(1.0), np.float32(1.0), np.float32(1.0), np.float32(0.0), np.float32(1.0), np.float32(1.0), np.float32(0.0), np.float32(1.0), np.float32(1.0), np.float32(0.0), np.float32(1.0), np.float32(1.0), np.float32(1.0), np.float32(0.0), np.float32(0.0)]",-1.0,99847.0,2
2025-08-14_08-18-36,3091,"[np.float32(0.0), np.float32(0.0), np.float32(0.0), np.float32(1.0), np.float32(0.0), np.float32(1.0), np.float32(0.0), np.float32(1.0), np.float32(1.0), np.float32(0.0), np.float32(1.0), np.float32(0.0), np.float32(0.0), np.float32(1.0), np.float32(0.0), np.float32(1.0)]",-4.0,99843.0,4
2025-08-14_08-18-36,3092,"[np.float32(1.0), np.float32(0.0), np.float32(1.0), np.float32(0.0), np.float32(1.0), np.float32(1.0), np.float32(0.0), np.float32(1.0), np.float32(0.0), np.float32(0.0), np.float32(0.0), np.float32(1.0), np.float32(1.0), np.float32(0.0), np.float32(0.0), np.float32(1.0)]",-4.0,99839.0,2
2025-08-14_08-18-36,3093,"[np.float32(0.0), np.float32(0.0), np.float32(0.0), np.float32(1.0), np.float32(1.0), np.float32(1.0), np.float32(1.0), np.float32(1.0), np.float32(1.0), np.float32(0.0), np.float32(1.0), np.float32(1.0), np.float32(1.0), np.float32(1.0), np.float32(0.0), np.float32(1.0)]",-3.0,99836.0,30
2025-08-14_08-18-36,3094,"[np.float32(0.0), np.float32(1.0), np.float32(1.0), np.float32(0.0), np.float32(1.0), np.float32(0.0), np.float32(1.0), np.float32(0.0), np.float32(1.0), np.float32(0.0), np.float32(0.0), np.float32(1.0), np.float32(1.0), np.float32(1.0), np.float32(1.0), np.float32(1.0)]",-2.0,99834.0,29
2025-08-14_08-18-36,3095,"[np.float32(1.0), np.float32(0.0), np.float32(0.0), np.float32(0.0), np.float32(1.0), np.float32(0.0), np.float32(0.0), np.float32(1.0), np.float32(0.0), np.float32(0.0), np.float32(1.0), np.float32(1.0), np.float32(1.0), np.float32(0.0), np.float32(0.0), np.float32(1.0)]",0.0,99834.0,1
2025-08-14_08-18-36,3096,"[np.float32(0.0), np.float32(0.0), np.float32(1.0), np.float32(0.0), np.float32(1.0), np.float32(1.0), np.float32(0.0), np.float32(0.0), np.float32(1.0), np.float32(1.0), np.float32(1.0), np.float32(0.0), np.float32(1.0), np.float32(0.0), np.float32(0.0), np.float32(0.0)]",-5.0,99829.0,21
2025-08-14_08-18-36,3097,"[np.float32(1.0), np.float32(0.0), np.float32(0.0), np.float32(1.0), np.float32(0.0), np.float32(0.0), np.float32(1.0), np.float32(0.0), np.float32(1.0), np.float32(1.0), np.float32(0.0), np.float32(1.0), np.float32(1.0), np.float32(1.0), np.float32(0.0), np.float32(0.0)]",2.0,99831.0,27
2025-08-14_08-18-36,3098,"[np.float32(1.0), np.float32(0.0), np.float32(0.0), np.float32(0.0), np.float32(0.0), np.float32(0.0), np.float32(1.0), np.float32(1.0), np.float32(1.0), np.float32(1.0), np.float32(0.0), np.float32(0.0), np.float32(0.0), np.float32(0.0), np.float32(0.0), np.float32(0.0)]",0.0,99831.0,36
2025-08-14_08-18-36,3099,"[np.float32(0.0), np.float32(0.0), np.float32(0.0), np.float32(0.0), np.float32(0.0), np.float32(1.0), np.float32(1.0), np.float32(1.0), np.float32(1.0), np.float32(0.0), np.float32(0.0), np.float32(1.0), np.float32(1.0), np.float32(0.0), np.float32(0.0), np.float32(0.0)]",2.0,99833.0,27
2025-08-14_08-18-36,3100,"[np.float32(0.0), np.float32(1.0), np.float32(0.0), np.float32(0.0), np.float32(1.0), np.float32(1.0), np.float32(1.0), np.float32(1.0), np.float32(0.0), np.float32(1.0), np.float32(1.0), np.float32(1.0), np.float32(0.0), np.float32(0.0), np.float32(1.0), np.float32(1.0)]",0.0,99833.0,33
2025-08-14_08-18-36,3101,"[np.float32(0.0), np.float32(1.0), np.float32(0.0), np.float32(0.0), np.float32(1.0), np.float32(1.0), np.float32(1.0), np.float32(0.0), np.float32(1.0), np.float32(1.0), np.float32(1.0), np.float32(0.0), np.float32(1.0), np.float32(1.0), np.float32(0.0), np.float32(1.0)]",37.0,99870.0,7
2025-08-14_08-18-36,3102,"[np.float32(0.0), np.float32(1.0), np.float32(1.0), np.float32(0.0), np.float32(0.0), np.float32(1.0), np.float32(0.0), np.float32(1.0), np.float32(1.0), np.float32(1.0), np.float32(1.0), np.float32(0.0), np.float32(1.0), np.float32(0.0), np.float32(0.0), np.float32(0.0)]",-8.0,99862.0,3
2025-08-14_08-18-36,3103,"[np.float32(0.0), np.float32(1.0), np.float32(1.0), np.float32(1.0), np.float32(0.0), np.float32(1.0), np.float32(1.0), np.float32(0.0), np.float32(1.0), np.float32(0.0), np.float32(0.0), np.float32(0.0), np.float32(1.0), np.float32(1.0), np.float32(0.0), np.float32(0.0)]",-3.0,99859.0,18
2025-08-14_08-18-36,3104,"[np.float32(1.0), np.float32(0.0), np.float32(1.0), np.float32(0.0), np.float32(1.0), np.float32(1.0), np.float32(1.0), np.float32(1.0), np.float32(0.0), np.float32(1.0), np.float32(0.0), np.float32(1.0), np.float32(1.0), np.float32(0.0), np.float32(0.0), np.float32(1.0)]",-6.0,99853.0,0
2025-08-14_08-18-36,3105,"[np.float32(0.0), np.float32(1.0), np.float32(0.0), np.float32(1.0), np.float32(0.0), np.float32(0.0), np.float32(0.0), np.float32(1.0), np.float32(0.0), np.float32(1.0), np.float32(1.0), np.float32(0.0), np.float32(1.0), np.float32(0.0), np.float32(1.0), np.float32(0.0)]",-4.0,99849.0,18
2025-08-14_08-18-36,3106,"[np.float32(0.0), np.float32(0.0), np.float32(0.0), np.float32(1.0), np.float32(0.0), np.float32(1.0), np.float32(0.0), np.float32(0.0), np.float32(0.0), np.float32(0.0), np.float32(1.0), np.float32(1.0), np.float32(1.0), np.float32(1.0), np.float32(1.0), np.float32(1.0)]",-1.0,99848.0,31
2025-08-14_08-18-36,3107,"[np.float32(0.0), np.float32(1.0), np.float32(0.0), np.float32(1.0), np.float32(0.0), np.float32(1.0), np.float32(0.0), np.float32(0.0), np.float32(0.0), np.float32(1.0), np.float32(0.0), np.float32(1.0), np.float32(0.0), np.float32(0.0), np.float32(1.0), np.float32(1.0)]",3.0,99851.0,24
2025-08-14_08-18-36,3108,"[np.float32(0.0), np.float32(1.0), np.float32(1.0), np.float32(1.0), np.float32(0.0), np.float32(1.0), np.float32(1.0), np.float32(0.0), np.float32(0.0), np.float32(1.0), np.float32(1.0), np.float32(1.0), np.float32(1.0), np.float32(1.0), np.float32(0.0), np.float32(1.0)]",0.0,99851.0,9
2025-08-14_08-18-36,3109,"[np.float32(1.0), np.float32(0.0), np.float32(0.0), np.float32(0.0), np.float32(0.0), np.float32(0.0), np.float32(1.0), np.float32(1.0), np.float32(1.0), np.float32(0.0), np.float32(0.0), np.float32(0.0), np.float32(1.0), np.float32(0.0), np.float32(0.0), np.float32(1.0)]",-3.0,99848.0,4
2025-08-14_08-18-36,3110,"[np.float32(0.0), np.float32(0.0), np.float32(0.0), np.float32(0.0), np.float32(0.0), np.float32(0.0), np.float32(1.0), np.float32(1.0), np.float32(0.0), np.float32(1.0), np.float32(0.0), np.float32(0.0), np.float32(0.0), np.float32(0.0), np.float32(0.0), np.float32(0.0)]",0.0,99848.0,15
2025-08-14_08-18-36,3111,"[np.float32(0.0), np.float32(0.0), np.float32(0.0), np.float32(1.0), np.float32(0.0), np.float32(0.0), np.float32(1.0), np.float32(1.0), np.float32(1.0), np.float32(0.0), np.float32(0.0), np.float32(1.0), np.float32(0.0), np.float32(1.0), np.float32(0.0), np.float32(0.0)]",-1.0,99847.0,17
2025-08-14_08-18-36,3112,"[np.float32(1.0), np.float32(0.0), np.float32(1.0), np.float32(0.0), np.float32(0.0), np.float32(1.0), np.float32(0.0), np.float32(1.0), np.float32(0.0), np.float32(1.0), np.float32(0.0), np.float32(1.0), np.float32(1.0), np.float32(0.0), np.float32(0.0), np.float32(0.0)]",-2.0,99845.0,4
2025-08-14_08-18-36,3113,"[np.float32(0.0), np.float32(1.0), np.float32(0.0), np.float32(1.0), np.float32(0.0), np.float32(1.0), np.float32(1.0), np.float32(1.0), np.float32(1.0), np.float32(0.0), np.float32(0.0), np.float32(1.0), np.float32(1.0), np.float32(0.0), np.float32(1.0), np.float32(0.0)]",4.0,99849.0,27
2025-08-14_08-18-36,3114,"[np.float32(1.0), np.float32(0.0), np.float32(0.0), np.float32(1.0), np.float32(1.0), np.float32(1.0), np.float32(1.0), np.float32(1.0), np.float32(0.0), np.float32(0.0), np.float32(0.0), np.float32(0.0), np.float32(0.0), np.float32(0.0), np.float32(1.0), np.float32(1.0)]",2.0,99851.0,13
2025-08-14_08-18-36,3115,"[np.float32(1.0), np.float32(0.0), np.float32(1.0), np.float32(0.0), np.float32(0.0), np.float32(1.0), np.float32(0.0), np.float32(0.0), np.float32(1.0), np.float32(1.0), np.float32(1.0), np.float32(0.0), np.float32(1.0), np.float32(0.0), np.float32(0.0), np.float32(0.0)]",0.0,99851.0,22
2025-08-14_08-18-36,3116,"[np.float32(0.0), np.float32(1.0), np.float32(0.0), np.float32(1.0), np.float32(1.0), np.float32(1.0), np.float32(0.0), np.float32(0.0), np.float32(0.0), np.float32(0.0), np.float32(1.0), np.float32(0.0), np.float32(1.0), np.float32(0.0), np.float32(0.0), np.float32(0.0)]",0.0,99851.0,31
2025-08-14_08-18-36,3117,"[np.float32(1.0), np.float32(1.0), np.float32(0.0), np.float32(0.0), np.float32(1.0), np.float32(0.0), np.float32(0.0), np.float32(1.0), np.float32(0.0), np.float32(0.0), np.float32(1.0), np.float32(1.0), np.float32(1.0), np.float32(1.0), np.float32(0.0), np.float32(1.0)]",-4.0,99847.0,34
2025-08-14_08-18-36,3118,"[np.float32(0.0), np.float32(1.0), np.float32(1.0), np.float32(0.0), np.float32(0.0), np.float32(1.0), np.float32(0.0), np.float32(1.0), np.float32(1.0), np.float32(0.0), np.float32(0.0), np.float32(0.0), np.float32(0.0), np.float32(1.0), np.float32(0.0), np.float32(1.0)]",-2.0,99845.0,16
2025-08-14_08-18-36,3119,"[np.float32(1.0), np.float32(0.0), np.float32(0.0), np.float32(1.0), np.float32(1.0), np.float32(1.0), np.float32(1.0), np.float32(1.0), np.float32(1.0), np.float32(1.0), np.float32(1.0), np.float32(0.0), np.float32(1.0), np.float32(0.0), np.float32(0.0), np.float32(1.0)]",-6.0,99839.0,24
2025-08-14_08-18-36,3120,"[np.float32(1.0), np.float32(1.0), np.float32(0.0), np.float32(1.0), np.float32(1.0), np.float32(0.0), np.float32(1.0), np.float32(0.0), np.float32(1.0), np.float32(0.0), np.float32(0.0), np.float32(1.0), np.float32(0.0), np.float32(1.0), np.float32(1.0), np.float32(1.0)]",-3.0,99836.0,16
2025-08-14_08-18-36,3121,"[np.float32(1.0), np.float32(0.0), np.float32(1.0), np.float32(0.0), np.float32(1.0), np.float32(1.0), np.float32(0.0), np.float32(1.0), np.float32(0.0), np.float32(1.0), np.float32(1.0), np.float32(0.0), np.float32(1.0), np.float32(1.0), np.float32(1.0), np.float32(0.0)]",0.0,99836.0,25
2025-08-14_08-18-36,3122,"[np.float32(1.0), np.float32(0.0), np.float32(0.0), np.float32(0.0), np.float32(0.0), np.float32(0.0), np.float32(0.0), np.float32(1.0), np.float32(0.0), np.float32(0.0), np.float32(1.0), np.float32(0.0), np.float32(0.0), np.float32(0.0), np.float32(0.0), np.float32(0.0)]",-1.0,99835.0,1
2025-08-14_08-18-36,3123,"[np.float32(1.0), np.float32(1.0), np.float32(1.0), np.float32(0.0), np.float32(0.0), np.float32(1.0), np.float32(1.0), np.float32(1.0), np.float32(1.0), np.float32(1.0), np.float32(1.0), np.float32(0.0), np.float32(1.0), np.float32(1.0), np.float32(0.0), np.float32(0.0)]",-1.0,99834.0,14
2025-08-14_08-18-36,3124,"[np.float32(0.0), np.float32(0.0), np.float32(0.0), np.float32(1.0), np.float32(1.0), np.float32(1.0), np.float32(1.0), np.float32(1.0), np.float32(1.0), np.float32(0.0), np.float32(0.0), np.float32(1.0), np.float32(0.0), np.float32(0.0), np.float32(0.0), np.float32(1.0)]",0.0,99834.0,36
2025-08-14_08-18-36,3125,"[np.float32(1.0), np.float32(1.0), np.float32(1.0), np.float32(1.0), np.float32(0.0), np.float32(0.0), np.float32(1.0), np.float32(1.0), np.float32(1.0), np.float32(1.0), np.float32(0.0), np.float32(0.0), np.float32(0.0), np.float32(0.0), np.float32(0.0), np.float32(1.0)]",1.0,99835.0,22
2025-08-14_08-18-36,3126,"[np.float32(1.0), np.float32(0.0), np.float32(0.0), np.float32(1.0), np.float32(0.0), np.float32(0.0), np.float32(0.0), np.float32(0.0), np.float32(0.0), np.float32(0.0), np.float32(1.0), np.float32(1.0), np.float32(0.0), np.float32(0.0), np.float32(1.0), np.float32(1.0)]",2.0,99837.0,11
2025-08-14_08-18-36,3127,"[np.float32(0.0), np.float32(0.0), np.float32(1.0), np.float32(0.0), np.float32(0.0), np.float32(1.0), np.float32(1.0), np.float32(0.0), np.float32(0.0), np.float32(0.0), np.float32(0.0), np.float32(0.0), np.float32(1.0), np.float32(1.0), np.float32(1.0), np.float32(0.0)]",-1.0,99836.0,33
2025-08-14_08-18-36,3128,"[np.float32(1.0), np.float32(1.0), np.float32(0.0), np.float32(1.0), np.float32(1.0), np.float32(1.0), np.float32(0.0), np.float32(0.0), np.float32(0.0), np.float32(0.0), np.float32(1.0), np.float32(1.0), np.float32(0.0), np.float32(1.0), np.float32(0.0), np.float32(0.0)]",-2.0,99834.0,13
2025-08-14_08-18-36,3129,"[np.float32(0.0), np.float32(0.0), np.float32(0.0), np.float32(1.0), np.float32(1.0), np.float32(1.0), np.float32(0.0), np.float32(1.0), np.float32(1.0), np.float32(0.0), np.float32(0.0), np.float32(0.0), np.float32(1.0), np.float32(0.0), np.float32(1.0), np.float32(0.0)]",0.0,99834.0,29
2025-08-14_08-18-36,3130,"[np.float32(0.0), np.float32(0.0), np.float32(0.0), np.float32(0.0), np.float32(1.0), np.float32(1.0), np.float32(0.0), np.float32(1.0), np.float32(1.0), np.float32(0.0), np.float32(1.0), np.float32(1.0), np.float32(1.0), np.float32(1.0), np.float32(0.0), np.float32(0.0)]",0.0,99834.0,23
2025-08-14_08-18-36,3131,"[np.float32(1.0), np.float32(0.0), np.float32(0.0), np.float32(1.0), np.float32(0.0), np.float32(1.0), np.float32(1.0), np.float32(0.0), np.float32(1.0), np.float32(0.0), np.float32(1.0), np.float32(0.0), np.float32(1.0), np.float32(1.0), np.float32(1.0), np.float32(0.0)]",2.0,99836.0,26
2025-08-14_08-18-36,3132,"[np.float32(1.0), np.float32(0.0), np.float32(0.0), np.float32(0.0), np.float32(1.0), np.float32(1.0), np.float32(1.0), np.float32(1.0), np.float32(0.0), np.float32(1.0), np.float32(1.0), np.float32(0.0), np.float32(1.0), np.float32(1.0), np.float32(1.0), np.float32(0.0)]",1.0,99837.0,22
2025-08-14_08-18-36,3133,"[np.float32(1.0), np.float32(0.0), np.float32(0.0), np.float32(0.0), np.float32(0.0), np.float32(1.0), np.float32(0.0), np.float32(0.0), np.float32(1.0), np.float32(1.0), np.float32(0.0), np.float32(1.0), np.float32(1.0), np.float32(0.0), np.float32(0.0), np.float32(0.0)]",4.0,99841.0,34
2025-08-14_08-18-36,3134,"[np.float32(1.0), np.float32(1.0), np.float32(1.0), np.float32(0.0), np.float32(0.0), np.float32(0.0), np.float32(0.0), np.float32(0.0), np.float32(0.0), np.float32(1.0), np.float32(1.0), np.float32(0.0), np.float32(0.0), np.float32(0.0), np.float32(0.0), np.float32(1.0)]",4.0,99845.0,34
2025-08-14_08-18-36,3135,"[np.float32(0.0), np.float32(1.0), np.float32(1.0), np.float32(1.0), np.float32(1.0), np.float32(0.0), np.float32(0.0), np.float32(0.0), np.float32(1.0), np.float32(0.0), np.float32(0.0), np.float32(0.0), np.float32(0.0), np.float32(0.0), np.float32(0.0), np.float32(0.0)]",0.0,99845.0,34
2025-08-14_08-18-36,3136,"[np.float32(0.0), np.float32(1.0), np.float32(1.0), np.float32(1.0), np.float32(1.0), np.float32(0.0), np.float32(0.0), np.float32(1.0), np.float32(0.0), np.float32(0.0), np.float32(1.0), np.float32(1.0), np.float32(1.0), np.float32(1.0), np.float32(1.0), np.float32(0.0)]",-8.0,99837.0,34
2025-08-14_08-18-36,3137,"[np.float32(0.0), np.float32(0.0), np.float32(0.0), np.float32(1.0), np.float32(0.0), np.float32(1.0), np.float32(1.0), np.float32(1.0), np.float32(0.0), np.float32(0.0), np.float32(1.0), np.float32(0.0), np.float32(1.0), np.float32(0.0), np.float32(0.0), np.float32(1.0)]",1.0,99838.0,5
2025-08-14_08-18-36,3138,"[np.float32(1.0), np.float32(0.0), np.float32(1.0), np.float32(1.0), np.float32(0.0), np.float32(1.0), np.float32(0.0), np.float32(1.0), np.float32(0.0), np.float32(0.0), np.float32(0.0), np.float32(1.0), np.float32(0.0), np.float32(1.0), np.float32(0.0), np.float32(0.0)]",3.0,99841.0,3
2025-08-14_08-18-36,3139,"[np.float32(0.0), np.float32(1.0), np.float32(0.0), np.float32(1.0), np.float32(1.0), np.float32(1.0), np.float32(1.0), np.float32(1.0), np.float32(1.0), np.float32(1.0), np.float32(1.0), np.float32(1.0), np.float32(1.0), np.float32(0.0), np.float32(0.0), np.float32(1.0)]",34.0,99875.0,7
2025-08-14_08-18-36,3140,"[np.float32(1.0), np.float32(1.0), np.float32(1.0), np.float32(1.0), np.float32(0.0), np.float32(1.0), np.float32(1.0), np.float32(1.0), np.float32(0.0), np.float32(1.0), np.float32(1.0), np.float32(0.0), np.float32(0.0), np.float32(0.0), np.float32(1.0), np.float32(0.0)]",2.0,99877.0,20
2025-08-14_08-18-36,3141,"[np.float32(1.0), np.float32(1.0), np.float32(1.0), np.float32(1.0), np.float32(1.0), np.float32(1.0), np.float32(0.0), np.float32(1.0), np.float32(0.0), np.float32(0.0), np.float32(1.0), np.float32(1.0), np.float32(0.0), np.float32(0.0), np.float32(1.0), np.float32(1.0)]",-2.0,99875.0,2
2025-08-14_08-18-36,3142,"[np.float32(0.0), np.float32(1.0), np.float32(0.0), np.float32(1.0), np.float32(1.0), np.float32(0.0), np.float32(1.0), np.float32(0.0), np.float32(0.0), np.float32(1.0), np.float32(0.0), np.float32(0.0), np.float32(0.0), np.float32(1.0), np.float32(1.0), np.float32(0.0)]",3.0,99878.0,1
2025-08-14_08-18-36,3143,"[np.float32(0.0), np.float32(0.0), np.float32(1.0), np.float32(1.0), np.float32(1.0), np.float32(1.0), np.float32(0.0), np.float32(1.0), np.float32(0.0), np.float32(0.0), np.float32(0.0), np.float32(1.0), np.float32(0.0), np.float32(0.0), np.float32(0.0), np.float32(0.0)]",-2.0,99876.0,0
2025-08-14_08-18-36,3144,"[np.float32(1.0), np.float32(1.0), np.float32(1.0), np.float32(0.0), np.float32(1.0), np.float32(0.0), np.float32(1.0), np.float32(0.0), np.float32(0.0), np.float32(0.0), np.float32(0.0), np.float32(1.0), np.float32(1.0), np.float32(1.0), np.float32(0.0), np.float32(1.0)]",6.0,99882.0,6
2025-08-14_08-18-36,3145,"[np.float32(1.0), np.float32(1.0), np.float32(0.0), np.float32(1.0), np.float32(0.0), np.float32(0.0), np.float32(0.0), np.float32(1.0), np.float32(1.0), np.float32(0.0), np.float32(0.0), np.float32(0.0), np.float32(1.0), np.float32(0.0), np.float32(0.0), np.float32(0.0)]",-4.0,99878.0,2
2025-08-14_08-18-36,3146,"[np.float32(1.0), np.float32(1.0), np.float32(0.0), np.float32(0.0), np.float32(0.0), np.float32(1.0), np.float32(1.0), np.float32(1.0), np.float32(1.0), np.float32(0.0), np.float32(0.0), np.float32(0.0), np.float32(1.0), np.float32(0.0), np.float32(1.0), np.float32(1.0)]",-1.0,99877.0,8
2025-08-14_08-18-36,3147,"[np.float32(1.0), np.float32(1.0), np.float32(0.0), np.float32(0.0), np.float32(0.0), np.float32(0.0), np.float32(1.0), np.float32(0.0), np.float32(1.0), np.float32(1.0), np.float32(0.0), np.float32(0.0), np.float32(0.0), np.float32(0.0), np.float32(0.0), np.float32(0.0)]",0.0,99877.0,5
2025-08-14_08-18-36,3148,"[np.float32(1.0), np.float32(0.0), np.float32(0.0), np.float32(0.0), np.float32(1.0), np.float32(0.0), np.float32(0.0), np.float32(1.0), np.float32(0.0), np.float32(1.0), np.float32(0.0), np.float32(0.0), np.float32(1.0), np.float32(0.0), np.float32(0.0), np.float32(1.0)]",0.0,99877.0,31
2025-08-14_08-18-36,3149,"[np.float32(0.0), np.float32(1.0), np.float32(0.0), np.float32(0.0), np.float32(0.0), np.float32(1.0), np.float32(1.0), np.float32(1.0), np.float32(1.0), np.float32(1.0), np.float32(1.0), np.float32(0.0), np.float32(1.0), np.float32(1.0), np.float32(0.0), np.float32(1.0)]",3.0,99880.0,26
2025-08-14_08-18-36,3150,"[np.float32(1.0), np.float32(1.0), np.float32(0.0), np.float32(0.0), np.float32(0.0), np.float32(1.0), np.float32(0.0), np.float32(0.0), np.float32(1.0), np.float32(1.0), np.float32(0.0), np.float32(0.0), np.float32(1.0), np.float32(0.0), np.float32(0.0), np.float32(1.0)]",-2.0,99878.0,17
2025-08-14_08-18-36,3151,"[np.float32(1.0), np.float32(0.0), np.float32(0.0), np.float32(1.0), np.float32(1.0), np.float32(0.0), np.float32(1.0), np.float32(0.0), np.float32(1.0), np.float32(1.0), np.float32(1.0), np.float32(0.0), np.float32(0.0), np.float32(0.0), np.float32(1.0), np.float32(0.0)]",-1.0,99877.0,17
2025-08-14_08-18-36,3152,"[np.float32(0.0), np.float32(1.0), np.float32(1.0), np.float32(1.0), np.float32(0.0), np.float32(1.0), np.float32(0.0), np.float32(1.0), np.float32(1.0), np.float32(1.0), np.float32(1.0), np.float32(0.0), np.float32(0.0), np.float32(0.0), np.float32(0.0), np.float32(0.0)]",4.0,99881.0,22
2025-08-14_08-18-36,3153,"[np.float32(1.0), np.float32(1.0), np.float32(0.0), np.float32(0.0), np.float32(0.0), np.float32(0.0), np.float32(0.0), np.float32(1.0), np.float32(0.0), np.float32(1.0), np.float32(1.0), np.float32(1.0), np.float32(1.0), np.float32(0.0), np.float32(0.0), np.float32(0.0)]",1.0,99882.0,18
2025-08-14_08-18-36,3154,"[np.float32(0.0), np.float32(1.0), np.float32(1.0), np.float32(1.0), np.float32(1.0), np.float32(1.0), np.float32(1.0), np.float32(1.0), np.float32(1.0), np.float32(0.0), np.float32(0.0), np.float32(1.0), np.float32(0.0), np.float32(0.0), np.float32(1.0), np.float32(1.0)]",1.0,99883.0,15
2025-08-14_08-18-36,3155,"[np.float32(1.0), np.float32(0.0), np.float32(1.0), np.float32(0.0), np.float32(0.0), np.float32(0.0), np.float32(1.0), np.float32(1.0), np.float32(0.0), np.float32(0.0), np.float32(0.0), np.float32(0.0), np.float32(0.0), np.float32(1.0), np.float32(1.0), np.float32(0.0)]",-1.0,99882.0,1
2025-08-14_08-18-36,3156,"[np.float32(1.0), np.float32(1.0), np.float32(0.0), np.float32(1.0), np.float32(1.0), np.float32(1.0), np.float32(1.0), np.float32(1.0), np.float32(0.0), np.float32(0.0), np.float32(1.0), np.float32(0.0), np.float32(0.0), np.float32(1.0), np.float32(1.0), np.float32(1.0)]",1.0,99883.0,15
2025-08-14_08-18-36,3157,"[np.float32(1.0), np.float32(1.0), np.float32(0.0), np.float32(1.0), np.float32(0.0), np.float32(1.0), np.float32(1.0), np.float32(0.0), np.float32(0.0), np.float32(1.0), np.float32(0.0), np.float32(0.0), np.float32(1.0), np.float32(1.0), np.float32(0.0), np.float32(0.0)]",-4.0,99879.0,30
2025-08-14_08-18-36,3158,"[np.float32(1.0), np.float32(1.0), np.float32(0.0), np.float32(0.0), np.float32(1.0), np.float32(1.0), np.float32(0.0), np.float32(0.0), np.float32(1.0), np.float32(0.0), np.float32(1.0), np.float32(1.0), np.float32(1.0), np.float32(1.0), np.float32(0.0), np.float32(0.0)]",1.0,99880.0,27
2025-08-14_08-18-36,3159,"[np.float32(1.0), np.float32(0.0), np.float32(0.0), np.float32(1.0), np.float32(0.0), np.float32(0.0), np.float32(1.0), np.float32(0.0), np.float32(0.0), np.float32(0.0), np.float32(0.0), np.float32(1.0), np.float32(0.0), np.float32(0.0), np.float32(1.0), np.float32(0.0)]",-5.0,99875.0,22
2025-08-14_08-18-36,3160,"[np.float32(0.0), np.float32(1.0), np.float32(1.0), np.float32(1.0), np.float32(0.0), np.float32(1.0), np.float32(1.0), np.float32(0.0), np.float32(1.0), np.float32(1.0), np.float32(1.0), np.float32(0.0), np.float32(0.0), np.float32(1.0), np.float32(0.0), np.float32(0.0)]",-4.0,99871.0,18
2025-08-14_08-18-36,3161,"[np.float32(1.0), np.float32(0.0), np.float32(1.0), np.float32(0.0), np.float32(0.0), np.float32(1.0), np.float32(1.0), np.float32(1.0), np.float32(0.0), np.float32(1.0), np.float32(1.0), np.float32(0.0), np.float32(1.0), np.float32(1.0), np.float32(0.0), np.float32(0.0)]",-1.0,99870.0,5
2025-08-14_08-18-36,3162,"[np.float32(0.0), np.float32(1.0), np.float32(1.0), np.float32(0.0), np.float32(0.0), np.float32(1.0), np.float32(1.0), np.float32(1.0), np.float32(0.0), np.float32(1.0), np.float32(0.0), np.float32(1.0), np.float32(1.0), np.float32(1.0), np.float32(1.0), np.float32(1.0)]",-1.0,99869.0,8
2025-08-14_08-18-36,3163,"[np.float32(0.0), np.float32(0.0), np.float32(0.0), np.float32(0.0), np.float32(1.0), np.float32(0.0), np.float32(0.0), np.float32(1.0), np.float32(0.0), np.float32(0.0), np.float32(1.0), np.float32(1.0), np.float32(1.0), np.float32(1.0), np.float32(0.0), np.float32(0.0)]",5.0,99874.0,15
2025-08-14_08-18-36,3164,"[np.float32(0.0), np.float32(1.0), np.float32(1.0), np.float32(1.0), np.float32(0.0), np.float32(1.0), np.float32(1.0), np.float32(0.0), np.float32(0.0), np.float32(0.0), np.float32(1.0), np.float32(0.0), np.float32(0.0), np.float32(1.0), np.float32(0.0), np.float32(0.0)]",1.0,99875.0,3
2025-08-14_08-18-36,3165,"[np.float32(1.0), np.float32(0.0), np.float32(1.0), np.float32(0.0), np.float32(0.0), np.float32(0.0), np.float32(0.0), np.float32(0.0), np.float32(1.0), np.float32(0.0), np.float32(0.0), np.float32(0.0), np.float32(0.0), np.float32(0.0), np.float32(1.0), np.float32(0.0)]",2.0,99877.0,33
2025-08-14_08-18-36,3166,"[np.float32(0.0), np.float32(1.0), np.float32(1.0), np.float32(1.0), np.float32(0.0), np.float32(1.0), np.float32(1.0), np.float32(1.0), np.float32(0.0), np.float32(1.0), np.float32(0.0), np.float32(0.0), np.float32(0.0), np.float32(1.0), np.float32(0.0), np.float32(1.0)]",0.0,99877.0,29
2025-08-14_08-18-36,3167,"[np.float32(0.0), np.float32(1.0), np.float32(0.0), np.float32(0.0), np.float32(0.0), np.float32(1.0), np.float32(1.0), np.float32(1.0), np.float32(0.0), np.float32(0.0), np.float32(1.0), np.float32(0.0), np.float32(0.0), np.float32(0.0), np.float32(1.0), np.float32(0.0)]",-3.0,99874.0,18
2025-08-14_08-18-36,3168,"[np.float32(1.0), np.float32(0.0), np.float32(1.0), np.float32(0.0), np.float32(1.0), np.float32(0.0), np.float32(1.0), np.float32(1.0), np.float32(0.0), np.float32(0.0), np.float32(0.0), np.float32(1.0), np.float32(0.0), np.float32(1.0), np.float32(0.0), np.float32(0.0)]",6.0,99880.0,3
2025-08-14_08-18-36,3169,"[np.float32(0.0), np.float32(1.0), np.float32(1.0), np.float32(0.0), np.float32(0.0), np.float32(1.0), np.float32(1.0), np.float32(1.0), np.float32(0.0), np.float32(0.0), np.float32(0.0), np.float32(0.0), np.float32(1.0), np.float32(1.0), np.float32(1.0), np.float32(0.0)]",2.0,99882.0,8
2025-08-14_08-18-36,3170,"[np.float32(1.0), np.float32(0.0), np.float32(0.0), np.float32(0.0), np.float32(1.0), np.float32(1.0), np.float32(1.0), np.float32(1.0), np.float32(1.0), np.float32(0.0), np.float32(1.0), np.float32(1.0), np.float32(1.0), np.float32(0.0), np.float32(0.0), np.float32(1.0)]",-2.0,99880.0,24
2025-08-14_08-18-36,3171,"[np.float32(0.0), np.float32(1.0), np.float32(0.0), np.float32(0.0), np.float32(0.0), np.float32(0.0), np.float32(0.0), np.float32(1.0), np.float32(1.0), np.float32(0.0), np.float32(1.0), np.float32(1.0), np.float32(0.0), np.float32(1.0), np.float32(0.0), np.float32(0.0)]",3.0,99883.0,21
2025-08-14_08-18-36,3172,"[np.float32(1.0), np.float32(0.0), np.float32(1.0), np.float32(1.0), np.float32(1.0), np.float32(1.0), np.float32(0.0), np.float32(1.0), np.float32(1.0), np.float32(1.0), np.float32(1.0), np.float32(0.0), np.float32(0.0), np.float32(1.0), np.float32(0.0), np.float32(0.0)]",3.0,99886.0,28
2025-08-14_08-18-36,3173,"[np.float32(1.0), np.float32(0.0), np.float32(0.0), np.float32(1.0), np.float32(0.0), np.float32(0.0), np.float32(1.0), np.float32(0.0), np.float32(1.0), np.float32(1.0), np.float32(0.0), np.float32(1.0), np.float32(1.0), np.float32(1.0), np.float32(1.0), np.float32(1.0)]",-2.0,99884.0,32
2025-08-14_08-18-36,3174,"[np.float32(0.0), np.float32(1.0), np.float32(1.0), np.float32(1.0), np.float32(1.0), np.float32(1.0), np.float32(1.0), np.float32(1.0), np.float32(1.0), np.float32(1.0), np.float32(1.0), np.float32(1.0), np.float32(1.0), np.float32(1.0), np.float32(0.0), np.float32(0.0)]",0.0,99884.0,21
2025-08-14_08-18-36,3175,"[np.float32(1.0), np.float32(0.0), np.float32(1.0), np.float32(0.0), np.float32(0.0), np.float32(0.0), np.float32(1.0), np.float32(1.0), np.float32(1.0), np.float32(0.0), np.float32(0.0), np.float32(1.0), np.float32(1.0), np.float32(0.0), np.float32(1.0), np.float32(1.0)]",-7.0,99877.0,0
2025-08-14_08-18-36,3176,"[np.float32(0.0), np.float32(1.0), np.float32(1.0), np.float32(0.0), np.float32(0.0), np.float32(1.0), np.float32(0.0), np.float32(1.0), np.float32(0.0), np.float32(0.0), np.float32(0.0), np.float32(0.0), np.float32(1.0), np.float32(0.0), np.float32(0.0), np.float32(0.0)]",1.0,99878.0,26
2025-08-14_08-18-36,3177,"[np.float32(1.0), np.float32(1.0), np.float32(0.0), np.float32(0.0), np.float32(1.0), np.float32(1.0), np.float32(0.0), np.float32(1.0), np.float32(0.0), np.float32(0.0), np.float32(1.0), np.float32(1.0), np.float32(1.0), np.float32(0.0), np.float32(1.0), np.float32(0.0)]",1.0,99879.0,27
2025-08-14_08-18-36,3178,"[np.float32(0.0), np.float32(0.0), np.float32(0.0), np.float32(0.0), np.float32(1.0), np.float32(1.0), np.float32(1.0), np.float32(1.0), np.float32(0.0), np.float32(1.0), np.float32(1.0), np.float32(1.0), np.float32(0.0), np.float32(0.0), np.float32(1.0), np.float32(1.0)]",-1.0,99878.0,36
2025-08-14_08-18-36,3179,"[np.float32(1.0), np.float32(0.0), np.float32(0.0), np.float32(0.0), np.float32(1.0), np.float32(1.0), np.float32(0.0), np.float32(1.0), np.float32(1.0), np.float32(1.0), np.float32(1.0), np.float32(1.0), np.float32(1.0), np.float32(0.0), np.float32(0.0), np.float32(1.0)]",0.0,99878.0,36
2025-08-14_08-18-36,3180,"[np.float32(1.0), np.float32(0.0), np.float32(1.0), np.float32(1.0), np.float32(1.0), np.float32(1.0), np.float32(0.0), np.float32(1.0), np.float32(0.0), np.float32(0.0), np.float32(1.0), np.float32(0.0), np.float32(0.0), np.float32(1.0), np.float32(1.0), np.float32(0.0)]",3.0,99881.0,14
2025-08-14_08-18-36,3181,"[np.float32(1.0), np.float32(1.0), np.float32(0.0), np.float32(1.0), np.float32(1.0), np.float32(1.0), np.float32(1.0), np.float32(0.0), np.float32(1.0), np.float32(1.0), np.float32(0.0), np.float32(1.0), np.float32(1.0), np.float32(1.0), np.float32(1.0), np.float32(1.0)]",-3.0,99878.0,16
2025-08-14_08-18-36,3182,"[np.float32(0.0), np.float32(0.0), np.float32(1.0), np.float32(1.0), np.float32(0.0), np.float32(1.0), np.float32(0.0), np.float32(1.0), np.float32(0.0), np.float32(0.0), np.float32(1.0), np.float32(0.0), np.float32(1.0), np.float32(1.0), np.float32(1.0), np.float32(1.0)]",-2.0,99876.0,31
2025-08-14_08-18-36,3183,"[np.float32(0.0), np.float32(1.0), np.float32(0.0), np.float32(1.0), np.float32(0.0), np.float32(1.0), np.float32(0.0), np.float32(0.0), np.float32(0.0), np.float32(0.0), np.float32(1.0), np.float32(0.0), np.float32(1.0), np.float32(0.0), np.float32(1.0), np.float32(1.0)]",-2.0,99874.0,32
2025-08-14_08-18-36,3184,"[np.float32(0.0), np.float32(0.0), np.float32(1.0), np.float32(1.0), np.float32(1.0), np.float32(0.0), np.float32(1.0), np.float32(0.0), np.float32(0.0), np.float32(1.0), np.float32(1.0), np.float32(1.0), np.float32(1.0), np.float32(0.0), np.float32(0.0), np.float32(1.0)]",-4.0,99870.0,22
2025-08-14_08-18-36,3185,"[np.float32(0.0), np.float32(1.0), np.float32(0.0), np.float32(0.0), np.float32(0.0), np.float32(0.0), np.float32(1.0), np.float32(0.0), np.float32(0.0), np.float32(1.0), np.float32(0.0), np.float32(0.0), np.float32(0.0), np.float32(0.0), np.float32(1.0), np.float32(1.0)]",-5.0,99865.0,32
2025-08-14_08-18-36,3186,"[np.float32(0.0), np.float32(0.0), np.float32(0.0), np.float32(1.0), np.float32(1.0), np.float32(0.0), np.float32(0.0), np.float32(1.0), np.float32(1.0), np.float32(1.0), np.float32(1.0), np.float32(1.0), np.float32(1.0), np.float32(0.0), np.float32(0.0), np.float32(0.0)]",-3.0,99862.0,4
2025-08-14_08-18-36,3187,"[np.float32(1.0), np.float32(1.0), np.float32(0.0), np.float32(1.0), np.float32(1.0), np.float32(1.0), np.float32(0.0), np.float32(1.0), np.float32(0.0), np.float32(0.0), np.float32(0.0), np.float32(1.0), np.float32(1.0), np.float32(1.0), np.float32(0.0), np.float32(0.0)]",-2.0,99860.0,32
2025-08-14_08-18-36,3188,"[np.float32(0.0), np.float32(0.0), np.float32(0.0), np.float32(1.0), np.float32(0.0), np.float32(0.0), np.float32(0.0), np.float32(0.0), np.float32(0.0), np.float32(1.0), np.float32(1.0), np.float32(1.0), np.float32(1.0), np.float32(0.0), np.float32(1.0), np.float32(1.0)]",-4.0,99856.0,28
2025-08-14_08-18-36,3189,"[np.float32(0.0), np.float32(0.0), np.float32(1.0), np.float32(1.0), np.float32(0.0), np.float32(0.0), np.float32(0.0), np.float32(0.0), np.float32(0.0), np.float32(0.0), np.float32(0.0), np.float32(0.0), np.float32(0.0), np.float32(0.0), np.float32(1.0), np.float32(0.0)]",2.0,99858.0,30
2025-08-14_08-18-36,3190,"[np.float32(0.0), np.float32(0.0), np.float32(1.0), np.float32(0.0), np.float32(1.0), np.float32(1.0), np.float32(1.0), np.float32(1.0), np.float32(1.0), np.float32(1.0), np.float32(1.0), np.float32(0.0), np.float32(1.0), np.float32(1.0), np.float32(0.0), np.float32(1.0)]",-3.0,99855.0,23
2025-08-14_08-18-36,3191,"[np.float32(1.0), np.float32(0.0), np.float32(1.0), np.float32(0.0), np.float32(0.0), np.float32(1.0), np.float32(0.0), np.float32(1.0), np.float32(1.0), np.float32(1.0), np.float32(0.0), np.float32(1.0), np.float32(0.0), np.float32(0.0), np.float32(1.0), np.float32(0.0)]",0.0,99855.0,10
2025-08-14_08-18-36,3192,"[np.float32(1.0), np.float32(0.0), np.float32(0.0), np.float32(1.0), np.float32(0.0), np.float32(0.0), np.float32(0.0), np.float32(1.0), np.float32(0.0), np.float32(0.0), np.float32(1.0), np.float32(1.0), np.float32(0.0), np.float32(1.0), np.float32(0.0), np.float32(0.0)]",2.0,99857.0,32
2025-08-14_08-18-36,3193,"[np.float32(1.0), np.float32(0.0), np.float32(1.0), np.float32(0.0), np.float32(1.0), np.float32(1.0), np.float32(0.0), np.float32(1.0), np.float32(1.0), np.float32(0.0), np.float32(0.0), np.float32(1.0), np.float32(1.0), np.float32(0.0), np.float32(0.0), np.float32(0.0)]",-3.0,99854.0,35
2025-08-14_08-18-36,3194,"[np.float32(0.0), np.float32(1.0), np.float32(0.0), np.float32(1.0), np.float32(1.0), np.float32(0.0), np.float32(1.0), np.float32(1.0), np.float32(1.0), np.float32(1.0), np.float32(0.0), np.float32(1.0), np.float32(1.0), np.float32(0.0), np.float32(1.0), np.float32(1.0)]",1.0,99855.0,11
2025-08-14_08-18-36,3195,"[np.float32(0.0), np.float32(1.0), np.float32(1.0), np.float32(0.0), np.float32(0.0), np.float32(0.0), np.float32(1.0), np.float32(1.0), np.float32(1.0), np.float32(0.0), np.float32(1.0), np.float32(0.0), np.float32(1.0), np.float32(1.0), np.float32(0.0), np.float32(0.0)]",3.0,99858.0,32
2025-08-14_08-18-36,3196,"[np.float32(0.0), np.float32(1.0), np.float32(1.0), np.float32(1.0), np.float32(1.0), np.float32(1.0), np.float32(0.0), np.float32(1.0), np.float32(1.0), np.float32(0.0), np.float32(0.0), np.float32(0.0), np.float32(1.0), np.float32(0.0), np.float32(1.0), np.float32(0.0)]",0.0,99858.0,31
2025-08-14_08-18-36,3197,"[np.float32(1.0), np.float32(0.0), np.float32(0.0), np.float32(1.0), np.float32(0.0), np.float32(0.0), np.float32(0.0), np.float32(1.0), np.float32(0.0), np.float32(1.0), np.float32(0.0), np.float32(0.0), np.float32(1.0), np.float32(1.0), np.float32(0.0), np.float32(0.0)]",-3.0,99855.0,26
2025-08-14_08-18-36,3198,"[np.float32(0.0), np.float32(0.0), np.float32(0.0), np.float32(1.0), np.float32(0.0), np.float32(0.0), np.float32(1.0), np.float32(0.0), np.float32(0.0), np.float32(1.0), np.float32(1.0), np.float32(1.0), np.float32(1.0), np.float32(0.0), np.float32(0.0), np.float32(1.0)]",-1.0,99854.0,12
2025-08-14_08-18-36,3199,"[np.float32(0.0), np.float32(0.0), np.float32(1.0), np.float32(1.0), np.float32(1.0), np.float32(0.0), np.float32(1.0), np.float32(0.0), np.float32(0.0), np.float32(1.0), np.float32(1.0), np.float32(1.0), np.float32(0.0), np.float32(1.0), np.float32(0.0), np.float32(0.0)]",0.0,99854.0,25
2025-08-14_08-18-36,3200,"[np.float32(1.0), np.float32(0.0), np.float32(0.0), np.float32(0.0), np.float32(1.0), np.float32(1.0), np.float32(0.0), np.float32(0.0), np.float32(0.0), np.float32(1.0), np.float32(1.0), np.float32(0.0), np.float32(1.0), np.float32(0.0), np.float32(0.0), np.float32(0.0)]",-2.0,99852.0,30
2025-08-14_08-18-36,3201,"[np.float32(0.0), np.float32(0.0), np.float32(0.0), np.float32(1.0), np.float32(1.0), np.float32(0.0), np.float32(1.0), np.float32(0.0), np.float32(0.0), np.float32(1.0), np.float32(0.0), np.float32(0.0), np.float32(1.0), np.float32(1.0), np.float32(0.0), np.float32(0.0)]",-1.0,99851.0,35
2025-08-14_08-18-36,3202,"[np.float32(1.0), np.float32(1.0), np.float32(0.0), np.float32(0.0), np.float32(1.0), np.float32(0.0), np.float32(0.0), np.float32(1.0), np.float32(1.0), np.float32(1.0), np.float32(0.0), np.float32(1.0), np.float32(1.0), np.float32(1.0), np.float32(1.0), np.float32(1.0)]",-3.0,99848.0,23
2025-08-14_08-18-36,3203,"[np.float32(1.0), np.float32(1.0), np.float32(0.0), np.float32(0.0), np.float32(1.0), np.float32(1.0), np.float32(0.0), np.float32(1.0), np.float32(1.0), np.float32(1.0), np.float32(1.0), np.float32(0.0), np.float32(1.0), np.float32(1.0), np.float32(0.0), np.float32(1.0)]",-1.0,99847.0,1
2025-08-14_08-18-36,3204,"[np.float32(0.0), np.float32(0.0), np.float32(1.0), np.float32(0.0), np.float32(0.0), np.float32(1.0), np.float32(1.0), np.float32(1.0), np.float32(0.0), np.float32(0.0), np.float32(0.0), np.float32(1.0), np.float32(1.0), np.float32(1.0), np.float32(0.0), np.float32(1.0)]",-3.0,99844.0,23
2025-08-14_08-18-36,3205,"[np.float32(1.0), np.float32(1.0), np.float32(0.0), np.float32(0.0), np.float32(0.0), np.float32(0.0), np.float32(0.0), np.float32(0.0), np.float32(0.0), np.float32(0.0), np.float32(1.0), np.float32(1.0), np.float32(0.0), np.float32(1.0), np.float32(1.0), np.float32(0.0)]",2.0,99846.0,15
2025-08-14_08-18-36,3206,"[np.float32(1.0), np.float32(1.0), np.float32(0.0), np.float32(1.0), np.float32(1.0), np.float32(1.0), np.float32(1.0), np.float32(1.0), np.float32(1.0), np.float32(0.0), np.float32(1.0), np.float32(0.0), np.float32(1.0), np.float32(1.0), np.float32(0.0), np.float32(1.0)]",1.0,99847.0,2
2025-08-14_08-18-36,3207,"[np.float32(0.0), np.float32(1.0), np.float32(0.0), np.float32(0.0), np.float32(0.0), np.float32(0.0), np.float32(0.0), np.float32(0.0), np.float32(1.0), np.float32(1.0), np.float32(1.0), np.float32(0.0), np.float32(1.0), np.float32(0.0), np.float32(0.0), np.float32(1.0)]",-6.0,99841.0,12
2025-08-14_08-18-36,3208,"[np.float32(1.0), np.float32(1.0), np.float32(0.0), np.float32(1.0), np.float32(0.0), np.float32(0.0), np.float32(0.0), np.float32(1.0), np.float32(0.0), np.float32(0.0), np.float32(0.0), np.float32(1.0), np.float32(0.0), np.float32(0.0), np.float32(0.0), np.float32(0.0)]",2.0,99843.0,19
2025-08-14_08-18-36,3209,"[np.float32(1.0), np.float32(0.0), np.float32(1.0), np.float32(1.0), np.float32(0.0), np.float32(1.0), np.float32(0.0), np.float32(1.0), np.float32(0.0), np.float32(1.0), np.float32(1.0), np.float32(0.0), np.float32(0.0), np.float32(0.0), np.float32(1.0), np.float32(0.0)]",-4.0,99839.0,3
2025-08-14_08-18-36,3210,"[np.float32(1.0), np.float32(0.0), np.float32(1.0), np.float32(0.0), np.float32(0.0), np.float32(0.0), np.float32(1.0), np.float32(1.0), np.float32(1.0), np.float32(0.0), np.float32(1.0), np.float32(0.0), np.float32(1.0), np.float32(0.0), np.float32(0.0), np.float32(1.0)]",-1.0,99838.0,16
2025-08-14_08-18-36,3211,"[np.float32(1.0), np.float32(1.0), np.float32(0.0), np.float32(1.0), np.float32(0.0), np.float32(0.0), np.float32(1.0), np.float32(1.0), np.float32(1.0), np.float32(0.0), np.float32(1.0), np.float32(1.0), np.float32(1.0), np.float32(0.0), np.float32(1.0), np.float32(0.0)]",-2.0,99836.0,18
2025-08-14_08-18-36,3212,"[np.float32(0.0), np.float32(1.0), np.float32(1.0), np.float32(0.0), np.float32(0.0), np.float32(0.0), np.float32(0.0), np.float32(1.0), np.float32(1.0), np.float32(0.0), np.float32(0.0), np.float32(0.0), np.float32(0.0), np.float32(1.0), np.float32(0.0), np.float32(0.0)]",0.0,99836.0,12
2025-08-14_08-18-36,3213,"[np.float32(1.0), np.float32(0.0), np.float32(1.0), np.float32(0.0), np.float32(1.0), np.float32(1.0), np.float32(1.0), np.float32(1.0), np.float32(1.0), np.float32(0.0), np.float32(1.0), np.float32(0.0), np.float32(1.0), np.float32(1.0), np.float32(0.0), np.float32(1.0)]",0.0,99836.0,29
2025-08-14_08-18-36,3214,"[np.float32(0.0), np.float32(0.0), np.float32(0.0), np.float32(0.0), np.float32(0.0), np.float32(1.0), np.float32(1.0), np.float32(1.0), np.float32(0.0), np.float32(1.0), np.float32(0.0), np.float32(0.0), np.float32(0.0), np.float32(1.0), np.float32(0.0), np.float32(1.0)]",0.0,99836.0,14
2025-08-14_08-18-36,3215,"[np.float32(1.0), np.float32(0.0), np.float32(0.0), np.float32(0.0), np.float32(0.0), np.float32(1.0), np.float32(1.0), np.float32(1.0), np.float32(1.0), np.float32(0.0), np.float32(0.0), np.float32(1.0), np.float32(1.0), np.float32(0.0), np.float32(1.0), np.float32(1.0)]",4.0,99840.0,36
2025-08-14_08-18-36,3216,"[np.float32(0.0), np.float32(0.0), np.float32(0.0), np.float32(0.0), np.float32(0.0), np.float32(0.0), np.float32(1.0), np.float32(0.0), np.float32(0.0), np.float32(0.0), np.float32(1.0), np.float32(0.0), np.float32(1.0), np.float32(1.0), np.float32(1.0), np.float32(0.0)]",-2.0,99838.0,9
2025-08-14_08-18-36,3217,"[np.float32(1.0), np.float32(0.0), np.float32(1.0), np.float32(0.0), np.float32(1.0), np.float32(1.0), np.float32(0.0), np.float32(0.0), np.float32(1.0), np.float32(1.0), np.float32(1.0), np.float32(0.0), np.float32(1.0), np.float32(0.0), np.float32(0.0), np.float32(0.0)]",-1.0,99837.0,19
2025-08-14_08-18-36,3218,"[np.float32(0.0), np.float32(0.0), np.float32(1.0), np.float32(0.0), np.float32(1.0), np.float32(0.0), np.float32(1.0), np.float32(0.0), np.float32(0.0), np.float32(1.0), np.float32(0.0), np.float32(1.0), np.float32(0.0), np.float32(0.0), np.float32(0.0), np.float32(0.0)]",-1.0,99836.0,14
2025-08-14_08-18-36,3219,"[np.float32(0.0), np.float32(0.0), np.float32(1.0), np.float32(0.0), np.float32(1.0), np.float32(1.0), np.float32(0.0), np.float32(1.0), np.float32(1.0), np.float32(1.0), np.float32(0.0), np.float32(0.0), np.float32(1.0), np.float32(0.0), np.float32(0.0), np.float32(0.0)]",1.0,99837.0,25
2025-08-14_08-18-36,3220,"[np.float32(0.0), np.float32(1.0), np.float32(0.0), np.float32(1.0), np.float32(1.0), np.float32(0.0), np.float32(0.0), np.float32(1.0), np.float32(0.0), np.float32(1.0), np.float32(1.0), np.float32(1.0), np.float32(1.0), np.float32(0.0), np.float32(0.0), np.float32(0.0)]",1.0,99838.0,11
2025-08-14_08-18-36,3221,"[np.float32(1.0), np.float32(1.0), np.float32(1.0), np.float32(1.0), np.float32(0.0), np.float32(0.0), np.float32(1.0), np.float32(0.0), np.float32(1.0), np.float32(1.0), np.float32(1.0), np.float32(0.0), np.float32(0.0), np.float32(1.0), np.float32(0.0), np.float32(1.0)]",-3.0,99835.0,33
2025-08-14_08-18-36,3222,"[np.float32(1.0), np.float32(1.0), np.float32(1.0), np.float32(0.0), np.float32(1.0), np.float32(0.0), np.float32(0.0), np.float32(0.0), np.float32(0.0), np.float32(0.0), np.float32(0.0), np.float32(0.0), np.float32(1.0), np.float32(1.0), np.float32(1.0), np.float32(0.0)]",0.0,99835.0,28
2025-08-14_08-18-36,3223,"[np.float32(0.0), np.float32(1.0), np.float32(0.0), np.float32(0.0), np.float32(0.0), np.float32(0.0), np.float32(0.0), np.float32(1.0), np.float32(1.0), np.float32(1.0), np.float32(0.0), np.float32(1.0), np.float32(1.0), np.float32(0.0), np.float32(1.0), np.float32(0.0)]",1.0,99836.0,31
2025-08-14_08-18-36,3224,"[np.float32(0.0), np.float32(1.0), np.float32(1.0), np.float32(0.0), np.float32(0.0), np.float32(1.0), np.float32(0.0), np.float32(1.0), np.float32(0.0), np.float32(1.0), np.float32(0.0), np.float32(0.0), np.float32(0.0), np.float32(0.0), np.float32(1.0), np.float32(0.0)]",-6.0,99830.0,3
2025-08-14_08-18-36,3225,"[np.float32(1.0), np.float32(1.0), np.float32(0.0), np.float32(0.0), np.float32(1.0), np.float32(0.0), np.float32(1.0), np.float32(0.0), np.float32(1.0), np.float32(1.0), np.float32(1.0), np.float32(1.0), np.float32(1.0), np.float32(0.0), np.float32(0.0), np.float32(0.0)]",-1.0,99829.0,32
2025-08-14_08-18-36,3226,"[np.float32(1.0), np.float32(1.0), np.float32(0.0), np.float32(1.0), np.float32(1.0), np.float32(1.0), np.float32(0.0), np.float32(0.0), np.float32(1.0), np.float32(0.0), np.float32(0.0), np.float32(0.0), np.float32(1.0), np.float32(1.0), np.float32(1.0), np.float32(1.0)]",-3.0,99826.0,22
2025-08-14_08-18-36,3227,"[np.float32(0.0), np.float32(0.0), np.float32(0.0), np.float32(0.0), np.float32(0.0), np.float32(1.0), np.float32(1.0), np.float32(1.0), np.float32(1.0), np.float32(1.0), np.float32(0.0), np.float32(1.0), np.float32(1.0), np.float32(1.0), np.float32(0.0), np.float32(0.0)]",-3.0,99823.0,20
2025-08-14_08-18-36,3228,"[np.float32(0.0), np.float32(0.0), np.float32(1.0), np.float32(0.0), np.float32(0.0), np.float32(1.0), np.float32(0.0), np.float32(0.0), np.float32(0.0), np.float32(0.0), np.float32(0.0), np.float32(1.0), np.float32(0.0), np.float32(0.0), np.float32(1.0), np.float32(1.0)]",2.0,99825.0,20
2025-08-14_08-18-36,3229,"[np.float32(1.0), np.float32(1.0), np.float32(0.0), np.float32(0.0), np.float32(0.0), np.float32(1.0), np.float32(1.0), np.float32(1.0), np.float32(0.0), np.float32(0.0), np.float32(1.0), np.float32(1.0), np.float32(0.0), np.float32(0.0), np.float32(0.0), np.float32(0.0)]",1.0,99826.0,2
2025-08-14_08-18-36,3230,"[np.float32(1.0), np.float32(1.0), np.float32(1.0), np.float32(0.0), np.float32(1.0), np.float32(1.0), np.float32(1.0), np.float32(0.0), np.float32(1.0), np.float32(1.0), np.float32(0.0), np.float32(0.0), np.float32(0.0), np.float32(0.0), np.float32(1.0), np.float32(1.0)]",2.0,99828.0,16
2025-08-14_08-18-36,3231,"[np.float32(1.0), np.float32(1.0), np.float32(0.0), np.float32(1.0), np.float32(1.0), np.float32(1.0), np.float32(1.0), np.float32(1.0), np.float32(0.0), np.float32(1.0), np.float32(1.0), np.float32(1.0), np.float32(0.0), np.float32(0.0), np.float32(1.0), np.float32(0.0)]",-2.0,99826.0,35
2025-08-14_08-18-36,3232,"[np.float32(1.0), np.float32(1.0), np.float32(0.0), np.float32(1.0), np.float32(0.0), np.float32(0.0), np.float32(0.0), np.float32(1.0), np.float32(1.0), np.float32(0.0), np.float32(0.0), np.float32(0.0), np.float32(1.0), np.float32(0.0), np.float32(1.0), np.float32(1.0)]",-1.0,99825.0,1
2025-08-14_08-18-36,3233,"[np.float32(1.0), np.float32(0.0), np.float32(1.0), np.float32(1.0), np.float32(0.0), np.float32(1.0), np.float32(1.0), np.float32(1.0), np.float32(0.0), np.float32(0.0), np.float32(1.0), np.float32(1.0), np.float32(0.0), np.float32(0.0), np.float32(0.0), np.float32(0.0)]",-1.0,99824.0,1
2025-08-14_08-18-36,3234,"[np.float32(1.0), np.float32(1.0), np.float32(0.0), np.float32(1.0), np.float32(0.0), np.float32(0.0), np.float32(1.0), np.float32(1.0), np.float32(0.0), np.float32(1.0), np.float32(0.0), np.float32(0.0), np.float32(0.0), np.float32(1.0), np.float32(1.0), np.float32(0.0)]",2.0,99826.0,3
2025-08-14_08-18-36,3235,"[np.float32(0.0), np.float32(0.0), np.float32(1.0), np.float32(0.0), np.float32(1.0), np.float32(1.0), np.float32(1.0), np.float32(1.0), np.float32(0.0), np.float32(1.0), np.float32(1.0), np.float32(1.0), np.float32(1.0), np.float32(1.0), np.float32(1.0), np.float32(0.0)]",0.0,99826.0,3
2025-08-14_08-18-36,3236,"[np.float32(0.0), np.float32(0.0), np.float32(1.0), np.float32(0.0), np.float32(0.0), np.float32(0.0), np.float32(0.0), np.float32(0.0), np.float32(0.0), np.float32(0.0), np.float32(0.0), np.float32(0.0), np.float32(1.0), np.float32(0.0), np.float32(1.0), np.float32(1.0)]",-2.0,99824.0,22
2025-08-14_08-18-36,3237,"[np.float32(0.0), np.float32(0.0), np.float32(0.0), np.float32(1.0), np.float32(0.0), np.float32(1.0), np.float32(1.0), np.float32(1.0), np.float32(0.0), np.float32(0.0), np.float32(1.0), np.float32(1.0), np.float32(0.0), np.float32(0.0), np.float32(0.0), np.float32(0.0)]",-4.0,99820.0,34
2025-08-14_08-18-36,3238,"[np.float32(0.0), np.float32(0.0), np.float32(1.0), np.float32(1.0), np.float32(0.0), np.float32(0.0), np.float32(0.0), np.float32(0.0), np.float32(1.0), np.float32(0.0), np.float32(0.0), np.float32(0.0), np.float32(1.0), np.float32(0.0), np.float32(1.0), np.float32(0.0)]",-3.0,99817.0,12
2025-08-14_08-18-36,3239,"[np.float32(0.0), np.float32(0.0), np.float32(0.0), np.float32(0.0), np.float32(1.0), np.float32(0.0), np.float32(1.0), np.float32(0.0), np.float32(0.0), np.float32(0.0), np.float32(1.0), np.float32(1.0), np.float32(1.0), np.float32(0.0), np.float32(0.0), np.float32(0.0)]",-2.0,99815.0,35
2025-08-14_08-18-36,3240,"[np.float32(0.0), np.float32(1.0), np.float32(1.0), np.float32(0.0), np.float32(1.0), np.float32(1.0), np.float32(0.0), np.float32(0.0), np.float32(1.0), np.float32(0.0), np.float32(0.0), np.float32(0.0), np.float32(1.0), np.float32(1.0), np.float32(0.0), np.float32(1.0)]",4.0,99819.0,28
2025-08-14_08-18-36,3241,"[np.float32(1.0), np.float32(0.0), np.float32(1.0), np.float32(1.0), np.float32(1.0), np.float32(0.0), np.float32(0.0), np.float32(0.0), np.float32(0.0), np.float32(0.0), np.float32(1.0), np.float32(1.0), np.float32(0.0), np.float32(1.0), np.float32(0.0), np.float32(0.0)]",-5.0,99814.0,31
2025-08-14_08-18-36,3242,"[np.float32(0.0), np.float32(0.0), np.float32(0.0), np.float32(0.0), np.float32(1.0), np.float32(1.0), np.float32(1.0), np.float32(1.0), np.float32(1.0), np.float32(1.0), np.float32(1.0), np.float32(1.0), np.float32(0.0), np.float32(0.0), np.float32(1.0), np.float32(0.0)]",-1.0,99813.0,7
2025-08-14_08-18-36,3243,"[np.float32(1.0), np.float32(1.0), np.float32(1.0), np.float32(0.0), np.float32(0.0), np.float32(1.0), np.float32(0.0), np.float32(0.0), np.float32(0.0), np.float32(0.0), np.float32(1.0), np.float32(0.0), np.float32(0.0), np.float32(1.0), np.float32(1.0), np.float32(1.0)]",-1.0,99812.0,25
2025-08-14_08-18-36,3244,"[np.float32(1.0), np.float32(0.0), np.float32(0.0), np.float32(0.0), np.float32(0.0), np.float32(0.0), np.float32(0.0), np.float32(0.0), np.float32(1.0), np.float32(1.0), np.float32(0.0), np.float32(1.0), np.float32(1.0), np.float32(0.0), np.float32(1.0), np.float32(0.0)]",-3.0,99809.0,26
2025-08-14_08-18-36,3245,"[np.float32(1.0), np.float32(1.0), np.float32(0.0), np.float32(1.0), np.float32(1.0), np.float32(1.0), np.float32(1.0), np.float32(1.0), np.float32(0.0), np.float32(0.0), np.float32(0.0), np.float32(0.0), np.float32(0.0), np.float32(0.0), np.float32(0.0), np.float32(1.0)]",-4.0,99805.0,30
2025-08-14_08-18-36,3246,"[np.float32(1.0), np.float32(1.0), np.float32(0.0), np.float32(0.0), np.float32(1.0), np.float32(1.0), np.float32(0.0), np.float32(1.0), np.float32(1.0), np.float32(1.0), np.float32(1.0), np.float32(1.0), np.float32(0.0), np.float32(1.0), np.float32(0.0), np.float32(1.0)]",-1.0,99804.0,2
2025-08-14_08-18-36,3247,"[np.float32(1.0), np.float32(0.0), np.float32(1.0), np.float32(0.0), np.float32(1.0), np.float32(0.0), np.float32(1.0), np.float32(0.0), np.float32(0.0), np.float32(0.0), np.float32(0.0), np.float32(1.0), np.float32(0.0), np.float32(1.0), np.float32(1.0), np.float32(1.0)]",1.0,99805.0,16
2025-08-14_08-18-36,3248,"[np.float32(1.0), np.float32(1.0), np.float32(1.0), np.float32(0.0), np.float32(0.0), np.float32(0.0), np.float32(0.0), np.float32(0.0), np.float32(0.0), np.float32(0.0), np.float32(1.0), np.float32(0.0), np.float32(0.0), np.float32(0.0), np.float32(0.0), np.float32(0.0)]",-2.0,99803.0,27
2025-08-14_08-18-36,3249,"[np.float32(0.0), np.float32(1.0), np.float32(0.0), np.float32(1.0), np.float32(1.0), np.float32(0.0), np.float32(0.0), np.float32(0.0), np.float32(1.0), np.float32(1.0), np.float32(0.0), np.float32(0.0), np.float32(0.0), np.float32(0.0), np.float32(0.0), np.float32(0.0)]",1.0,99804.0,15
2025-08-14_08-18-36,3250,"[np.float32(0.0), np.float32(0.0), np.float32(0.0), np.float32(1.0), np.float32(1.0), np.float32(0.0), np.float32(0.0), np.float32(1.0), np.float32(0.0), np.float32(0.0), np.float32(0.0), np.float32(0.0), np.float32(0.0), np.float32(0.0), np.float32(0.0), np.float32(0.0)]",-3.0,99801.0,30
2025-08-14_08-18-36,3251,"[np.float32(0.0), np.float32(1.0), np.float32(0.0), np.float32(1.0), np.float32(1.0), np.float32(1.0), np.float32(1.0), np.float32(1.0), np.float32(1.0), np.float32(0.0), np.float32(0.0), np.float32(1.0), np.float32(1.0), np.float32(1.0), np.float32(1.0), np.float32(0.0)]",0.0,99801.0,30
2025-08-14_08-18-36,3252,"[np.float32(1.0), np.float32(1.0), np.float32(1.0), np.float32(1.0), np.float32(1.0), np.float32(1.0), np.float32(1.0), np.float32(0.0), np.float32(1.0), np.float32(0.0), np.float32(1.0), np.float32(0.0), np.float32(1.0), np.float32(1.0), np.float32(1.0), np.float32(0.0)]",0.0,99801.0,4
2025-08-14_08-18-36,3253,"[np.float32(1.0), np.float32(1.0), np.float32(1.0), np.float32(1.0), np.float32(1.0), np.float32(0.0), np.float32(1.0), np.float32(1.0), np.float32(1.0), np.float32(1.0), np.float32(1.0), np.float32(0.0), np.float32(1.0), np.float32(1.0), np.float32(0.0), np.float32(1.0)]",-3.0,99798.0,23
2025-08-14_08-18-36,3254,"[np.float32(1.0), np.float32(1.0), np.float32(1.0), np.float32(0.0), np.float32(0.0), np.float32(1.0), np.float32(1.0), np.float32(1.0), np.float32(0.0), np.float32(1.0), np.float32(1.0), np.float32(0.0), np.float32(0.0), np.float32(1.0), np.float32(0.0), np.float32(0.0)]",2.0,99800.0,7
2025-08-14_08-18-36,3255,"[np.float32(0.0), np.float32(0.0), np.float32(0.0), np.float32(1.0), np.float32(1.0), np.float32(1.0), np.float32(0.0), np.float32(0.0), np.float32(1.0), np.float32(1.0), np.float32(1.0), np.float32(1.0), np.float32(1.0), np.float32(1.0), np.float32(0.0), np.float32(0.0)]",-4.0,99796.0,14
2025-08-14_08-18-36,3256,"[np.float32(0.0), np.float32(1.0), np.float32(1.0), np.float32(1.0), np.float32(1.0), np.float32(0.0), np.float32(0.0), np.float32(1.0), np.float32(0.0), np.float32(1.0), np.float32(0.0), np.float32(0.0), np.float32(0.0), np.float32(1.0), np.float32(0.0), np.float32(0.0)]",-5.0,99791.0,30
2025-08-14_08-18-36,3257,"[np.float32(0.0), np.float32(0.0), np.float32(0.0), np.float32(1.0), np.float32(1.0), np.float32(1.0), np.float32(1.0), np.float32(1.0), np.float32(1.0), np.float32(1.0), np.float32(0.0), np.float32(0.0), np.float32(1.0), np.float32(0.0), np.float32(0.0), np.float32(0.0)]",-3.0,99788.0,32
2025-08-14_08-18-36,3258,"[np.float32(1.0), np.float32(1.0), np.float32(0.0), np.float32(0.0), np.float32(0.0), np.float32(0.0), np.float32(1.0), np.float32(1.0), np.float32(0.0), np.float32(0.0), np.float32(1.0), np.float32(0.0), np.float32(1.0), np.float32(1.0), np.float32(0.0), np.float32(0.0)]",1.0,99789.0,5
2025-08-14_08-18-36,3259,"[np.float32(0.0), np.float32(1.0), np.float32(0.0), np.float32(1.0), np.float32(0.0), np.float32(1.0), np.float32(1.0), np.float32(0.0), np.float32(1.0), np.float32(0.0), np.float32(0.0), np.float32(1.0), np.float32(0.0), np.float32(0.0), np.float32(0.0), np.float32(1.0)]",1.0,99790.0,36
2025-08-14_08-18-36,3260,"[np.float32(1.0), np.float32(1.0), np.float32(1.0), np.float32(1.0), np.float32(1.0), np.float32(0.0), np.float32(0.0), np.float32(1.0), np.float32(0.0), np.float32(1.0), np.float32(0.0), np.float32(0.0), np.float32(0.0), np.float32(1.0), np.float32(0.0), np.float32(0.0)]",-1.0,99789.0,35
2025-08-14_08-18-36,3261,"[np.float32(0.0), np.float32(1.0), np.float32(1.0), np.float32(1.0), np.float32(0.0), np.float32(0.0), np.float32(0.0), np.float32(1.0), np.float32(1.0), np.float32(1.0), np.float32(0.0), np.float32(1.0), np.float32(0.0), np.float32(1.0), np.float32(0.0), np.float32(1.0)]",-2.0,99787.0,10
2025-08-14_08-18-36,3262,"[np.float32(0.0), np.float32(1.0), np.float32(0.0), np.float32(0.0), np.float32(0.0), np.float32(1.0), np.float32(0.0), np.float32(0.0), np.float32(1.0), np.float32(1.0), np.float32(1.0), np.float32(0.0), np.float32(1.0), np.float32(0.0), np.float32(0.0), np.float32(1.0)]",-2.0,99785.0,2
2025-08-14_08-18-36,3263,"[np.float32(1.0), np.float32(0.0), np.float32(1.0), np.float32(0.0), np.float32(1.0), np.float32(0.0), np.float32(0.0), np.float32(1.0), np.float32(1.0), np.float32(1.0), np.float32(0.0), np.float32(1.0), np.float32(1.0), np.float32(1.0), np.float32(0.0), np.float32(1.0)]",1.0,99786.0,19
2025-08-14_08-18-36,3264,"[np.float32(0.0), np.float32(0.0), np.float32(1.0), np.float32(1.0), np.float32(1.0), np.float32(1.0), np.float32(1.0), np.float32(0.0), np.float32(1.0), np.float32(0.0), np.float32(1.0), np.float32(0.0), np.float32(0.0), np.float32(1.0), np.float32(1.0), np.float32(0.0)]",-2.0,99784.0,6
2025-08-14_08-18-36,3265,"[np.float32(1.0), np.float32(1.0), np.float32(0.0), np.float32(1.0), np.float32(0.0), np.float32(1.0), np.float32(0.0), np.float32(0.0), np.float32(1.0), np.float32(0.0), np.float32(1.0), np.float32(0.0), np.float32(0.0), np.float32(1.0), np.float32(0.0), np.float32(1.0)]",1.0,99785.0,27
2025-08-14_08-18-36,3266,"[np.float32(1.0), np.float32(0.0), np.float32(1.0), np.float32(0.0), np.float32(1.0), np.float32(1.0), np.float32(0.0), np.float32(0.0), np.float32(1.0), np.float32(0.0), np.float32(1.0), np.float32(0.0), np.float32(1.0), np.float32(1.0), np.float32(0.0), np.float32(1.0)]",1.0,99786.0,2
2025-08-14_08-18-36,3267,"[np.float32(0.0), np.float32(1.0), np.float32(1.0), np.float32(0.0), np.float32(1.0), np.float32(0.0), np.float32(0.0), np.float32(1.0), np.float32(0.0), np.float32(1.0), np.float32(0.0), np.float32(1.0), np.float32(1.0), np.float32(0.0), np.float32(1.0), np.float32(0.0)]",-1.0,99785.0,14
2025-08-14_08-18-36,3268,"[np.float32(1.0), np.float32(0.0), np.float32(0.0), np.float32(1.0), np.float32(0.0), np.float32(0.0), np.float32(0.0), np.float32(0.0), np.float32(0.0), np.float32(0.0), np.float32(1.0), np.float32(0.0), np.float32(0.0), np.float32(1.0), np.float32(1.0), np.float32(0.0)]",0.0,99785.0,15
2025-08-14_08-18-36,3269,"[np.float32(0.0), np.float32(1.0), np.float32(0.0), np.float32(0.0), np.float32(0.0), np.float32(1.0), np.float32(1.0), np.float32(1.0), np.float32(1.0), np.float32(1.0), np.float32(0.0), np.float32(1.0), np.float32(1.0), np.float32(1.0), np.float32(1.0), np.float32(1.0)]",-1.0,99784.0,26
2025-08-14_08-18-36,3270,"[np.float32(1.0), np.float32(0.0), np.float32(0.0), np.float32(0.0), np.float32(0.0), np.float32(1.0), np.float32(1.0), np.float32(0.0), np.float32(1.0), np.float32(0.0), np.float32(0.0), np.float32(0.0), np.float32(0.0), np.float32(1.0), np.float32(1.0), np.float32(1.0)]",3.0,99787.0,27
2025-08-14_08-18-36,3271,"[np.float32(0.0), np.float32(1.0), np.float32(1.0), np.float32(1.0), np.float32(1.0), np.float32(1.0), np.float32(1.0), np.float32(0.0), np.float32(1.0), np.float32(1.0), np.float32(0.0), np.float32(1.0), np.float32(1.0), np.float32(0.0), np.float32(0.0), np.float32(1.0)]",-4.0,99783.0,5
2025-08-14_08-18-36,3272,"[np.float32(0.0), np.float32(0.0), np.float32(1.0), np.float32(0.0), np.float32(0.0), np.float32(0.0), np.float32(0.0), np.float32(0.0), np.float32(1.0), np.float32(1.0), np.float32(0.0), np.float32(1.0), np.float32(1.0), np.float32(0.0), np.float32(1.0), np.float32(0.0)]",2.0,99785.0,34
2025-08-14_08-18-36,3273,"[np.float32(1.0), np.float32(0.0), np.float32(1.0), np.float32(0.0), np.float32(1.0), np.float32(0.0), np.float32(0.0), np.float32(0.0), np.float32(0.0), np.float32(0.0), np.float32(1.0), np.float32(0.0), np.float32(1.0), np.float32(0.0), np.float32(0.0), np.float32(1.0)]",1.0,99786.0,8
2025-08-14_08-18-36,3274,"[np.float32(0.0), np.float32(0.0), np.float32(1.0), np.float32(0.0), np.float32(0.0), np.float32(0.0), np.float32(0.0), np.float32(0.0), np.float32(1.0), np.float32(1.0), np.float32(1.0), np.float32(0.0), np.float32(1.0), np.float32(0.0), np.float32(0.0), np.float32(1.0)]",-1.0,99785.0,16
2025-08-14_08-18-36,3275,"[np.float32(0.0), np.float32(0.0), np.float32(0.0), np.float32(1.0), np.float32(1.0), np.float32(1.0), np.float32(0.0), np.float32(0.0), np.float32(0.0), np.float32(0.0), np.float32(0.0), np.float32(0.0), np.float32(1.0), np.float32(1.0), np.float32(0.0), np.float32(0.0)]",2.0,99787.0,29
2025-08-14_08-18-36,3276,"[np.float32(1.0), np.float32(1.0), np.float32(0.0), np.float32(1.0), np.float32(1.0), np.float32(1.0), np.float32(1.0), np.float32(1.0), np.float32(1.0), np.float32(0.0), np.float32(0.0), np.float32(1.0), np.float32(1.0), np.float32(0.0), np.float32(0.0), np.float32(0.0)]",-1.0,99786.0,25
2025-08-14_08-18-36,3277,"[np.float32(1.0), np.float32(1.0), np.float32(0.0), np.float32(0.0), np.float32(0.0), np.float32(1.0), np.float32(1.0), np.float32(1.0), np.float32(1.0), np.float32(0.0), np.float32(0.0), np.float32(1.0), np.float32(0.0), np.float32(1.0), np.float32(0.0), np.float32(0.0)]",-3.0,99783.0,14
2025-08-14_08-18-36,3278,"[np.float32(0.0), np.float32(0.0), np.float32(1.0), np.float32(0.0), np.float32(0.0), np.float32(1.0), np.float32(0.0), np.float32(1.0), np.float32(0.0), np.float32(0.0), np.float32(1.0), np.float32(1.0), np.float32(0.0), np.float32(1.0), np.float32(0.0), np.float32(1.0)]",-1.0,99782.0,3
2025-08-14_08-18-36,3279,"[np.float32(0.0), np.float32(1.0), np.float32(1.0), np.float32(0.0), np.float32(1.0), np.float32(1.0), np.float32(0.0), np.float32(0.0), np.float32(0.0), np.float32(1.0), np.float32(1.0), np.float32(1.0), np.float32(1.0), np.float32(1.0), np.float32(1.0), np.float32(1.0)]",-1.0,99781.0,30
2025-08-14_08-18-36,3280,"[np.float32(0.0), np.float32(1.0), np.float32(1.0), np.float32(0.0), np.float32(0.0), np.float32(1.0), np.float32(1.0), np.float32(1.0), np.float32(0.0), np.float32(0.0), np.float32(1.0), np.float32(1.0), np.float32(1.0), np.float32(1.0), np.float32(0.0), np.float32(0.0)]",-4.0,99777.0,13
2025-08-14_08-18-36,3281,"[np.float32(0.0), np.float32(0.0), np.float32(1.0), np.float32(1.0), np.float32(0.0), np.float32(1.0), np.float32(0.0), np.float32(0.0), np.float32(0.0), np.float32(0.0), np.float32(1.0), np.float32(1.0), np.float32(0.0), np.float32(1.0), np.float32(1.0), np.float32(0.0)]",-2.0,99775.0,7
2025-08-14_08-18-36,3282,"[np.float32(1.0), np.float32(0.0), np.float32(1.0), np.float32(1.0), np.float32(1.0), np.float32(0.0), np.float32(0.0), np.float32(0.0), np.float32(0.0), np.float32(0.0), np.float32(0.0), np.float32(1.0), np.float32(0.0), np.float32(0.0), np.float32(0.0), np.float32(1.0)]",1.0,99776.0,30
2025-08-14_08-18-36,3283,"[np.float32(1.0), np.float32(0.0), np.float32(1.0), np.float32(1.0), np.float32(0.0), np.float32(1.0), np.float32(0.0), np.float32(0.0), np.float32(0.0), np.float32(0.0), np.float32(0.0), np.float32(0.0), np.float32(1.0), np.float32(1.0), np.float32(0.0), np.float32(0.0)]",-4.0,99772.0,8
2025-08-14_08-18-36,3284,"[np.float32(0.0), np.float32(0.0), np.float32(0.0), np.float32(1.0), np.float32(0.0), np.float32(1.0), np.float32(1.0), np.float32(0.0), np.float32(0.0), np.float32(1.0), np.float32(0.0), np.float32(0.0), np.float32(0.0), np.float32(1.0), np.float32(0.0), np.float32(1.0)]",4.0,99776.0,25
2025-08-14_08-18-36,3285,"[np.float32(1.0), np.float32(1.0), np.float32(0.0), np.float32(1.0), np.float32(1.0), np.float32(1.0), np.float32(0.0), np.float32(0.0), np.float32(1.0), np.float32(1.0), np.float32(0.0), np.float32(1.0), np.float32(1.0), np.float32(1.0), np.float32(1.0), np.float32(0.0)]",-7.0,99769.0,14
2025-08-14_08-18-36,3286,"[np.float32(0.0), np.float32(1.0), np.float32(0.0), np.float32(0.0), np.float32(0.0), np.float32(1.0), np.float32(1.0), np.float32(0.0), np.float32(0.0), np.float32(1.0), np.float32(1.0), np.float32(0.0), np.float32(1.0), np.float32(1.0), np.float32(1.0), np.float32(1.0)]",-1.0,99768.0,17
2025-08-14_08-18-36,3287,"[np.float32(1.0), np.float32(1.0), np.float32(1.0), np.float32(0.0), np.float32(1.0), np.float32(1.0), np.float32(0.0), np.float32(1.0), np.float32(0.0), np.float32(1.0), np.float32(0.0), np.float32(1.0), np.float32(1.0), np.float32(0.0), np.float32(0.0), np.float32(0.0)]",3.0,99771.0,18
2025-08-14_08-18-36,3288,"[np.float32(0.0), np.float32(0.0), np.float32(1.0), np.float32(0.0), np.float32(0.0), np.float32(0.0), np.float32(1.0), np.float32(0.0), np.float32(0.0), np.float32(1.0), np.float32(1.0), np.float32(0.0), np.float32(0.0), np.float32(0.0), np.float32(0.0), np.float32(0.0)]",-1.0,99770.0,25
2025-08-14_08-18-36,3289,"[np.float32(1.0), np.float32(1.0), np.float32(0.0), np.float32(0.0), np.float32(1.0), np.float32(0.0), np.float32(1.0), np.float32(1.0), np.float32(1.0), np.float32(1.0), np.float32(1.0), np.float32(0.0), np.float32(1.0), np.float32(1.0), np.float32(1.0), np.float32(0.0)]",-3.0,99767.0,36
2025-08-14_08-18-36,3290,"[np.float32(0.0), np.float32(1.0), np.float32(1.0), np.float32(1.0), np.float32(1.0), np.float32(1.0), np.float32(0.0), np.float32(0.0), np.float32(1.0), np.float32(1.0), np.float32(1.0), np.float32(1.0), np.float32(1.0), np.float32(0.0), np.float32(0.0), np.float32(0.0)]",-1.0,99766.0,4
2025-08-14_08-18-36,3291,"[np.float32(1.0), np.float32(1.0), np.float32(1.0), np.float32(1.0), np.float32(0.0), np.float32(0.0), np.float32(0.0), np.float32(1.0), np.float32(1.0), np.float32(0.0), np.float32(0.0), np.float32(0.0), np.float32(1.0), np.float32(1.0), np.float32(1.0), np.float32(1.0)]",0.0,99766.0,20
2025-08-14_08-18-36,3292,"[np.float32(1.0), np.float32(1.0), np.float32(1.0), np.float32(1.0), np.float32(1.0), np.float32(0.0), np.float32(0.0), np.float32(1.0), np.float32(1.0), np.float32(0.0), np.float32(1.0), np.float32(1.0), np.float32(0.0), np.float32(0.0), np.float32(0.0), np.float32(1.0)]",0.0,99766.0,30
2025-08-14_08-18-36,3293,"[np.float32(1.0), np.float32(0.0), np.float32(1.0), np.float32(0.0), np.float32(0.0), np.float32(0.0), np.float32(1.0), np.float32(0.0), np.float32(1.0), np.float32(0.0), np.float32(1.0), np.float32(0.0), np.float32(0.0), np.float32(1.0), np.float32(0.0), np.float32(1.0)]",-2.0,99764.0,10
2025-08-14_08-18-36,3294,"[np.float32(1.0), np.float32(0.0), np.float32(0.0), np.float32(0.0), np.float32(1.0), np.float32(1.0), np.float32(1.0), np.float32(1.0), np.float32(1.0), np.float32(1.0), np.float32(1.0), np.float32(0.0), np.float32(1.0), np.float32(1.0), np.float32(1.0), np.float32(0.0)]",2.0,99766.0,19
2025-08-14_08-18-36,3295,"[np.float32(0.0), np.float32(1.0), np.float32(1.0), np.float32(0.0), np.float32(0.0), np.float32(0.0), np.float32(0.0), np.float32(1.0), np.float32(1.0), np.float32(1.0), np.float32(0.0), np.float32(1.0), np.float32(0.0), np.float32(0.0), np.float32(0.0), np.float32(1.0)]",-1.0,99765.0,19
2025-08-14_08-18-36,3296,"[np.float32(0.0), np.float32(1.0), np.float32(1.0), np.float32(0.0), np.float32(1.0), np.float32(1.0), np.float32(0.0), np.float32(1.0), np.float32(0.0), np.float32(0.0), np.float32(0.0), np.float32(1.0), np.float32(0.0), np.float32(1.0), np.float32(1.0), np.float32(0.0)]",1.0,99766.0,6
2025-08-14_08-18-36,3297,"[np.float32(1.0), np.float32(0.0), np.float32(0.0), np.float32(1.0), np.float32(0.0), np.float32(0.0), np.float32(0.0), np.float32(0.0), np.float32(0.0), np.float32(0.0), np.float32(0.0), np.float32(0.0), np.float32(0.0), np.float32(0.0), np.float32(0.0), np.float32(0.0)]",-2.0,99764.0,4
2025-08-14_08-18-36,3298,"[np.float32(0.0), np.float32(1.0), np.float32(1.0), np.float32(1.0), np.float32(1.0), np.float32(1.0), np.float32(0.0), np.float32(1.0), np.float32(1.0), np.float32(1.0), np.float32(0.0), np.float32(0.0), np.float32(1.0), np.float32(0.0), np.float32(1.0), np.float32(0.0)]",0.0,99764.0,19
2025-08-14_08-18-36,3299,"[np.float32(1.0), np.float32(1.0), np.float32(0.0), np.float32(0.0), np.float32(1.0), np.float32(0.0), np.float32(0.0), np.float32(1.0), np.float32(0.0), np.float32(0.0), np.float32(1.0), np.float32(1.0), np.float32(0.0), np.float32(0.0), np.float32(0.0), np.float32(0.0)]",-4.0,99760.0,25
2025-08-14_08-18-36,3300,"[np.float32(0.0), np.float32(0.0), np.float32(1.0), np.float32(1.0), np.float32(1.0), np.float32(0.0), np.float32(1.0), np.float32(0.0), np.float32(0.0), np.float32(0.0), np.float32(1.0), np.float32(1.0), np.float32(0.0), np.float32(1.0), np.float32(0.0), np.float32(0.0)]",3.0,99763.0,4
2025-08-14_08-18-36,3301,"[np.float32(0.0), np.float32(1.0), np.float32(0.0), np.float32(0.0), np.float32(1.0), np.float32(0.0), np.float32(0.0), np.float32(1.0), np.float32(0.0), np.float32(0.0), np.float32(0.0), np.float32(0.0), np.float32(0.0), np.float32(1.0), np.float32(0.0), np.float32(0.0)]",-2.0,99761.0,5
2025-08-14_08-18-36,3302,"[np.float32(0.0), np.float32(1.0), np.float32(0.0), np.float32(0.0), np.float32(0.0), np.float32(0.0), np.float32(0.0), np.float32(0.0), np.float32(1.0), np.float32(1.0), np.float32(1.0), np.float32(1.0), np.float32(0.0), np.float32(1.0), np.float32(0.0), np.float32(0.0)]",-1.0,99760.0,24
2025-08-14_08-18-36,3303,"[np.float32(1.0), np.float32(1.0), np.float32(1.0), np.float32(0.0), np.float32(0.0), np.float32(0.0), np.float32(0.0), np.float32(1.0), np.float32(0.0), np.float32(0.0), np.float32(1.0), np.float32(0.0), np.float32(0.0), np.float32(1.0), np.float32(0.0), np.float32(1.0)]",4.0,99764.0,17
2025-08-14_08-18-36,3304,"[np.float32(0.0), np.float32(0.0), np.float32(1.0), np.float32(1.0), np.float32(0.0), np.float32(0.0), np.float32(1.0), np.float32(0.0), np.float32(0.0), np.float32(1.0), np.float32(0.0), np.float32(1.0), np.float32(1.0), np.float32(1.0), np.float32(1.0), np.float32(1.0)]",2.0,99766.0,1
2025-08-14_08-18-36,3305,"[np.float32(0.0), np.float32(1.0), np.float32(1.0), np.float32(0.0), np.float32(0.0), np.float32(1.0), np.float32(1.0), np.float32(1.0), np.float32(0.0), np.float32(1.0), np.float32(0.0), np.float32(0.0), np.float32(1.0), np.float32(0.0), np.float32(0.0), np.float32(1.0)]",-1.0,99765.0,8
2025-08-14_08-18-36,3306,"[np.float32(1.0), np.float32(0.0), np.float32(0.0), np.float32(0.0), np.float32(1.0), np.float32(1.0), np.float32(1.0), np.float32(0.0), np.float32(0.0), np.float32(1.0), np.float32(0.0), np.float32(1.0), np.float32(1.0), np.float32(1.0), np.float32(0.0), np.float32(1.0)]",-5.0,99760.0,23
2025-08-14_08-18-36,3307,"[np.float32(1.0), np.float32(1.0), np.float32(1.0), np.float32(1.0), np.float32(1.0), np.float32(0.0), np.float32(1.0), np.float32(0.0), np.float32(0.0), np.float32(1.0), np.float32(1.0), np.float32(0.0), np.float32(1.0), np.float32(1.0), np.float32(0.0), np.float32(0.0)]",-3.0,99757.0,21
2025-08-14_08-18-36,3308,"[np.float32(1.0), np.float32(0.0), np.float32(1.0), np.float32(0.0), np.float32(0.0), np.float32(0.0), np.float32(0.0), np.float32(1.0), np.float32(0.0), np.float32(0.0), np.float32(0.0), np.float32(1.0), np.float32(1.0), np.float32(1.0), np.float32(0.0), np.float32(1.0)]",-5.0,99752.0,8
2025-08-14_08-18-36,3309,"[np.float32(0.0), np.float32(1.0), np.float32(1.0), np.float32(1.0), np.float32(0.0), np.float32(0.0), np.float32(1.0), np.float32(1.0), np.float32(1.0), np.float32(0.0), np.float32(1.0), np.float32(0.0), np.float32(1.0), np.float32(0.0), np.float32(1.0), np.float32(1.0)]",-2.0,99750.0,16
2025-08-14_08-18-36,3310,"[np.float32(0.0), np.float32(1.0), np.float32(1.0), np.float32(0.0), np.float32(0.0), np.float32(1.0), np.float32(1.0), np.float32(1.0), np.float32(0.0), np.float32(0.0), np.float32(0.0), np.float32(1.0), np.float32(1.0), np.float32(1.0), np.float32(0.0), np.float32(0.0)]",-3.0,99747.0,13
2025-08-14_08-18-36,3311,"[np.float32(0.0), np.float32(1.0), np.float32(0.0), np.float32(0.0), np.float32(1.0), np.float32(0.0), np.float32(0.0), np.float32(1.0), np.float32(0.0), np.float32(1.0), np.float32(1.0), np.float32(1.0), np.float32(1.0), np.float32(1.0), np.float32(0.0), np.float32(0.0)]",0.0,99747.0,20
2025-08-14_08-18-36,3312,"[np.float32(0.0), np.float32(1.0), np.float32(1.0), np.float32(1.0), np.float32(0.0), np.float32(1.0), np.float32(1.0), np.float32(0.0), np.float32(0.0), np.float32(0.0), np.float32(1.0), np.float32(0.0), np.float32(1.0), np.float32(1.0), np.float32(0.0), np.float32(0.0)]",-4.0,99743.0,34
2025-08-14_08-18-36,3313,"[np.float32(1.0), np.float32(1.0), np.float32(1.0), np.float32(1.0), np.float32(0.0), np.float32(1.0), np.float32(0.0), np.float32(1.0), np.float32(0.0), np.float32(1.0), np.float32(1.0), np.float32(0.0), np.float32(0.0), np.float32(1.0), np.float32(0.0), np.float32(0.0)]",-2.0,99741.0,5
2025-08-14_08-18-36,3314,"[np.float32(1.0), np.float32(0.0), np.float32(1.0), np.float32(1.0), np.float32(0.0), np.float32(0.0), np.float32(1.0), np.float32(1.0), np.float32(1.0), np.float32(0.0), np.float32(0.0), np.float32(0.0), np.float32(0.0), np.float32(0.0), np.float32(1.0), np.float32(1.0)]",2.0,99743.0,27
2025-08-14_08-18-36,3315,"[np.float32(1.0), np.float32(1.0), np.float32(0.0), np.float32(1.0), np.float32(1.0), np.float32(0.0), np.float32(0.0), np.float32(0.0), np.float32(1.0), np.float32(0.0), np.float32(0.0), np.float32(0.0), np.float32(1.0), np.float32(0.0), np.float32(0.0), np.float32(0.0)]",0.0,99743.0,11
2025-08-14_08-18-36,3316,"[np.float32(0.0), np.float32(1.0), np.float32(0.0), np.float32(1.0), np.float32(0.0), np.float32(0.0), np.float32(1.0), np.float32(1.0), np.float32(1.0), np.float32(1.0), np.float32(1.0), np.float32(1.0), np.float32(0.0), np.float32(0.0), np.float32(0.0), np.float32(1.0)]",-3.0,99740.0,30
2025-08-14_08-18-36,3317,"[np.float32(0.0), np.float32(1.0), np.float32(1.0), np.float32(0.0), np.float32(0.0), np.float32(1.0), np.float32(1.0), np.float32(1.0), np.float32(1.0), np.float32(1.0), np.float32(0.0), np.float32(0.0), np.float32(0.0), np.float32(0.0), np.float32(1.0), np.float32(0.0)]",-3.0,99737.0,12
2025-08-14_08-18-36,3318,"[np.float32(1.0), np.float32(1.0), np.float32(1.0), np.float32(1.0), np.float32(0.0), np.float32(0.0), np.float32(0.0), np.float32(1.0), np.float32(0.0), np.float32(0.0), np.float32(0.0), np.float32(0.0), np.float32(0.0), np.float32(0.0), np.float32(1.0), np.float32(0.0)]",-2.0,99735.0,32
2025-08-14_08-18-36,3319,"[np.float32(1.0), np.float32(0.0), np.float32(1.0), np.float32(1.0), np.float32(0.0), np.float32(1.0), np.float32(0.0), np.float32(1.0), np.float32(0.0), np.float32(0.0), np.float32(1.0), np.float32(1.0), np.float32(1.0), np.float32(1.0), np.float32(1.0), np.float32(0.0)]",0.0,99735.0,16
2025-08-14_08-18-36,3320,"[np.float32(0.0), np.float32(1.0), np.float32(1.0), np.float32(1.0), np.float32(1.0), np.float32(1.0), np.float32(1.0), np.float32(1.0), np.float32(0.0), np.float32(1.0), np.float32(0.0), np.float32(0.0), np.float32(0.0), np.float32(0.0), np.float32(1.0), np.float32(0.0)]",3.0,99738.0,4
2025-08-14_08-18-36,3321,"[np.float32(0.0), np.float32(0.0), np.float32(0.0), np.float32(1.0), np.float32(0.0), np.float32(1.0), np.float32(1.0), np.float32(1.0), np.float32(0.0), np.float32(0.0), np.float32(1.0), np.float32(0.0), np.float32(0.0), np.float32(0.0), np.float32(0.0), np.float32(0.0)]",2.0,99740.0,35
2025-08-14_08-18-36,3322,"[np.float32(1.0), np.float32(0.0), np.float32(1.0), np.float32(1.0), np.float32(0.0), np.float32(0.0), np.float32(1.0), np.float32(0.0), np.float32(1.0), np.float32(0.0), np.float32(1.0), np.float32(0.0), np.float32(1.0), np.float32(0.0), np.float32(1.0), np.float32(0.0)]",-3.0,99737.0,31
2025-08-14_08-18-36,3323,"[np.float32(0.0), np.float32(0.0), np.float32(0.0), np.float32(1.0), np.float32(0.0), np.float32(0.0), np.float32(0.0), np.float32(1.0), np.float32(1.0), np.float32(0.0), np.float32(1.0), np.float32(0.0), np.float32(1.0), np.float32(1.0), np.float32(0.0), np.float32(1.0)]",-1.0,99736.0,28
2025-08-14_08-18-36,3324,"[np.float32(1.0), np.float32(1.0), np.float32(0.0), np.float32(1.0), np.float32(0.0), np.float32(1.0), np.float32(0.0), np.float32(1.0), np.float32(1.0), np.float32(0.0), np.float32(1.0), np.float32(0.0), np.float32(0.0), np.float32(0.0), np.float32(1.0), np.float32(0.0)]",2.0,99738.0,5
2025-08-14_08-18-36,3325,"[np.float32(0.0), np.float32(0.0), np.float32(0.0), np.float32(1.0), np.float32(0.0), np.float32(1.0), np.float32(0.0), np.float32(0.0), np.float32(0.0), np.float32(1.0), np.float32(1.0), np.float32(0.0), np.float32(0.0), np.float32(1.0), np.float32(0.0), np.float32(1.0)]",2.0,99740.0,32
2025-08-14_08-18-36,3326,"[np.float32(0.0), np.float32(1.0), np.float32(0.0), np.float32(1.0), np.float32(0.0), np.float32(0.0), np.float32(0.0), np.float32(1.0), np.float32(0.0), np.float32(1.0), np.float32(1.0), np.float32(0.0), np.float32(0.0), np.float32(0.0), np.float32(1.0), np.float32(0.0)]",1.0,99741.0,33
2025-08-14_08-18-36,3327,"[np.float32(0.0), np.float32(1.0), np.float32(1.0), np.float32(0.0), np.float32(1.0), np.float32(1.0), np.float32(1.0), np.float32(1.0), np.float32(1.0), np.float32(0.0), np.float32(1.0), np.float32(0.0), np.float32(0.0), np.float32(1.0), np.float32(0.0), np.float32(0.0)]",6.0,99747.0,26
2025-08-14_08-18-36,3328,"[np.float32(0.0), np.float32(0.0), np.float32(0.0), np.float32(1.0), np.float32(0.0), np.float32(0.0), np.float32(0.0), np.float32(1.0), np.float32(0.0), np.float32(1.0), np.float32(1.0), np.float32(0.0), np.float32(0.0), np.float32(1.0), np.float32(0.0), np.float32(0.0)]",-2.0,99745.0,8
2025-08-14_08-18-36,3329,"[np.float32(0.0), np.float32(0.0), np.float32(0.0), np.float32(0.0), np.float32(0.0), np.float32(0.0), np.float32(1.0), np.float32(1.0), np.float32(1.0), np.float32(1.0), np.float32(1.0), np.float32(1.0), np.float32(1.0), np.float32(0.0), np.float32(0.0), np.float32(1.0)]",1.0,99746.0,6
2025-08-14_08-18-36,3330,"[np.float32(0.0), np.float32(0.0), np.float32(1.0), np.float32(0.0), np.float32(1.0), np.float32(0.0), np.float32(0.0), np.float32(0.0), np.float32(1.0), np.float32(1.0), np.float32(1.0), np.float32(1.0), np.float32(1.0), np.float32(1.0), np.float32(1.0), np.float32(1.0)]",-2.0,99744.0,9
2025-08-14_08-18-36,3331,"[np.float32(0.0), np.float32(0.0), np.float32(0.0), np.float32(1.0), np.float32(0.0), np.float32(0.0), np.float32(1.0), np.float32(1.0), np.float32(0.0), np.float32(0.0), np.float32(0.0), np.float32(1.0), np.float32(0.0), np.float32(1.0), np.float32(0.0), np.float32(1.0)]",-3.0,99741.0,28
2025-08-14_08-18-36,3332,"[np.float32(1.0), np.float32(1.0), np.float32(1.0), np.float32(0.0), np.float32(1.0), np.float32(1.0), np.float32(0.0), np.float32(1.0), np.float32(0.0), np.float32(1.0), np.float32(1.0), np.float32(0.0), np.float32(1.0), np.float32(1.0), np.float32(0.0), np.float32(1.0)]",-1.0,99740.0,23
2025-08-14_08-18-36,3333,"[np.float32(1.0), np.float32(0.0), np.float32(1.0), np.float32(1.0), np.float32(0.0), np.float32(1.0), np.float32(1.0), np.float32(0.0), np.float32(1.0), np.float32(1.0), np.float32(0.0), np.float32(1.0), np.float32(1.0), np.float32(0.0), np.float32(0.0), np.float32(0.0)]",-1.0,99739.0,6
2025-08-14_08-18-36,3334,"[np.float32(0.0), np.float32(1.0), np.float32(0.0), np.float32(1.0), np.float32(1.0), np.float32(0.0), np.float32(0.0), np.float32(1.0), np.float32(0.0), np.float32(1.0), np.float32(1.0), np.float32(1.0), np.float32(0.0), np.float32(1.0), np.float32(0.0), np.float32(0.0)]",2.0,99741.0,35
2025-08-14_08-18-36,3335,"[np.float32(1.0), np.float32(1.0), np.float32(0.0), np.float32(1.0), np.float32(0.0), np.float32(1.0), np.float32(0.0), np.float32(1.0), np.float32(1.0), np.float32(0.0), np.float32(1.0), np.float32(0.0), np.float32(0.0), np.float32(0.0), np.float32(0.0), np.float32(0.0)]",-3.0,99738.0,3
2025-08-14_08-18-36,3336,"[np.float32(0.0), np.float32(0.0), np.float32(1.0), np.float32(1.0), np.float32(1.0), np.float32(1.0), np.float32(1.0), np.float32(1.0), np.float32(1.0), np.float32(0.0), np.float32(0.0), np.float32(1.0), np.float32(1.0), np.float32(0.0), np.float32(0.0), np.float32(1.0)]",0.0,99738.0,1
2025-08-14_08-18-36,3337,"[np.float32(1.0), np.float32(0.0), np.float32(1.0), np.float32(0.0), np.float32(1.0), np.float32(0.0), np.float32(0.0), np.float32(0.0), np.float32(1.0), np.float32(0.0), np.float32(1.0), np.float32(0.0), np.float32(1.0), np.float32(0.0), np.float32(1.0), np.float32(0.0)]",1.0,99739.0,27
2025-08-14_08-18-36,3338,"[np.float32(0.0), np.float32(1.0), np.float32(1.0), np.float32(0.0), np.float32(1.0), np.float32(0.0), np.float32(1.0), np.float32(1.0), np.float32(1.0), np.float32(1.0), np.float32(1.0), np.float32(1.0), np.float32(0.0), np.float32(0.0), np.float32(1.0), np.float32(0.0)]",-2.0,99737.0,32
2025-08-14_08-18-36,3339,"[np.float32(0.0), np.float32(0.0), np.float32(0.0), np.float32(1.0), np.float32(0.0), np.float32(1.0), np.float32(0.0), np.float32(0.0), np.float32(0.0), np.float32(1.0), np.float32(0.0), np.float32(1.0), np.float32(1.0), np.float32(0.0), np.float32(1.0), np.float32(1.0)]",-2.0,99735.0,28
2025-08-14_08-18-36,3340,"[np.float32(0.0), np.float32(1.0), np.float32(0.0), np.float32(1.0), np.float32(0.0), np.float32(0.0), np.float32(1.0), np.float32(1.0), np.float32(0.0), np.float32(0.0), np.float32(0.0), np.float32(0.0), np.float32(1.0), np.float32(0.0), np.float32(0.0), np.float32(0.0)]",-2.0,99733.0,12
2025-08-14_08-18-36,3341,"[np.float32(0.0), np.float32(0.0), np.float32(1.0), np.float32(0.0), np.float32(1.0), np.float32(0.0), np.float32(1.0), np.float32(1.0), np.float32(1.0), np.float32(0.0), np.float32(0.0), np.float32(0.0), np.float32(0.0), np.float32(1.0), np.float32(0.0), np.float32(0.0)]",2.0,99735.0,22
2025-08-14_08-18-36,3342,"[np.float32(1.0), np.float32(0.0), np.float32(1.0), np.float32(1.0), np.float32(1.0), np.float32(1.0), np.float32(0.0), np.float32(1.0), np.float32(0.0), np.float32(0.0), np.float32(0.0), np.float32(1.0), np.float32(0.0), np.float32(0.0), np.float32(1.0), np.float32(1.0)]",1.0,99736.0,6
2025-08-14_08-18-36,3343,"[np.float32(0.0), np.float32(0.0), np.float32(0.0), np.float32(0.0), np.float32(1.0), np.float32(0.0), np.float32(1.0), np.float32(1.0), np.float32(1.0), np.float32(0.0), np.float32(0.0), np.float32(1.0), np.float32(0.0), np.float32(1.0), np.float32(0.0), np.float32(0.0)]",2.0,99738.0,9
2025-08-14_08-18-36,3344,"[np.float32(1.0), np.float32(1.0), np.float32(1.0), np.float32(0.0), np.float32(0.0), np.float32(1.0), np.float32(0.0), np.float32(1.0), np.float32(1.0), np.float32(1.0), np.float32(1.0), np.float32(0.0), np.float32(1.0), np.float32(1.0), np.float32(1.0), np.float32(1.0)]",3.0,99741.0,28
2025-08-14_08-18-36,3345,"[np.float32(0.0), np.float32(0.0), np.float32(0.0), np.float32(1.0), np.float32(1.0), np.float32(0.0), np.float32(0.0), np.float32(1.0), np.float32(1.0), np.float32(0.0), np.float32(1.0), np.float32(0.0), np.float32(1.0), np.float32(0.0), np.float32(1.0), np.float32(0.0)]",3.0,99744.0,11
2025-08-14_08-18-36,3346,"[np.float32(0.0), np.float32(1.0), np.float32(0.0), np.float32(0.0), np.float32(1.0), np.float32(0.0), np.float32(1.0), np.float32(1.0), np.float32(1.0), np.float32(1.0), np.float32(0.0), np.float32(0.0), np.float32(1.0), np.float32(0.0), np.float32(0.0), np.float32(0.0)]",1.0,99745.0,16
2025-08-14_08-18-36,3347,"[np.float32(0.0), np.float32(1.0), np.float32(1.0), np.float32(1.0), np.float32(1.0), np.float32(0.0), np.float32(1.0), np.float32(1.0), np.float32(0.0), np.float32(1.0), np.float32(0.0), np.float32(0.0), np.float32(0.0), np.float32(1.0), np.float32(0.0), np.float32(1.0)]",-7.0,99738.0,27
2025-08-14_08-18-36,3348,"[np.float32(0.0), np.float32(1.0), np.float32(0.0), np.float32(1.0), np.float32(0.0), np.float32(0.0), np.float32(0.0), np.float32(0.0), np.float32(1.0), np.float32(1.0), np.float32(0.0), np.float32(1.0), np.float32(1.0), np.float32(0.0), np.float32(0.0), np.float32(0.0)]",-1.0,99737.0,6
2025-08-14_08-18-36,3349,"[np.float32(1.0), np.float32(1.0), np.float32(1.0), np.float32(0.0), np.float32(0.0), np.float32(0.0), np.float32(0.0), np.float32(1.0), np.float32(1.0), np.float32(0.0), np.float32(0.0), np.float32(0.0), np.float32(0.0), np.float32(0.0), np.float32(0.0), np.float32(0.0)]",0.0,99737.0,23
2025-08-14_08-18-36,3350,"[np.float32(1.0), np.float32(0.0), np.float32(0.0), np.float32(1.0), np.float32(0.0), np.float32(1.0), np.float32(1.0), np.float32(1.0), np.float32(1.0), np.float32(1.0), np.float32(0.0), np.float32(0.0), np.float32(0.0), np.float32(1.0), np.float32(0.0), np.float32(0.0)]",-3.0,99734.0,20
2025-08-14_08-18-36,3351,"[np.float32(1.0), np.float32(0.0), np.float32(0.0), np.float32(0.0), np.float32(0.0), np.float32(1.0), np.float32(1.0), np.float32(1.0), np.float32(0.0), np.float32(0.0), np.float32(0.0), np.float32(0.0), np.float32(1.0), np.float32(1.0), np.float32(1.0), np.float32(0.0)]",-2.0,99732.0,29
2025-08-14_08-18-36,3352,"[np.float32(1.0), np.float32(1.0), np.float32(1.0), np.float32(1.0), np.float32(0.0), np.float32(0.0), np.float32(0.0), np.float32(1.0), np.float32(1.0), np.float32(1.0), np.float32(1.0), np.float32(0.0), np.float32(1.0), np.float32(0.0), np.float32(1.0), np.float32(0.0)]",-3.0,99729.0,1
2025-08-14_08-18-36,3353,"[np.float32(0.0), np.float32(0.0), np.float32(0.0), np.float32(1.0), np.float32(1.0), np.float32(1.0), np.float32(0.0), np.float32(0.0), np.float32(1.0), np.float32(0.0), np.float32(1.0), np.float32(0.0), np.float32(0.0), np.float32(1.0), np.float32(0.0), np.float32(1.0)]",6.0,99735.0,29
2025-08-14_08-18-36,3354,"[np.float32(0.0), np.float32(1.0), np.float32(0.0), np.float32(1.0), np.float32(0.0), np.float32(1.0), np.float32(1.0), np.float32(1.0), np.float32(1.0), np.float32(1.0), np.float32(1.0), np.float32(0.0), np.float32(0.0), np.float32(1.0), np.float32(1.0), np.float32(0.0)]",-4.0,99731.0,12
2025-08-14_08-18-36,3355,"[np.float32(0.0), np.float32(0.0), np.float32(1.0), np.float32(1.0), np.float32(1.0), np.float32(0.0), np.float32(1.0), np.float32(1.0), np.float32(0.0), np.float32(0.0), np.float32(1.0), np.float32(0.0), np.float32(0.0), np.float32(0.0), np.float32(1.0), np.float32(1.0)]",-3.0,99728.0,36
2025-08-14_08-18-36,3356,"[np.float32(1.0), np.float32(1.0), np.float32(0.0), np.float32(0.0), np.float32(1.0), np.float32(1.0), np.float32(1.0), np.float32(0.0), np.float32(1.0), np.float32(0.0), np.float32(1.0), np.float32(0.0), np.float32(0.0), np.float32(1.0), np.float32(0.0), np.float32(0.0)]",-1.0,99727.0,9
2025-08-14_08-18-36,3357,"[np.float32(1.0), np.float32(1.0), np.float32(1.0), np.float32(0.0), np.float32(0.0), np.float32(0.0), np.float32(0.0), np.float32(0.0), np.float32(0.0), np.float32(0.0), np.float32(1.0), np.float32(0.0), np.float32(0.0), np.float32(0.0), np.float32(1.0), np.float32(0.0)]",0.0,99727.0,35
2025-08-14_08-18-36,3358,"[np.float32(0.0), np.float32(0.0), np.float32(0.0), np.float32(0.0), np.float32(1.0), np.float32(1.0), np.float32(0.0), np.float32(0.0), np.float32(0.0), np.float32(1.0), np.float32(1.0), np.float32(1.0), np.float32(0.0), np.float32(0.0), np.float32(1.0), np.float32(0.0)]",2.0,99729.0,30
2025-08-14_08-18-36,3359,"[np.float32(1.0), np.float32(1.0), np.float32(1.0), np.float32(1.0), np.float32(1.0), np.float32(0.0), np.float32(0.0), np.float32(0.0), np.float32(0.0), np.float32(1.0), np.float32(1.0), np.float32(1.0), np.float32(0.0), np.float32(1.0), np.float32(1.0), np.float32(0.0)]",2.0,99731.0,11
2025-08-14_08-18-36,3360,"[np.float32(1.0), np.float32(1.0), np.float32(0.0), np.float32(0.0), np.float32(1.0), np.float32(1.0), np.float32(1.0), np.float32(0.0), np.float32(1.0), np.float32(1.0), np.float32(0.0), np.float32(0.0), np.float32(0.0), np.float32(0.0), np.float32(1.0), np.float32(1.0)]",-2.0,99729.0,19
2025-08-14_08-18-36,3361,"[np.float32(1.0), np.float32(1.0), np.float32(1.0), np.float32(1.0), np.float32(1.0), np.float32(0.0), np.float32(0.0), np.float32(0.0), np.float32(1.0), np.float32(0.0), np.float32(1.0), np.float32(0.0), np.float32(1.0), np.float32(1.0), np.float32(1.0), np.float32(0.0)]",3.0,99732.0,35
2025-08-14_08-18-36,3362,"[np.float32(1.0), np.float32(1.0), np.float32(1.0), np.float32(1.0), np.float32(0.0), np.float32(1.0), np.float32(1.0), np.float32(1.0), np.float32(0.0), np.float32(0.0), np.float32(0.0), np.float32(1.0), np.float32(1.0), np.float32(0.0), np.float32(1.0), np.float32(0.0)]",0.0,99732.0,16
2025-08-14_08-18-36,3363,"[np.float32(0.0), np.float32(0.0), np.float32(0.0), np.float32(1.0), np.float32(1.0), np.float32(0.0), np.float32(0.0), np.float32(1.0), np.float32(1.0), np.float32(1.0), np.float32(1.0), np.float32(1.0), np.float32(1.0), np.float32(0.0), np.float32(1.0), np.float32(1.0)]",-2.0,99730.0,8
2025-08-14_08-18-36,3364,"[np.float32(1.0), np.float32(0.0), np.float32(0.0), np.float32(1.0), np.float32(1.0), np.float32(0.0), np.float32(1.0), np.float32(1.0), np.float32(1.0), np.float32(1.0), np.float32(1.0), np.float32(0.0), np.float32(0.0), np.float32(0.0), np.float32(1.0), np.float32(0.0)]",-9.0,99721.0,0
2025-08-14_08-18-36,3365,"[np.float32(0.0), np.float32(0.0), np.float32(1.0), np.float32(1.0), np.float32(0.0), np.float32(1.0), np.float32(1.0), np.float32(1.0), np.float32(1.0), np.float32(0.0), np.float32(1.0), np.float32(1.0), np.float32(0.0), np.float32(1.0), np.float32(0.0), np.float32(1.0)]",-5.0,99716.0,13
2025-08-14_08-18-36,3366,"[np.float32(0.0), np.float32(0.0), np.float32(0.0), np.float32(1.0), np.float32(0.0), np.float32(0.0), np.float32(1.0), np.float32(1.0), np.float32(1.0), np.float32(1.0), np.float32(0.0), np.float32(0.0), np.float32(0.0), np.float32(1.0), np.float32(1.0), np.float32(1.0)]",-2.0,99714.0,32
2025-08-14_08-18-36,3367,"[np.float32(0.0), np.float32(1.0), np.float32(1.0), np.float32(0.0), np.float32(0.0), np.float32(0.0), np.float32(1.0), np.float32(0.0), np.float32(1.0), np.float32(1.0), np.float32(1.0), np.float32(1.0), np.float32(0.0), np.float32(1.0), np.float32(0.0), np.float32(0.0)]",-3.0,99711.0,13
2025-08-14_08-18-36,3368,"[np.float32(0.0), np.float32(1.0), np.float32(1.0), np.float32(1.0), np.float32(0.0), np.float32(1.0), np.float32(1.0), np.float32(0.0), np.float32(0.0), np.float32(0.0), np.float32(1.0), np.float32(0.0), np.float32(0.0), np.float32(0.0), np.float32(1.0), np.float32(0.0)]",2.0,99713.0,33
2025-08-14_08-18-36,3369,"[np.float32(1.0), np.float32(0.0), np.float32(1.0), np.float32(0.0), np.float32(1.0), np.float32(0.0), np.float32(1.0), np.float32(0.0), np.float32(0.0), np.float32(1.0), np.float32(1.0), np.float32(0.0), np.float32(1.0), np.float32(1.0), np.float32(1.0), np.float32(1.0)]",-5.0,99708.0,0
2025-08-14_08-18-36,3370,"[np.float32(1.0), np.float32(1.0), np.float32(0.0), np.float32(1.0), np.float32(1.0), np.float32(1.0), np.float32(0.0), np.float32(1.0), np.float32(0.0), np.float32(1.0), np.float32(1.0), np.float32(0.0), np.float32(1.0), np.float32(0.0), np.float32(1.0), np.float32(1.0)]",-2.0,99706.0,33
2025-08-14_08-18-36,3371,"[np.float32(1.0), np.float32(0.0), np.float32(1.0), np.float32(0.0), np.float32(0.0), np.float32(0.0), np.float32(1.0), np.float32(1.0), np.float32(0.0), np.float32(1.0), np.float32(0.0), np.float32(0.0), np.float32(0.0), np.float32(0.0), np.float32(0.0), np.float32(1.0)]",-4.0,99702.0,26
2025-08-14_08-18-36,3372,"[np.float32(1.0), np.float32(1.0), np.float32(1.0), np.float32(0.0), np.float32(1.0), np.float32(1.0), np.float32(0.0), np.float32(0.0), np.float32(1.0), np.float32(0.0), np.float32(0.0), np.float32(1.0), np.float32(1.0), np.float32(0.0), np.float32(1.0), np.float32(1.0)]",-3.0,99699.0,17
2025-08-14_08-18-36,3373,"[np.float32(1.0), np.float32(1.0), np.float32(1.0), np.float32(0.0), np.float32(0.0), np.float32(1.0), np.float32(1.0), np.float32(1.0), np.float32(1.0), np.float32(1.0), np.float32(0.0), np.float32(1.0), np.float32(1.0), np.float32(0.0), np.float32(0.0), np.float32(0.0)]",-3.0,99696.0,23
2025-08-14_08-18-36,3374,"[np.float32(1.0), np.float32(0.0), np.float32(1.0), np.float32(1.0), np.float32(0.0), np.float32(0.0), np.float32(1.0), np.float32(1.0), np.float32(1.0), np.float32(0.0), np.float32(1.0), np.float32(1.0), np.float32(1.0), np.float32(1.0), np.float32(0.0), np.float32(0.0)]",-2.0,99694.0,33
2025-08-14_08-18-36,3375,"[np.float32(0.0), np.float32(1.0), np.float32(0.0), np.float32(0.0), np.float32(1.0), np.float32(1.0), np.float32(0.0), np.float32(1.0), np.float32(1.0), np.float32(1.0), np.float32(0.0), np.float32(0.0), np.float32(0.0), np.float32(0.0), np.float32(0.0), np.float32(1.0)]",0.0,99694.0,29
2025-08-14_08-18-36,3376,"[np.float32(0.0), np.float32(0.0), np.float32(0.0), np.float32(0.0), np.float32(1.0), np.float32(1.0), np.float32(0.0), np.float32(1.0), np.float32(1.0), np.float32(0.0), np.float32(0.0), np.float32(1.0), np.float32(1.0), np.float32(1.0), np.float32(1.0), np.float32(0.0)]",-3.0,99691.0,4
2025-08-14_08-18-36,3377,"[np.float32(0.0), np.float32(0.0), np.float32(1.0), np.float32(1.0), np.float32(1.0), np.float32(1.0), np.float32(0.0), np.float32(1.0), np.float32(0.0), np.float32(0.0), np.float32(1.0), np.float32(0.0), np.float32(0.0), np.float32(0.0), np.float32(0.0), np.float32(1.0)]",-3.0,99688.0,10
2025-08-14_08-18-36,3378,"[np.float32(0.0), np.float32(0.0), np.float32(1.0), np.float32(0.0), np.float32(1.0), np.float32(1.0), np.float32(0.0), np.float32(1.0), np.float32(0.0), np.float32(1.0), np.float32(0.0), np.float32(1.0), np.float32(1.0), np.float32(0.0), np.float32(0.0), np.float32(1.0)]",-4.0,99684.0,0
2025-08-14_08-18-36,3379,"[np.float32(0.0), np.float32(1.0), np.float32(0.0), np.float32(0.0), np.float32(1.0), np.float32(1.0), np.float32(1.0), np.float32(0.0), np.float32(0.0), np.float32(0.0), np.float32(0.0), np.float32(0.0), np.float32(0.0), np.float32(0.0), np.float32(0.0), np.float32(0.0)]",-2.0,99682.0,25
2025-08-14_08-18-36,3380,"[np.float32(0.0), np.float32(1.0), np.float32(0.0), np.float32(0.0), np.float32(0.0), np.float32(1.0), np.float32(0.0), np.float32(1.0), np.float32(1.0), np.float32(0.0), np.float32(0.0), np.float32(1.0), np.float32(1.0), np.float32(1.0), np.float32(1.0), np.float32(0.0)]",0.0,99682.0,25
2025-08-14_08-18-36,3381,"[np.float32(1.0), np.float32(1.0), np.float32(0.0), np.float32(0.0), np.float32(1.0), np.float32(0.0), np.float32(0.0), np.float32(1.0), np.float32(0.0), np.float32(0.0), np.float32(1.0), np.float32(1.0), np.float32(0.0), np.float32(1.0), np.float32(0.0), np.float32(1.0)]",-1.0,99681.0,11
2025-08-14_08-18-36,3382,"[np.float32(1.0), np.float32(1.0), np.float32(1.0), np.float32(1.0), np.float32(0.0), np.float32(1.0), np.float32(1.0), np.float32(0.0), np.float32(1.0), np.float32(1.0), np.float32(1.0), np.float32(0.0), np.float32(0.0), np.float32(1.0), np.float32(0.0), np.float32(1.0)]",-4.0,99677.0,15
2025-08-14_08-18-36,3383,"[np.float32(0.0), np.float32(0.0), np.float32(0.0), np.float32(1.0), np.float32(0.0), np.float32(1.0), np.float32(0.0), np.float32(1.0), np.float32(0.0), np.float32(1.0), np.float32(0.0), np.float32(1.0), np.float32(1.0), np.float32(0.0), np.float32(0.0), np.float32(0.0)]",-1.0,99676.0,20
2025-08-14_08-18-36,3384,"[np.float32(0.0), np.float32(0.0), np.float32(1.0), np.float32(1.0), np.float32(0.0), np.float32(1.0), np.float32(0.0), np.float32(0.0), np.float32(0.0), np.float32(0.0), np.float32(1.0), np.float32(1.0), np.float32(0.0), np.float32(1.0), np.float32(0.0), np.float32(0.0)]",1.0,99677.0,24
2025-08-14_08-18-36,3385,"[np.float32(0.0), np.float32(0.0), np.float32(0.0), np.float32(1.0), np.float32(0.0), np.float32(1.0), np.float32(0.0), np.float32(1.0), np.float32(1.0), np.float32(0.0), np.float32(1.0), np.float32(0.0), np.float32(1.0), np.float32(1.0), np.float32(0.0), np.float32(0.0)]",1.0,99678.0,15
2025-08-14_08-18-36,3386,"[np.float32(0.0), np.float32(0.0), np.float32(1.0), np.float32(1.0), np.float32(1.0), np.float32(1.0), np.float32(0.0), np.float32(0.0), np.float32(1.0), np.float32(1.0), np.float32(0.0), np.float32(0.0), np.float32(1.0), np.float32(1.0), np.float32(0.0), np.float32(1.0)]",-5.0,99673.0,23
2025-08-14_08-18-36,3387,"[np.float32(0.0), np.float32(1.0), np.float32(0.0), np.float32(1.0), np.float32(0.0), np.float32(1.0), np.float32(0.0), np.float32(1.0), np.float32(1.0), np.float32(0.0), np.float32(0.0), np.float32(1.0), np.float32(1.0), np.float32(0.0), np.float32(0.0), np.float32(1.0)]",-2.0,99671.0,18
2025-08-14_08-18-36,3388,"[np.float32(1.0), np.float32(0.0), np.float32(0.0), np.float32(1.0), np.float32(0.0), np.float32(0.0), np.float32(1.0), np.float32(1.0), np.float32(1.0), np.float32(0.0), np.float32(1.0), np.float32(1.0), np.float32(0.0), np.float32(0.0), np.float32(1.0), np.float32(1.0)]",-6.0,99665.0,28
2025-08-14_08-18-36,3389,"[np.float32(0.0), np.float32(1.0), np.float32(1.0), np.float32(1.0), np.float32(0.0), np.float32(1.0), np.float32(1.0), np.float32(1.0), np.float32(1.0), np.float32(0.0), np.float32(1.0), np.float32(1.0), np.float32(0.0), np.float32(0.0), np.float32(1.0), np.float32(0.0)]",5.0,99670.0,33
2025-08-14_08-18-36,3390,"[np.float32(0.0), np.float32(0.0), np.float32(1.0), np.float32(0.0), np.float32(1.0), np.float32(1.0), np.float32(0.0), np.float32(1.0), np.float32(0.0), np.float32(0.0), np.float32(0.0), np.float32(0.0), np.float32(1.0), np.float32(1.0), np.float32(0.0), np.float32(0.0)]",-2.0,99668.0,30
2025-08-14_08-18-36,3391,"[np.float32(0.0), np.float32(0.0), np.float32(0.0), np.float32(0.0), np.float32(1.0), np.float32(0.0), np.float32(1.0), np.float32(1.0), np.float32(0.0), np.float32(1.0), np.float32(1.0), np.float32(1.0), np.float32(0.0), np.float32(0.0), np.float32(0.0), np.float32(1.0)]",1.0,99669.0,2
2025-08-14_08-18-36,3392,"[np.float32(0.0), np.float32(1.0), np.float32(0.0), np.float32(0.0), np.float32(1.0), np.float32(0.0), np.float32(1.0), np.float32(1.0), np.float32(0.0), np.float32(1.0), np.float32(0.0), np.float32(1.0), np.float32(1.0), np.float32(0.0), np.float32(0.0), np.float32(0.0)]",-5.0,99664.0,29
2025-08-14_08-18-36,3393,"[np.float32(1.0), np.float32(1.0), np.float32(0.0), np.float32(0.0), np.float32(0.0), np.float32(1.0), np.float32(1.0), np.float32(0.0), np.float32(0.0), np.float32(0.0), np.float32(1.0), np.float32(1.0), np.float32(1.0), np.float32(0.0), np.float32(0.0), np.float32(1.0)]",0.0,99664.0,11
2025-08-14_08-18-36,3394,"[np.float32(0.0), np.float32(1.0), np.float32(0.0), np.float32(1.0), np.float32(1.0), np.float32(0.0), np.float32(1.0), np.float32(1.0), np.float32(0.0), np.float32(0.0), np.float32(0.0), np.float32(1.0), np.float32(1.0), np.float32(0.0), np.float32(1.0), np.float32(0.0)]",0.0,99664.0,16
2025-08-14_08-18-36,3395,"[np.float32(1.0), np.float32(1.0), np.float32(0.0), np.float32(1.0), np.float32(1.0), np.float32(0.0), np.float32(1.0), np.float32(1.0), np.float32(0.0), np.float32(1.0), np.float32(0.0), np.float32(1.0), np.float32(0.0), np.float32(0.0), np.float32(0.0), np.float32(0.0)]",-6.0,99658.0,26
2025-08-14_08-18-36,3396,"[np.float32(0.0), np.float32(1.0), np.float32(0.0), np.float32(1.0), np.float32(1.0), np.float32(0.0), np.float32(1.0), np.float32(1.0), np.float32(0.0), np.float32(1.0), np.float32(1.0), np.float32(0.0), np.float32(1.0), np.float32(0.0), np.float32(1.0), np.float32(0.0)]",-4.0,99654.0,12
2025-08-14_08-18-36,3397,"[np.float32(0.0), np.float32(1.0), np.float32(0.0), np.float32(1.0), np.float32(0.0), np.float32(1.0), np.float32(0.0), np.float32(1.0), np.float32(1.0), np.float32(0.0), np.float32(1.0), np.float32(1.0), np.float32(0.0), np.float32(0.0), np.float32(1.0), np.float32(1.0)]",-6.0,99648.0,12
2025-08-14_08-18-36,3398,"[np.float32(0.0), np.float32(1.0), np.float32(1.0), np.float32(0.0), np.float32(0.0), np.float32(0.0), np.float32(1.0), np.float32(0.0), np.float32(1.0), np.float32(0.0), np.float32(1.0), np.float32(1.0), np.float32(1.0), np.float32(1.0), np.float32(1.0), np.float32(0.0)]",-1.0,99647.0,18
2025-08-14_08-18-36,3399,"[np.float32(0.0), np.float32(1.0), np.float32(1.0), np.float32(1.0), np.float32(0.0), np.float32(1.0), np.float32(0.0), np.float32(1.0), np.float32(0.0), np.float32(1.0), np.float32(0.0), np.float32(1.0), np.float32(1.0), np.float32(1.0), np.float32(1.0), np.float32(0.0)]",-1.0,99646.0,31
2025-08-14_08-18-36,3400,"[np.float32(0.0), np.float32(0.0), np.float32(1.0), np.float32(1.0), np.float32(1.0), np.float32(0.0), np.float32(0.0), np.float32(0.0), np.float32(1.0), np.float32(1.0), np.float32(0.0), np.float32(1.0), np.float32(1.0), np.float32(1.0), np.float32(1.0), np.float32(0.0)]",-1.0,99645.0,32
2025-08-14_08-18-36,3401,"[np.float32(1.0), np.float32(0.0), np.float32(1.0), np.float32(0.0), np.float32(0.0), np.float32(0.0), np.float32(1.0), np.float32(1.0), np.float32(1.0), np.float32(0.0), np.float32(1.0), np.float32(1.0), np.float32(1.0), np.float32(0.0), np.float32(0.0), np.float32(1.0)]",-1.0,99644.0,24
2025-08-14_08-18-36,3402,"[np.float32(1.0), np.float32(0.0), np.float32(1.0), np.float32(0.0), np.float32(0.0), np.float32(0.0), np.float32(1.0), np.float32(0.0), np.float32(0.0), np.float32(1.0), np.float32(0.0), np.float32(1.0), np.float32(0.0), np.float32(1.0), np.float32(1.0), np.float32(0.0)]",4.0,99648.0,4
2025-08-14_08-18-36,3403,"[np.float32(1.0), np.float32(1.0), np.float32(0.0), np.float32(0.0), np.float32(1.0), np.float32(1.0), np.float32(1.0), np.float32(0.0), np.float32(1.0), np.float32(0.0), np.float32(1.0), np.float32(1.0), np.float32(0.0), np.float32(1.0), np.float32(1.0), np.float32(0.0)]",3.0,99651.0,36
2025-08-14_08-18-36,3404,"[np.float32(0.0), np.float32(1.0), np.float32(0.0), np.float32(0.0), np.float32(1.0), np.float32(1.0), np.float32(0.0), np.float32(1.0), np.float32(0.0), np.float32(1.0), np.float32(0.0), np.float32(1.0), np.float32(0.0), np.float32(1.0), np.float32(0.0), np.float32(0.0)]",0.0,99651.0,33
2025-08-14_08-18-36,3405,"[np.float32(1.0), np.float32(1.0), np.float32(1.0), np.float32(0.0), np.float32(1.0), np.float32(0.0), np.float32(1.0), np.float32(0.0), np.float32(1.0), np.float32(1.0), np.float32(1.0), np.float32(1.0), np.float32(1.0), np.float32(0.0), np.float32(0.0), np.float32(0.0)]",0.0,99651.0,26
2025-08-14_08-18-36,3406,"[np.float32(0.0), np.float32(0.0), np.float32(1.0), np.float32(1.0), np.float32(0.0), np.float32(0.0), np.float32(0.0), np.float32(1.0), np.float32(0.0), np.float32(0.0), np.float32(1.0), np.float32(0.0), np.float32(1.0), np.float32(0.0), np.float32(0.0), np.float32(1.0)]",-4.0,99647.0,4
2025-08-14_08-18-36,3407,"[np.float32(0.0), np.float32(1.0), np.float32(1.0), np.float32(0.0), np.float32(1.0), np.float32(0.0), np.float32(0.0), np.float32(1.0), np.float32(1.0), np.float32(0.0), np.float32(0.0), np.float32(1.0), np.float32(0.0), np.float32(0.0), np.float32(0.0), np.float32(0.0)]",-4.0,99643.0,7
2025-08-14_08-18-36,3408,"[np.float32(1.0), np.float32(0.0), np.float32(0.0), np.float32(1.0), np.float32(0.0), np.float32(0.0), np.float32(0.0), np.float32(0.0), np.float32(0.0), np.float32(0.0), np.float32(0.0), np.float32(1.0), np.float32(1.0), np.float32(0.0), np.float32(0.0), np.float32(1.0)]",-2.0,99641.0,24
2025-08-14_08-18-36,3409,"[np.float32(1.0), np.float32(1.0), np.float32(0.0), np.float32(0.0), np.float32(0.0), np.float32(1.0), np.float32(0.0), np.float32(1.0), np.float32(0.0), np.float32(0.0), np.float32(0.0), np.float32(1.0), np.float32(1.0), np.float32(0.0), np.float32(0.0), np.float32(1.0)]",1.0,99642.0,9
2025-08-14_08-18-36,3410,"[np.float32(0.0), np.float32(1.0), np.float32(0.0), np.float32(1.0), np.float32(1.0), np.float32(1.0), np.float32(1.0), np.float32(1.0), np.float32(0.0), np.float32(0.0), np.float32(0.0), np.float32(1.0), np.float32(1.0), np.float32(0.0), np.float32(0.0), np.float32(1.0)]",0.0,99642.0,13
2025-08-14_08-18-36,3411,"[np.float32(1.0), np.float32(0.0), np.float32(0.0), np.float32(1.0), np.float32(1.0), np.float32(0.0), np.float32(0.0), np.float32(1.0), np.float32(0.0), np.float32(0.0), np.float32(1.0), np.float32(0.0), np.float32(0.0), np.float32(0.0), np.float32(0.0), np.float32(0.0)]",-3.0,99639.0,10
2025-08-14_08-18-36,3412,"[np.float32(0.0), np.float32(1.0), np.float32(0.0), np.float32(0.0), np.float32(1.0), np.float32(1.0), np.float32(1.0), np.float32(1.0), np.float32(0.0), np.float32(1.0), np.float32(0.0), np.float32(1.0), np.float32(0.0), np.float32(0.0), np.float32(0.0), np.float32(1.0)]",-3.0,99636.0,30
2025-08-14_08-18-36,3413,"[np.float32(1.0), np.float32(1.0), np.float32(0.0), np.float32(1.0), np.float32(0.0), np.float32(0.0), np.float32(1.0), np.float32(1.0), np.float32(1.0), np.float32(0.0), np.float32(1.0), np.float32(1.0), np.float32(1.0), np.float32(0.0), np.float32(1.0), np.float32(0.0)]",-3.0,99633.0,1
2025-08-14_08-18-36,3414,"[np.float32(1.0), np.float32(0.0), np.float32(0.0), np.float32(1.0), np.float32(0.0), np.float32(1.0), np.float32(1.0), np.float32(0.0), np.float32(1.0), np.float32(1.0), np.float32(0.0), np.float32(0.0), np.float32(1.0), np.float32(1.0), np.float32(1.0), np.float32(0.0)]",0.0,99633.0,4
2025-08-14_08-18-36,3415,"[np.float32(0.0), np.float32(0.0), np.float32(0.0), np.float32(1.0), np.float32(1.0), np.float32(0.0), np.float32(1.0), np.float32(1.0), np.float32(0.0), np.float32(1.0), np.float32(0.0), np.float32(0.0), np.float32(0.0), np.float32(1.0), np.float32(1.0), np.float32(0.0)]",1.0,99634.0,8
2025-08-14_08-18-36,3416,"[np.float32(1.0), np.float32(0.0), np.float32(1.0), np.float32(0.0), np.float32(1.0), np.float32(1.0), np.float32(1.0), np.float32(1.0), np.float32(1.0), np.float32(1.0), np.float32(0.0), np.float32(1.0), np.float32(1.0), np.float32(1.0), np.float32(0.0), np.float32(1.0)]",-7.0,99627.0,11
2025-08-14_08-18-36,3417,"[np.float32(0.0), np.float32(1.0), np.float32(0.0), np.float32(0.0), np.float32(0.0), np.float32(0.0), np.float32(1.0), np.float32(1.0), np.float32(1.0), np.float32(0.0), np.float32(0.0), np.float32(0.0), np.float32(0.0), np.float32(0.0), np.float32(0.0), np.float32(0.0)]",-1.0,99626.0,23
2025-08-14_08-18-36,3418,"[np.float32(1.0), np.float32(1.0), np.float32(0.0), np.float32(1.0), np.float32(1.0), np.float32(0.0), np.float32(0.0), np.float32(1.0), np.float32(1.0), np.float32(0.0), np.float32(1.0), np.float32(0.0), np.float32(1.0), np.float32(1.0), np.float32(1.0), np.float32(0.0)]",-3.0,99623.0,4
2025-08-14_08-18-36,3419,"[np.float32(0.0), np.float32(1.0), np.float32(1.0), np.float32(0.0), np.float32(0.0), np.float32(0.0), np.float32(1.0), np.float32(0.0), np.float32(1.0), np.float32(0.0), np.float32(1.0), np.float32(1.0), np.float32(1.0), np.float32(0.0), np.float32(1.0), np.float32(0.0)]",-3.0,99620.0,15
2025-08-14_08-18-36,3420,"[np.float32(0.0), np.float32(0.0), np.float32(1.0), np.float32(1.0), np.float32(0.0), np.float32(0.0), np.float32(0.0), np.float32(0.0), np.float32(1.0), np.float32(1.0), np.float32(0.0), np.float32(0.0), np.float32(0.0), np.float32(0.0), np.float32(1.0), np.float32(1.0)]",5.0,99625.0,34
2025-08-14_08-18-36,3421,"[np.float32(0.0), np.float32(0.0), np.float32(0.0), np.float32(0.0), np.float32(1.0), np.float32(0.0), np.float32(0.0), np.float32(1.0), np.float32(0.0), np.float32(1.0), np.float32(0.0), np.float32(0.0), np.float32(0.0), np.float32(1.0), np.float32(0.0), np.float32(1.0)]",-3.0,99622.0,8
2025-08-14_08-18-36,3422,"[np.float32(0.0), np.float32(0.0), np.float32(1.0), np.float32(0.0), np.float32(1.0), np.float32(0.0), np.float32(0.0), np.float32(1.0), np.float32(1.0), np.float32(1.0), np.float32(1.0), np.float32(1.0), np.float32(1.0), np.float32(0.0), np.float32(1.0), np.float32(1.0)]",1.0,99623.0,13
2025-08-14_08-18-36,3423,"[np.float32(1.0), np.float32(1.0), np.float32(0.0), np.float32(0.0), np.float32(0.0), np.float32(1.0), np.float32(1.0), np.float32(1.0), np.float32(0.0), np.float32(0.0), np.float32(1.0), np.float32(1.0), np.float32(0.0), np.float32(0.0), np.float32(1.0), np.float32(1.0)]",1.0,99624.0,27
2025-08-14_08-18-36,3424,"[np.float32(0.0), np.float32(1.0), np.float32(1.0), np.float32(1.0), np.float32(0.0), np.float32(1.0), np.float32(0.0), np.float32(1.0), np.float32(1.0), np.float32(1.0), np.float32(0.0), np.float32(1.0), np.float32(0.0), np.float32(0.0), np.float32(1.0), np.float32(0.0)]",-1.0,99623.0,18
2025-08-14_08-18-36,3425,"[np.float32(1.0), np.float32(1.0), np.float32(0.0), np.float32(0.0), np.float32(0.0), np.float32(0.0), np.float32(0.0), np.float32(1.0), np.float32(0.0), np.float32(1.0), np.float32(0.0), np.float32(1.0), np.float32(0.0), np.float32(0.0), np.float32(0.0), np.float32(0.0)]",0.0,99623.0,1
2025-08-14_08-18-36,3426,"[np.float32(0.0), np.float32(1.0), np.float32(0.0), np.float32(1.0), np.float32(0.0), np.float32(0.0), np.float32(1.0), np.float32(0.0), np.float32(0.0), np.float32(0.0), np.float32(1.0), np.float32(0.0), np.float32(1.0), np.float32(1.0), np.float32(0.0), np.float32(1.0)]",-5.0,99618.0,27
2025-08-14_08-18-36,3427,"[np.float32(1.0), np.float32(1.0), np.float32(1.0), np.float32(1.0), np.float32(1.0), np.float32(1.0), np.float32(1.0), np.float32(0.0), np.float32(1.0), np.float32(1.0), np.float32(1.0), np.float32(1.0), np.float32(1.0), np.float32(1.0), np.float32(0.0), np.float32(0.0)]",-1.0,99617.0,36
2025-08-14_08-18-36,3428,"[np.float32(0.0), np.float32(0.0), np.float32(1.0), np.float32(0.0), np.float32(1.0), np.float32(1.0), np.float32(1.0), np.float32(1.0), np.float32(1.0), np.float32(0.0), np.float32(0.0), np.float32(1.0), np.float32(0.0), np.float32(1.0), np.float32(1.0), np.float32(1.0)]",3.0,99620.0,18
2025-08-14_08-18-36,3429,"[np.float32(1.0), np.float32(1.0), np.float32(1.0), np.float32(0.0), np.float32(0.0), np.float32(1.0), np.float32(1.0), np.float32(0.0), np.float32(0.0), np.float32(0.0), np.float32(0.0), np.float32(0.0), np.float32(1.0), np.float32(1.0), np.float32(1.0), np.float32(0.0)]",-2.0,99618.0,20
2025-08-14_08-18-36,3430,"[np.float32(1.0), np.float32(0.0), np.float32(0.0), np.float32(1.0), np.float32(1.0), np.float32(1.0), np.float32(1.0), np.float32(0.0), np.float32(0.0), np.float32(0.0), np.float32(1.0), np.float32(0.0), np.float32(0.0), np.float32(1.0), np.float32(0.0), np.float32(1.0)]",4.0,99622.0,3
2025-08-14_08-18-36,3431,"[np.float32(0.0), np.float32(0.0), np.float32(0.0), np.float32(0.0), np.float32(0.0), np.float32(1.0), np.float32(1.0), np.float32(1.0), np.float32(0.0), np.float32(1.0), np.float32(0.0), np.float32(0.0), np.float32(1.0), np.float32(1.0), np.float32(0.0), np.float32(1.0)]",4.0,99626.0,22
2025-08-14_08-18-36,3432,"[np.float32(1.0), np.float32(1.0), np.float32(1.0), np.float32(0.0), np.float32(0.0), np.float32(1.0), np.float32(1.0), np.float32(1.0), np.float32(1.0), np.float32(1.0), np.float32(1.0), np.float32(1.0), np.float32(0.0), np.float32(1.0), np.float32(1.0), np.float32(0.0)]",-2.0,99624.0,6
2025-08-14_08-18-36,3433,"[np.float32(0.0), np.float32(1.0), np.float32(1.0), np.float32(1.0), np.float32(0.0), np.float32(0.0), np.float32(1.0), np.float32(0.0), np.float32(1.0), np.float32(1.0), np.float32(0.0), np.float32(1.0), np.float32(0.0), np.float32(0.0), np.float32(0.0), np.float32(1.0)]",-1.0,99623.0,17
2025-08-14_08-18-36,3434,"[np.float32(1.0), np.float32(0.0), np.float32(1.0), np.float32(0.0), np.float32(0.0), np.float32(0.0), np.float32(1.0), np.float32(0.0), np.float32(0.0), np.float32(1.0), np.float32(0.0), np.float32(1.0), np.float32(1.0), np.float32(0.0), np.float32(0.0), np.float32(0.0)]",-1.0,99622.0,5
2025-08-14_08-18-36,3435,"[np.float32(0.0), np.float32(1.0), np.float32(1.0), np.float32(1.0), np.float32(1.0), np.float32(0.0), np.float32(0.0), np.float32(0.0), np.float32(1.0), np.float32(1.0), np.float32(0.0), np.float32(1.0), np.float32(0.0), np.float32(0.0), np.float32(1.0), np.float32(0.0)]",-1.0,99621.0,7
2025-08-14_08-18-36,3436,"[np.float32(1.0), np.float32(1.0), np.float32(0.0), np.float32(0.0), np.float32(0.0), np.float32(1.0), np.float32(1.0), np.float32(1.0), np.float32(0.0), np.float32(0.0), np.float32(1.0), np.float32(0.0), np.float32(1.0), np.float32(0.0), np.float32(1.0), np.float32(0.0)]",0.0,99621.0,17
2025-08-14_08-18-36,3437,"[np.float32(0.0), np.float32(0.0), np.float32(1.0), np.float32(1.0), np.float32(0.0), np.float32(1.0), np.float32(1.0), np.float32(0.0), np.float32(0.0), np.float32(0.0), np.float32(0.0), np.float32(0.0), np.float32(1.0), np.float32(0.0), np.float32(0.0), np.float32(1.0)]",35.0,99656.0,7
2025-08-14_08-18-36,3438,"[np.float32(1.0), np.float32(0.0), np.float32(1.0), np.float32(1.0), np.float32(0.0), np.float32(1.0), np.float32(0.0), np.float32(0.0), np.float32(1.0), np.float32(0.0), np.float32(1.0), np.float32(1.0), np.float32(0.0), np.float32(1.0), np.float32(1.0), np.float32(1.0)]",0.0,99656.0,12
2025-08-14_08-18-36,3439,"[np.float32(0.0), np.float32(1.0), np.float32(1.0), np.float32(1.0), np.float32(1.0), np.float32(0.0), np.float32(0.0), np.float32(1.0), np.float32(0.0), np.float32(1.0), np.float32(0.0), np.float32(1.0), np.float32(1.0), np.float32(0.0), np.float32(0.0), np.float32(1.0)]",1.0,99657.0,14
2025-08-14_08-18-36,3440,"[np.float32(0.0), np.float32(1.0), np.float32(1.0), np.float32(0.0), np.float32(1.0), np.float32(0.0), np.float32(0.0), np.float32(0.0), np.float32(1.0), np.float32(0.0), np.float32(1.0), np.float32(1.0), np.float32(1.0), np.float32(1.0), np.float32(0.0), np.float32(0.0)]",4.0,99661.0,2
2025-08-14_08-18-36,3441,"[np.float32(0.0), np.float32(1.0), np.float32(0.0), np.float32(1.0), np.float32(0.0), np.float32(1.0), np.float32(0.0), np.float32(1.0), np.float32(1.0), np.float32(0.0), np.float32(1.0), np.float32(1.0), np.float32(1.0), np.float32(0.0), np.float32(1.0), np.float32(1.0)]",-2.0,99659.0,6
2025-08-14_08-18-36,3442,"[np.float32(0.0), np.float32(1.0), np.float32(0.0), np.float32(1.0), np.float32(1.0), np.float32(0.0), np.float32(0.0), np.float32(1.0), np.float32(0.0), np.float32(0.0), np.float32(0.0), np.float32(0.0), np.float32(1.0), np.float32(0.0), np.float32(0.0), np.float32(0.0)]",-5.0,99654.0,34
2025-08-14_08-18-36,3443,"[np.float32(1.0), np.float32(1.0), np.float32(1.0), np.float32(1.0), np.float32(1.0), np.float32(0.0), np.float32(1.0), np.float32(0.0), np.float32(1.0), np.float32(1.0), np.float32(0.0), np.float32(0.0), np.float32(1.0), np.float32(0.0), np.float32(0.0), np.float32(0.0)]",-3.0,99651.0,18
2025-08-14_08-18-36,3444,"[np.float32(1.0), np.float32(1.0), np.float32(0.0), np.float32(0.0), np.float32(0.0), np.float32(0.0), np.float32(1.0), np.float32(0.0), np.float32(1.0), np.float32(1.0), np.float32(1.0), np.float32(1.0), np.float32(1.0), np.float32(0.0), np.float32(1.0), np.float32(0.0)]",-1.0,99650.0,32
2025-08-14_08-18-36,3445,"[np.float32(0.0), np.float32(0.0), np.float32(0.0), np.float32(0.0), np.float32(0.0), np.float32(1.0), np.float32(1.0), np.float32(1.0), np.float32(0.0), np.float32(0.0), np.float32(0.0), np.float32(1.0), np.float32(1.0), np.float32(0.0), np.float32(1.0), np.float32(1.0)]",-4.0,99646.0,2
2025-08-14_08-18-36,3446,"[np.float32(0.0), np.float32(0.0), np.float32(0.0), np.float32(1.0), np.float32(0.0), np.float32(1.0), np.float32(1.0), np.float32(1.0), np.float32(0.0), np.float32(1.0), np.float32(1.0), np.float32(1.0), np.float32(0.0), np.float32(1.0), np.float32(0.0), np.float32(0.0)]",3.0,99649.0,15
2025-08-14_08-18-36,3447,"[np.float32(0.0), np.float32(1.0), np.float32(0.0), np.float32(1.0), np.float32(1.0), np.float32(0.0), np.float32(1.0), np.float32(1.0), np.float32(1.0), np.float32(1.0), np.float32(0.0), np.float32(1.0), np.float32(1.0), np.float32(1.0), np.float32(0.0), np.float32(1.0)]",-6.0,99643.0,23
2025-08-14_08-18-36,3448,"[np.float32(0.0), np.float32(1.0), np.float32(1.0), np.float32(1.0), np.float32(1.0), np.float32(1.0), np.float32(1.0), np.float32(0.0), np.float32(0.0), np.float32(1.0), np.float32(1.0), np.float32(1.0), np.float32(0.0), np.float32(0.0), np.float32(0.0), np.float32(0.0)]",3.0,99646.0,2
2025-08-14_08-18-36,3449,"[np.float32(1.0), np.float32(1.0), np.float32(1.0), np.float32(1.0), np.float32(0.0), np.float32(0.0), np.float32(0.0), np.float32(1.0), np.float32(1.0), np.float32(0.0), np.float32(1.0), np.float32(0.0), np.float32(0.0), np.float32(0.0), np.float32(0.0), np.float32(1.0)]",-1.0,99645.0,5
2025-08-14_08-18-36,3450,"[np.float32(1.0), np.float32(1.0), np.float32(0.0), np.float32(1.0), np.float32(1.0), np.float32(0.0), np.float32(0.0), np.float32(1.0), np.float32(0.0), np.float32(1.0), np.float32(1.0), np.float32(0.0), np.float32(0.0), np.float32(1.0), np.float32(1.0), np.float32(0.0)]",-2.0,99643.0,12
2025-08-14_08-18-36,3451,"[np.float32(0.0), np.float32(1.0), np.float32(0.0), np.float32(0.0), np.float32(1.0), np.float32(1.0), np.float32(1.0), np.float32(1.0), np.float32(1.0), np.float32(0.0), np.float32(1.0), np.float32(1.0), np.float32(1.0), np.float32(1.0), np.float32(1.0), np.float32(0.0)]",0.0,99643.0,12
2025-08-14_08-18-36,3452,"[np.float32(1.0), np.float32(0.0), np.float32(0.0), np.float32(1.0), np.float32(0.0), np.float32(1.0), np.float32(1.0), np.float32(1.0), np.float32(1.0), np.float32(1.0), np.float32(1.0), np.float32(0.0), np.float32(1.0), np.float32(1.0), np.float32(0.0), np.float32(1.0)]",-6.0,99637.0,0
2025-08-14_08-18-36,3453,"[np.float32(1.0), np.float32(1.0), np.float32(0.0), np.float32(1.0), np.float32(1.0), np.float32(1.0), np.float32(1.0), np.float32(0.0), np.float32(0.0), np.float32(1.0), np.float32(0.0), np.float32(0.0), np.float32(1.0), np.float32(1.0), np.float32(0.0), np.float32(1.0)]",-3.0,99634.0,20
2025-08-14_08-18-36,3454,"[np.float32(1.0), np.float32(0.0), np.float32(0.0), np.float32(1.0), np.float32(1.0), np.float32(1.0), np.float32(0.0), np.float32(1.0), np.float32(1.0), np.float32(1.0), np.float32(0.0), np.float32(1.0), np.float32(1.0), np.float32(0.0), np.float32(0.0), np.float32(0.0)]",-4.0,99630.0,10
2025-08-14_08-18-36,3455,"[np.float32(1.0), np.float32(1.0), np.float32(1.0), np.float32(0.0), np.float32(0.0), np.float32(1.0), np.float32(1.0), np.float32(0.0), np.float32(0.0), np.float32(0.0), np.float32(0.0), np.float32(0.0), np.float32(0.0), np.float32(0.0), np.float32(0.0), np.float32(0.0)]",0.0,99630.0,1
2025-08-14_08-18-36,3456,"[np.float32(0.0), np.float32(0.0), np.float32(0.0), np.float32(1.0), np.float32(0.0), np.float32(1.0), np.float32(1.0), np.float32(1.0), np.float32(1.0), np.float32(0.0), np.float32(1.0), np.float32(1.0), np.float32(0.0), np.float32(1.0), np.float32(0.0), np.float32(1.0)]",1.0,99631.0,19
2025-08-14_08-18-36,3457,"[np.float32(0.0), np.float32(0.0), np.float32(0.0), np.float32(1.0), np.float32(0.0), np.float32(0.0), np.float32(0.0), np.float32(1.0), np.float32(0.0), np.float32(1.0), np.float32(0.0), np.float32(1.0), np.float32(1.0), np.float32(0.0), np.float32(0.0), np.float32(1.0)]",0.0,99631.0,18
2025-08-14_08-18-36,3458,"[np.float32(1.0), np.float32(0.0), np.float32(1.0), np.float32(0.0), np.float32(1.0), np.float32(1.0), np.float32(1.0), np.float32(1.0), np.float32(0.0), np.float32(1.0), np.float32(1.0), np.float32(0.0), np.float32(1.0), np.float32(0.0), np.float32(0.0), np.float32(0.0)]",0.0,99631.0,18
2025-08-14_08-18-36,3459,"[np.float32(0.0), np.float32(1.0), np.float32(0.0), np.float32(1.0), np.float32(1.0), np.float32(0.0), np.float32(0.0), np.float32(0.0), np.float32(0.0), np.float32(1.0), np.float32(1.0), np.float32(1.0), np.float32(0.0), np.float32(1.0), np.float32(1.0), np.float32(1.0)]",1.0,99632.0,8
2025-08-14_08-18-36,3460,"[np.float32(1.0), np.float32(0.0), np.float32(1.0), np.float32(1.0), np.float32(0.0), np.float32(0.0), np.float32(1.0), np.float32(1.0), np.float32(0.0), np.float32(0.0), np.float32(1.0), np.float32(0.0), np.float32(1.0), np.float32(1.0), np.float32(0.0), np.float32(0.0)]",0.0,99632.0,15
2025-08-14_08-18-36,3461,"[np.float32(1.0), np.float32(1.0), np.float32(0.0), np.float32(1.0), np.float32(1.0), np.float32(1.0), np.float32(1.0), np.float32(1.0), np.float32(0.0), np.float32(0.0), np.float32(0.0), np.float32(0.0), np.float32(0.0), np.float32(1.0), np.float32(1.0), np.float32(0.0)]",0.0,99632.0,25
2025-08-14_08-18-36,3462,"[np.float32(0.0), np.float32(1.0), np.float32(0.0), np.float32(0.0), np.float32(0.0), np.float32(0.0), np.float32(1.0), np.float32(0.0), np.float32(0.0), np.float32(1.0), np.float32(0.0), np.float32(0.0), np.float32(0.0), np.float32(1.0), np.float32(1.0), np.float32(0.0)]",3.0,99635.0,2
2025-08-14_08-18-36,3463,"[np.float32(1.0), np.float32(1.0), np.float32(1.0), np.float32(1.0), np.float32(0.0), np.float32(0.0), np.float32(1.0), np.float32(1.0), np.float32(1.0), np.float32(1.0), np.float32(0.0), np.float32(0.0), np.float32(0.0), np.float32(0.0), np.float32(1.0), np.float32(0.0)]",4.0,99639.0,13
2025-08-14_08-18-36,3464,"[np.float32(0.0), np.float32(1.0), np.float32(0.0), np.float32(0.0), np.float32(1.0), np.float32(1.0), np.float32(0.0), np.float32(1.0), np.float32(1.0), np.float32(0.0), np.float32(1.0), np.float32(0.0), np.float32(0.0), np.float32(1.0), np.float32(0.0), np.float32(0.0)]",1.0,99640.0,21
2025-08-14_08-18-36,3465,"[np.float32(0.0), np.float32(1.0), np.float32(0.0), np.float32(0.0), np.float32(0.0), np.float32(1.0), np.float32(0.0), np.float32(1.0), np.float32(1.0), np.float32(1.0), np.float32(0.0), np.float32(1.0), np.float32(1.0), np.float32(0.0), np.float32(0.0), np.float32(1.0)]",2.0,99642.0,22
2025-08-14_08-18-36,3466,"[np.float32(0.0), np.float32(1.0), np.float32(1.0), np.float32(0.0), np.float32(0.0), np.float32(0.0), np.float32(0.0), np.float32(1.0), np.float32(0.0), np.float32(0.0), np.float32(0.0), np.float32(1.0), np.float32(0.0), np.float32(1.0), np.float32(0.0), np.float32(1.0)]",0.0,99642.0,9
2025-08-14_08-18-36,3467,"[np.float32(0.0), np.float32(0.0), np.float32(1.0), np.float32(1.0), np.float32(1.0), np.float32(0.0), np.float32(0.0), np.float32(0.0), np.float32(0.0), np.float32(1.0), np.float32(0.0), np.float32(1.0), np.float32(0.0), np.float32(1.0), np.float32(1.0), np.float32(1.0)]",2.0,99644.0,10
2025-08-14_08-18-36,3468,"[np.float32(0.0), np.float32(0.0), np.float32(0.0), np.float32(1.0), np.float32(0.0), np.float32(1.0), np.float32(1.0), np.float32(0.0), np.float32(0.0), np.float32(1.0), np.float32(0.0), np.float32(1.0), np.float32(0.0), np.float32(1.0), np.float32(0.0), np.float32(0.0)]",-4.0,99640.0,20
2025-08-14_08-18-36,3469,"[np.float32(0.0), np.float32(0.0), np.float32(1.0), np.float32(1.0), np.float32(1.0), np.float32(1.0), np.float32(0.0), np.float32(1.0), np.float32(1.0), np.float32(0.0), np.float32(0.0), np.float32(0.0), np.float32(0.0), np.float32(0.0), np.float32(1.0), np.float32(0.0)]",0.0,99640.0,8
2025-08-14_08-18-36,3470,"[np.float32(1.0), np.float32(1.0), np.float32(0.0), np.float32(0.0), np.float32(1.0), np.float32(0.0), np.float32(1.0), np.float32(1.0), np.float32(0.0), np.float32(1.0), np.float32(0.0), np.float32(1.0), np.float32(0.0), np.float32(1.0), np.float32(1.0), np.float32(1.0)]",-2.0,99638.0,27
2025-08-14_08-18-36,3471,"[np.float32(0.0), np.float32(1.0), np.float32(0.0), np.float32(0.0), np.float32(0.0), np.float32(0.0), np.float32(1.0), np.float32(1.0), np.float32(1.0), np.float32(0.0), np.float32(1.0), np.float32(1.0), np.float32(0.0), np.float32(0.0), np.float32(0.0), np.float32(0.0)]",0.0,99638.0,5
2025-08-14_08-18-36,3472,"[np.float32(1.0), np.float32(1.0), np.float32(0.0), np.float32(1.0), np.float32(0.0), np.float32(1.0), np.float32(0.0), np.float32(1.0), np.float32(0.0), np.float32(1.0), np.float32(0.0), np.float32(1.0), np.float32(1.0), np.float32(1.0), np.float32(0.0), np.float32(0.0)]",-2.0,99636.0,34
2025-08-14_08-18-36,3473,"[np.float32(1.0), np.float32(0.0), np.float32(0.0), np.float32(0.0), np.float32(1.0), np.float32(1.0), np.float32(1.0), np.float32(1.0), np.float32(0.0), np.float32(0.0), np.float32(1.0), np.float32(1.0), np.float32(0.0), np.float32(1.0), np.float32(1.0), np.float32(0.0)]",-4.0,99632.0,0
2025-08-14_08-18-36,3474,"[np.float32(0.0), np.float32(1.0), np.float32(1.0), np.float32(1.0), np.float32(0.0), np.float32(0.0), np.float32(0.0), np.float32(1.0), np.float32(1.0), np.float32(1.0), np.float32(0.0), np.float32(0.0), np.float32(1.0), np.float32(0.0), np.float32(1.0), np.float32(0.0)]",0.0,99632.0,27
2025-08-14_08-18-36,3475,"[np.float32(1.0), np.float32(1.0), np.float32(0.0), np.float32(1.0), np.float32(0.0), np.float32(0.0), np.float32(0.0), np.float32(1.0), np.float32(0.0), np.float32(1.0), np.float32(1.0), np.float32(0.0), np.float32(0.0), np.float32(1.0), np.float32(1.0), np.float32(0.0)]",0.0,99632.0,18
2025-08-14_08-18-36,3476,"[np.float32(1.0), np.float32(0.0), np.float32(1.0), np.float32(0.0), np.float32(0.0), np.float32(1.0), np.float32(1.0), np.float32(0.0), np.float32(0.0), np.float32(1.0), np.float32(1.0), np.float32(1.0), np.float32(1.0), np.float32(0.0), np.float32(0.0), np.float32(0.0)]",-1.0,99631.0,18
2025-08-14_08-18-36,3477,"[np.float32(0.0), np.float32(0.0), np.float32(1.0), np.float32(1.0), np.float32(0.0), np.float32(0.0), np.float32(1.0), np.float32(1.0), np.float32(1.0), np.float32(0.0), np.float32(0.0), np.float32(1.0), np.float32(1.0), np.float32(1.0), np.float32(0.0), np.float32(0.0)]",0.0,99631.0,29
2025-08-14_08-18-36,3478,"[np.float32(0.0), np.float32(0.0), np.float32(1.0), np.float32(1.0), np.float32(0.0), np.float32(0.0), np.float32(0.0), np.float32(0.0), np.float32(0.0), np.float32(1.0), np.float32(1.0), np.float32(1.0), np.float32(0.0), np.float32(1.0), np.float32(0.0), np.float32(1.0)]",-2.0,99629.0,10
2025-08-14_08-18-36,3479,"[np.float32(1.0), np.float32(1.0), np.float32(1.0), np.float32(1.0), np.float32(1.0), np.float32(0.0), np.float32(1.0), np.float32(1.0), np.float32(0.0), np.float32(1.0), np.float32(0.0), np.float32(0.0), np.float32(1.0), np.float32(0.0), np.float32(0.0), np.float32(1.0)]",0.0,99629.0,20
2025-08-14_08-18-36,3480,"[np.float32(1.0), np.float32(1.0), np.float32(0.0), np.float32(0.0), np.float32(0.0), np.float32(0.0), np.float32(0.0), np.float32(0.0), np.float32(1.0), np.float32(1.0), np.float32(1.0), np.float32(1.0), np.float32(1.0), np.float32(0.0), np.float32(0.0), np.float32(0.0)]",1.0,99630.0,30
2025-08-14_08-18-36,3481,"[np.float32(1.0), np.float32(0.0), np.float32(0.0), np.float32(1.0), np.float32(0.0), np.float32(0.0), np.float32(0.0), np.float32(1.0), np.float32(0.0), np.float32(1.0), np.float32(0.0), np.float32(0.0), np.float32(1.0), np.float32(0.0), np.float32(0.0), np.float32(1.0)]",2.0,99632.0,13
2025-08-14_08-18-36,3482,"[np.float32(1.0), np.float32(0.0), np.float32(1.0), np.float32(0.0), np.float32(0.0), np.float32(1.0), np.float32(1.0), np.float32(0.0), np.float32(0.0), np.float32(0.0), np.float32(1.0), np.float32(0.0), np.float32(1.0), np.float32(0.0), np.float32(1.0), np.float32(1.0)]",1.0,99633.0,11
2025-08-14_08-18-36,3483,"[np.float32(1.0), np.float32(0.0), np.float32(0.0), np.float32(1.0), np.float32(1.0), np.float32(1.0), np.float32(1.0), np.float32(1.0), np.float32(1.0), np.float32(0.0), np.float32(0.0), np.float32(0.0), np.float32(1.0), np.float32(0.0), np.float32(1.0), np.float32(0.0)]",0.0,99633.0,25
2025-08-14_08-18-36,3484,"[np.float32(1.0), np.float32(1.0), np.float32(1.0), np.float32(0.0), np.float32(1.0), np.float32(0.0), np.float32(0.0), np.float32(0.0), np.float32(1.0), np.float32(0.0), np.float32(1.0), np.float32(0.0), np.float32(1.0), np.float32(0.0), np.float32(0.0), np.float32(1.0)]",-1.0,99632.0,36
2025-08-14_08-18-36,3485,"[np.float32(1.0), np.float32(1.0), np.float32(1.0), np.float32(0.0), np.float32(0.0), np.float32(1.0), np.float32(1.0), np.float32(1.0), np.float32(1.0), np.float32(0.0), np.float32(1.0), np.float32(0.0), np.float32(1.0), np.float32(0.0), np.float32(1.0), np.float32(1.0)]",1.0,99633.0,26
2025-08-14_08-18-36,3486,"[np.float32(1.0), np.float32(0.0), np.float32(0.0), np.float32(1.0), np.float32(0.0), np.float32(1.0), np.float32(0.0), np.float32(1.0), np.float32(0.0), np.float32(0.0), np.float32(0.0), np.float32(1.0), np.float32(0.0), np.float32(1.0), np.float32(0.0), np.float32(0.0)]",1.0,99634.0,7
2025-08-14_08-18-36,3487,"[np.float32(0.0), np.float32(1.0), np.float32(1.0), np.float32(1.0), np.float32(0.0), np.float32(0.0), np.float32(0.0), np.float32(0.0), np.float32(1.0), np.float32(0.0), np.float32(0.0), np.float32(0.0), np.float32(0.0), np.float32(1.0), np.float32(0.0), np.float32(0.0)]",-3.0,99631.0,14
2025-08-14_08-18-36,3488,"[np.float32(0.0), np.float32(0.0), np.float32(0.0), np.float32(1.0), np.float32(1.0), np.float32(1.0), np.float32(1.0), np.float32(0.0), np.float32(1.0), np.float32(1.0), np.float32(1.0), np.float32(1.0), np.float32(0.0), np.float32(1.0), np.float32(0.0), np.float32(0.0)]",4.0,99635.0,3
2025-08-14_08-18-36,3489,"[np.float32(0.0), np.float32(1.0), np.float32(1.0), np.float32(0.0), np.float32(0.0), np.float32(0.0), np.float32(0.0), np.float32(1.0), np.float32(1.0), np.float32(0.0), np.float32(0.0), np.float32(0.0), np.float32(0.0), np.float32(0.0), np.float32(0.0), np.float32(1.0)]",-1.0,99634.0,8
2025-08-14_08-18-36,3490,"[np.float32(0.0), np.float32(1.0), np.float32(0.0), np.float32(0.0), np.float32(1.0), np.float32(1.0), np.float32(0.0), np.float32(1.0), np.float32(1.0), np.float32(1.0), np.float32(0.0), np.float32(0.0), np.float32(0.0), np.float32(0.0), np.float32(1.0), np.float32(1.0)]",0.0,99634.0,36
2025-08-14_08-18-36,3491,"[np.float32(0.0), np.float32(0.0), np.float32(1.0), np.float32(1.0), np.float32(1.0), np.float32(1.0), np.float32(1.0), np.float32(1.0), np.float32(1.0), np.float32(0.0), np.float32(1.0), np.float32(1.0), np.float32(0.0), np.float32(1.0), np.float32(0.0), np.float32(0.0)]",0.0,99634.0,9
2025-08-14_08-18-36,3492,"[np.float32(1.0), np.float32(1.0), np.float32(1.0), np.float32(1.0), np.float32(1.0), np.float32(1.0), np.float32(0.0), np.float32(0.0), np.float32(0.0), np.float32(1.0), np.float32(1.0), np.float32(0.0), np.float32(1.0), np.float32(0.0), np.float32(0.0), np.float32(0.0)]",0.0,99634.0,26
2025-08-14_08-18-36,3493,"[np.float32(1.0), np.float32(1.0), np.float32(1.0), np.float32(0.0), np.float32(0.0), np.float32(1.0), np.float32(0.0), np.float32(1.0), np.float32(1.0), np.float32(1.0), np.float32(0.0), np.float32(0.0), np.float32(1.0), np.float32(0.0), np.float32(1.0), np.float32(0.0)]",4.0,99638.0,16
2025-08-14_08-18-36,3494,"[np.float32(0.0), np.float32(1.0), np.float32(0.0), np.float32(1.0), np.float32(0.0), np.float32(0.0), np.float32(1.0), np.float32(1.0), np.float32(0.0), np.float32(1.0), np.float32(1.0), np.float32(1.0), np.float32(0.0), np.float32(1.0), np.float32(0.0), np.float32(0.0)]",3.0,99641.0,3
2025-08-14_08-18-36,3495,"[np.float32(1.0), np.float32(0.0), np.float32(0.0), np.float32(0.0), np.float32(0.0), np.float32(0.0), np.float32(1.0), np.float32(1.0), np.float32(0.0), np.float32(1.0), np.float32(0.0), np.float32(1.0), np.float32(0.0), np.float32(0.0), np.float32(1.0), np.float32(0.0)]",3.0,99644.0,24
2025-08-14_08-18-36,3496,"[np.float32(1.0), np.float32(0.0), np.float32(1.0), np.float32(1.0), np.float32(1.0), np.float32(1.0), np.float32(1.0), np.float32(1.0), np.float32(1.0), np.float32(1.0), np.float32(1.0), np.float32(0.0), np.float32(0.0), np.float32(0.0), np.float32(1.0), np.float32(1.0)]",1.0,99645.0,31
2025-08-14_08-18-36,3497,"[np.float32(0.0), np.float32(0.0), np.float32(1.0), np.float32(0.0), np.float32(0.0), np.float32(1.0), np.float32(0.0), np.float32(0.0), np.float32(0.0), np.float32(1.0), np.float32(0.0), np.float32(1.0), np.float32(0.0), np.float32(0.0), np.float32(0.0), np.float32(0.0)]",-1.0,99644.0,15
2025-08-14_08-18-36,3498,"[np.float32(1.0), np.float32(0.0), np.float32(1.0), np.float32(0.0), np.float32(1.0), np.float32(0.0), np.float32(1.0), np.float32(0.0), np.float32(0.0), np.float32(0.0), np.float32(1.0), np.float32(1.0), np.float32(1.0), np.float32(0.0), np.float32(0.0), np.float32(0.0)]",-2.0,99642.0,17
2025-08-14_08-18-36,3499,"[np.float32(1.0), np.float32(0.0), np.float32(1.0), np.float32(1.0), np.float32(0.0), np.float32(1.0), np.float32(1.0), np.float32(1.0), np.float32(1.0), np.float32(1.0), np.float32(0.0), np.float32(0.0), np.float32(0.0), np.float32(1.0), np.float32(0.0), np.float32(0.0)]",2.0,99644.0,4
2025-08-14_08-18-36,3500,"[np.float32(1.0), np.float32(0.0), np.float32(0.0), np.float32(0.0), np.float32(0.0), np.float32(1.0), np.float32(1.0), np.float32(1.0), np.float32(0.0), np.float32(1.0), np.float32(1.0), np.float32(1.0), np.float32(1.0), np.float32(1.0), np.float32(1.0), np.float32(1.0)]",-2.0,99642.0,11
2025-08-14_08-18-36,3501,"[np.float32(1.0), np.float32(1.0), np.float32(1.0), np.float32(0.0), np.float32(1.0), np.float32(1.0), np.float32(1.0), np.float32(1.0), np.float32(0.0), np.float32(0.0), np.float32(1.0), np.float32(1.0), np.float32(1.0), np.float32(0.0), np.float32(0.0), np.float32(1.0)]",-4.0,99638.0,35
2025-08-14_08-18-36,3502,"[np.float32(0.0), np.float32(0.0), np.float32(0.0), np.float32(1.0), np.float32(1.0), np.float32(1.0), np.float32(1.0), np.float32(1.0), np.float32(0.0), np.float32(1.0), np.float32(1.0), np.float32(1.0), np.float32(1.0), np.float32(1.0), np.float32(0.0), np.float32(0.0)]",-2.0,99636.0,32
2025-08-14_08-18-36,3503,"[np.float32(0.0), np.float32(1.0), np.float32(1.0), np.float32(1.0), np.float32(1.0), np.float32(0.0), np.float32(1.0), np.float32(0.0), np.float32(0.0), np.float32(0.0), np.float32(1.0), np.float32(0.0), np.float32(0.0), np.float32(1.0), np.float32(1.0), np.float32(0.0)]",-3.0,99633.0,27
2025-08-14_08-18-36,3504,"[np.float32(0.0), np.float32(0.0), np.float32(1.0), np.float32(1.0), np.float32(0.0), np.float32(1.0), np.float32(1.0), np.float32(0.0), np.float32(1.0), np.float32(0.0), np.float32(0.0), np.float32(1.0), np.float32(0.0), np.float32(0.0), np.float32(0.0), np.float32(0.0)]",-1.0,99632.0,4
2025-08-14_08-18-36,3505,"[np.float32(1.0), np.float32(1.0), np.float32(0.0), np.float32(0.0), np.float32(1.0), np.float32(0.0), np.float32(0.0), np.float32(0.0), np.float32(0.0), np.float32(0.0), np.float32(1.0), np.float32(0.0), np.float32(0.0), np.float32(1.0), np.float32(0.0), np.float32(0.0)]",2.0,99634.0,17
2025-08-14_08-18-36,3506,"[np.float32(0.0), np.float32(1.0), np.float32(1.0), np.float32(1.0), np.float32(1.0), np.float32(1.0), np.float32(0.0), np.float32(1.0), np.float32(0.0), np.float32(1.0), np.float32(1.0), np.float32(1.0), np.float32(1.0), np.float32(1.0), np.float32(0.0), np.float32(0.0)]",1.0,99635.0,13
2025-08-14_08-18-36,3507,"[np.float32(1.0), np.float32(1.0), np.float32(1.0), np.float32(1.0), np.float32(0.0), np.float32(0.0), np.float32(0.0), np.float32(1.0), np.float32(1.0), np.float32(1.0), np.float32(1.0), np.float32(0.0), np.float32(1.0), np.float32(0.0), np.float32(1.0), np.float32(1.0)]",-1.0,99634.0,28
2025-08-14_08-18-36,3508,"[np.float32(1.0), np.float32(1.0), np.float32(0.0), np.float32(0.0), np.float32(0.0), np.float32(1.0), np.float32(1.0), np.float32(1.0), np.float32(0.0), np.float32(1.0), np.float32(0.0), np.float32(1.0), np.float32(1.0), np.float32(0.0), np.float32(0.0), np.float32(0.0)]",0.0,99634.0,6
2025-08-14_08-18-36,3509,"[np.float32(1.0), np.float32(1.0), np.float32(0.0), np.float32(1.0), np.float32(0.0), np.float32(0.0), np.float32(0.0), np.float32(1.0), np.float32(1.0), np.float32(1.0), np.float32(1.0), np.float32(1.0), np.float32(1.0), np.float32(1.0), np.float32(0.0), np.float32(0.0)]",-5.0,99629.0,8
2025-08-14_08-18-36,3510,"[np.float32(1.0), np.float32(0.0), np.float32(0.0), np.float32(1.0), np.float32(0.0), np.float32(0.0), np.float32(1.0), np.float32(1.0), np.float32(0.0), np.float32(0.0), np.float32(0.0), np.float32(1.0), np.float32(1.0), np.float32(0.0), np.float32(0.0), np.float32(1.0)]",-5.0,99624.0,32
2025-08-14_08-18-36,3511,"[np.float32(1.0), np.float32(1.0), np.float32(0.0), np.float32(1.0), np.float32(0.0), np.float32(1.0), np.float32(1.0), np.float32(1.0), np.float32(1.0), np.float32(0.0), np.float32(1.0), np.float32(0.0), np.float32(0.0), np.float32(0.0), np.float32(0.0), np.float32(0.0)]",-4.0,99620.0,0
2025-08-14_08-18-36,3512,"[np.float32(0.0), np.float32(1.0), np.float32(0.0), np.float32(1.0), np.float32(0.0), np.float32(1.0), np.float32(0.0), np.float32(1.0), np.float32(0.0), np.float32(0.0), np.float32(0.0), np.float32(0.0), np.float32(0.0), np.float32(0.0), np.float32(0.0), np.float32(0.0)]",3.0,99623.0,20
2025-08-14_08-18-36,3513,"[np.float32(1.0), np.float32(1.0), np.float32(1.0), np.float32(1.0), np.float32(0.0), np.float32(1.0), np.float32(1.0), np.float32(0.0), np.float32(0.0), np.float32(0.0), np.float32(1.0), np.float32(0.0), np.float32(1.0), np.float32(1.0), np.float32(0.0), np.float32(0.0)]",1.0,99624.0,4
2025-08-14_08-18-36,3514,"[np.float32(1.0), np.float32(0.0), np.float32(0.0), np.float32(1.0), np.float32(0.0), np.float32(1.0), np.float32(1.0), np.float32(1.0), np.float32(1.0), np.float32(0.0), np.float32(0.0), np.float32(1.0), np.float32(0.0), np.float32(1.0), np.float32(1.0), np.float32(0.0)]",-4.0,99620.0,20
2025-08-14_08-18-36,3515,"[np.float32(0.0), np.float32(1.0), np.float32(0.0), np.float32(0.0), np.float32(0.0), np.float32(1.0), np.float32(0.0), np.float32(1.0), np.float32(1.0), np.float32(1.0), np.float32(0.0), np.float32(0.0), np.float32(1.0), np.float32(0.0), np.float32(1.0), np.float32(1.0)]",5.0,99625.0,31
2025-08-14_08-18-36,3516,"[np.float32(0.0), np.float32(1.0), np.float32(0.0), np.float32(0.0), np.float32(1.0), np.float32(0.0), np.float32(1.0), np.float32(0.0), np.float32(0.0), np.float32(0.0), np.float32(1.0), np.float32(1.0), np.float32(0.0), np.float32(0.0), np.float32(0.0), np.float32(0.0)]",-3.0,99622.0,31
2025-08-14_08-18-36,3517,"[np.float32(1.0), np.float32(0.0), np.float32(0.0), np.float32(1.0), np.float32(1.0), np.float32(0.0), np.float32(0.0), np.float32(0.0), np.float32(1.0), np.float32(0.0), np.float32(0.0), np.float32(1.0), np.float32(0.0), np.float32(0.0), np.float32(0.0), np.float32(0.0)]",-1.0,99621.0,19
2025-08-14_08-18-36,3518,"[np.float32(0.0), np.float32(0.0), np.float32(0.0), np.float32(1.0), np.float32(0.0), np.float32(0.0), np.float32(0.0), np.float32(1.0), np.float32(0.0), np.float32(0.0), np.float32(0.0), np.float32(1.0), np.float32(1.0), np.float32(0.0), np.float32(1.0), np.float32(0.0)]",-3.0,99618.0,25
2025-08-14_08-18-36,3519,"[np.float32(0.0), np.float32(1.0), np.float32(0.0), np.float32(1.0), np.float32(0.0), np.float32(0.0), np.float32(1.0), np.float32(0.0), np.float32(1.0), np.float32(0.0), np.float32(1.0), np.float32(0.0), np.float32(0.0), np.float32(0.0), np.float32(0.0), np.float32(1.0)]",-2.0,99616.0,13
2025-08-14_08-18-36,3520,"[np.float32(1.0), np.float32(0.0), np.float32(0.0), np.float32(1.0), np.float32(1.0), np.float32(1.0), np.float32(1.0), np.float32(0.0), np.float32(0.0), np.float32(0.0), np.float32(1.0), np.float32(0.0), np.float32(1.0), np.float32(0.0), np.float32(0.0), np.float32(0.0)]",-2.0,99614.0,26
2025-08-14_08-18-36,3521,"[np.float32(1.0), np.float32(0.0), np.float32(1.0), np.float32(1.0), np.float32(0.0), np.float32(1.0), np.float32(1.0), np.float32(0.0), np.float32(0.0), np.float32(1.0), np.float32(1.0), np.float32(1.0), np.float32(0.0), np.float32(1.0), np.float32(0.0), np.float32(0.0)]",1.0,99615.0,9
2025-08-14_08-18-36,3522,"[np.float32(0.0), np.float32(1.0), np.float32(0.0), np.float32(0.0), np.float32(1.0), np.float32(0.0), np.float32(0.0), np.float32(0.0), np.float32(0.0), np.float32(0.0), np.float32(0.0), np.float32(0.0), np.float32(1.0), np.float32(0.0), np.float32(1.0), np.float32(1.0)]",-3.0,99612.0,0
2025-08-14_08-18-36,3523,"[np.float32(1.0), np.float32(1.0), np.float32(1.0), np.float32(1.0), np.float32(1.0), np.float32(0.0), np.float32(1.0), np.float32(0.0), np.float32(0.0), np.float32(1.0), np.float32(0.0), np.float32(1.0), np.float32(0.0), np.float32(0.0), np.float32(1.0), np.float32(0.0)]",3.0,99615.0,11
2025-08-14_08-18-36,3524,"[np.float32(1.0), np.float32(0.0), np.float32(1.0), np.float32(0.0), np.float32(0.0), np.float32(0.0), np.float32(0.0), np.float32(1.0), np.float32(1.0), np.float32(0.0), np.float32(1.0), np.float32(1.0), np.float32(0.0), np.float32(0.0), np.float32(0.0), np.float32(0.0)]",-4.0,99611.0,7
2025-08-14_08-18-36,3525,"[np.float32(1.0), np.float32(1.0), np.float32(0.0), np.float32(0.0), np.float32(0.0), np.float32(1.0), np.float32(0.0), np.float32(0.0), np.float32(0.0), np.float32(0.0), np.float32(0.0), np.float32(0.0), np.float32(1.0), np.float32(0.0), np.float32(1.0), np.float32(1.0)]",1.0,99612.0,36
2025-08-14_08-18-36,3526,"[np.float32(0.0), np.float32(0.0), np.float32(1.0), np.float32(1.0), np.float32(1.0), np.float32(0.0), np.float32(1.0), np.float32(0.0), np.float32(1.0), np.float32(1.0), np.float32(1.0), np.float32(0.0), np.float32(0.0), np.float32(0.0), np.float32(0.0), np.float32(0.0)]",3.0,99615.0,5
2025-08-14_08-18-36,3527,"[np.float32(0.0), np.float32(0.0), np.float32(1.0), np.float32(0.0), np.float32(1.0), np.float32(1.0), np.float32(1.0), np.float32(1.0), np.float32(1.0), np.float32(1.0), np.float32(1.0), np.float32(1.0), np.float32(0.0), np.float32(0.0), np.float32(0.0), np.float32(0.0)]",-1.0,99614.0,5
2025-08-14_08-18-36,3528,"[np.float32(0.0), np.float32(0.0), np.float32(1.0), np.float32(0.0), np.float32(0.0), np.float32(1.0), np.float32(0.0), np.float32(1.0), np.float32(0.0), np.float32(0.0), np.float32(1.0), np.float32(1.0), np.float32(1.0), np.float32(0.0), np.float32(0.0), np.float32(0.0)]",1.0,99615.0,36
2025-08-14_08-18-36,3529,"[np.float32(1.0), np.float32(1.0), np.float32(1.0), np.float32(0.0), np.float32(1.0), np.float32(1.0), np.float32(1.0), np.float32(1.0), np.float32(0.0), np.float32(0.0), np.float32(0.0), np.float32(1.0), np.float32(0.0), np.float32(1.0), np.float32(0.0), np.float32(1.0)]",2.0,99617.0,2
2025-08-14_08-18-36,3530,"[np.float32(1.0), np.float32(0.0), np.float32(0.0), np.float32(0.0), np.float32(0.0), np.float32(1.0), np.float32(0.0), np.float32(1.0), np.float32(0.0), np.float32(1.0), np.float32(1.0), np.float32(0.0), np.float32(0.0), np.float32(1.0), np.float32(1.0), np.float32(0.0)]",4.0,99621.0,16
2025-08-14_08-18-36,3531,"[np.float32(1.0), np.float32(1.0), np.float32(0.0), np.float32(0.0), np.float32(1.0), np.float32(1.0), np.float32(1.0), np.float32(1.0), np.float32(1.0), np.float32(0.0), np.float32(0.0), np.float32(0.0), np.float32(0.0), np.float32(1.0), np.float32(0.0), np.float32(0.0)]",-1.0,99620.0,33
2025-08-14_08-18-36,3532,"[np.float32(1.0), np.float32(0.0), np.float32(1.0), np.float32(0.0), np.float32(1.0), np.float32(1.0), np.float32(0.0), np.float32(1.0), np.float32(1.0), np.float32(0.0), np.float32(0.0), np.float32(1.0), np.float32(1.0), np.float32(1.0), np.float32(0.0), np.float32(0.0)]",0.0,99620.0,14
2025-08-14_08-18-36,3533,"[np.float32(1.0), np.float32(1.0), np.float32(0.0), np.float32(0.0), np.float32(1.0), np.float32(1.0), np.float32(1.0), np.float32(0.0), np.float32(1.0), np.float32(1.0), np.float32(1.0), np.float32(0.0), np.float32(0.0), np.float32(0.0), np.float32(1.0), np.float32(1.0)]",0.0,99620.0,32
2025-08-14_08-18-36,3534,"[np.float32(0.0), np.float32(1.0), np.float32(0.0), np.float32(1.0), np.float32(1.0), np.float32(1.0), np.float32(0.0), np.float32(1.0), np.float32(1.0), np.float32(0.0), np.float32(1.0), np.float32(1.0), np.float32(0.0), np.float32(1.0), np.float32(0.0), np.float32(1.0)]",0.0,99620.0,2
2025-08-14_08-18-36,3535,"[np.float32(1.0), np.float32(0.0), np.float32(1.0), np.float32(1.0), np.float32(0.0), np.float32(1.0), np.float32(1.0), np.float32(0.0), np.float32(1.0), np.float32(0.0), np.float32(0.0), np.float32(1.0), np.float32(1.0), np.float32(0.0), np.float32(0.0), np.float32(0.0)]",1.0,99621.0,34
2025-08-14_08-18-36,3536,"[np.float32(1.0), np.float32(0.0), np.float32(1.0), np.float32(1.0), np.float32(1.0), np.float32(0.0), np.float32(1.0), np.float32(1.0), np.float32(1.0), np.float32(1.0), np.float32(1.0), np.float32(1.0), np.float32(0.0), np.float32(1.0), np.float32(0.0), np.float32(0.0)]",0.0,99621.0,28
2025-08-14_08-18-36,3537,"[np.float32(0.0), np.float32(0.0), np.float32(0.0), np.float32(0.0), np.float32(1.0), np.float32(0.0), np.float32(0.0), np.float32(0.0), np.float32(0.0), np.float32(0.0), np.float32(1.0), np.float32(0.0), np.float32(0.0), np.float32(0.0), np.float32(0.0), np.float32(1.0)]",5.0,99626.0,14
2025-08-14_08-18-36,3538,"[np.float32(0.0), np.float32(0.0), np.float32(1.0), np.float32(1.0), np.float32(0.0), np.float32(1.0), np.float32(0.0), np.float32(0.0), np.float32(1.0), np.float32(1.0), np.float32(0.0), np.float32(0.0), np.float32(0.0), np.float32(0.0), np.float32(1.0), np.float32(0.0)]",2.0,99628.0,13
2025-08-14_08-18-36,3539,"[np.float32(0.0), np.float32(0.0), np.float32(1.0), np.float32(0.0), np.float32(1.0), np.float32(1.0), np.float32(0.0), np.float32(0.0), np.float32(0.0), np.float32(1.0), np.float32(1.0), np.float32(1.0), np.float32(0.0), np.float32(0.0), np.float32(0.0), np.float32(0.0)]",-1.0,99627.0,33
2025-08-14_08-18-36,3540,"[np.float32(1.0), np.float32(0.0), np.float32(0.0), np.float32(0.0), np.float32(0.0), np.float32(1.0), np.float32(1.0), np.float32(1.0), np.float32(1.0), np.float32(1.0), np.float32(0.0), np.float32(1.0), np.float32(0.0), np.float32(0.0), np.float32(1.0), np.float32(0.0)]",-6.0,99621.0,0
2025-08-14_08-18-36,3541,"[np.float32(1.0), np.float32(1.0), np.float32(0.0), np.float32(1.0), np.float32(1.0), np.float32(1.0), np.float32(1.0), np.float32(1.0), np.float32(1.0), np.float32(0.0), np.float32(1.0), np.float32(1.0), np.float32(0.0), np.float32(0.0), np.float32(0.0), np.float32(0.0)]",2.0,99623.0,35
2025-08-14_08-18-36,3542,"[np.float32(0.0), np.float32(1.0), np.float32(1.0), np.float32(1.0), np.float32(0.0), np.float32(1.0), np.float32(0.0), np.float32(0.0), np.float32(1.0), np.float32(1.0), np.float32(0.0), np.float32(0.0), np.float32(1.0), np.float32(1.0), np.float32(1.0), np.float32(0.0)]",-2.0,99621.0,23
2025-08-14_08-18-36,3543,"[np.float32(1.0), np.float32(0.0), np.float32(0.0), np.float32(0.0), np.float32(1.0), np.float32(1.0), np.float32(1.0), np.float32(0.0), np.float32(0.0), np.float32(0.0), np.float32(1.0), np.float32(0.0), np.float32(1.0), np.float32(1.0), np.float32(1.0), np.float32(0.0)]",-1.0,99620.0,1
2025-08-14_08-18-36,3544,"[np.float32(0.0), np.float32(0.0), np.float32(1.0), np.float32(0.0), np.float32(0.0), np.float32(1.0), np.float32(1.0), np.float32(0.0), np.float32(1.0), np.float32(1.0), np.float32(1.0), np.float32(0.0), np.float32(1.0), np.float32(0.0), np.float32(0.0), np.float32(0.0)]",-2.0,99618.0,16
2025-08-14_08-18-36,3545,"[np.float32(1.0), np.float32(1.0), np.float32(0.0), np.float32(0.0), np.float32(0.0), np.float32(1.0), np.float32(1.0), np.float32(1.0), np.float32(0.0), np.float32(1.0), np.float32(1.0), np.float32(0.0), np.float32(1.0), np.float32(1.0), np.float32(0.0), np.float32(0.0)]",-2.0,99616.0,0
2025-08-14_08-18-36,3546,"[np.float32(0.0), np.float32(0.0), np.float32(0.0), np.float32(0.0), np.float32(1.0), np.float32(0.0), np.float32(1.0), np.float32(0.0), np.float32(0.0), np.float32(1.0), np.float32(0.0), np.float32(0.0), np.float32(0.0), np.float32(0.0), np.float32(1.0), np.float32(1.0)]",0.0,99616.0,2
2025-08-14_08-18-36,3547,"[np.float32(0.0), np.float32(1.0), np.float32(1.0), np.float32(0.0), np.float32(1.0), np.float32(1.0), np.float32(0.0), np.float32(0.0), np.float32(0.0), np.float32(0.0), np.float32(1.0), np.float32(0.0), np.float32(1.0), np.float32(0.0), np.float32(1.0), np.float32(1.0)]",-1.0,99615.0,13
2025-08-14_08-18-36,3548,"[np.float32(0.0), np.float32(0.0), np.float32(0.0), np.float32(0.0), np.float32(1.0), np.float32(0.0), np.float32(1.0), np.float32(0.0), np.float32(0.0), np.float32(0.0), np.float32(1.0), np.float32(0.0), np.float32(1.0), np.float32(0.0), np.float32(0.0), np.float32(1.0)]",-5.0,99610.0,22
2025-08-14_08-18-36,3549,"[np.float32(1.0), np.float32(1.0), np.float32(0.0), np.float32(1.0), np.float32(0.0), np.float32(1.0), np.float32(0.0), np.float32(1.0), np.float32(0.0), np.float32(1.0), np.float32(1.0), np.float32(1.0), np.float32(0.0), np.float32(1.0), np.float32(0.0), np.float32(1.0)]",-3.0,99607.0,5
2025-08-14_08-18-36,3550,"[np.float32(0.0), np.float32(1.0), np.float32(1.0), np.float32(0.0), np.float32(0.0), np.float32(1.0), np.float32(0.0), np.float32(0.0), np.float32(0.0), np.float32(1.0), np.float32(1.0), np.float32(0.0), np.float32(1.0), np.float32(1.0), np.float32(0.0), np.float32(1.0)]",4.0,99611.0,22
2025-08-14_08-18-36,3551,"[np.float32(0.0), np.float32(1.0), np.float32(0.0), np.float32(0.0), np.float32(1.0), np.float32(0.0), np.float32(1.0), np.float32(1.0), np.float32(0.0), np.float32(0.0), np.float32(1.0), np.float32(1.0), np.float32(1.0), np.float32(0.0), np.float32(1.0), np.float32(0.0)]",33.0,99644.0,7
2025-08-14_08-18-36,3552,"[np.float32(1.0), np.float32(1.0), np.float32(1.0), np.float32(0.0), np.float32(0.0), np.float32(0.0), np.float32(0.0), np.float32(0.0), np.float32(1.0), np.float32(1.0), np.float32(1.0), np.float32(0.0), np.float32(0.0), np.float32(0.0), np.float32(0.0), np.float32(1.0)]",1.0,99645.0,29
2025-08-14_08-18-36,3553,"[np.float32(0.0), np.float32(1.0), np.float32(0.0), np.float32(0.0), np.float32(0.0), np.float32(1.0), np.float32(0.0), np.float32(1.0), np.float32(0.0), np.float32(0.0), np.float32(1.0), np.float32(1.0), np.float32(0.0), np.float32(0.0), np.float32(0.0), np.float32(0.0)]",2.0,99647.0,33
2025-08-14_08-18-36,3554,"[np.float32(0.0), np.float32(1.0), np.float32(1.0), np.float32(1.0), np.float32(0.0), np.float32(1.0), np.float32(0.0), np.float32(1.0), np.float32(1.0), np.float32(1.0), np.float32(1.0), np.float32(0.0), np.float32(0.0), np.float32(1.0), np.float32(0.0), np.float32(0.0)]",3.0,99650.0,31
2025-08-14_08-18-36,3555,"[np.float32(1.0), np.float32(0.0), np.float32(1.0), np.float32(1.0), np.float32(0.0), np.float32(1.0), np.float32(0.0), np.float32(0.0), np.float32(0.0), np.float32(1.0), np.float32(0.0), np.float32(1.0), np.float32(1.0), np.float32(1.0), np.float32(1.0), np.float32(0.0)]",1.0,99651.0,24
2025-08-14_08-18-36,3556,"[np.float32(1.0), np.float32(1.0), np.float32(1.0), np.float32(1.0), np.float32(0.0), np.float32(0.0), np.float32(0.0), np.float32(0.0), np.float32(0.0), np.float32(0.0), np.float32(0.0), np.float32(0.0), np.float32(1.0), np.float32(1.0), np.float32(1.0), np.float32(1.0)]",-1.0,99650.0,35
2025-08-14_08-18-36,3557,"[np.float32(1.0), np.float32(1.0), np.float32(0.0), np.float32(1.0), np.float32(1.0), np.float32(1.0), np.float32(1.0), np.float32(1.0), np.float32(0.0), np.float32(1.0), np.float32(0.0), np.float32(1.0), np.float32(1.0), np.float32(0.0), np.float32(0.0), np.float32(0.0)]",2.0,99652.0,21
2025-08-14_08-18-36,3558,"[np.float32(1.0), np.float32(0.0), np.float32(0.0), np.float32(0.0), np.float32(0.0), np.float32(1.0), np.float32(1.0), np.float32(0.0), np.float32(1.0), np.float32(0.0), np.float32(0.0), np.float32(0.0), np.float32(1.0), np.float32(1.0), np.float32(0.0), np.float32(0.0)]",-1.0,99651.0,0
2025-08-14_08-18-36,3559,"[np.float32(0.0), np.float32(0.0), np.float32(1.0), np.float32(1.0), np.float32(1.0), np.float32(1.0), np.float32(0.0), np.float32(1.0), np.float32(0.0), np.float32(0.0), np.float32(0.0), np.float32(1.0), np.float32(1.0), np.float32(0.0), np.float32(1.0), np.float32(1.0)]",-5.0,99646.0,32
2025-08-14_08-18-36,3560,"[np.float32(1.0), np.float32(1.0), np.float32(0.0), np.float32(0.0), np.float32(0.0), np.float32(1.0), np.float32(0.0), np.float32(0.0), np.float32(0.0), np.float32(1.0), np.float32(0.0), np.float32(0.0), np.float32(1.0), np.float32(1.0), np.float32(0.0), np.float32(1.0)]",-2.0,99644.0,15
2025-08-14_08-18-36,3561,"[np.float32(1.0), np.float32(0.0), np.float32(0.0), np.float32(0.0), np.float32(0.0), np.float32(1.0), np.float32(1.0), np.float32(0.0), np.float32(0.0), np.float32(1.0), np.float32(1.0), np.float32(0.0), np.float32(0.0), np.float32(0.0), np.float32(0.0), np.float32(1.0)]",-1.0,99643.0,22
2025-08-14_08-18-36,3562,"[np.float32(1.0), np.float32(1.0), np.float32(1.0), np.float32(1.0), np.float32(1.0), np.float32(1.0), np.float32(1.0), np.float32(1.0), np.float32(0.0), np.float32(0.0), np.float32(1.0), np.float32(1.0), np.float32(0.0), np.float32(1.0), np.float32(0.0), np.float32(0.0)]",4.0,99647.0,18
2025-08-14_08-18-36,3563,"[np.float32(1.0), np.float32(1.0), np.float32(0.0), np.float32(1.0), np.float32(1.0), np.float32(1.0), np.float32(1.0), np.float32(1.0), np.float32(0.0), np.float32(1.0), np.float32(1.0), np.float32(0.0), np.float32(0.0), np.float32(0.0), np.float32(0.0), np.float32(1.0)]",0.0,99647.0,16
2025-08-14_08-18-36,3564,"[np.float32(0.0), np.float32(0.0), np.float32(1.0), np.float32(0.0), np.float32(0.0), np.float32(0.0), np.float32(1.0), np.float32(0.0), np.float32(0.0), np.float32(0.0), np.float32(0.0), np.float32(1.0), np.float32(0.0), np.float32(1.0), np.float32(0.0), np.float32(1.0)]",0.0,99647.0,22
2025-08-14_08-18-36,3565,"[np.float32(0.0), np.float32(0.0), np.float32(1.0), np.float32(0.0), np.float32(0.0), np.float32(1.0), np.float32(0.0), np.float32(0.0), np.float32(1.0), np.float32(0.0), np.float32(1.0), np.float32(0.0), np.float32(1.0), np.float32(0.0), np.float32(0.0), np.float32(0.0)]",-1.0,99646.0,0
2025-08-14_08-18-36,3566,"[np.float32(0.0), np.float32(0.0), np.float32(1.0), np.float32(1.0), np.float32(0.0), np.float32(0.0), np.float32(1.0), np.float32(0.0), np.float32(1.0), np.float32(1.0), np.float32(1.0), np.float32(1.0), np.float32(0.0), np.float32(1.0), np.float32(1.0), np.float32(0.0)]",2.0,99648.0,28
2025-08-14_08-18-36,3567,"[np.float32(0.0), np.float32(1.0), np.float32(1.0), np.float32(0.0), np.float32(1.0), np.float32(0.0), np.float32(1.0), np.float32(1.0), np.float32(1.0), np.float32(1.0), np.float32(1.0), np.float32(1.0), np.float32(1.0), np.float32(0.0), np.float32(1.0), np.float32(0.0)]",-5.0,99643.0,21
2025-08-14_08-18-36,3568,"[np.float32(0.0), np.float32(0.0), np.float32(0.0), np.float32(1.0), np.float32(0.0), np.float32(0.0), np.float32(1.0), np.float32(1.0), np.float32(0.0), np.float32(0.0), np.float32(1.0), np.float32(0.0), np.float32(0.0), np.float32(0.0), np.float32(0.0), np.float32(0.0)]",-1.0,99642.0,12
2025-08-14_08-18-36,3569,"[np.float32(1.0), np.float32(1.0), np.float32(0.0), np.float32(1.0), np.float32(1.0), np.float32(1.0), np.float32(0.0), np.float32(0.0), np.float32(1.0), np.float32(1.0), np.float32(1.0), np.float32(1.0), np.float32(1.0), np.float32(1.0), np.float32(1.0), np.float32(1.0)]",-1.0,99641.0,15
2025-08-14_08-18-36,3570,"[np.float32(1.0), np.float32(0.0), np.float32(1.0), np.float32(0.0), np.float32(1.0), np.float32(1.0), np.float32(0.0), np.float32(1.0), np.float32(1.0), np.float32(1.0), np.float32(1.0), np.float32(0.0), np.float32(0.0), np.float32(1.0), np.float32(1.0), np.float32(0.0)]",-2.0,99639.0,31
2025-08-14_08-18-36,3571,"[np.float32(0.0), np.float32(1.0), np.float32(1.0), np.float32(0.0), np.float32(1.0), np.float32(1.0), np.float32(0.0), np.float32(0.0), np.float32(0.0), np.float32(0.0), np.float32(1.0), np.float32(0.0), np.float32(0.0), np.float32(0.0), np.float32(0.0), np.float32(0.0)]",-1.0,99638.0,33
2025-08-14_08-18-36,3572,"[np.float32(0.0), np.float32(1.0), np.float32(1.0), np.float32(0.0), np.float32(0.0), np.float32(0.0), np.float32(1.0), np.float32(1.0), np.float32(1.0), np.float32(1.0), np.float32(1.0), np.float32(0.0), np.float32(1.0), np.float32(1.0), np.float32(0.0), np.float32(1.0)]",3.0,99641.0,28
2025-08-14_08-18-36,3573,"[np.float32(1.0), np.float32(1.0), np.float32(0.0), np.float32(1.0), np.float32(0.0), np.float32(1.0), np.float32(1.0), np.float32(0.0), np.float32(1.0), np.float32(1.0), np.float32(1.0), np.float32(1.0), np.float32(1.0), np.float32(0.0), np.float32(0.0), np.float32(1.0)]",-1.0,99640.0,5
2025-08-14_08-18-36,3574,"[np.float32(0.0), np.float32(0.0), np.float32(0.0), np.float32(1.0), np.float32(1.0), np.float32(1.0), np.float32(1.0), np.float32(1.0), np.float32(1.0), np.float32(1.0), np.float32(1.0), np.float32(0.0), np.float32(1.0), np.float32(1.0), np.float32(0.0), np.float32(1.0)]",-4.0,99636.0,27
2025-08-14_08-18-36,3575,"[np.float32(0.0), np.float32(0.0), np.float32(1.0), np.float32(1.0), np.float32(1.0), np.float32(1.0), np.float32(1.0), np.float32(0.0), np.float32(0.0), np.float32(0.0), np.float32(1.0), np.float32(0.0), np.float32(1.0), np.float32(1.0), np.float32(1.0), np.float32(1.0)]",3.0,99639.0,8
2025-08-14_08-18-36,3576,"[np.float32(0.0), np.float32(0.0), np.float32(0.0), np.float32(0.0), np.float32(0.0), np.float32(0.0), np.float32(0.0), np.float32(1.0), np.float32(0.0), np.float32(1.0), np.float32(1.0), np.float32(1.0), np.float32(1.0), np.float32(0.0), np.float32(1.0), np.float32(0.0)]",3.0,99642.0,16
2025-08-14_08-18-36,3577,"[np.float32(0.0), np.float32(1.0), np.float32(1.0), np.float32(0.0), np.float32(1.0), np.float32(0.0), np.float32(1.0), np.float32(1.0), np.float32(1.0), np.float32(1.0), np.float32(1.0), np.float32(0.0), np.float32(1.0), np.float32(1.0), np.float32(1.0), np.float32(0.0)]",0.0,99642.0,32
2025-08-14_08-18-36,3578,"[np.float32(1.0), np.float32(0.0), np.float32(0.0), np.float32(1.0), np.float32(1.0), np.float32(0.0), np.float32(0.0), np.float32(1.0), np.float32(1.0), np.float32(0.0), np.float32(0.0), np.float32(1.0), np.float32(0.0), np.float32(1.0), np.float32(1.0), np.float32(0.0)]",3.0,99645.0,33
2025-08-14_08-18-36,3579,"[np.float32(0.0), np.float32(0.0), np.float32(1.0), np.float32(1.0), np.float32(0.0), np.float32(0.0), np.float32(0.0), np.float32(0.0), np.float32(1.0), np.float32(1.0), np.float32(0.0), np.float32(1.0), np.float32(1.0), np.float32(0.0), np.float32(1.0), np.float32(0.0)]",4.0,99649.0,33
2025-08-14_08-18-36,3580,"[np.float32(1.0), np.float32(1.0), np.float32(0.0), np.float32(1.0), np.float32(1.0), np.float32(0.0), np.float32(1.0), np.float32(0.0), np.float32(0.0), np.float32(0.0), np.float32(0.0), np.float32(1.0), np.float32(0.0), np.float32(1.0), np.float32(0.0), np.float32(0.0)]",5.0,99654.0,9
2025-08-14_08-18-36,3581,"[np.float32(1.0), np.float32(1.0), np.float32(0.0), np.float32(0.0), np.float32(0.0), np.float32(1.0), np.float32(0.0), np.float32(0.0), np.float32(1.0), np.float32(0.0), np.float32(1.0), np.float32(1.0), np.float32(0.0), np.float32(0.0), np.float32(1.0), np.float32(1.0)]",2.0,99656.0,29
2025-08-14_08-18-36,3582,"[np.float32(0.0), np.float32(1.0), np.float32(0.0), np.float32(1.0), np.float32(0.0), np.float32(1.0), np.float32(1.0), np.float32(0.0), np.float32(1.0), np.float32(0.0), np.float32(0.0), np.float32(0.0), np.float32(0.0), np.float32(0.0), np.float32(1.0), np.float32(0.0)]",-1.0,99655.0,7
2025-08-14_08-18-36,3583,"[np.float32(1.0), np.float32(1.0), np.float32(0.0), np.float32(1.0), np.float32(1.0), np.float32(0.0), np.float32(1.0), np.float32(0.0), np.float32(0.0), np.float32(1.0), np.float32(0.0), np.float32(0.0), np.float32(0.0), np.float32(1.0), np.float32(0.0), np.float32(0.0)]",3.0,99658.0,2
2025-08-14_08-18-36,3584,"[np.float32(1.0), np.float32(0.0), np.float32(0.0), np.float32(0.0), np.float32(1.0), np.float32(1.0), np.float32(1.0), np.float32(1.0), np.float32(0.0), np.float32(1.0), np.float32(1.0), np.float32(0.0), np.float32(1.0), np.float32(1.0), np.float32(1.0), np.float32(0.0)]",0.0,99658.0,32
2025-08-14_08-18-36,3585,"[np.float32(1.0), np.float32(0.0), np.float32(1.0), np.float32(1.0), np.float32(1.0), np.float32(1.0), np.float32(1.0), np.float32(0.0), np.float32(0.0), np.float32(0.0), np.float32(1.0), np.float32(0.0), np.float32(0.0), np.float32(0.0), np.float32(0.0), np.float32(1.0)]",1.0,99659.0,3
2025-08-14_08-18-36,3586,"[np.float32(0.0), np.float32(1.0), np.float32(0.0), np.float32(1.0), np.float32(0.0), np.float32(1.0), np.float32(0.0), np.float32(0.0), np.float32(1.0), np.float32(0.0), np.float32(0.0), np.float32(1.0), np.float32(1.0), np.float32(0.0), np.float32(0.0), np.float32(1.0)]",0.0,99659.0,25
2025-08-14_08-18-36,3587,"[np.float32(0.0), np.float32(0.0), np.float32(0.0), np.float32(0.0), np.float32(1.0), np.float32(1.0), np.float32(0.0), np.float32(1.0), np.float32(0.0), np.float32(0.0), np.float32(1.0), np.float32(1.0), np.float32(1.0), np.float32(1.0), np.float32(1.0), np.float32(1.0)]",-1.0,99658.0,13
2025-08-14_08-18-36,3588,"[np.float32(1.0), np.float32(0.0), np.float32(1.0), np.float32(0.0), np.float32(0.0), np.float32(1.0), np.float32(0.0), np.float32(1.0), np.float32(0.0), np.float32(0.0), np.float32(0.0), np.float32(0.0), np.float32(1.0), np.float32(0.0), np.float32(0.0), np.float32(0.0)]",-1.0,99657.0,28
2025-08-14_08-18-36,3589,"[np.float32(1.0), np.float32(1.0), np.float32(0.0), np.float32(0.0), np.float32(0.0), np.float32(0.0), np.float32(0.0), np.float32(0.0), np.float32(1.0), np.float32(0.0), np.float32(1.0), np.float32(0.0), np.float32(0.0), np.float32(1.0), np.float32(0.0), np.float32(0.0)]",0.0,99657.0,11
2025-08-14_08-18-36,3590,"[np.float32(1.0), np.float32(1.0), np.float32(1.0), np.float32(1.0), np.float32(0.0), np.float32(1.0), np.float32(0.0), np.float32(0.0), np.float32(0.0), np.float32(0.0), np.float32(0.0), np.float32(0.0), np.float32(1.0), np.float32(0.0), np.float32(0.0), np.float32(0.0)]",0.0,99657.0,21
2025-08-14_08-18-36,3591,"[np.float32(1.0), np.float32(1.0), np.float32(1.0), np.float32(1.0), np.float32(1.0), np.float32(1.0), np.float32(1.0), np.float32(0.0), np.float32(1.0), np.float32(0.0), np.float32(0.0), np.float32(0.0), np.float32(1.0), np.float32(1.0), np.float32(1.0), np.float32(0.0)]",-2.0,99655.0,6
2025-08-14_08-18-36,3592,"[np.float32(0.0), np.float32(0.0), np.float32(0.0), np.float32(0.0), np.float32(1.0), np.float32(1.0), np.float32(0.0), np.float32(0.0), np.float32(1.0), np.float32(0.0), np.float32(1.0), np.float32(0.0), np.float32(0.0), np.float32(0.0), np.float32(1.0), np.float32(0.0)]",-3.0,99652.0,7
2025-08-14_08-18-36,3593,"[np.float32(1.0), np.float32(0.0), np.float32(1.0), np.float32(1.0), np.float32(0.0), np.float32(1.0), np.float32(1.0), np.float32(0.0), np.float32(1.0), np.float32(0.0), np.float32(0.0), np.float32(1.0), np.float32(0.0), np.float32(0.0), np.float32(1.0), np.float32(0.0)]",2.0,99654.0,9
2025-08-14_08-18-36,3594,"[np.float32(0.0), np.float32(0.0), np.float32(0.0), np.float32(0.0), np.float32(0.0), np.float32(0.0), np.float32(1.0), np.float32(1.0), np.float32(0.0), np.float32(1.0), np.float32(0.0), np.float32(0.0), np.float32(1.0), np.float32(0.0), np.float32(0.0), np.float32(1.0)]",-2.0,99652.0,15
2025-08-14_08-18-36,3595,"[np.float32(1.0), np.float32(0.0), np.float32(1.0), np.float32(0.0), np.float32(1.0), np.float32(1.0), np.float32(1.0), np.float32(0.0), np.float32(0.0), np.float32(0.0), np.float32(0.0), np.float32(0.0), np.float32(1.0), np.float32(1.0), np.float32(0.0), np.float32(1.0)]",-3.0,99649.0,29
2025-08-14_08-18-36,3596,"[np.float32(1.0), np.float32(0.0), np.float32(1.0), np.float32(1.0), np.float32(0.0), np.float32(0.0), np.float32(0.0), np.float32(1.0), np.float32(0.0), np.float32(0.0), np.float32(1.0), np.float32(0.0), np.float32(0.0), np.float32(0.0), np.float32(0.0), np.float32(1.0)]",-4.0,99645.0,33
2025-08-14_08-18-36,3597,"[np.float32(1.0), np.float32(1.0), np.float32(0.0), np.float32(1.0), np.float32(0.0), np.float32(1.0), np.float32(1.0), np.float32(0.0), np.float32(1.0), np.float32(0.0), np.float32(0.0), np.float32(0.0), np.float32(0.0), np.float32(0.0), np.float32(0.0), np.float32(1.0)]",-1.0,99644.0,19
2025-08-14_08-18-36,3598,"[np.float32(0.0), np.float32(1.0), np.float32(0.0), np.float32(1.0), np.float32(0.0), np.float32(1.0), np.float32(1.0), np.float32(0.0), np.float32(1.0), np.float32(0.0), np.float32(1.0), np.float32(1.0), np.float32(0.0), np.float32(1.0), np.float32(1.0), np.float32(1.0)]",3.0,99647.0,27
2025-08-14_08-18-36,3599,"[np.float32(1.0), np.float32(1.0), np.float32(1.0), np.float32(0.0), np.float32(0.0), np.float32(1.0), np.float32(1.0), np.float32(0.0), np.float32(1.0), np.float32(1.0), np.float32(0.0), np.float32(0.0), np.float32(0.0), np.float32(1.0), np.float32(1.0), np.float32(1.0)]",5.0,99652.0,28
2025-08-14_08-18-36,3600,"[np.float32(1.0), np.float32(0.0), np.float32(1.0), np.float32(1.0), np.float32(1.0), np.float32(0.0), np.float32(1.0), np.float32(0.0), np.float32(1.0), np.float32(1.0), np.float32(0.0), np.float32(0.0), np.float32(1.0), np.float32(0.0), np.float32(0.0), np.float32(0.0)]",0.0,99652.0,28
2025-08-14_08-18-36,3601,"[np.float32(1.0), np.float32(1.0), np.float32(1.0), np.float32(0.0), np.float32(0.0), np.float32(1.0), np.float32(1.0), np.float32(1.0), np.float32(1.0), np.float32(0.0), np.float32(0.0), np.float32(0.0), np.float32(0.0), np.float32(0.0), np.float32(0.0), np.float32(1.0)]",-1.0,99651.0,21
2025-08-14_08-18-36,3602,"[np.float32(1.0), np.float32(0.0), np.float32(1.0), np.float32(1.0), np.float32(0.0), np.float32(1.0), np.float32(1.0), np.float32(0.0), np.float32(0.0), np.float32(0.0), np.float32(1.0), np.float32(1.0), np.float32(0.0), np.float32(0.0), np.float32(1.0), np.float32(1.0)]",-2.0,99649.0,16
2025-08-14_08-18-36,3603,"[np.float32(1.0), np.float32(1.0), np.float32(1.0), np.float32(1.0), np.float32(0.0), np.float32(0.0), np.float32(1.0), np.float32(0.0), np.float32(0.0), np.float32(0.0), np.float32(1.0), np.float32(0.0), np.float32(1.0), np.float32(1.0), np.float32(0.0), np.float32(0.0)]",-4.0,99645.0,33
2025-08-14_08-18-36,3604,"[np.float32(1.0), np.float32(1.0), np.float32(1.0), np.float32(1.0), np.float32(0.0), np.float32(0.0), np.float32(0.0), np.float32(1.0), np.float32(1.0), np.float32(1.0), np.float32(0.0), np.float32(1.0), np.float32(1.0), np.float32(0.0), np.float32(0.0), np.float32(1.0)]",0.0,99645.0,22
2025-08-14_08-18-36,3605,"[np.float32(1.0), np.float32(0.0), np.float32(1.0), np.float32(0.0), np.float32(1.0), np.float32(1.0), np.float32(1.0), np.float32(1.0), np.float32(1.0), np.float32(0.0), np.float32(0.0), np.float32(1.0), np.float32(1.0), np.float32(0.0), np.float32(1.0), np.float32(1.0)]",-1.0,99644.0,10
2025-08-14_08-18-36,3606,"[np.float32(0.0), np.float32(1.0), np.float32(0.0), np.float32(1.0), np.float32(0.0), np.float32(1.0), np.float32(0.0), np.float32(0.0), np.float32(1.0), np.float32(0.0), np.float32(0.0), np.float32(1.0), np.float32(0.0), np.float32(0.0), np.float32(0.0), np.float32(1.0)]",-2.0,99642.0,23
2025-08-14_08-18-36,3607,"[np.float32(0.0), np.float32(1.0), np.float32(0.0), np.float32(0.0), np.float32(1.0), np.float32(0.0), np.float32(0.0), np.float32(1.0), np.float32(1.0), np.float32(1.0), np.float32(1.0), np.float32(1.0), np.float32(1.0), np.float32(1.0), np.float32(0.0), np.float32(0.0)]",4.0,99646.0,15
2025-08-14_08-18-36,3608,"[np.float32(1.0), np.float32(0.0), np.float32(0.0), np.float32(0.0), np.float32(1.0), np.float32(1.0), np.float32(0.0), np.float32(1.0), np.float32(0.0), np.float32(0.0), np.float32(1.0), np.float32(1.0), np.float32(1.0), np.float32(1.0), np.float32(1.0), np.float32(0.0)]",-2.0,99644.0,25
2025-08-14_08-18-36,3609,"[np.float32(0.0), np.float32(1.0), np.float32(1.0), np.float32(1.0), np.float32(1.0), np.float32(1.0), np.float32(0.0), np.float32(0.0), np.float32(0.0), np.float32(1.0), np.float32(0.0), np.float32(0.0), np.float32(1.0), np.float32(1.0), np.float32(0.0), np.float32(0.0)]",-1.0,99643.0,3
2025-08-14_08-18-36,3610,"[np.float32(0.0), np.float32(1.0), np.float32(0.0), np.float32(0.0), np.float32(0.0), np.float32(0.0), np.float32(0.0), np.float32(0.0), np.float32(0.0), np.float32(0.0), np.float32(1.0), np.float32(0.0), np.float32(0.0), np.float32(0.0), np.float32(1.0), np.float32(0.0)]",2.0,99645.0,26
2025-08-14_08-18-36,3611,"[np.float32(0.0), np.float32(1.0), np.float32(0.0), np.float32(0.0), np.float32(0.0), np.float32(1.0), np.float32(0.0), np.float32(1.0), np.float32(0.0), np.float32(0.0), np.float32(0.0), np.float32(0.0), np.float32(1.0), np.float32(0.0), np.float32(1.0), np.float32(0.0)]",-1.0,99644.0,26
2025-08-14_08-18-36,3612,"[np.float32(1.0), np.float32(1.0), np.float32(1.0), np.float32(1.0), np.float32(0.0), np.float32(0.0), np.float32(1.0), np.float32(0.0), np.float32(0.0), np.float32(0.0), np.float32(1.0), np.float32(0.0), np.float32(0.0), np.float32(1.0), np.float32(1.0), np.float32(1.0)]",1.0,99645.0,17
2025-08-14_08-18-36,3613,"[np.float32(1.0), np.float32(0.0), np.float32(1.0), np.float32(1.0), np.float32(1.0), np.float32(0.0), np.float32(0.0), np.float32(0.0), np.float32(0.0), np.float32(1.0), np.float32(1.0), np.float32(0.0), np.float32(1.0), np.float32(0.0), np.float32(1.0), np.float32(0.0)]",-3.0,99642.0,29
2025-08-14_08-18-36,3614,"[np.float32(1.0), np.float32(1.0), np.float32(1.0), np.float32(0.0), np.float32(1.0), np.float32(0.0), np.float32(0.0), np.float32(1.0), np.float32(1.0), np.float32(0.0), np.float32(0.0), np.float32(0.0), np.float32(1.0), np.float32(1.0), np.float32(1.0), np.float32(0.0)]",-2.0,99640.0,5
2025-08-14_08-18-36,3615,"[np.float32(0.0), np.float32(1.0), np.float32(0.0), np.float32(0.0), np.float32(1.0), np.float32(1.0), np.float32(1.0), np.float32(1.0), np.float32(1.0), np.float32(1.0), np.float32(0.0), np.float32(1.0), np.float32(0.0), np.float32(1.0), np.float32(1.0), np.float32(0.0)]",1.0,99641.0,19
2025-08-14_08-18-36,3616,"[np.float32(0.0), np.float32(0.0), np.float32(0.0), np.float32(1.0), np.float32(0.0), np.float32(0.0), np.float32(1.0), np.float32(0.0), np.float32(0.0), np.float32(0.0), np.float32(0.0), np.float32(0.0), np.float32(1.0), np.float32(1.0), np.float32(1.0), np.float32(1.0)]",-1.0,99640.0,17
2025-08-14_08-18-36,3617,"[np.float32(0.0), np.float32(0.0), np.float32(0.0), np.float32(0.0), np.float32(1.0), np.float32(1.0), np.float32(1.0), np.float32(1.0), np.float32(1.0), np.float32(0.0), np.float32(0.0), np.float32(1.0), np.float32(1.0), np.float32(0.0), np.float32(1.0), np.float32(1.0)]",2.0,99642.0,6
2025-08-14_08-18-36,3618,"[np.float32(1.0), np.float32(1.0), np.float32(1.0), np.float32(1.0), np.float32(1.0), np.float32(0.0), np.float32(0.0), np.float32(1.0), np.float32(0.0), np.float32(1.0), np.float32(1.0), np.float32(1.0), np.float32(0.0), np.float32(0.0), np.float32(0.0), np.float32(1.0)]",2.0,99644.0,9
2025-08-14_08-18-36,3619,"[np.float32(1.0), np.float32(1.0), np.float32(0.0), np.float32(0.0), np.float32(0.0), np.float32(1.0), np.float32(1.0), np.float32(1.0), np.float32(0.0), np.float32(1.0), np.float32(1.0), np.float32(1.0), np.float32(1.0), np.float32(0.0), np.float32(0.0), np.float32(1.0)]",34.0,99678.0,7
2025-08-14_08-18-36,3620,"[np.float32(0.0), np.float32(0.0), np.float32(0.0), np.float32(1.0), np.float32(0.0), np.float32(0.0), np.float32(1.0), np.float32(0.0), np.float32(1.0), np.float32(0.0), np.float32(0.0), np.float32(1.0), np.float32(1.0), np.float32(1.0), np.float32(1.0), np.float32(0.0)]",-4.0,99674.0,34
2025-08-14_08-18-36,3621,"[np.float32(0.0), np.float32(0.0), np.float32(0.0), np.float32(0.0), np.float32(0.0), np.float32(0.0), np.float32(0.0), np.float32(1.0), np.float32(0.0), np.float32(0.0), np.float32(1.0), np.float32(1.0), np.float32(0.0), np.float32(1.0), np.float32(1.0), np.float32(0.0)]",4.0,99678.0,23
2025-08-14_08-18-36,3622,"[np.float32(1.0), np.float32(0.0), np.float32(0.0), np.float32(0.0), np.float32(0.0), np.float32(0.0), np.float32(0.0), np.float32(0.0), np.float32(0.0), np.float32(1.0), np.float32(0.0), np.float32(0.0), np.float32(1.0), np.float32(0.0), np.float32(1.0), np.float32(0.0)]",1.0,99679.0,23
2025-08-14_08-18-36,3623,"[np.float32(1.0), np.float32(0.0), np.float32(1.0), np.float32(1.0), np.float32(1.0), np.float32(0.0), np.float32(0.0), np.float32(1.0), np.float32(1.0), np.float32(1.0), np.float32(1.0), np.float32(0.0), np.float32(1.0), np.float32(0.0), np.float32(1.0), np.float32(0.0)]",5.0,99684.0,16
2025-08-14_08-18-36,3624,"[np.float32(1.0), np.float32(1.0), np.float32(1.0), np.float32(1.0), np.float32(1.0), np.float32(1.0), np.float32(0.0), np.float32(0.0), np.float32(1.0), np.float32(0.0), np.float32(0.0), np.float32(0.0), np.float32(0.0), np.float32(0.0), np.float32(0.0), np.float32(0.0)]",-1.0,99683.0,12
2025-08-14_08-18-36,3625,"[np.float32(1.0), np.float32(0.0), np.float32(1.0), np.float32(0.0), np.float32(1.0), np.float32(0.0), np.float32(1.0), np.float32(1.0), np.float32(0.0), np.float32(1.0), np.float32(0.0), np.float32(0.0), np.float32(1.0), np.float32(1.0), np.float32(0.0), np.float32(0.0)]",-4.0,99679.0,30
2025-08-14_08-18-36,3626,"[np.float32(1.0), np.float32(0.0), np.float32(1.0), np.float32(1.0), np.float32(1.0), np.float32(1.0), np.float32(0.0), np.float32(1.0), np.float32(1.0), np.float32(0.0), np.float32(1.0), np.float32(1.0), np.float32(1.0), np.float32(1.0), np.float32(0.0), np.float32(1.0)]",3.0,99682.0,18
2025-08-14_08-18-36,3627,"[np.float32(1.0), np.float32(0.0), np.float32(1.0), np.float32(1.0), np.float32(0.0), np.float32(1.0), np.float32(1.0), np.float32(0.0), np.float32(0.0), np.float32(0.0), np.float32(1.0), np.float32(1.0), np.float32(0.0), np.float32(1.0), np.float32(1.0), np.float32(0.0)]",-1.0,99681.0,10
2025-08-14_08-18-36,3628,"[np.float32(1.0), np.float32(1.0), np.float32(1.0), np.float32(0.0), np.float32(0.0), np.float32(1.0), np.float32(0.0), np.float32(0.0), np.float32(1.0), np.float32(1.0), np.float32(0.0), np.float32(1.0), np.float32(1.0), np.float32(1.0), np.float32(0.0), np.float32(0.0)]",-4.0,99677.0,1
2025-08-14_08-18-36,3629,"[np.float32(0.0), np.float32(0.0), np.float32(1.0), np.float32(1.0), np.float32(0.0), np.float32(1.0), np.float32(0.0), np.float32(1.0), np.float32(1.0), np.float32(0.0), np.float32(1.0), np.float32(1.0), np.float32(0.0), np.float32(1.0), np.float32(0.0), np.float32(0.0)]",-3.0,99674.0,4
2025-08-14_08-18-36,3630,"[np.float32(1.0), np.float32(1.0), np.float32(0.0), np.float32(0.0), np.float32(0.0), np.float32(1.0), np.float32(0.0), np.float32(1.0), np.float32(1.0), np.float32(1.0), np.float32(1.0), np.float32(0.0), np.float32(1.0), np.float32(1.0), np.float32(1.0), np.float32(0.0)]",-2.0,99672.0,4
2025-08-14_08-18-36,3631,"[np.float32(1.0), np.float32(1.0), np.float32(1.0), np.float32(1.0), np.float32(1.0), np.float32(1.0), np.float32(1.0), np.float32(0.0), np.float32(0.0), np.float32(1.0), np.float32(1.0), np.float32(0.0), np.float32(0.0), np.float32(1.0), np.float32(0.0), np.float32(0.0)]",2.0,99674.0,12
2025-08-14_08-18-36,3632,"[np.float32(0.0), np.float32(0.0), np.float32(0.0), np.float32(1.0), np.float32(1.0), np.float32(1.0), np.float32(1.0), np.float32(1.0), np.float32(1.0), np.float32(1.0), np.float32(1.0), np.float32(1.0), np.float32(1.0), np.float32(1.0), np.float32(1.0), np.float32(0.0)]",-1.0,99673.0,24
2025-08-14_08-18-36,3633,"[np.float32(1.0), np.float32(0.0), np.float32(1.0), np.float32(0.0), np.float32(1.0), np.float32(1.0), np.float32(0.0), np.float32(0.0), np.float32(0.0), np.float32(0.0), np.float32(1.0), np.float32(0.0), np.float32(1.0), np.float32(1.0), np.float32(1.0), np.float32(0.0)]",-4.0,99669.0,1
2025-08-14_08-18-36,3634,"[np.float32(0.0), np.float32(0.0), np.float32(0.0), np.float32(1.0), np.float32(1.0), np.float32(0.0), np.float32(1.0), np.float32(1.0), np.float32(0.0), np.float32(0.0), np.float32(0.0), np.float32(0.0), np.float32(0.0), np.float32(0.0), np.float32(0.0), np.float32(1.0)]",3.0,99672.0,6
2025-08-14_08-18-36,3635,"[np.float32(1.0), np.float32(0.0), np.float32(0.0), np.float32(0.0), np.float32(0.0), np.float32(0.0), np.float32(0.0), np.float32(1.0), np.float32(0.0), np.float32(0.0), np.float32(1.0), np.float32(1.0), np.float32(0.0), np.float32(0.0), np.float32(0.0), np.float32(1.0)]",-5.0,99667.0,0
2025-08-14_08-18-36,3636,"[np.float32(0.0), np.float32(0.0), np.float32(1.0), np.float32(0.0), np.float32(1.0), np.float32(0.0), np.float32(1.0), np.float32(1.0), np.float32(1.0), np.float32(1.0), np.float32(0.0), np.float32(0.0), np.float32(0.0), np.float32(1.0), np.float32(0.0), np.float32(1.0)]",-5.0,99662.0,27
2025-08-14_08-18-36,3637,"[np.float32(0.0), np.float32(1.0), np.float32(0.0), np.float32(0.0), np.float32(1.0), np.float32(1.0), np.float32(1.0), np.float32(1.0), np.float32(0.0), np.float32(0.0), np.float32(1.0), np.float32(0.0), np.float32(0.0), np.float32(1.0), np.float32(1.0), np.float32(1.0)]",-4.0,99658.0,36
2025-08-14_08-18-36,3638,"[np.float32(0.0), np.float32(0.0), np.float32(1.0), np.float32(0.0), np.float32(0.0), np.float32(0.0), np.float32(1.0), np.float32(0.0), np.float32(1.0), np.float32(1.0), np.float32(0.0), np.float32(0.0), np.float32(0.0), np.float32(1.0), np.float32(0.0), np.float32(0.0)]",-3.0,99655.0,14
2025-08-14_08-18-36,3639,"[np.float32(0.0), np.float32(0.0), np.float32(0.0), np.float32(0.0), np.float32(1.0), np.float32(0.0), np.float32(1.0), np.float32(1.0), np.float32(1.0), np.float32(0.0), np.float32(1.0), np.float32(1.0), np.float32(0.0), np.float32(1.0), np.float32(0.0), np.float32(0.0)]",1.0,99656.0,8
2025-08-14_08-18-36,3640,"[np.float32(0.0), np.float32(1.0), np.float32(1.0), np.float32(1.0), np.float32(0.0), np.float32(0.0), np.float32(1.0), np.float32(0.0), np.float32(0.0), np.float32(1.0), np.float32(1.0), np.float32(0.0), np.float32(0.0), np.float32(0.0), np.float32(1.0), np.float32(0.0)]",-2.0,99654.0,14
2025-08-14_08-18-36,3641,"[np.float32(0.0), np.float32(0.0), np.float32(1.0), np.float32(1.0), np.float32(1.0), np.float32(0.0), np.float32(1.0), np.float32(1.0), np.float32(0.0), np.float32(0.0), np.float32(0.0), np.float32(0.0), np.float32(1.0), np.float32(1.0), np.float32(0.0), np.float32(0.0)]",-5.0,99649.0,34
2025-08-14_08-18-36,3642,"[np.float32(0.0), np.float32(1.0), np.float32(0.0), np.float32(0.0), np.float32(0.0), np.float32(1.0), np.float32(1.0), np.float32(1.0), np.float32(1.0), np.float32(1.0), np.float32(1.0), np.float32(1.0), np.float32(0.0), np.float32(1.0), np.float32(0.0), np.float32(0.0)]",-1.0,99648.0,13
2025-08-14_08-18-36,3643,"[np.float32(1.0), np.float32(1.0), np.float32(1.0), np.float32(0.0), np.float32(1.0), np.float32(1.0), np.float32(1.0), np.float32(1.0), np.float32(0.0), np.float32(0.0), np.float32(0.0), np.float32(1.0), np.float32(1.0), np.float32(1.0), np.float32(0.0), np.float32(1.0)]",-2.0,99646.0,28
2025-08-14_08-18-36,3644,"[np.float32(0.0), np.float32(0.0), np.float32(1.0), np.float32(1.0), np.float32(1.0), np.float32(0.0), np.float32(1.0), np.float32(1.0), np.float32(1.0), np.float32(1.0), np.float32(1.0), np.float32(0.0), np.float32(1.0), np.float32(0.0), np.float32(1.0), np.float32(0.0)]",-2.0,99644.0,34
2025-08-14_08-18-36,3645,"[np.float32(0.0), np.float32(0.0), np.float32(1.0), np.float32(0.0), np.float32(1.0), np.float32(0.0), np.float32(0.0), np.float32(0.0), np.float32(1.0), np.float32(0.0), np.float32(0.0), np.float32(0.0), np.float32(1.0), np.float32(1.0), np.float32(1.0), np.float32(1.0)]",0.0,99644.0,2
2025-08-14_08-18-36,3646,"[np.float32(0.0), np.float32(0.0), np.float32(0.0), np.float32(0.0), np.float32(0.0), np.float32(0.0), np.float32(0.0), np.float32(1.0), np.float32(1.0), np.float32(0.0), np.float32(1.0), np.float32(1.0), np.float32(1.0), np.float32(1.0), np.float32(1.0), np.float32(1.0)]",1.0,99645.0,36
2025-08-14_08-18-36,3647,"[np.float32(0.0), np.float32(0.0), np.float32(0.0), np.float32(1.0), np.float32(0.0), np.float32(1.0), np.float32(0.0), np.float32(1.0), np.float32(1.0), np.float32(0.0), np.float32(1.0), np.float32(1.0), np.float32(1.0), np.float32(0.0), np.float32(0.0), np.float32(0.0)]",1.0,99646.0,20
2025-08-14_08-18-36,3648,"[np.float32(0.0), np.float32(1.0), np.float32(0.0), np.float32(0.0), np.float32(0.0), np.float32(1.0), np.float32(0.0), np.float32(0.0), np.float32(0.0), np.float32(0.0), np.float32(1.0), np.float32(1.0), np.float32(0.0), np.float32(1.0), np.float32(1.0), np.float32(1.0)]",-2.0,99644.0,10
2025-08-14_08-18-36,3649,"[np.float32(0.0), np.float32(1.0), np.float32(0.0), np.float32(0.0), np.float32(0.0), np.float32(1.0), np.float32(0.0), np.float32(1.0), np.float32(1.0), np.float32(1.0), np.float32(0.0), np.float32(1.0), np.float32(0.0), np.float32(0.0), np.float32(1.0), np.float32(0.0)]",-4.0,99640.0,1
2025-08-14_08-18-36,3650,"[np.float32(1.0), np.float32(1.0), np.float32(1.0), np.float32(0.0), np.float32(1.0), np.float32(0.0), np.float32(1.0), np.float32(0.0), np.float32(1.0), np.float32(0.0), np.float32(1.0), np.float32(0.0), np.float32(0.0), np.float32(0.0), np.float32(0.0), np.float32(0.0)]",2.0,99642.0,6
2025-08-14_08-18-36,3651,"[np.float32(1.0), np.float32(1.0), np.float32(1.0), np.float32(1.0), np.float32(1.0), np.float32(0.0), np.float32(0.0), np.float32(1.0), np.float32(0.0), np.float32(1.0), np.float32(1.0), np.float32(0.0), np.float32(0.0), np.float32(0.0), np.float32(1.0), np.float32(0.0)]",6.0,99648.0,16
2025-08-14_08-18-36,3652,"[np.float32(1.0), np.float32(1.0), np.float32(1.0), np.float32(1.0), np.float32(0.0), np.float32(1.0), np.float32(0.0), np.float32(1.0), np.float32(0.0), np.float32(0.0), np.float32(1.0), np.float32(1.0), np.float32(0.0), np.float32(1.0), np.float32(0.0), np.float32(1.0)]",-1.0,99647.0,27
2025-08-14_08-18-36,3653,"[np.float32(1.0), np.float32(1.0), np.float32(0.0), np.float32(1.0), np.float32(1.0), np.float32(1.0), np.float32(0.0), np.float32(1.0), np.float32(1.0), np.float32(1.0), np.float32(1.0), np.float32(0.0), np.float32(0.0), np.float32(0.0), np.float32(1.0), np.float32(1.0)]",-1.0,99646.0,22
2025-08-14_08-18-36,3654,"[np.float32(1.0), np.float32(0.0), np.float32(0.0), np.float32(1.0), np.float32(0.0), np.float32(0.0), np.float32(1.0), np.float32(0.0), np.float32(0.0), np.float32(0.0), np.float32(1.0), np.float32(0.0), np.float32(1.0), np.float32(1.0), np.float32(0.0), np.float32(0.0)]",-3.0,99643.0,6
2025-08-14_08-18-36,3655,"[np.float32(1.0), np.float32(0.0), np.float32(1.0), np.float32(1.0), np.float32(1.0), np.float32(0.0), np.float32(1.0), np.float32(1.0), np.float32(0.0), np.float32(1.0), np.float32(0.0), np.float32(1.0), np.float32(1.0), np.float32(0.0), np.float32(0.0), np.float32(0.0)]",1.0,99644.0,19
2025-08-14_08-18-36,3656,"[np.float32(1.0), np.float32(0.0), np.float32(0.0), np.float32(1.0), np.float32(0.0), np.float32(0.0), np.float32(0.0), np.float32(1.0), np.float32(0.0), np.float32(0.0), np.float32(1.0), np.float32(1.0), np.float32(0.0), np.float32(1.0), np.float32(0.0), np.float32(0.0)]",-3.0,99641.0,4
2025-08-14_08-18-36,3657,"[np.float32(1.0), np.float32(0.0), np.float32(1.0), np.float32(1.0), np.float32(1.0), np.float32(0.0), np.float32(1.0), np.float32(0.0), np.float32(1.0), np.float32(1.0), np.float32(0.0), np.float32(1.0), np.float32(0.0), np.float32(0.0), np.float32(1.0), np.float32(1.0)]",0.0,99641.0,11
2025-08-14_08-18-36,3658,"[np.float32(1.0), np.float32(1.0), np.float32(1.0), np.float32(0.0), np.float32(0.0), np.float32(1.0), np.float32(1.0), np.float32(0.0), np.float32(1.0), np.float32(1.0), np.float32(0.0), np.float32(0.0), np.float32(1.0), np.float32(1.0), np.float32(0.0), np.float32(1.0)]",-6.0,99635.0,23
2025-08-14_08-18-36,3659,"[np.float32(0.0), np.float32(1.0), np.float32(0.0), np.float32(1.0), np.float32(0.0), np.float32(0.0), np.float32(1.0), np.float32(0.0), np.float32(0.0), np.float32(0.0), np.float32(0.0), np.float32(0.0), np.float32(0.0), np.float32(1.0), np.float32(0.0), np.float32(0.0)]",4.0,99639.0,7
2025-08-14_08-18-36,3660,"[np.float32(0.0), np.float32(0.0), np.float32(0.0), np.float32(0.0), np.float32(0.0), np.float32(0.0), np.float32(0.0), np.float32(1.0), np.float32(1.0), np.float32(1.0), np.float32(0.0), np.float32(0.0), np.float32(1.0), np.float32(1.0), np.float32(0.0), np.float32(0.0)]",-2.0,99637.0,1
2025-08-14_08-18-36,3661,"[np.float32(0.0), np.float32(1.0), np.float32(1.0), np.float32(1.0), np.float32(0.0), np.float32(0.0), np.float32(1.0), np.float32(1.0), np.float32(1.0), np.float32(0.0), np.float32(0.0), np.float32(1.0), np.float32(0.0), np.float32(0.0), np.float32(0.0), np.float32(1.0)]",-3.0,99634.0,7
2025-08-14_08-18-36,3662,"[np.float32(0.0), np.float32(0.0), np.float32(1.0), np.float32(1.0), np.float32(1.0), np.float32(1.0), np.float32(0.0), np.float32(0.0), np.float32(0.0), np.float32(0.0), np.float32(0.0), np.float32(1.0), np.float32(1.0), np.float32(1.0), np.float32(0.0), np.float32(1.0)]",-4.0,99630.0,16
2025-08-14_08-18-36,3663,"[np.float32(1.0), np.float32(0.0), np.float32(1.0), np.float32(0.0), np.float32(1.0), np.float32(1.0), np.float32(1.0), np.float32(1.0), np.float32(1.0), np.float32(1.0), np.float32(0.0), np.float32(0.0), np.float32(0.0), np.float32(1.0), np.float32(1.0), np.float32(0.0)]",0.0,99630.0,24
2025-08-14_08-18-36,3664,"[np.float32(0.0), np.float32(1.0), np.float32(1.0), np.float32(0.0), np.float32(0.0), np.float32(0.0), np.float32(0.0), np.float32(1.0), np.float32(1.0), np.float32(1.0), np.float32(0.0), np.float32(0.0), np.float32(0.0), np.float32(0.0), np.float32(1.0), np.float32(1.0)]",4.0,99634.0,13
2025-08-14_08-18-36,3665,"[np.float32(1.0), np.float32(0.0), np.float32(0.0), np.float32(1.0), np.float32(1.0), np.float32(0.0), np.float32(0.0), np.float32(1.0), np.float32(0.0), np.float32(0.0), np.float32(1.0), np.float32(1.0), np.float32(1.0), np.float32(0.0), np.float32(1.0), np.float32(0.0)]",2.0,99636.0,11
2025-08-14_08-18-36,3666,"[np.float32(0.0), np.float32(1.0), np.float32(1.0), np.float32(1.0), np.float32(1.0), np.float32(0.0), np.float32(1.0), np.float32(1.0), np.float32(1.0), np.float32(0.0), np.float32(1.0), np.float32(1.0), np.float32(0.0), np.float32(0.0), np.float32(1.0), np.float32(1.0)]",-1.0,99635.0,12
2025-08-14_08-18-36,3667,"[np.float32(1.0), np.float32(0.0), np.float32(0.0), np.float32(1.0), np.float32(1.0), np.float32(0.0), np.float32(1.0), np.float32(0.0), np.float32(1.0), np.float32(0.0), np.float32(0.0), np.float32(0.0), np.float32(0.0), np.float32(1.0), np.float32(0.0), np.float32(1.0)]",-2.0,99633.0,10
2025-08-14_08-18-36,3668,"[np.float32(0.0), np.float32(1.0), np.float32(1.0), np.float32(0.0), np.float32(1.0), np.float32(0.0), np.float32(0.0), np.float32(1.0), np.float32(1.0), np.float32(1.0), np.float32(0.0), np.float32(1.0), np.float32(1.0), np.float32(0.0), np.float32(0.0), np.float32(0.0)]",2.0,99635.0,18
2025-08-14_08-18-36,3669,"[np.float32(1.0), np.float32(1.0), np.float32(1.0), np.float32(0.0), np.float32(0.0), np.float32(1.0), np.float32(1.0), np.float32(1.0), np.float32(0.0), np.float32(1.0), np.float32(0.0), np.float32(1.0), np.float32(0.0), np.float32(0.0), np.float32(0.0), np.float32(1.0)]",0.0,99635.0,30
2025-08-14_08-18-36,3670,"[np.float32(0.0), np.float32(0.0), np.float32(1.0), np.float32(0.0), np.float32(0.0), np.float32(1.0), np.float32(1.0), np.float32(1.0), np.float32(1.0), np.float32(0.0), np.float32(1.0), np.float32(0.0), np.float32(0.0), np.float32(1.0), np.float32(1.0), np.float32(1.0)]",-3.0,99632.0,3
2025-08-14_08-18-36,3671,"[np.float32(1.0), np.float32(1.0), np.float32(0.0), np.float32(0.0), np.float32(0.0), np.float32(1.0), np.float32(1.0), np.float32(1.0), np.float32(0.0), np.float32(0.0), np.float32(1.0), np.float32(0.0), np.float32(0.0), np.float32(1.0), np.float32(0.0), np.float32(1.0)]",3.0,99635.0,2
2025-08-14_08-18-36,3672,"[np.float32(0.0), np.float32(0.0), np.float32(1.0), np.float32(1.0), np.float32(0.0), np.float32(1.0), np.float32(0.0), np.float32(1.0), np.float32(1.0), np.float32(0.0), np.float32(0.0), np.float32(1.0), np.float32(1.0), np.float32(1.0), np.float32(1.0), np.float32(1.0)]",0.0,99635.0,32
2025-08-14_08-18-36,3673,"[np.float32(1.0), np.float32(1.0), np.float32(1.0), np.float32(0.0), np.float32(0.0), np.float32(1.0), np.float32(1.0), np.float32(0.0), np.float32(1.0), np.float32(0.0), np.float32(1.0), np.float32(0.0), np.float32(1.0), np.float32(1.0), np.float32(0.0), np.float32(1.0)]",-1.0,99634.0,0
2025-08-14_08-18-36,3674,"[np.float32(0.0), np.float32(0.0), np.float32(0.0), np.float32(1.0), np.float32(0.0), np.float32(0.0), np.float32(0.0), np.float32(1.0), np.float32(1.0), np.float32(1.0), np.float32(1.0), np.float32(0.0), np.float32(1.0), np.float32(1.0), np.float32(1.0), np.float32(0.0)]",-5.0,99629.0,0
2025-08-14_08-18-36,3675,"[np.float32(1.0), np.float32(1.0), np.float32(0.0), np.float32(1.0), np.float32(1.0), np.float32(1.0), np.float32(0.0), np.float32(1.0), np.float32(1.0), np.float32(1.0), np.float32(0.0), np.float32(1.0), np.float32(1.0), np.float32(1.0), np.float32(1.0), np.float32(0.0)]",3.0,99632.0,21
2025-08-14_08-18-36,3676,"[np.float32(1.0), np.float32(0.0), np.float32(1.0), np.float32(1.0), np.float32(1.0), np.float32(0.0), np.float32(1.0), np.float32(1.0), np.float32(0.0), np.float32(1.0), np.float32(0.0), np.float32(1.0), np.float32(1.0), np.float32(0.0), np.float32(0.0), np.float32(1.0)]",2.0,99634.0,18
2025-08-14_08-18-36,3677,"[np.float32(0.0), np.float32(1.0), np.float32(0.0), np.float32(0.0), np.float32(1.0), np.float32(0.0), np.float32(1.0), np.float32(0.0), np.float32(1.0), np.float32(1.0), np.float32(0.0), np.float32(1.0), np.float32(0.0), np.float32(1.0), np.float32(0.0), np.float32(1.0)]",5.0,99639.0,4
2025-08-14_08-18-36,3678,"[np.float32(1.0), np.float32(1.0), np.float32(1.0), np.float32(0.0), np.float32(0.0), np.float32(1.0), np.float32(0.0), np.float32(1.0), np.float32(0.0), np.float32(0.0), np.float32(1.0), np.float32(1.0), np.float32(1.0), np.float32(1.0), np.float32(1.0), np.float32(0.0)]",-2.0,99637.0,17
2025-08-14_08-18-36,3679,"[np.float32(1.0), np.float32(1.0), np.float32(1.0), np.float32(0.0), np.float32(1.0), np.float32(1.0), np.float32(1.0), np.float32(1.0), np.float32(1.0), np.float32(1.0), np.float32(1.0), np.float32(0.0), np.float32(0.0), np.float32(1.0), np.float32(1.0), np.float32(1.0)]",-1.0,99636.0,12
2025-08-14_08-18-36,3680,"[np.float32(0.0), np.float32(0.0), np.float32(0.0), np.float32(0.0), np.float32(0.0), np.float32(0.0), np.float32(0.0), np.float32(1.0), np.float32(1.0), np.float32(1.0), np.float32(0.0), np.float32(1.0), np.float32(1.0), np.float32(0.0), np.float32(1.0), np.float32(0.0)]",3.0,99639.0,16
2025-08-14_08-18-36,3681,"[np.float32(0.0), np.float32(0.0), np.float32(1.0), np.float32(0.0), np.float32(0.0), np.float32(1.0), np.float32(1.0), np.float32(0.0), np.float32(1.0), np.float32(1.0), np.float32(1.0), np.float32(0.0), np.float32(1.0), np.float32(0.0), np.float32(1.0), np.float32(1.0)]",-6.0,99633.0,3
2025-08-14_08-18-36,3682,"[np.float32(0.0), np.float32(0.0), np.float32(0.0), np.float32(1.0), np.float32(0.0), np.float32(0.0), np.float32(0.0), np.float32(1.0), np.float32(0.0), np.float32(0.0), np.float32(1.0), np.float32(1.0), np.float32(0.0), np.float32(0.0), np.float32(0.0), np.float32(1.0)]",0.0,99633.0,3
2025-08-14_08-18-36,3683,"[np.float32(0.0), np.float32(1.0), np.float32(0.0), np.float32(0.0), np.float32(1.0), np.float32(0.0), np.float32(0.0), np.float32(1.0), np.float32(0.0), np.float32(0.0), np.float32(1.0), np.float32(1.0), np.float32(0.0), np.float32(0.0), np.float32(0.0), np.float32(0.0)]",2.0,99635.0,13
2025-08-14_08-18-36,3684,"[np.float32(1.0), np.float32(0.0), np.float32(1.0), np.float32(1.0), np.float32(1.0), np.float32(1.0), np.float32(1.0), np.float32(1.0), np.float32(1.0), np.float32(1.0), np.float32(1.0), np.float32(0.0), np.float32(0.0), np.float32(0.0), np.float32(0.0), np.float32(1.0)]",-1.0,99634.0,4
2025-08-14_08-18-36,3685,"[np.float32(0.0), np.float32(1.0), np.float32(1.0), np.float32(0.0), np.float32(0.0), np.float32(0.0), np.float32(0.0), np.float32(1.0), np.float32(0.0), np.float32(1.0), np.float32(1.0), np.float32(1.0), np.float32(1.0), np.float32(1.0), np.float32(0.0), np.float32(1.0)]",-6.0,99628.0,5
2025-08-14_08-18-36,3686,"[np.float32(0.0), np.float32(0.0), np.float32(1.0), np.float32(1.0), np.float32(0.0), np.float32(1.0), np.float32(1.0), np.float32(0.0), np.float32(1.0), np.float32(1.0), np.float32(0.0), np.float32(0.0), np.float32(0.0), np.float32(0.0), np.float32(0.0), np.float32(0.0)]",-1.0,99627.0,9
2025-08-14_08-18-36,3687,"[np.float32(1.0), np.float32(1.0), np.float32(1.0), np.float32(1.0), np.float32(1.0), np.float32(1.0), np.float32(0.0), np.float32(0.0), np.float32(1.0), np.float32(1.0), np.float32(1.0), np.float32(1.0), np.float32(1.0), np.float32(0.0), np.float32(0.0), np.float32(0.0)]",-5.0,99622.0,0
2025-08-14_08-18-36,3688,"[np.float32(1.0), np.float32(1.0), np.float32(0.0), np.float32(0.0), np.float32(0.0), np.float32(0.0), np.float32(0.0), np.float32(1.0), np.float32(0.0), np.float32(0.0), np.float32(0.0), np.float32(1.0), np.float32(0.0), np.float32(1.0), np.float32(1.0), np.float32(1.0)]",-2.0,99620.0,32
2025-08-14_08-18-36,3689,"[np.float32(0.0), np.float32(0.0), np.float32(0.0), np.float32(1.0), np.float32(0.0), np.float32(1.0), np.float32(1.0), np.float32(1.0), np.float32(0.0), np.float32(0.0), np.float32(0.0), np.float32(1.0), np.float32(1.0), np.float32(1.0), np.float32(1.0), np.float32(1.0)]",-1.0,99619.0,11
2025-08-14_08-18-36,3690,"[np.float32(0.0), np.float32(1.0), np.float32(0.0), np.float32(0.0), np.float32(0.0), np.float32(1.0), np.float32(0.0), np.float32(1.0), np.float32(0.0), np.float32(1.0), np.float32(0.0), np.float32(0.0), np.float32(0.0), np.float32(0.0), np.float32(0.0), np.float32(1.0)]",-3.0,99616.0,30
2025-08-14_08-18-36,3691,"[np.float32(0.0), np.float32(1.0), np.float32(1.0), np.float32(0.0), np.float32(0.0), np.float32(0.0), np.float32(0.0), np.float32(0.0), np.float32(1.0), np.float32(0.0), np.float32(1.0), np.float32(1.0), np.float32(0.0), np.float32(1.0), np.float32(1.0), np.float32(0.0)]",-4.0,99612.0,19
2025-08-14_08-18-36,3692,"[np.float32(1.0), np.float32(0.0), np.float32(0.0), np.float32(0.0), np.float32(1.0), np.float32(0.0), np.float32(1.0), np.float32(0.0), np.float32(1.0), np.float32(1.0), np.float32(0.0), np.float32(1.0), np.float32(0.0), np.float32(1.0), np.float32(0.0), np.float32(0.0)]",1.0,99613.0,27
2025-08-14_08-18-36,3693,"[np.float32(0.0), np.float32(1.0), np.float32(0.0), np.float32(0.0), np.float32(1.0), np.float32(1.0), np.float32(1.0), np.float32(1.0), np.float32(0.0), np.float32(1.0), np.float32(1.0), np.float32(0.0), np.float32(0.0), np.float32(1.0), np.float32(0.0), np.float32(0.0)]",2.0,99615.0,26
2025-08-14_08-18-36,3694,"[np.float32(1.0), np.float32(0.0), np.float32(0.0), np.float32(1.0), np.float32(1.0), np.float32(1.0), np.float32(0.0), np.float32(0.0), np.float32(0.0), np.float32(0.0), np.float32(0.0), np.float32(1.0), np.float32(1.0), np.float32(0.0), np.float32(1.0), np.float32(1.0)]",-1.0,99614.0,14
2025-08-14_08-18-36,3695,"[np.float32(1.0), np.float32(1.0), np.float32(0.0), np.float32(1.0), np.float32(0.0), np.float32(1.0), np.float32(0.0), np.float32(0.0), np.float32(0.0), np.float32(1.0), np.float32(0.0), np.float32(0.0), np.float32(1.0), np.float32(0.0), np.float32(1.0), np.float32(0.0)]",2.0,99616.0,33
2025-08-14_08-18-36,3696,"[np.float32(0.0), np.float32(1.0), np.float32(0.0), np.float32(0.0), np.float32(1.0), np.float32(0.0), np.float32(1.0), np.float32(0.0), np.float32(0.0), np.float32(1.0), np.float32(0.0), np.float32(0.0), np.float32(0.0), np.float32(1.0), np.float32(0.0), np.float32(1.0)]",-4.0,99612.0,33
2025-08-14_08-18-36,3697,"[np.float32(0.0), np.float32(1.0), np.float32(0.0), np.float32(1.0), np.float32(1.0), np.float32(0.0), np.float32(0.0), np.float32(0.0), np.float32(1.0), np.float32(0.0), np.float32(0.0), np.float32(0.0), np.float32(1.0), np.float32(0.0), np.float32(0.0), np.float32(0.0)]",0.0,99612.0,26
2025-08-14_08-18-36,3698,"[np.float32(0.0), np.float32(1.0), np.float32(1.0), np.float32(0.0), np.float32(0.0), np.float32(1.0), np.float32(1.0), np.float32(1.0), np.float32(1.0), np.float32(0.0), np.float32(1.0), np.float32(1.0), np.float32(0.0), np.float32(0.0), np.float32(1.0), np.float32(0.0)]",-4.0,99608.0,25
2025-08-14_08-18-36,3699,"[np.float32(0.0), np.float32(1.0), np.float32(1.0), np.float32(0.0), np.float32(0.0), np.float32(0.0), np.float32(1.0), np.float32(1.0), np.float32(0.0), np.float32(0.0), np.float32(1.0), np.float32(1.0), np.float32(1.0), np.float32(0.0), np.float32(0.0), np.float32(1.0)]",-3.0,99605.0,30
2025-08-14_08-18-36,3700,"[np.float32(1.0), np.float32(0.0), np.float32(1.0), np.float32(0.0), np.float32(1.0), np.float32(1.0), np.float32(1.0), np.float32(0.0), np.float32(0.0), np.float32(0.0), np.float32(1.0), np.float32(0.0), np.float32(1.0), np.float32(1.0), np.float32(0.0), np.float32(0.0)]",2.0,99607.0,3
2025-08-14_08-18-36,3701,"[np.float32(1.0), np.float32(0.0), np.float32(0.0), np.float32(0.0), np.float32(0.0), np.float32(0.0), np.float32(0.0), np.float32(0.0), np.float32(0.0), np.float32(0.0), np.float32(0.0), np.float32(1.0), np.float32(0.0), np.float32(1.0), np.float32(0.0), np.float32(0.0)]",-3.0,99604.0,17
2025-08-14_08-18-36,3702,"[np.float32(0.0), np.float32(1.0), np.float32(1.0), np.float32(1.0), np.float32(1.0), np.float32(1.0), np.float32(1.0), np.float32(1.0), np.float32(0.0), np.float32(1.0), np.float32(0.0), np.float32(1.0), np.float32(0.0), np.float32(1.0), np.float32(0.0), np.float32(0.0)]",5.0,99609.0,4
2025-08-14_08-18-36,3703,"[np.float32(1.0), np.float32(1.0), np.float32(0.0), np.float32(1.0), np.float32(1.0), np.float32(0.0), np.float32(0.0), np.float32(1.0), np.float32(0.0), np.float32(0.0), np.float32(0.0), np.float32(1.0), np.float32(0.0), np.float32(1.0), np.float32(1.0), np.float32(0.0)]",5.0,99614.0,21
2025-08-14_08-18-36,3704,"[np.float32(1.0), np.float32(1.0), np.float32(1.0), np.float32(0.0), np.float32(1.0), np.float32(0.0), np.float32(1.0), np.float32(0.0), np.float32(1.0), np.float32(0.0), np.float32(0.0), np.float32(1.0), np.float32(1.0), np.float32(0.0), np.float32(1.0), np.float32(1.0)]",-3.0,99611.0,13
2025-08-14_08-18-36,3705,"[np.float32(0.0), np.float32(0.0), np.float32(0.0), np.float32(1.0), np.float32(0.0), np.float32(1.0), np.float32(0.0), np.float32(1.0), np.float32(0.0), np.float32(0.0), np.float32(1.0), np.float32(0.0), np.float32(0.0), np.float32(1.0), np.float32(0.0), np.float32(1.0)]",-1.0,99610.0,9
2025-08-14_08-18-36,3706,"[np.float32(1.0), np.float32(1.0), np.float32(0.0), np.float32(1.0), np.float32(0.0), np.float32(1.0), np.float32(0.0), np.float32(0.0), np.float32(0.0), np.float32(1.0), np.float32(0.0), np.float32(1.0), np.float32(1.0), np.float32(1.0), np.float32(1.0), np.float32(0.0)]",0.0,99610.0,23
2025-08-14_08-18-36,3707,"[np.float32(0.0), np.float32(1.0), np.float32(0.0), np.float32(0.0), np.float32(0.0), np.float32(1.0), np.float32(1.0), np.float32(1.0), np.float32(0.0), np.float32(0.0), np.float32(1.0), np.float32(1.0), np.float32(1.0), np.float32(0.0), np.float32(1.0), np.float32(1.0)]",4.0,99614.0,20
2025-08-14_08-18-36,3708,"[np.float32(0.0), np.float32(0.0), np.float32(0.0), np.float32(1.0), np.float32(1.0), np.float32(1.0), np.float32(1.0), np.float32(1.0), np.float32(1.0), np.float32(0.0), np.float32(0.0), np.float32(0.0), np.float32(0.0), np.float32(0.0), np.float32(0.0), np.float32(0.0)]",-1.0,99613.0,18
2025-08-14_08-18-36,3709,"[np.float32(0.0), np.float32(0.0), np.float32(1.0), np.float32(0.0), np.float32(1.0), np.float32(0.0), np.float32(1.0), np.float32(1.0), np.float32(1.0), np.float32(0.0), np.float32(0.0), np.float32(0.0), np.float32(1.0), np.float32(1.0), np.float32(0.0), np.float32(0.0)]",-1.0,99612.0,35
2025-08-14_08-18-36,3710,"[np.float32(0.0), np.float32(0.0), np.float32(1.0), np.float32(0.0), np.float32(1.0), np.float32(1.0), np.float32(1.0), np.float32(0.0), np.float32(1.0), np.float32(0.0), np.float32(1.0), np.float32(1.0), np.float32(0.0), np.float32(1.0), np.float32(1.0), np.float32(0.0)]",-4.0,99608.0,31
2025-08-14_08-18-36,3711,"[np.float32(0.0), np.float32(0.0), np.float32(0.0), np.float32(0.0), np.float32(0.0), np.float32(0.0), np.float32(1.0), np.float32(0.0), np.float32(0.0), np.float32(1.0), np.float32(1.0), np.float32(0.0), np.float32(1.0), np.float32(1.0), np.float32(1.0), np.float32(0.0)]",-3.0,99605.0,17
2025-08-14_08-18-36,3712,"[np.float32(1.0), np.float32(0.0), np.float32(1.0), np.float32(0.0), np.float32(0.0), np.float32(1.0), np.float32(0.0), np.float32(0.0), np.float32(1.0), np.float32(1.0), np.float32(0.0), np.float32(0.0), np.float32(0.0), np.float32(1.0), np.float32(0.0), np.float32(0.0)]",6.0,99611.0,34
2025-08-14_08-18-36,3713,"[np.float32(1.0), np.float32(0.0), np.float32(1.0), np.float32(1.0), np.float32(1.0), np.float32(0.0), np.float32(1.0), np.float32(1.0), np.float32(0.0), np.float32(1.0), np.float32(1.0), np.float32(1.0), np.float32(1.0), np.float32(1.0), np.float32(1.0), np.float32(0.0)]",1.0,99612.0,4
2025-08-14_08-18-36,3714,"[np.float32(0.0), np.float32(1.0), np.float32(0.0), np.float32(0.0), np.float32(0.0), np.float32(1.0), np.float32(0.0), np.float32(0.0), np.float32(1.0), np.float32(1.0), np.float32(1.0), np.float32(0.0), np.float32(0.0), np.float32(1.0), np.float32(1.0), np.float32(0.0)]",-4.0,99608.0,3
2025-08-14_08-18-36,3715,"[np.float32(1.0), np.float32(1.0), np.float32(0.0), np.float32(0.0), np.float32(0.0), np.float32(0.0), np.float32(1.0), np.float32(1.0), np.float32(1.0), np.float32(1.0), np.float32(0.0), np.float32(0.0), np.float32(0.0), np.float32(0.0), np.float32(0.0), np.float32(0.0)]",2.0,99610.0,31
2025-08-14_08-18-36,3716,"[np.float32(1.0), np.float32(0.0), np.float32(0.0), np.float32(1.0), np.float32(1.0), np.float32(1.0), np.float32(1.0), np.float32(1.0), np.float32(1.0), np.float32(0.0), np.float32(1.0), np.float32(0.0), np.float32(0.0), np.float32(1.0), np.float32(1.0), np.float32(0.0)]",0.0,99610.0,16
2025-08-14_08-18-36,3717,"[np.float32(1.0), np.float32(1.0), np.float32(0.0), np.float32(1.0), np.float32(1.0), np.float32(0.0), np.float32(0.0), np.float32(1.0), np.float32(0.0), np.float32(1.0), np.float32(0.0), np.float32(1.0), np.float32(1.0), np.float32(1.0), np.float32(0.0), np.float32(0.0)]",-2.0,99608.0,10
2025-08-14_08-18-36,3718,"[np.float32(1.0), np.float32(1.0), np.float32(0.0), np.float32(0.0), np.float32(1.0), np.float32(1.0), np.float32(0.0), np.float32(1.0), np.float32(1.0), np.float32(0.0), np.float32(0.0), np.float32(1.0), np.float32(0.0), np.float32(1.0), np.float32(1.0), np.float32(1.0)]",0.0,99608.0,25
2025-08-14_08-18-36,3719,"[np.float32(1.0), np.float32(0.0), np.float32(0.0), np.float32(0.0), np.float32(0.0), np.float32(0.0), np.float32(0.0), np.float32(0.0), np.float32(1.0), np.float32(1.0), np.float32(0.0), np.float32(0.0), np.float32(1.0), np.float32(1.0), np.float32(0.0), np.float32(0.0)]",39.0,99647.0,7
2025-08-14_08-18-36,3720,"[np.float32(0.0), np.float32(1.0), np.float32(1.0), np.float32(1.0), np.float32(0.0), np.float32(1.0), np.float32(1.0), np.float32(0.0), np.float32(0.0), np.float32(1.0), np.float32(0.0), np.float32(1.0), np.float32(1.0), np.float32(1.0), np.float32(1.0), np.float32(0.0)]",-1.0,99646.0,35
2025-08-14_08-18-36,3721,"[np.float32(0.0), np.float32(0.0), np.float32(1.0), np.float32(0.0), np.float32(1.0), np.float32(1.0), np.float32(1.0), np.float32(0.0), np.float32(0.0), np.float32(1.0), np.float32(1.0), np.float32(0.0), np.float32(1.0), np.float32(0.0), np.float32(0.0), np.float32(1.0)]",-1.0,99645.0,26
2025-08-14_08-18-36,3722,"[np.float32(1.0), np.float32(1.0), np.float32(1.0), np.float32(1.0), np.float32(1.0), np.float32(1.0), np.float32(0.0), np.float32(1.0), np.float32(1.0), np.float32(0.0), np.float32(0.0), np.float32(0.0), np.float32(1.0), np.float32(1.0), np.float32(0.0), np.float32(1.0)]",1.0,99646.0,32
2025-08-14_08-18-36,3723,"[np.float32(0.0), np.float32(0.0), np.float32(1.0), np.float32(0.0), np.float32(0.0), np.float32(1.0), np.float32(1.0), np.float32(0.0), np.float32(0.0), np.float32(1.0), np.float32(0.0), np.float32(1.0), np.float32(0.0), np.float32(0.0), np.float32(0.0), np.float32(1.0)]",-3.0,99643.0,5
2025-08-14_08-18-36,3724,"[np.float32(1.0), np.float32(1.0), np.float32(1.0), np.float32(1.0), np.float32(0.0), np.float32(1.0), np.float32(1.0), np.float32(1.0), np.float32(1.0), np.float32(0.0), np.float32(1.0), np.float32(1.0), np.float32(0.0), np.float32(1.0), np.float32(0.0), np.float32(1.0)]",0.0,99643.0,19
2025-08-14_08-18-36,3725,"[np.float32(0.0), np.float32(1.0), np.float32(0.0), np.float32(0.0), np.float32(1.0), np.float32(1.0), np.float32(1.0), np.float32(1.0), np.float32(1.0), np.float32(1.0), np.float32(1.0), np.float32(0.0), np.float32(0.0), np.float32(0.0), np.float32(0.0), np.float32(0.0)]",-3.0,99640.0,27
2025-08-14_08-18-36,3726,"[np.float32(1.0), np.float32(1.0), np.float32(1.0), np.float32(0.0), np.float32(1.0), np.float32(0.0), np.float32(1.0), np.float32(1.0), np.float32(1.0), np.float32(0.0), np.float32(1.0), np.float32(1.0), np.float32(1.0), np.float32(1.0), np.float32(0.0), np.float32(0.0)]",1.0,99641.0,6
2025-08-14_08-18-36,3727,"[np.float32(0.0), np.float32(0.0), np.float32(1.0), np.float32(1.0), np.float32(1.0), np.float32(1.0), np.float32(1.0), np.float32(0.0), np.float32(1.0), np.float32(0.0), np.float32(0.0), np.float32(0.0), np.float32(1.0), np.float32(0.0), np.float32(1.0), np.float32(1.0)]",-2.0,99639.0,13
2025-08-14_08-18-36,3728,"[np.float32(1.0), np.float32(0.0), np.float32(1.0), np.float32(1.0), np.float32(1.0), np.float32(1.0), np.float32(0.0), np.float32(1.0), np.float32(1.0), np.float32(1.0), np.float32(1.0), np.float32(0.0), np.float32(0.0), np.float32(1.0), np.float32(0.0), np.float32(0.0)]",-1.0,99638.0,12
2025-08-14_08-18-36,3729,"[np.float32(1.0), np.float32(0.0), np.float32(1.0), np.float32(0.0), np.float32(1.0), np.float32(1.0), np.float32(0.0), np.float32(1.0), np.float32(0.0), np.float32(1.0), np.float32(0.0), np.float32(0.0), np.float32(0.0), np.float32(1.0), np.float32(1.0), np.float32(1.0)]",-4.0,99634.0,29
2025-08-14_08-18-36,3730,"[np.float32(0.0), np.float32(1.0), np.float32(0.0), np.float32(0.0), np.float32(0.0), np.float32(1.0), np.float32(1.0), np.float32(1.0), np.float32(1.0), np.float32(1.0), np.float32(0.0), np.float32(1.0), np.float32(1.0), np.float32(1.0), np.float32(1.0), np.float32(0.0)]",0.0,99634.0,29
2025-08-14_08-18-36,3731,"[np.float32(0.0), np.float32(1.0), np.float32(0.0), np.float32(0.0), np.float32(1.0), np.float32(0.0), np.float32(1.0), np.float32(0.0), np.float32(0.0), np.float32(1.0), np.float32(1.0), np.float32(1.0), np.float32(1.0), np.float32(0.0), np.float32(1.0), np.float32(1.0)]",1.0,99635.0,4
2025-08-14_08-18-36,3732,"[np.float32(1.0), np.float32(0.0), np.float32(0.0), np.float32(0.0), np.float32(1.0), np.float32(0.0), np.float32(0.0), np.float32(0.0), np.float32(1.0), np.float32(1.0), np.float32(0.0), np.float32(0.0), np.float32(1.0), np.float32(1.0), np.float32(0.0), np.float32(0.0)]",1.0,99636.0,3
2025-08-14_08-18-36,3733,"[np.float32(1.0), np.float32(0.0), np.float32(0.0), np.float32(0.0), np.float32(1.0), np.float32(1.0), np.float32(1.0), np.float32(0.0), np.float32(1.0), np.float32(0.0), np.float32(0.0), np.float32(1.0), np.float32(1.0), np.float32(1.0), np.float32(1.0), np.float32(0.0)]",-2.0,99634.0,19
2025-08-14_08-18-36,3734,"[np.float32(0.0), np.float32(0.0), np.float32(1.0), np.float32(0.0), np.float32(1.0), np.float32(1.0), np.float32(1.0), np.float32(1.0), np.float32(1.0), np.float32(1.0), np.float32(1.0), np.float32(1.0), np.float32(0.0), np.float32(0.0), np.float32(0.0), np.float32(0.0)]",1.0,99635.0,28
2025-08-14_08-18-36,3735,"[np.float32(1.0), np.float32(0.0), np.float32(0.0), np.float32(1.0), np.float32(1.0), np.float32(0.0), np.float32(1.0), np.float32(1.0), np.float32(1.0), np.float32(1.0), np.float32(0.0), np.float32(1.0), np.float32(1.0), np.float32(1.0), np.float32(0.0), np.float32(0.0)]",3.0,99638.0,18
2025-08-14_08-18-36,3736,"[np.float32(0.0), np.float32(1.0), np.float32(0.0), np.float32(0.0), np.float32(1.0), np.float32(1.0), np.float32(1.0), np.float32(0.0), np.float32(0.0), np.float32(1.0), np.float32(0.0), np.float32(0.0), np.float32(1.0), np.float32(1.0), np.float32(0.0), np.float32(0.0)]",-2.0,99636.0,18
2025-08-14_08-18-36,3737,"[np.float32(0.0), np.float32(1.0), np.float32(0.0), np.float32(0.0), np.float32(1.0), np.float32(0.0), np.float32(0.0), np.float32(1.0), np.float32(1.0), np.float32(1.0), np.float32(1.0), np.float32(1.0), np.float32(1.0), np.float32(1.0), np.float32(0.0), np.float32(1.0)]",0.0,99636.0,2
2025-08-14_08-18-36,3738,"[np.float32(1.0), np.float32(1.0), np.float32(1.0), np.float32(1.0), np.float32(0.0), np.float32(1.0), np.float32(0.0), np.float32(1.0), np.float32(1.0), np.float32(1.0), np.float32(0.0), np.float32(0.0), np.float32(0.0), np.float32(1.0), np.float32(1.0), np.float32(1.0)]",1.0,99637.0,24
2025-08-14_08-18-36,3739,"[np.float32(1.0), np.float32(0.0), np.float32(0.0), np.float32(0.0), np.float32(0.0), np.float32(1.0), np.float32(0.0), np.float32(0.0), np.float32(1.0), np.float32(0.0), np.float32(0.0), np.float32(0.0), np.float32(0.0), np.float32(1.0), np.float32(1.0), np.float32(0.0)]",3.0,99640.0,28
2025-08-14_08-18-36,3740,"[np.float32(0.0), np.float32(0.0), np.float32(1.0), np.float32(0.0), np.float32(1.0), np.float32(1.0), np.float32(0.0), np.float32(1.0), np.float32(0.0), np.float32(0.0), np.float32(0.0), np.float32(0.0), np.float32(0.0), np.float32(1.0), np.float32(1.0), np.float32(0.0)]",4.0,99644.0,16
2025-08-14_08-18-36,3741,"[np.float32(1.0), np.float32(0.0), np.float32(1.0), np.float32(0.0), np.float32(1.0), np.float32(1.0), np.float32(1.0), np.float32(0.0), np.float32(1.0), np.float32(0.0), np.float32(0.0), np.float32(1.0), np.float32(1.0), np.float32(1.0), np.float32(0.0), np.float32(1.0)]",0.0,99644.0,28
2025-08-14_08-18-36,3742,"[np.float32(0.0), np.float32(0.0), np.float32(1.0), np.float32(0.0), np.float32(0.0), np.float32(0.0), np.float32(0.0), np.float32(1.0), np.float32(1.0), np.float32(1.0), np.float32(1.0), np.float32(0.0), np.float32(1.0), np.float32(0.0), np.float32(0.0), np.float32(1.0)]",-7.0,99637.0,3
2025-08-14_08-18-36,3743,"[np.float32(1.0), np.float32(0.0), np.float32(1.0), np.float32(1.0), np.float32(0.0), np.float32(1.0), np.float32(0.0), np.float32(1.0), np.float32(0.0), np.float32(1.0), np.float32(1.0), np.float32(0.0), np.float32(1.0), np.float32(0.0), np.float32(0.0), np.float32(1.0)]",3.0,99640.0,34
2025-08-14_08-18-36,3744,"[np.float32(0.0), np.float32(0.0), np.float32(1.0), np.float32(1.0), np.float32(1.0), np.float32(0.0), np.float32(0.0), np.float32(1.0), np.float32(0.0), np.float32(0.0), np.float32(1.0), np.float32(1.0), np.float32(1.0), np.float32(0.0), np.float32(1.0), np.float32(1.0)]",-4.0,99636.0,35
2025-08-14_08-18-36,3745,"[np.float32(0.0), np.float32(1.0), np.float32(1.0), np.float32(0.0), np.float32(1.0), np.float32(0.0), np.float32(1.0), np.float32(0.0), np.float32(1.0), np.float32(1.0), np.float32(1.0), np.float32(0.0), np.float32(0.0), np.float32(1.0), np.float32(1.0), np.float32(0.0)]",-1.0,99635.0,34
2025-08-14_08-18-36,3746,"[np.float32(0.0), np.float32(0.0), np.float32(1.0), np.float32(0.0), np.float32(1.0), np.float32(0.0), np.float32(0.0), np.float32(0.0), np.float32(1.0), np.float32(1.0), np.float32(1.0), np.float32(0.0), np.float32(1.0), np.float32(0.0), np.float32(0.0), np.float32(1.0)]",1.0,99636.0,1
2025-08-14_08-18-36,3747,"[np.float32(1.0), np.float32(1.0), np.float32(1.0), np.float32(1.0), np.float32(1.0), np.float32(0.0), np.float32(0.0), np.float32(0.0), np.float32(1.0), np.float32(1.0), np.float32(0.0), np.float32(1.0), np.float32(1.0), np.float32(0.0), np.float32(0.0), np.float32(0.0)]",0.0,99636.0,13
2025-08-14_08-18-36,3748,"[np.float32(1.0), np.float32(0.0), np.float32(0.0), np.float32(0.0), np.float32(1.0), np.float32(0.0), np.float32(0.0), np.float32(1.0), np.float32(0.0), np.float32(1.0), np.float32(1.0), np.float32(1.0), np.float32(0.0), np.float32(1.0), np.float32(1.0), np.float32(0.0)]",5.0,99641.0,16
2025-08-14_08-18-36,3749,"[np.float32(0.0), np.float32(1.0), np.float32(0.0), np.float32(0.0), np.float32(0.0), np.float32(0.0), np.float32(1.0), np.float32(0.0), np.float32(0.0), np.float32(0.0), np.float32(1.0), np.float32(0.0), np.float32(1.0), np.float32(0.0), np.float32(0.0), np.float32(1.0)]",3.0,99644.0,6
2025-08-14_08-18-36,3750,"[np.float32(0.0), np.float32(1.0), np.float32(0.0), np.float32(0.0), np.float32(0.0), np.float32(0.0), np.float32(1.0), np.float32(1.0), np.float32(0.0), np.float32(0.0), np.float32(0.0), np.float32(1.0), np.float32(0.0), np.float32(1.0), np.float32(1.0), np.float32(1.0)]",4.0,99648.0,6
2025-08-14_08-18-36,3751,"[np.float32(1.0), np.float32(1.0), np.float32(0.0), np.float32(1.0), np.float32(0.0), np.float32(0.0), np.float32(0.0), np.float32(1.0), np.float32(1.0), np.float32(0.0), np.float32(0.0), np.float32(0.0), np.float32(1.0), np.float32(0.0), np.float32(1.0), np.float32(1.0)]",0.0,99648.0,16
2025-08-14_08-18-36,3752,"[np.float32(0.0), np.float32(1.0), np.float32(1.0), np.float32(1.0), np.float32(0.0), np.float32(1.0), np.float32(0.0), np.float32(1.0), np.float32(1.0), np.float32(0.0), np.float32(1.0), np.float32(1.0), np.float32(1.0), np.float32(0.0), np.float32(0.0), np.float32(1.0)]",-2.0,99646.0,18
2025-08-14_08-18-36,3753,"[np.float32(0.0), np.float32(0.0), np.float32(0.0), np.float32(0.0), np.float32(0.0), np.float32(1.0), np.float32(1.0), np.float32(0.0), np.float32(0.0), np.float32(0.0), np.float32(1.0), np.float32(1.0), np.float32(0.0), np.float32(1.0), np.float32(0.0), np.float32(0.0)]",3.0,99649.0,21
2025-08-14_08-18-36,3754,"[np.float32(0.0), np.float32(0.0), np.float32(0.0), np.float32(1.0), np.float32(1.0), np.float32(0.0), np.float32(1.0), np.float32(0.0), np.float32(1.0), np.float32(0.0), np.float32(1.0), np.float32(0.0), np.float32(0.0), np.float32(0.0), np.float32(1.0), np.float32(0.0)]",-1.0,99648.0,16
2025-08-14_08-18-36,3755,"[np.float32(0.0), np.float32(1.0), np.float32(1.0), np.float32(0.0), np.float32(1.0), np.float32(0.0), np.float32(0.0), np.float32(1.0), np.float32(0.0), np.float32(0.0), np.float32(0.0), np.float32(0.0), np.float32(1.0), np.float32(0.0), np.float32(0.0), np.float32(0.0)]",2.0,99650.0,24
2025-08-14_08-18-36,3756,"[np.float32(1.0), np.float32(1.0), np.float32(1.0), np.float32(0.0), np.float32(0.0), np.float32(1.0), np.float32(0.0), np.float32(1.0), np.float32(1.0), np.float32(1.0), np.float32(1.0), np.float32(1.0), np.float32(0.0), np.float32(1.0), np.float32(0.0), np.float32(0.0)]",0.0,99650.0,2
2025-08-14_08-18-36,3757,"[np.float32(0.0), np.float32(1.0), np.float32(0.0), np.float32(1.0), np.float32(1.0), np.float32(0.0), np.float32(1.0), np.float32(1.0), np.float32(1.0), np.float32(1.0), np.float32(0.0), np.float32(1.0), np.float32(1.0), np.float32(0.0), np.float32(0.0), np.float32(1.0)]",-3.0,99647.0,8
2025-08-14_08-18-36,3758,"[np.float32(1.0), np.float32(0.0), np.float32(0.0), np.float32(1.0), np.float32(0.0), np.float32(0.0), np.float32(1.0), np.float32(1.0), np.float32(1.0), np.float32(0.0), np.float32(0.0), np.float32(0.0), np.float32(1.0), np.float32(1.0), np.float32(1.0), np.float32(0.0)]",-2.0,99645.0,22
2025-08-14_08-18-36,3759,"[np.float32(0.0), np.float32(1.0), np.float32(0.0), np.float32(1.0), np.float32(1.0), np.float32(0.0), np.float32(0.0), np.float32(0.0), np.float32(0.0), np.float32(1.0), np.float32(1.0), np.float32(1.0), np.float32(0.0), np.float32(1.0), np.float32(0.0), np.float32(1.0)]",2.0,99647.0,1
2025-08-14_08-18-36,3760,"[np.float32(1.0), np.float32(1.0), np.float32(1.0), np.float32(1.0), np.float32(1.0), np.float32(0.0), np.float32(1.0), np.float32(1.0), np.float32(1.0), np.float32(0.0), np.float32(0.0), np.float32(1.0), np.float32(0.0), np.float32(0.0), np.float32(0.0), np.float32(0.0)]",0.0,99647.0,11
2025-08-14_08-18-36,3761,"[np.float32(0.0), np.float32(0.0), np.float32(0.0), np.float32(1.0), np.float32(1.0), np.float32(1.0), np.float32(0.0), np.float32(1.0), np.float32(0.0), np.float32(0.0), np.float32(0.0), np.float32(1.0), np.float32(0.0), np.float32(0.0), np.float32(1.0), np.float32(0.0)]",-4.0,99643.0,2
2025-08-14_08-18-36,3762,"[np.float32(1.0), np.float32(0.0), np.float32(0.0), np.float32(1.0), np.float32(0.0), np.float32(1.0), np.float32(0.0), np.float32(0.0), np.float32(1.0), np.float32(0.0), np.float32(1.0), np.float32(1.0), np.float32(1.0), np.float32(1.0), np.float32(0.0), np.float32(1.0)]",4.0,99647.0,32
2025-08-14_08-18-36,3763,"[np.float32(1.0), np.float32(0.0), np.float32(1.0), np.float32(0.0), np.float32(0.0), np.float32(0.0), np.float32(0.0), np.float32(1.0), np.float32(0.0), np.float32(0.0), np.float32(1.0), np.float32(1.0), np.float32(1.0), np.float32(0.0), np.float32(0.0), np.float32(1.0)]",1.0,99648.0,6
2025-08-14_08-18-36,3764,"[np.float32(0.0), np.float32(0.0), np.float32(1.0), np.float32(1.0), np.float32(0.0), np.float32(1.0), np.float32(0.0), np.float32(1.0), np.float32(1.0), np.float32(1.0), np.float32(1.0), np.float32(0.0), np.float32(0.0), np.float32(0.0), np.float32(0.0), np.float32(0.0)]",-2.0,99646.0,7
2025-08-14_08-18-36,3765,"[np.float32(0.0), np.float32(0.0), np.float32(1.0), np.float32(0.0), np.float32(1.0), np.float32(0.0), np.float32(0.0), np.float32(1.0), np.float32(0.0), np.float32(1.0), np.float32(1.0), np.float32(1.0), np.float32(1.0), np.float32(1.0), np.float32(1.0), np.float32(0.0)]",1.0,99647.0,10
2025-08-14_08-18-36,3766,"[np.float32(1.0), np.float32(1.0), np.float32(1.0), np.float32(1.0), np.float32(1.0), np.float32(0.0), np.float32(0.0), np.float32(0.0), np.float32(0.0), np.float32(0.0), np.float32(0.0), np.float32(1.0), np.float32(0.0), np.float32(1.0), np.float32(0.0), np.float32(1.0)]",-2.0,99645.0,10
2025-08-14_08-18-36,3767,"[np.float32(0.0), np.float32(1.0), np.float32(1.0), np.float32(0.0), np.float32(0.0), np.float32(1.0), np.float32(0.0), np.float32(0.0), np.float32(1.0), np.float32(0.0), np.float32(0.0), np.float32(0.0), np.float32(1.0), np.float32(0.0), np.float32(0.0), np.float32(0.0)]",-3.0,99642.0,12
2025-08-14_08-18-36,3768,"[np.float32(0.0), np.float32(0.0), np.float32(0.0), np.float32(1.0), np.float32(1.0), np.float32(1.0), np.float32(0.0), np.float32(0.0), np.float32(1.0), np.float32(1.0), np.float32(0.0), np.float32(1.0), np.float32(0.0), np.float32(0.0), np.float32(1.0), np.float32(0.0)]",-2.0,99640.0,26
2025-08-14_08-18-36,3769,"[np.float32(1.0), np.float32(1.0), np.float32(0.0), np.float32(0.0), np.float32(0.0), np.float32(0.0), np.float32(0.0), np.float32(1.0), np.float32(1.0), np.float32(1.0), np.float32(1.0), np.float32(1.0), np.float32(0.0), np.float32(1.0), np.float32(1.0), np.float32(1.0)]",1.0,99641.0,24
2025-08-14_08-18-36,3770,"[np.float32(1.0), np.float32(0.0), np.float32(1.0), np.float32(1.0), np.float32(0.0), np.float32(1.0), np.float32(1.0), np.float32(1.0), np.float32(1.0), np.float32(0.0), np.float32(1.0), np.float32(0.0), np.float32(0.0), np.float32(1.0), np.float32(0.0), np.float32(0.0)]",0.0,99641.0,27
2025-08-14_08-18-36,3771,"[np.float32(0.0), np.float32(0.0), np.float32(1.0), np.float32(0.0), np.float32(1.0), np.float32(1.0), np.float32(0.0), np.float32(0.0), np.float32(1.0), np.float32(0.0), np.float32(0.0), np.float32(1.0), np.float32(1.0), np.float32(0.0), np.float32(1.0), np.float32(1.0)]",-3.0,99638.0,17
2025-08-14_08-18-36,3772,"[np.float32(0.0), np.float32(0.0), np.float32(1.0), np.float32(1.0), np.float32(0.0), np.float32(1.0), np.float32(1.0), np.float32(1.0), np.float32(1.0), np.float32(1.0), np.float32(1.0), np.float32(0.0), np.float32(1.0), np.float32(1.0), np.float32(0.0), np.float32(0.0)]",3.0,99641.0,19
2025-08-14_08-18-36,3773,"[np.float32(0.0), np.float32(1.0), np.float32(1.0), np.float32(0.0), np.float32(1.0), np.float32(1.0), np.float32(1.0), np.float32(1.0), np.float32(1.0), np.float32(1.0), np.float32(1.0), np.float32(1.0), np.float32(0.0), np.float32(1.0), np.float32(1.0), np.float32(0.0)]",-3.0,99638.0,0
2025-08-14_08-18-36,3774,"[np.float32(0.0), np.float32(1.0), np.float32(0.0), np.float32(0.0), np.float32(1.0), np.float32(1.0), np.float32(1.0), np.float32(1.0), np.float32(0.0), np.float32(0.0), np.float32(0.0), np.float32(0.0), np.float32(1.0), np.float32(0.0), np.float32(1.0), np.float32(0.0)]",34.0,99672.0,7
2025-08-14_08-18-36,3775,"[np.float32(0.0), np.float32(0.0), np.float32(1.0), np.float32(1.0), np.float32(1.0), np.float32(0.0), np.float32(1.0), np.float32(1.0), np.float32(0.0), np.float32(1.0), np.float32(1.0), np.float32(0.0), np.float32(0.0), np.float32(0.0), np.float32(0.0), np.float32(1.0)]",2.0,99674.0,11
2025-08-14_08-18-36,3776,"[np.float32(0.0), np.float32(0.0), np.float32(1.0), np.float32(1.0), np.float32(0.0), np.float32(1.0), np.float32(1.0), np.float32(0.0), np.float32(0.0), np.float32(0.0), np.float32(0.0), np.float32(0.0), np.float32(0.0), np.float32(0.0), np.float32(1.0), np.float32(0.0)]",-1.0,99673.0,0
2025-08-14_08-18-36,3777,"[np.float32(1.0), np.float32(0.0), np.float32(0.0), np.float32(0.0), np.float32(1.0), np.float32(1.0), np.float32(1.0), np.float32(1.0), np.float32(1.0), np.float32(1.0), np.float32(1.0), np.float32(1.0), np.float32(1.0), np.float32(1.0), np.float32(1.0), np.float32(1.0)]",-2.0,99671.0,4
2025-08-14_08-18-36,3778,"[np.float32(0.0), np.float32(1.0), np.float32(1.0), np.float32(1.0), np.float32(1.0), np.float32(0.0), np.float32(1.0), np.float32(0.0), np.float32(0.0), np.float32(0.0), np.float32(1.0), np.float32(1.0), np.float32(0.0), np.float32(1.0), np.float32(0.0), np.float32(0.0)]",1.0,99672.0,10
2025-08-14_08-18-36,3779,"[np.float32(0.0), np.float32(1.0), np.float32(1.0), np.float32(1.0), np.float32(0.0), np.float32(1.0), np.float32(0.0), np.float32(0.0), np.float32(0.0), np.float32(0.0), np.float32(1.0), np.float32(0.0), np.float32(0.0), np.float32(0.0), np.float32(1.0), np.float32(1.0)]",-2.0,99670.0,1
2025-08-14_08-18-36,3780,"[np.float32(1.0), np.float32(1.0), np.float32(0.0), np.float32(0.0), np.float32(1.0), np.float32(1.0), np.float32(1.0), np.float32(1.0), np.float32(0.0), np.float32(0.0), np.float32(1.0), np.float32(1.0), np.float32(1.0), np.float32(0.0), np.float32(0.0), np.float32(0.0)]",-2.0,99668.0,1
2025-08-14_08-18-36,3781,"[np.float32(0.0), np.float32(0.0), np.float32(0.0), np.float32(1.0), np.float32(0.0), np.float32(1.0), np.float32(0.0), np.float32(0.0), np.float32(1.0), np.float32(1.0), np.float32(0.0), np.float32(0.0), np.float32(0.0), np.float32(1.0), np.float32(0.0), np.float32(0.0)]",-2.0,99666.0,2
2025-08-14_08-18-36,3782,"[np.float32(0.0), np.float32(1.0), np.float32(0.0), np.float32(0.0), np.float32(0.0), np.float32(1.0), np.float32(1.0), np.float32(0.0), np.float32(1.0), np.float32(0.0), np.float32(1.0), np.float32(0.0), np.float32(0.0), np.float32(1.0), np.float32(1.0), np.float32(0.0)]",3.0,99669.0,33
2025-08-14_08-18-36,3783,"[np.float32(0.0), np.float32(1.0), np.float32(0.0), np.float32(0.0), np.float32(1.0), np.float32(1.0), np.float32(1.0), np.float32(0.0), np.float32(0.0), np.float32(0.0), np.float32(0.0), np.float32(1.0), np.float32(1.0), np.float32(0.0), np.float32(1.0), np.float32(0.0)]",0.0,99669.0,13
2025-08-14_08-18-36,3784,"[np.float32(1.0), np.float32(1.0), np.float32(1.0), np.float32(1.0), np.float32(1.0), np.float32(0.0), np.float32(0.0), np.float32(1.0), np.float32(0.0), np.float32(1.0), np.float32(0.0), np.float32(1.0), np.float32(1.0), np.float32(0.0), np.float32(1.0), np.float32(0.0)]",-1.0,99668.0,1
2025-08-14_08-18-36,3785,"[np.float32(1.0), np.float32(0.0), np.float32(0.0), np.float32(1.0), np.float32(0.0), np.float32(0.0), np.float32(1.0), np.float32(1.0), np.float32(0.0), np.float32(0.0), np.float32(1.0), np.float32(0.0), np.float32(1.0), np.float32(1.0), np.float32(1.0), np.float32(0.0)]",0.0,99668.0,32
2025-08-14_08-18-36,3786,"[np.float32(0.0), np.float32(1.0), np.float32(0.0), np.float32(1.0), np.float32(1.0), np.float32(1.0), np.float32(0.0), np.float32(0.0), np.float32(1.0), np.float32(0.0), np.float32(0.0), np.float32(1.0), np.float32(0.0), np.float32(0.0), np.float32(0.0), np.float32(1.0)]",-2.0,99666.0,14
2025-08-14_08-18-36,3787,"[np.float32(0.0), np.float32(0.0), np.float32(0.0), np.float32(0.0), np.float32(0.0), np.float32(1.0), np.float32(0.0), np.float32(0.0), np.float32(1.0), np.float32(0.0), np.float32(1.0), np.float32(0.0), np.float32(1.0), np.float32(0.0), np.float32(0.0), np.float32(0.0)]",1.0,99667.0,36
2025-08-14_08-18-36,3788,"[np.float32(1.0), np.float32(1.0), np.float32(0.0), np.float32(1.0), np.float32(0.0), np.float32(1.0), np.float32(0.0), np.float32(0.0), np.float32(0.0), np.float32(1.0), np.float32(0.0), np.float32(0.0), np.float32(0.0), np.float32(1.0), np.float32(1.0), np.float32(0.0)]",1.0,99668.0,10
2025-08-14_08-18-36,3789,"[np.float32(1.0), np.float32(1.0), np.float32(0.0), np.float32(1.0), np.float32(1.0), np.float32(0.0), np.float32(1.0), np.float32(1.0), np.float32(0.0), np.float32(0.0), np.float32(1.0), np.float32(0.0), np.float32(1.0), np.float32(0.0), np.float32(0.0), np.float32(1.0)]",2.0,99670.0,20
2025-08-14_08-18-36,3790,"[np.float32(0.0), np.float32(0.0), np.float32(1.0), np.float32(0.0), np.float32(0.0), np.float32(1.0), np.float32(1.0), np.float32(0.0), np.float32(1.0), np.float32(0.0), np.float32(1.0), np.float32(0.0), np.float32(0.0), np.float32(0.0), np.float32(1.0), np.float32(0.0)]",1.0,99671.0,34
2025-08-14_08-18-36,3791,"[np.float32(0.0), np.float32(1.0), np.float32(0.0), np.float32(1.0), np.float32(0.0), np.float32(1.0), np.float32(1.0), np.float32(1.0), np.float32(1.0), np.float32(1.0), np.float32(1.0), np.float32(0.0), np.float32(1.0), np.float32(0.0), np.float32(0.0), np.float32(1.0)]",-1.0,99670.0,14
2025-08-14_08-18-36,3792,"[np.float32(1.0), np.float32(1.0), np.float32(1.0), np.float32(0.0), np.float32(0.0), np.float32(0.0), np.float32(1.0), np.float32(1.0), np.float32(0.0), np.float32(0.0), np.float32(1.0), np.float32(1.0), np.float32(0.0), np.float32(0.0), np.float32(0.0), np.float32(0.0)]",-2.0,99668.0,27
2025-08-14_08-18-36,3793,"[np.float32(0.0), np.float32(0.0), np.float32(1.0), np.float32(0.0), np.float32(1.0), np.float32(1.0), np.float32(0.0), np.float32(0.0), np.float32(1.0), np.float32(0.0), np.float32(0.0), np.float32(1.0), np.float32(0.0), np.float32(1.0), np.float32(1.0), np.float32(0.0)]",1.0,99669.0,3
2025-08-14_08-18-36,3794,"[np.float32(1.0), np.float32(0.0), np.float32(1.0), np.float32(0.0), np.float32(1.0), np.float32(1.0), np.float32(0.0), np.float32(1.0), np.float32(1.0), np.float32(0.0), np.float32(0.0), np.float32(1.0), np.float32(0.0), np.float32(1.0), np.float32(0.0), np.float32(0.0)]",-1.0,99668.0,0
2025-08-14_08-18-36,3795,"[np.float32(1.0), np.float32(0.0), np.float32(1.0), np.float32(1.0), np.float32(0.0), np.float32(1.0), np.float32(0.0), np.float32(1.0), np.float32(1.0), np.float32(1.0), np.float32(1.0), np.float32(1.0), np.float32(0.0), np.float32(0.0), np.float32(1.0), np.float32(0.0)]",0.0,99668.0,28
2025-08-14_08-18-36,3796,"[np.float32(1.0), np.float32(1.0), np.float32(1.0), np.float32(1.0), np.float32(1.0), np.float32(0.0), np.float32(0.0), np.float32(0.0), np.float32(1.0), np.float32(1.0), np.float32(1.0), np.float32(1.0), np.float32(1.0), np.float32(1.0), np.float32(0.0), np.float32(1.0)]",-2.0,99666.0,19
2025-08-14_08-18-36,3797,"[np.float32(1.0), np.float32(1.0), np.float32(0.0), np.float32(1.0), np.float32(0.0), np.float32(1.0), np.float32(0.0), np.float32(1.0), np.float32(1.0), np.float32(1.0), np.float32(1.0), np.float32(0.0), np.float32(1.0), np.float32(1.0), np.float32(0.0), np.float32(0.0)]",5.0,99671.0,19
2025-08-14_08-18-36,3798,"[np.float32(1.0), np.float32(1.0), np.float32(1.0), np.float32(0.0), np.float32(1.0), np.float32(0.0), np.float32(1.0), np.float32(0.0), np.float32(1.0), np.float32(1.0), np.float32(1.0), np.float32(1.0), np.float32(1.0), np.float32(1.0), np.float32(1.0), np.float32(1.0)]",-2.0,99669.0,35
2025-08-14_08-18-36,3799,"[np.float32(0.0), np.float32(0.0), np.float32(1.0), np.float32(0.0), np.float32(1.0), np.float32(1.0), np.float32(1.0), np.float32(1.0), np.float32(1.0), np.float32(0.0), np.float32(1.0), np.float32(0.0), np.float32(1.0), np.float32(1.0), np.float32(0.0), np.float32(0.0)]",-1.0,99668.0,19
2025-08-14_08-18-36,3800,"[np.float32(0.0), np.float32(0.0), np.float32(0.0), np.float32(1.0), np.float32(0.0), np.float32(1.0), np.float32(0.0), np.float32(0.0), np.float32(0.0), np.float32(0.0), np.float32(0.0), np.float32(1.0), np.float32(0.0), np.float32(0.0), np.float32(1.0), np.float32(1.0)]",3.0,99671.0,24
2025-08-14_08-18-36,3801,"[np.float32(1.0), np.float32(1.0), np.float32(0.0), np.float32(1.0), np.float32(1.0), np.float32(1.0), np.float32(0.0), np.float32(0.0), np.float32(0.0), np.float32(1.0), np.float32(0.0), np.float32(1.0), np.float32(1.0), np.float32(1.0), np.float32(1.0), np.float32(0.0)]",0.0,99671.0,16
2025-08-14_08-18-36,3802,"[np.float32(0.0), np.float32(0.0), np.float32(0.0), np.float32(0.0), np.float32(1.0), np.float32(1.0), np.float32(1.0), np.float32(1.0), np.float32(1.0), np.float32(1.0), np.float32(1.0), np.float32(0.0), np.float32(0.0), np.float32(1.0), np.float32(0.0), np.float32(0.0)]",-3.0,99668.0,9
2025-08-14_08-18-36,3803,"[np.float32(0.0), np.float32(1.0), np.float32(1.0), np.float32(0.0), np.float32(1.0), np.float32(0.0), np.float32(0.0), np.float32(1.0), np.float32(1.0), np.float32(0.0), np.float32(0.0), np.float32(1.0), np.float32(0.0), np.float32(0.0), np.float32(0.0), np.float32(1.0)]",3.0,99671.0,18
2025-08-14_08-18-36,3804,"[np.float32(1.0), np.float32(0.0), np.float32(1.0), np.float32(0.0), np.float32(1.0), np.float32(0.0), np.float32(0.0), np.float32(1.0), np.float32(1.0), np.float32(1.0), np.float32(0.0), np.float32(0.0), np.float32(0.0), np.float32(0.0), np.float32(0.0), np.float32(1.0)]",2.0,99673.0,31
2025-08-14_08-18-36,3805,"[np.float32(1.0), np.float32(0.0), np.float32(1.0), np.float32(0.0), np.float32(1.0), np.float32(0.0), np.float32(1.0), np.float32(0.0), np.float32(1.0), np.float32(0.0), np.float32(1.0), np.float32(1.0), np.float32(1.0), np.float32(1.0), np.float32(1.0), np.float32(0.0)]",3.0,99676.0,36
2025-08-14_08-18-36,3806,"[np.float32(0.0), np.float32(0.0), np.float32(0.0), np.float32(0.0), np.float32(1.0), np.float32(1.0), np.float32(0.0), np.float32(0.0), np.float32(1.0), np.float32(0.0), np.float32(0.0), np.float32(0.0), np.float32(0.0), np.float32(0.0), np.float32(1.0), np.float32(0.0)]",1.0,99677.0,13
2025-08-14_08-18-36,3807,"[np.float32(0.0), np.float32(0.0), np.float32(0.0), np.float32(0.0), np.float32(1.0), np.float32(1.0), np.float32(1.0), np.float32(1.0), np.float32(0.0), np.float32(0.0), np.float32(0.0), np.float32(1.0), np.float32(0.0), np.float32(1.0), np.float32(0.0), np.float32(0.0)]",2.0,99679.0,22
2025-08-14_08-18-36,3808,"[np.float32(1.0), np.float32(1.0), np.float32(0.0), np.float32(1.0), np.float32(1.0), np.float32(1.0), np.float32(0.0), np.float32(0.0), np.float32(1.0), np.float32(1.0), np.float32(0.0), np.float32(0.0), np.float32(1.0), np.float32(1.0), np.float32(1.0), np.float32(1.0)]",-1.0,99678.0,16
2025-08-14_08-18-36,3809,"[np.float32(0.0), np.float32(1.0), np.float32(0.0), np.float32(1.0), np.float32(0.0), np.float32(1.0), np.float32(0.0), np.float32(0.0), np.float32(0.0), np.float32(1.0), np.float32(0.0), np.float32(1.0), np.float32(1.0), np.float32(1.0), np.float32(0.0), np.float32(1.0)]",1.0,99679.0,29
2025-08-14_08-18-36,3810,"[np.float32(0.0), np.float32(0.0), np.float32(0.0), np.float32(1.0), np.float32(0.0), np.float32(1.0), np.float32(1.0), np.float32(1.0), np.float32(0.0), np.float32(1.0), np.float32(0.0), np.float32(1.0), np.float32(1.0), np.float32(1.0), np.float32(0.0), np.float32(0.0)]",-2.0,99677.0,6
2025-08-14_08-18-36,3811,"[np.float32(1.0), np.float32(1.0), np.float32(1.0), np.float32(1.0), np.float32(0.0), np.float32(1.0), np.float32(1.0), np.float32(1.0), np.float32(1.0), np.float32(1.0), np.float32(0.0), np.float32(1.0), np.float32(1.0), np.float32(0.0), np.float32(1.0), np.float32(0.0)]",1.0,99678.0,16
2025-08-14_08-18-36,3812,"[np.float32(0.0), np.float32(0.0), np.float32(0.0), np.float32(1.0), np.float32(0.0), np.float32(0.0), np.float32(1.0), np.float32(1.0), np.float32(0.0), np.float32(1.0), np.float32(1.0), np.float32(1.0), np.float32(1.0), np.float32(0.0), np.float32(1.0), np.float32(0.0)]",-5.0,99673.0,28
2025-08-14_08-18-36,3813,"[np.float32(0.0), np.float32(1.0), np.float32(1.0), np.float32(0.0), np.float32(1.0), np.float32(0.0), np.float32(1.0), np.float32(1.0), np.float32(0.0), np.float32(1.0), np.float32(1.0), np.float32(0.0), np.float32(1.0), np.float32(1.0), np.float32(1.0), np.float32(0.0)]",0.0,99673.0,28
2025-08-14_08-18-36,3814,"[np.float32(0.0), np.float32(0.0), np.float32(0.0), np.float32(1.0), np.float32(0.0), np.float32(0.0), np.float32(0.0), np.float32(1.0), np.float32(1.0), np.float32(1.0), np.float32(0.0), np.float32(1.0), np.float32(1.0), np.float32(1.0), np.float32(0.0), np.float32(0.0)]",-2.0,99671.0,23
2025-08-14_08-18-36,3815,"[np.float32(1.0), np.float32(0.0), np.float32(1.0), np.float32(0.0), np.float32(0.0), np.float32(1.0), np.float32(1.0), np.float32(0.0), np.float32(0.0), np.float32(1.0), np.float32(1.0), np.float32(0.0), np.float32(0.0), np.float32(0.0), np.float32(0.0), np.float32(0.0)]",2.0,99673.0,10
2025-08-14_08-18-36,3816,"[np.float32(0.0), np.float32(0.0), np.float32(1.0), np.float32(0.0), np.float32(0.0), np.float32(1.0), np.float32(1.0), np.float32(1.0), np.float32(1.0), np.float32(0.0), np.float32(0.0), np.float32(1.0), np.float32(1.0), np.float32(1.0), np.float32(0.0), np.float32(0.0)]",2.0,99675.0,30
2025-08-14_08-18-36,3817,"[np.float32(1.0), np.float32(1.0), np.float32(0.0), np.float32(0.0), np.float32(0.0), np.float32(1.0), np.float32(0.0), np.float32(0.0), np.float32(1.0), np.float32(1.0), np.float32(1.0), np.float32(1.0), np.float32(1.0), np.float32(1.0), np.float32(0.0), np.float32(0.0)]",-4.0,99671.0,10
2025-08-14_08-18-36,3818,"[np.float32(0.0), np.float32(0.0), np.float32(0.0), np.float32(0.0), np.float32(0.0), np.float32(0.0), np.float32(0.0), np.float32(0.0), np.float32(1.0), np.float32(0.0), np.float32(1.0), np.float32(0.0), np.float32(0.0), np.float32(1.0), np.float32(1.0), np.float32(1.0)]",1.0,99672.0,33
2025-08-14_08-18-36,3819,"[np.float32(1.0), np.float32(0.0), np.float32(1.0), np.float32(0.0), np.float32(0.0), np.float32(1.0), np.float32(1.0), np.float32(1.0), np.float32(0.0), np.float32(1.0), np.float32(0.0), np.float32(0.0), np.float32(1.0), np.float32(0.0), np.float32(1.0), np.float32(1.0)]",-4.0,99668.0,2
2025-08-14_08-18-36,3820,"[np.float32(0.0), np.float32(0.0), np.float32(0.0), np.float32(1.0), np.float32(0.0), np.float32(1.0), np.float32(0.0), np.float32(0.0), np.float32(0.0), np.float32(0.0), np.float32(0.0), np.float32(0.0), np.float32(0.0), np.float32(1.0), np.float32(0.0), np.float32(0.0)]",4.0,99672.0,19
2025-08-14_08-18-36,3821,"[np.float32(1.0), np.float32(1.0), np.float32(0.0), np.float32(0.0), np.float32(0.0), np.float32(1.0), np.float32(1.0), np.float32(1.0), np.float32(1.0), np.float32(0.0), np.float32(1.0), np.float32(1.0), np.float32(0.0), np.float32(1.0), np.float32(0.0), np.float32(0.0)]",1.0,99673.0,28
2025-08-14_08-18-36,3822,"[np.float32(0.0), np.float32(1.0), np.float32(0.0), np.float32(1.0), np.float32(1.0), np.float32(1.0), np.float32(1.0), np.float32(1.0), np.float32(1.0), np.float32(0.0), np.float32(0.0), np.float32(0.0), np.float32(1.0), np.float32(1.0), np.float32(0.0), np.float32(1.0)]",-3.0,99670.0,5
2025-08-14_08-18-36,3823,"[np.float32(1.0), np.float32(1.0), np.float32(0.0), np.float32(0.0), np.float32(0.0), np.float32(0.0), np.float32(0.0), np.float32(1.0), np.float32(0.0), np.float32(0.0), np.float32(0.0), np.float32(0.0), np.float32(0.0), np.float32(1.0), np.float32(0.0), np.float32(1.0)]",-3.0,99667.0,33
2025-08-14_08-18-36,3824,"[np.float32(0.0), np.float32(1.0), np.float32(0.0), np.float32(0.0), np.float32(1.0), np.float32(1.0), np.float32(1.0), np.float32(0.0), np.float32(0.0), np.float32(0.0), np.float32(1.0), np.float32(0.0), np.float32(1.0), np.float32(1.0), np.float32(1.0), np.float32(0.0)]",2.0,99669.0,10
2025-08-14_08-18-36,3825,"[np.float32(1.0), np.float32(0.0), np.float32(0.0), np.float32(1.0), np.float32(0.0), np.float32(1.0), np.float32(0.0), np.float32(1.0), np.float32(1.0), np.float32(0.0), np.float32(0.0), np.float32(0.0), np.float32(1.0), np.float32(0.0), np.float32(1.0), np.float32(1.0)]",2.0,99671.0,30
2025-08-14_08-18-36,3826,"[np.float32(1.0), np.float32(0.0), np.float32(0.0), np.float32(1.0), np.float32(0.0), np.float32(0.0), np.float32(1.0), np.float32(1.0), np.float32(1.0), np.float32(1.0), np.float32(1.0), np.float32(1.0), np.float32(1.0), np.float32(1.0), np.float32(1.0), np.float32(1.0)]",-1.0,99670.0,18
2025-08-14_08-18-36,3827,"[np.float32(0.0), np.float32(0.0), np.float32(1.0), np.float32(1.0), np.float32(0.0), np.float32(1.0), np.float32(1.0), np.float32(1.0), np.float32(1.0), np.float32(1.0), np.float32(0.0), np.float32(0.0), np.float32(1.0), np.float32(1.0), np.float32(1.0), np.float32(1.0)]",-1.0,99669.0,36
2025-08-14_08-18-36,3828,"[np.float32(1.0), np.float32(1.0), np.float32(1.0), np.float32(0.0), np.float32(0.0), np.float32(0.0), np.float32(1.0), np.float32(1.0), np.float32(1.0), np.float32(1.0), np.float32(0.0), np.float32(0.0), np.float32(1.0), np.float32(0.0), np.float32(0.0), np.float32(0.0)]",-3.0,99666.0,15
2025-08-14_08-18-36,3829,"[np.float32(0.0), np.float32(0.0), np.float32(1.0), np.float32(0.0), np.float32(0.0), np.float32(0.0), np.float32(1.0), np.float32(0.0), np.float32(1.0), np.float32(0.0), np.float32(0.0), np.float32(0.0), np.float32(0.0), np.float32(0.0), np.float32(0.0), np.float32(0.0)]",-1.0,99665.0,24
2025-08-14_08-18-36,3830,"[np.float32(1.0), np.float32(1.0), np.float32(1.0), np.float32(1.0), np.float32(1.0), np.float32(1.0), np.float32(0.0), np.float32(1.0), np.float32(1.0), np.float32(1.0), np.float32(1.0), np.float32(0.0), np.float32(0.0), np.float32(0.0), np.float32(0.0), np.float32(0.0)]",2.0,99667.0,19
2025-08-14_08-18-36,3831,"[np.float32(0.0), np.float32(1.0), np.float32(0.0), np.float32(0.0), np.float32(0.0), np.float32(1.0), np.float32(0.0), np.float32(0.0), np.float32(0.0), np.float32(0.0), np.float32(1.0), np.float32(0.0), np.float32(0.0), np.float32(0.0), np.float32(1.0), np.float32(0.0)]",-2.0,99665.0,25
2025-08-14_08-18-36,3832,"[np.float32(0.0), np.float32(0.0), np.float32(1.0), np.float32(1.0), np.float32(0.0), np.float32(1.0), np.float32(0.0), np.float32(0.0), np.float32(0.0), np.float32(1.0), np.float32(0.0), np.float32(0.0), np.float32(0.0), np.float32(1.0), np.float32(0.0), np.float32(0.0)]",-3.0,99662.0,14
2025-08-14_08-18-36,3833,"[np.float32(0.0), np.float32(1.0), np.float32(1.0), np.float32(0.0), np.float32(0.0), np.float32(1.0), np.float32(1.0), np.float32(1.0), np.float32(0.0), np.float32(1.0), np.float32(1.0), np.float32(0.0), np.float32(1.0), np.float32(1.0), np.float32(0.0), np.float32(0.0)]",-3.0,99659.0,3
2025-08-14_08-18-36,3834,"[np.float32(1.0), np.float32(1.0), np.float32(0.0), np.float32(1.0), np.float32(1.0), np.float32(0.0), np.float32(1.0), np.float32(1.0), np.float32(0.0), np.float32(1.0), np.float32(0.0), np.float32(1.0), np.float32(1.0), np.float32(0.0), np.float32(0.0), np.float32(1.0)]",-5.0,99654.0,36
2025-08-14_08-18-36,3835,"[np.float32(1.0), np.float32(0.0), np.float32(0.0), np.float32(1.0), np.float32(0.0), np.float32(0.0), np.float32(0.0), np.float32(0.0), np.float32(0.0), np.float32(0.0), np.float32(0.0), np.float32(1.0), np.float32(1.0), np.float32(0.0), np.float32(1.0), np.float32(0.0)]",-1.0,99653.0,19
2025-08-14_08-18-36,3836,"[np.float32(0.0), np.float32(0.0), np.float32(1.0), np.float32(1.0), np.float32(1.0), np.float32(1.0), np.float32(1.0), np.float32(1.0), np.float32(1.0), np.float32(0.0), np.float32(0.0), np.float32(1.0), np.float32(1.0), np.float32(0.0), np.float32(0.0), np.float32(1.0)]",0.0,99653.0,20
2025-08-14_08-18-36,3837,"[np.float32(1.0), np.float32(1.0), np.float32(0.0), np.float32(0.0), np.float32(0.0), np.float32(0.0), np.float32(1.0), np.float32(1.0), np.float32(1.0), np.float32(1.0), np.float32(1.0), np.float32(0.0), np.float32(1.0), np.float32(1.0), np.float32(1.0), np.float32(1.0)]",0.0,99653.0,35
2025-08-14_08-18-36,3838,"[np.float32(0.0), np.float32(0.0), np.float32(0.0), np.float32(1.0), np.float32(0.0), np.float32(0.0), np.float32(1.0), np.float32(1.0), np.float32(1.0), np.float32(1.0), np.float32(1.0), np.float32(1.0), np.float32(1.0), np.float32(1.0), np.float32(1.0), np.float32(1.0)]",0.0,99653.0,15
2025-08-14_08-18-36,3839,"[np.float32(1.0), np.float32(0.0), np.float32(0.0), np.float32(1.0), np.float32(0.0), np.float32(1.0), np.float32(0.0), np.float32(0.0), np.float32(0.0), np.float32(1.0), np.float32(1.0), np.float32(1.0), np.float32(0.0), np.float32(0.0), np.float32(1.0), np.float32(1.0)]",2.0,99655.0,30
2025-08-14_08-18-36,3840,"[np.float32(1.0), np.float32(0.0), np.float32(1.0), np.float32(0.0), np.float32(1.0), np.float32(1.0), np.float32(0.0), np.float32(1.0), np.float32(0.0), np.float32(0.0), np.float32(1.0), np.float32(0.0), np.float32(0.0), np.float32(0.0), np.float32(1.0), np.float32(1.0)]",-4.0,99651.0,0
2025-08-14_08-18-36,3841,"[np.float32(0.0), np.float32(1.0), np.float32(1.0), np.float32(0.0), np.float32(0.0), np.float32(1.0), np.float32(0.0), np.float32(1.0), np.float32(1.0), np.float32(0.0), np.float32(1.0), np.float32(1.0), np.float32(1.0), np.float32(0.0), np.float32(1.0), np.float32(1.0)]",1.0,99652.0,17
2025-08-14_08-18-36,3842,"[np.float32(0.0), np.float32(1.0), np.float32(0.0), np.float32(0.0), np.float32(1.0), np.float32(1.0), np.float32(1.0), np.float32(1.0), np.float32(0.0), np.float32(0.0), np.float32(1.0), np.float32(0.0), np.float32(1.0), np.float32(0.0), np.float32(0.0), np.float32(0.0)]",0.0,99652.0,22
2025-08-14_08-18-36,3843,"[np.float32(0.0), np.float32(1.0), np.float32(0.0), np.float32(1.0), np.float32(0.0), np.float32(1.0), np.float32(0.0), np.float32(1.0), np.float32(0.0), np.float32(0.0), np.float32(1.0), np.float32(0.0), np.float32(0.0), np.float32(0.0), np.float32(1.0), np.float32(0.0)]",-4.0,99648.0,9
2025-08-14_08-18-36,3844,"[np.float32(1.0), np.float32(0.0), np.float32(1.0), np.float32(1.0), np.float32(0.0), np.float32(1.0), np.float32(0.0), np.float32(1.0), np.float32(0.0), np.float32(1.0), np.float32(1.0), np.float32(1.0), np.float32(0.0), np.float32(0.0), np.float32(0.0), np.float32(0.0)]",-1.0,99647.0,33
2025-08-14_08-18-36,3845,"[np.float32(1.0), np.float32(1.0), np.float32(0.0), np.float32(1.0), np.float32(1.0), np.float32(1.0), np.float32(0.0), np.float32(1.0), np.float32(1.0), np.float32(0.0), np.float32(1.0), np.float32(1.0), np.float32(0.0), np.float32(0.0), np.float32(1.0), np.float32(0.0)]",0.0,99647.0,26
2025-08-14_08-18-36,3846,"[np.float32(1.0), np.float32(0.0), np.float32(1.0), np.float32(0.0), np.float32(1.0), np.float32(1.0), np.float32(0.0), np.float32(0.0), np.float32(1.0), np.float32(1.0), np.float32(1.0), np.float32(0.0), np.float32(0.0), np.float32(0.0), np.float32(1.0), np.float32(1.0)]",3.0,99650.0,14
2025-08-14_08-18-36,3847,"[np.float32(1.0), np.float32(0.0), np.float32(0.0), np.float32(0.0), np.float32(0.0), np.float32(0.0), np.float32(1.0), np.float32(0.0), np.float32(0.0), np.float32(1.0), np.float32(1.0), np.float32(0.0), np.float32(1.0), np.float32(1.0), np.float32(0.0), np.float32(1.0)]",-1.0,99649.0,10
2025-08-14_08-18-36,3848,"[np.float32(0.0), np.float32(1.0), np.float32(1.0), np.float32(0.0), np.float32(1.0), np.float32(0.0), np.float32(0.0), np.float32(1.0), np.float32(0.0), np.float32(0.0), np.float32(1.0), np.float32(0.0), np.float32(0.0), np.float32(1.0), np.float32(1.0), np.float32(1.0)]",1.0,99650.0,23
2025-08-14_08-18-36,3849,"[np.float32(1.0), np.float32(0.0), np.float32(1.0), np.float32(1.0), np.float32(0.0), np.float32(0.0), np.float32(1.0), np.float32(1.0), np.float32(1.0), np.float32(0.0), np.float32(0.0), np.float32(0.0), np.float32(1.0), np.float32(0.0), np.float32(0.0), np.float32(0.0)]",-2.0,99648.0,13
2025-08-14_08-18-36,3850,"[np.float32(1.0), np.float32(1.0), np.float32(1.0), np.float32(1.0), np.float32(1.0), np.float32(1.0), np.float32(1.0), np.float32(1.0), np.float32(1.0), np.float32(0.0), np.float32(1.0), np.float32(1.0), np.float32(0.0), np.float32(1.0), np.float32(1.0), np.float32(0.0)]",2.0,99650.0,15
2025-08-14_08-18-36,3851,"[np.float32(0.0), np.float32(0.0), np.float32(0.0), np.float32(1.0), np.float32(1.0), np.float32(1.0), np.float32(1.0), np.float32(1.0), np.float32(1.0), np.float32(1.0), np.float32(0.0), np.float32(0.0), np.float32(0.0), np.float32(0.0), np.float32(0.0), np.float32(1.0)]",2.0,99652.0,25
2025-08-14_08-18-36,3852,"[np.float32(1.0), np.float32(1.0), np.float32(0.0), np.float32(1.0), np.float32(1.0), np.float32(1.0), np.float32(0.0), np.float32(1.0), np.float32(0.0), np.float32(1.0), np.float32(0.0), np.float32(0.0), np.float32(1.0), np.float32(0.0), np.float32(0.0), np.float32(0.0)]",4.0,99656.0,19
2025-08-14_08-18-36,3853,"[np.float32(0.0), np.float32(1.0), np.float32(0.0), np.float32(1.0), np.float32(1.0), np.float32(1.0), np.float32(0.0), np.float32(1.0), np.float32(0.0), np.float32(1.0), np.float32(0.0), np.float32(0.0), np.float32(0.0), np.float32(0.0), np.float32(0.0), np.float32(1.0)]",0.0,99656.0,28
2025-08-14_08-18-36,3854,"[np.float32(1.0), np.float32(1.0), np.float32(0.0), np.float32(1.0), np.float32(1.0), np.float32(1.0), np.float32(1.0), np.float32(0.0), np.float32(1.0), np.float32(0.0), np.float32(0.0), np.float32(1.0), np.float32(0.0), np.float32(1.0), np.float32(0.0), np.float32(1.0)]",-1.0,99655.0,11
2025-08-14_08-18-36,3855,"[np.float32(1.0), np.float32(1.0), np.float32(1.0), np.float32(1.0), np.float32(0.0), np.float32(1.0), np.float32(0.0), np.float32(1.0), np.float32(0.0), np.float32(0.0), np.float32(1.0), np.float32(1.0), np.float32(1.0), np.float32(0.0), np.float32(0.0), np.float32(0.0)]",-3.0,99652.0,28
2025-08-14_08-18-36,3856,"[np.float32(1.0), np.float32(1.0), np.float32(1.0), np.float32(0.0), np.float32(1.0), np.float32(0.0), np.float32(1.0), np.float32(1.0), np.float32(0.0), np.float32(0.0), np.float32(0.0), np.float32(0.0), np.float32(0.0), np.float32(0.0), np.float32(1.0), np.float32(1.0)]",-1.0,99651.0,7
2025-08-14_08-18-36,3857,"[np.float32(1.0), np.float32(1.0), np.float32(0.0), np.float32(0.0), np.float32(0.0), np.float32(0.0), np.float32(1.0), np.float32(0.0), np.float32(1.0), np.float32(0.0), np.float32(0.0), np.float32(1.0), np.float32(1.0), np.float32(0.0), np.float32(1.0), np.float32(1.0)]",3.0,99654.0,9
2025-08-14_08-18-36,3858,"[np.float32(0.0), np.float32(0.0), np.float32(1.0), np.float32(0.0), np.float32(0.0), np.float32(0.0), np.float32(1.0), np.float32(1.0), np.float32(1.0), np.float32(1.0), np.float32(1.0), np.float32(0.0), np.float32(1.0), np.float32(0.0), np.float32(1.0), np.float32(0.0)]",-2.0,99652.0,29
2025-08-14_08-18-36,3859,"[np.float32(1.0), np.float32(1.0), np.float32(0.0), np.float32(1.0), np.float32(0.0), np.float32(1.0), np.float32(0.0), np.float32(0.0), np.float32(1.0), np.float32(1.0), np.float32(0.0), np.float32(0.0), np.float32(1.0), np.float32(1.0), np.float32(0.0), np.float32(0.0)]",0.0,99652.0,4
2025-08-14_08-18-36,3860,"[np.float32(0.0), np.float32(1.0), np.float32(0.0), np.float32(0.0), np.float32(0.0), np.float32(0.0), np.float32(0.0), np.float32(0.0), np.float32(0.0), np.float32(0.0), np.float32(0.0), np.float32(1.0), np.float32(1.0), np.float32(1.0), np.float32(0.0), np.float32(1.0)]",1.0,99653.0,12
2025-08-14_08-18-36,3861,"[np.float32(1.0), np.float32(1.0), np.float32(0.0), np.float32(1.0), np.float32(0.0), np.float32(0.0), np.float32(1.0), np.float32(0.0), np.float32(1.0), np.float32(1.0), np.float32(0.0), np.float32(1.0), np.float32(1.0), np.float32(0.0), np.float32(0.0), np.float32(0.0)]",-1.0,99652.0,19
2025-08-14_08-18-36,3862,"[np.float32(0.0), np.float32(0.0), np.float32(0.0), np.float32(0.0), np.float32(1.0), np.float32(0.0), np.float32(1.0), np.float32(1.0), np.float32(1.0), np.float32(1.0), np.float32(1.0), np.float32(0.0), np.float32(1.0), np.float32(0.0), np.float32(1.0), np.float32(0.0)]",-3.0,99649.0,3
2025-08-14_08-18-36,3863,"[np.float32(1.0), np.float32(0.0), np.float32(1.0), np.float32(1.0), np.float32(1.0), np.float32(1.0), np.float32(0.0), np.float32(1.0), np.float32(0.0), np.float32(1.0), np.float32(1.0), np.float32(0.0), np.float32(1.0), np.float32(0.0), np.float32(1.0), np.float32(1.0)]",34.0,99683.0,7
2025-08-14_08-18-36,3864,"[np.float32(0.0), np.float32(0.0), np.float32(0.0), np.float32(0.0), np.float32(1.0), np.float32(1.0), np.float32(1.0), np.float32(1.0), np.float32(0.0), np.float32(0.0), np.float32(1.0), np.float32(0.0), np.float32(0.0), np.float32(0.0), np.float32(0.0), np.float32(1.0)]",-4.0,99679.0,36
2025-08-14_08-18-36,3865,"[np.float32(0.0), np.float32(1.0), np.float32(0.0), np.float32(0.0), np.float32(0.0), np.float32(1.0), np.float32(1.0), np.float32(1.0), np.float32(1.0), np.float32(0.0), np.float32(0.0), np.float32(0.0), np.float32(0.0), np.float32(0.0), np.float32(1.0), np.float32(0.0)]",-3.0,99676.0,14
2025-08-14_08-18-36,3866,"[np.float32(0.0), np.float32(1.0), np.float32(0.0), np.float32(1.0), np.float32(0.0), np.float32(1.0), np.float32(1.0), np.float32(0.0), np.float32(1.0), np.float32(1.0), np.float32(1.0), np.float32(1.0), np.float32(1.0), np.float32(1.0), np.float32(1.0), np.float32(0.0)]",2.0,99678.0,27
2025-08-14_08-18-36,3867,"[np.float32(1.0), np.float32(0.0), np.float32(0.0), np.float32(0.0), np.float32(0.0), np.float32(1.0), np.float32(0.0), np.float32(0.0), np.float32(1.0), np.float32(0.0), np.float32(0.0), np.float32(0.0), np.float32(1.0), np.float32(1.0), np.float32(0.0), np.float32(0.0)]",-5.0,99673.0,11
2025-08-14_08-18-36,3868,"[np.float32(0.0), np.float32(1.0), np.float32(0.0), np.float32(1.0), np.float32(0.0), np.float32(0.0), np.float32(0.0), np.float32(0.0), np.float32(1.0), np.float32(0.0), np.float32(0.0), np.float32(1.0), np.float32(0.0), np.float32(1.0), np.float32(0.0), np.float32(1.0)]",-4.0,99669.0,10
2025-08-14_08-18-36,3869,"[np.float32(0.0), np.float32(1.0), np.float32(0.0), np.float32(1.0), np.float32(1.0), np.float32(0.0), np.float32(1.0), np.float32(1.0), np.float32(1.0), np.float32(1.0), np.float32(0.0), np.float32(1.0), np.float32(0.0), np.float32(0.0), np.float32(0.0), np.float32(1.0)]",-1.0,99668.0,16
2025-08-14_08-18-36,3870,"[np.float32(0.0), np.float32(1.0), np.float32(0.0), np.float32(0.0), np.float32(1.0), np.float32(1.0), np.float32(0.0), np.float32(1.0), np.float32(0.0), np.float32(1.0), np.float32(1.0), np.float32(1.0), np.float32(0.0), np.float32(1.0), np.float32(0.0), np.float32(0.0)]",2.0,99670.0,20
2025-08-14_08-18-36,3871,"[np.float32(0.0), np.float32(0.0), np.float32(1.0), np.float32(1.0), np.float32(0.0), np.float32(1.0), np.float32(0.0), np.float32(1.0), np.float32(0.0), np.float32(1.0), np.float32(0.0), np.float32(1.0), np.float32(1.0), np.float32(1.0), np.float32(1.0), np.float32(1.0)]",-5.0,99665.0,2
2025-08-14_08-18-36,3872,"[np.float32(1.0), np.float32(0.0), np.float32(1.0), np.float32(1.0), np.float32(0.0), np.float32(0.0), np.float32(0.0), np.float32(0.0), np.float32(1.0), np.float32(0.0), np.float32(1.0), np.float32(1.0), np.float32(0.0), np.float32(1.0), np.float32(1.0), np.float32(1.0)]",1.0,99666.0,12
2025-08-14_08-18-36,3873,"[np.float32(0.0), np.float32(0.0), np.float32(1.0), np.float32(0.0), np.float32(1.0), np.float32(0.0), np.float32(0.0), np.float32(1.0), np.float32(0.0), np.float32(1.0), np.float32(0.0), np.float32(0.0), np.float32(1.0), np.float32(0.0), np.float32(1.0), np.float32(1.0)]",1.0,99667.0,24
2025-08-14_08-18-36,3874,"[np.float32(0.0), np.float32(0.0), np.float32(0.0), np.float32(0.0), np.float32(0.0), np.float32(1.0), np.float32(0.0), np.float32(0.0), np.float32(1.0), np.float32(0.0), np.float32(0.0), np.float32(0.0), np.float32(1.0), np.float32(1.0), np.float32(0.0), np.float32(1.0)]",-2.0,99665.0,1
2025-08-14_08-18-36,3875,"[np.float32(1.0), np.float32(1.0), np.float32(0.0), np.float32(0.0), np.float32(1.0), np.float32(1.0), np.float32(1.0), np.float32(1.0), np.float32(0.0), np.float32(0.0), np.float32(1.0), np.float32(0.0), np.float32(1.0), np.float32(0.0), np.float32(1.0), np.float32(1.0)]",-6.0,99659.0,28
2025-08-14_08-18-36,3876,"[np.float32(0.0), np.float32(1.0), np.float32(1.0), np.float32(0.0), np.float32(0.0), np.float32(0.0), np.float32(0.0), np.float32(1.0), np.float32(1.0), np.float32(0.0), np.float32(1.0), np.float32(0.0), np.float32(1.0), np.float32(1.0), np.float32(0.0), np.float32(1.0)]",3.0,99662.0,29
2025-08-14_08-18-36,3877,"[np.float32(1.0), np.float32(1.0), np.float32(0.0), np.float32(1.0), np.float32(1.0), np.float32(0.0), np.float32(1.0), np.float32(0.0), np.float32(0.0), np.float32(0.0), np.float32(1.0), np.float32(0.0), np.float32(1.0), np.float32(0.0), np.float32(0.0), np.float32(0.0)]",5.0,99667.0,5
2025-08-14_08-18-36,3878,"[np.float32(1.0), np.float32(1.0), np.float32(0.0), np.float32(0.0), np.float32(0.0), np.float32(1.0), np.float32(1.0), np.float32(1.0), np.float32(1.0), np.float32(0.0), np.float32(0.0), np.float32(0.0), np.float32(0.0), np.float32(0.0), np.float32(0.0), np.float32(0.0)]",1.0,99668.0,35
2025-08-14_08-18-36,3879,"[np.float32(0.0), np.float32(1.0), np.float32(0.0), np.float32(1.0), np.float32(0.0), np.float32(1.0), np.float32(1.0), np.float32(1.0), np.float32(1.0), np.float32(1.0), np.float32(1.0), np.float32(0.0), np.float32(0.0), np.float32(0.0), np.float32(1.0), np.float32(1.0)]",2.0,99670.0,35
2025-08-14_08-18-36,3880,"[np.float32(0.0), np.float32(1.0), np.float32(1.0), np.float32(1.0), np.float32(1.0), np.float32(1.0), np.float32(1.0), np.float32(0.0), np.float32(1.0), np.float32(0.0), np.float32(1.0), np.float32(0.0), np.float32(0.0), np.float32(0.0), np.float32(1.0), np.float32(0.0)]",3.0,99673.0,2
2025-08-14_08-18-36,3881,"[np.float32(0.0), np.float32(0.0), np.float32(0.0), np.float32(1.0), np.float32(0.0), np.float32(0.0), np.float32(0.0), np.float32(0.0), np.float32(1.0), np.float32(1.0), np.float32(0.0), np.float32(0.0), np.float32(0.0), np.float32(1.0), np.float32(0.0), np.float32(1.0)]",-2.0,99671.0,2
2025-08-14_08-18-36,3882,"[np.float32(0.0), np.float32(1.0), np.float32(0.0), np.float32(0.0), np.float32(1.0), np.float32(0.0), np.float32(1.0), np.float32(1.0), np.float32(0.0), np.float32(1.0), np.float32(1.0), np.float32(0.0), np.float32(1.0), np.float32(0.0), np.float32(0.0), np.float32(1.0)]",-3.0,99668.0,12
2025-08-14_08-18-36,3883,"[np.float32(0.0), np.float32(1.0), np.float32(1.0), np.float32(0.0), np.float32(1.0), np.float32(1.0), np.float32(0.0), np.float32(1.0), np.float32(0.0), np.float32(0.0), np.float32(0.0), np.float32(0.0), np.float32(1.0), np.float32(1.0), np.float32(1.0), np.float32(0.0)]",2.0,99670.0,18
2025-08-14_08-18-36,3884,"[np.float32(0.0), np.float32(1.0), np.float32(1.0), np.float32(1.0), np.float32(0.0), np.float32(0.0), np.float32(0.0), np.float32(0.0), np.float32(0.0), np.float32(1.0), np.float32(1.0), np.float32(1.0), np.float32(0.0), np.float32(1.0), np.float32(1.0), np.float32(0.0)]",2.0,99672.0,11
2025-08-14_08-18-36,3885,"[np.float32(0.0), np.float32(0.0), np.float32(0.0), np.float32(1.0), np.float32(0.0), np.float32(1.0), np.float32(1.0), np.float32(1.0), np.float32(0.0), np.float32(1.0), np.float32(0.0), np.float32(0.0), np.float32(1.0), np.float32(1.0), np.float32(0.0), np.float32(0.0)]",-2.0,99670.0,0
2025-08-14_08-18-36,3886,"[np.float32(1.0), np.float32(1.0), np.float32(0.0), np.float32(1.0), np.float32(1.0), np.float32(1.0), np.float32(0.0), np.float32(0.0), np.float32(1.0), np.float32(1.0), np.float32(1.0), np.float32(0.0), np.float32(0.0), np.float32(0.0), np.float32(1.0), np.float32(1.0)]",0.0,99670.0,10
2025-08-14_08-18-36,3887,"[np.float32(0.0), np.float32(0.0), np.float32(0.0), np.float32(0.0), np.float32(0.0), np.float32(1.0), np.float32(0.0), np.float32(1.0), np.float32(1.0), np.float32(0.0), np.float32(0.0), np.float32(0.0), np.float32(1.0), np.float32(0.0), np.float32(1.0), np.float32(0.0)]",-2.0,99668.0,17
2025-08-14_08-18-36,3888,"[np.float32(1.0), np.float32(0.0), np.float32(0.0), np.float32(1.0), np.float32(1.0), np.float32(0.0), np.float32(1.0), np.float32(1.0), np.float32(1.0), np.float32(1.0), np.float32(0.0), np.float32(0.0), np.float32(0.0), np.float32(0.0), np.float32(0.0), np.float32(0.0)]",-2.0,99666.0,36
2025-08-14_08-18-36,3889,"[np.float32(1.0), np.float32(0.0), np.float32(0.0), np.float32(1.0), np.float32(0.0), np.float32(1.0), np.float32(0.0), np.float32(1.0), np.float32(1.0), np.float32(0.0), np.float32(0.0), np.float32(0.0), np.float32(1.0), np.float32(0.0), np.float32(1.0), np.float32(1.0)]",-5.0,99661.0,8
2025-08-14_08-18-36,3890,"[np.float32(1.0), np.float32(0.0), np.float32(0.0), np.float32(1.0), np.float32(1.0), np.float32(1.0), np.float32(0.0), np.float32(0.0), np.float32(1.0), np.float32(0.0), np.float32(0.0), np.float32(0.0), np.float32(0.0), np.float32(1.0), np.float32(0.0), np.float32(0.0)]",-4.0,99657.0,10
2025-08-14_08-18-36,3891,"[np.float32(1.0), np.float32(0.0), np.float32(0.0), np.float32(1.0), np.float32(1.0), np.float32(1.0), np.float32(0.0), np.float32(1.0), np.float32(1.0), np.float32(1.0), np.float32(1.0), np.float32(0.0), np.float32(1.0), np.float32(0.0), np.float32(0.0), np.float32(0.0)]",1.0,99658.0,31
2025-08-14_08-18-36,3892,"[np.float32(1.0), np.float32(0.0), np.float32(0.0), np.float32(0.0), np.float32(1.0), np.float32(1.0), np.float32(1.0), np.float32(1.0), np.float32(0.0), np.float32(1.0), np.float32(1.0), np.float32(0.0), np.float32(1.0), np.float32(0.0), np.float32(0.0), np.float32(1.0)]",37.0,99695.0,7
2025-08-14_08-18-36,3893,"[np.float32(0.0), np.float32(1.0), np.float32(0.0), np.float32(0.0), np.float32(0.0), np.float32(0.0), np.float32(1.0), np.float32(1.0), np.float32(0.0), np.float32(0.0), np.float32(1.0), np.float32(0.0), np.float32(1.0), np.float32(1.0), np.float32(1.0), np.float32(0.0)]",-1.0,99694.0,18
2025-08-14_08-18-36,3894,"[np.float32(1.0), np.float32(0.0), np.float32(0.0), np.float32(0.0), np.float32(0.0), np.float32(1.0), np.float32(1.0), np.float32(1.0), np.float32(0.0), np.float32(1.0), np.float32(0.0), np.float32(0.0), np.float32(0.0), np.float32(0.0), np.float32(1.0), np.float32(0.0)]",-1.0,99693.0,3
2025-08-14_08-18-36,3895,"[np.float32(0.0), np.float32(0.0), np.float32(0.0), np.float32(1.0), np.float32(0.0), np.float32(0.0), np.float32(1.0), np.float32(0.0), np.float32(1.0), np.float32(0.0), np.float32(0.0), np.float32(0.0), np.float32(0.0), np.float32(0.0), np.float32(0.0), np.float32(0.0)]",-1.0,99692.0,21
2025-08-14_08-18-36,3896,"[np.float32(0.0), np.float32(0.0), np.float32(1.0), np.float32(1.0), np.float32(1.0), np.float32(1.0), np.float32(0.0), np.float32(1.0), np.float32(1.0), np.float32(1.0), np.float32(1.0), np.float32(1.0), np.float32(0.0), np.float32(1.0), np.float32(0.0), np.float32(0.0)]",0.0,99692.0,17
2025-08-14_08-18-36,3897,"[np.float32(1.0), np.float32(0.0), np.float32(0.0), np.float32(1.0), np.float32(1.0), np.float32(1.0), np.float32(1.0), np.float32(1.0), np.float32(1.0), np.float32(0.0), np.float32(0.0), np.float32(1.0), np.float32(1.0), np.float32(1.0), np.float32(1.0), np.float32(0.0)]",-3.0,99689.0,10
2025-08-14_08-18-36,3898,"[np.float32(0.0), np.float32(0.0), np.float32(0.0), np.float32(0.0), np.float32(0.0), np.float32(1.0), np.float32(0.0), np.float32(0.0), np.float32(0.0), np.float32(1.0), np.float32(1.0), np.float32(0.0), np.float32(1.0), np.float32(0.0), np.float32(0.0), np.float32(0.0)]",-4.0,99685.0,3
2025-08-14_08-18-36,3899,"[np.float32(0.0), np.float32(1.0), np.float32(0.0), np.float32(0.0), np.float32(1.0), np.float32(0.0), np.float32(0.0), np.float32(0.0), np.float32(0.0), np.float32(1.0), np.float32(0.0), np.float32(0.0), np.float32(0.0), np.float32(0.0), np.float32(1.0), np.float32(1.0)]",-2.0,99683.0,25
2025-08-14_08-18-36,3900,"[np.float32(0.0), np.float32(0.0), np.float32(1.0), np.float32(0.0), np.float32(0.0), np.float32(1.0), np.float32(0.0), np.float32(0.0), np.float32(1.0), np.float32(0.0), np.float32(0.0), np.float32(0.0), np.float32(1.0), np.float32(0.0), np.float32(1.0), np.float32(0.0)]",2.0,99685.0,24
2025-08-14_08-18-36,3901,"[np.float32(1.0), np.float32(1.0), np.float32(0.0), np.float32(1.0), np.float32(0.0), np.float32(0.0), np.float32(1.0), np.float32(1.0), np.float32(1.0), np.float32(0.0), np.float32(0.0), np.float32(1.0), np.float32(1.0), np.float32(1.0), np.float32(1.0), np.float32(0.0)]",-5.0,99680.0,0
2025-08-14_08-18-36,3902,"[np.float32(0.0), np.float32(0.0), np.float32(0.0), np.float32(1.0), np.float32(1.0), np.float32(0.0), np.float32(1.0), np.float32(1.0), np.float32(1.0), np.float32(0.0), np.float32(1.0), np.float32(0.0), np.float32(1.0), np.float32(0.0), np.float32(1.0), np.float32(0.0)]",-8.0,99672.0,0
2025-08-14_08-18-36,3903,"[np.float32(0.0), np.float32(0.0), np.float32(1.0), np.float32(1.0), np.float32(1.0), np.float32(1.0), np.float32(1.0), np.float32(1.0), np.float32(1.0), np.float32(0.0), np.float32(1.0), np.float32(0.0), np.float32(1.0), np.float32(0.0), np.float32(0.0), np.float32(1.0)]",0.0,99672.0,34
2025-08-14_08-18-36,3904,"[np.float32(1.0), np.float32(0.0), np.float32(0.0), np.float32(1.0), np.float32(1.0), np.float32(0.0), np.float32(1.0), np.float32(1.0), np.float32(1.0), np.float32(1.0), np.float32(0.0), np.float32(1.0), np.float32(0.0), np.float32(1.0), np.float32(1.0), np.float32(1.0)]",-1.0,99671.0,14
2025-08-14_08-18-36,3905,"[np.float32(1.0), np.float32(0.0), np.float32(1.0), np.float32(0.0), np.float32(0.0), np.float32(1.0), np.float32(1.0), np.float32(1.0), np.float32(0.0), np.float32(0.0), np.float32(1.0), np.float32(1.0), np.float32(1.0), np.float32(0.0), np.float32(0.0), np.float32(0.0)]",-1.0,99670.0,27
2025-08-14_08-18-36,3906,"[np.float32(1.0), np.float32(1.0), np.float32(0.0), np.float32(1.0), np.float32(1.0), np.float32(0.0), np.float32(0.0), np.float32(1.0), np.float32(0.0), np.float32(1.0), np.float32(0.0), np.float32(1.0), np.float32(1.0), np.float32(0.0), np.float32(0.0), np.float32(1.0)]",3.0,99673.0,9
2025-08-14_08-18-36,3907,"[np.float32(1.0), np.float32(0.0), np.float32(0.0), np.float32(0.0), np.float32(1.0), np.float32(0.0), np.float32(0.0), np.float32(1.0), np.float32(1.0), np.float32(1.0), np.float32(1.0), np.float32(1.0), np.float32(0.0), np.float32(0.0), np.float32(0.0), np.float32(1.0)]",-3.0,99670.0,8
2025-08-14_08-18-36,3908,"[np.float32(0.0), np.float32(1.0), np.float32(0.0), np.float32(0.0), np.float32(1.0), np.float32(1.0), np.float32(1.0), np.float32(0.0), np.float32(0.0), np.float32(0.0), np.float32(1.0), np.float32(0.0), np.float32(1.0), np.float32(1.0), np.float32(0.0), np.float32(1.0)]",-6.0,99664.0,27
2025-08-14_08-18-36,3909,"[np.float32(1.0), np.float32(0.0), np.float32(1.0), np.float32(1.0), np.float32(0.0), np.float32(0.0), np.float32(0.0), np.float32(1.0), np.float32(1.0), np.float32(0.0), np.float32(1.0), np.float32(0.0), np.float32(1.0), np.float32(0.0), np.float32(0.0), np.float32(0.0)]",33.0,99697.0,7
2025-08-14_08-18-36,3910,"[np.float32(1.0), np.float32(1.0), np.float32(1.0), np.float32(1.0), np.float32(0.0), np.float32(0.0), np.float32(0.0), np.float32(0.0), np.float32(0.0), np.float32(0.0), np.float32(0.0), np.float32(0.0), np.float32(1.0), np.float32(1.0), np.float32(0.0), np.float32(0.0)]",-2.0,99695.0,34
2025-08-14_08-18-36,3911,"[np.float32(1.0), np.float32(0.0), np.float32(1.0), np.float32(0.0), np.float32(1.0), np.float32(1.0), np.float32(1.0), np.float32(1.0), np.float32(1.0), np.float32(1.0), np.float32(1.0), np.float32(1.0), np.float32(1.0), np.float32(0.0), np.float32(0.0), np.float32(0.0)]",-3.0,99692.0,29
2025-08-14_08-18-36,3912,"[np.float32(1.0), np.float32(0.0), np.float32(1.0), np.float32(0.0), np.float32(0.0), np.float32(1.0), np.float32(0.0), np.float32(1.0), np.float32(0.0), np.float32(1.0), np.float32(0.0), np.float32(0.0), np.float32(0.0), np.float32(1.0), np.float32(0.0), np.float32(1.0)]",3.0,99695.0,18
2025-08-14_08-18-36,3913,"[np.float32(0.0), np.float32(0.0), np.float32(1.0), np.float32(0.0), np.float32(1.0), np.float32(1.0), np.float32(0.0), np.float32(0.0), np.float32(1.0), np.float32(1.0), np.float32(0.0), np.float32(0.0), np.float32(0.0), np.float32(1.0), np.float32(0.0), np.float32(0.0)]",1.0,99696.0,2
2025-08-14_08-18-36,3914,"[np.float32(1.0), np.float32(0.0), np.float32(1.0), np.float32(1.0), np.float32(0.0), np.float32(0.0), np.float32(0.0), np.float32(1.0), np.float32(1.0), np.float32(1.0), np.float32(1.0), np.float32(1.0), np.float32(0.0), np.float32(0.0), np.float32(1.0), np.float32(0.0)]",1.0,99697.0,32
2025-08-14_08-18-36,3915,"[np.float32(1.0), np.float32(0.0), np.float32(0.0), np.float32(1.0), np.float32(0.0), np.float32(1.0), np.float32(0.0), np.float32(1.0), np.float32(0.0), np.float32(0.0), np.float32(0.0), np.float32(0.0), np.float32(1.0), np.float32(0.0), np.float32(0.0), np.float32(1.0)]",-6.0,99691.0,2
2025-08-14_08-18-36,3916,"[np.float32(1.0), np.float32(1.0), np.float32(0.0), np.float32(1.0), np.float32(0.0), np.float32(1.0), np.float32(0.0), np.float32(1.0), np.float32(1.0), np.float32(1.0), np.float32(0.0), np.float32(1.0), np.float32(0.0), np.float32(0.0), np.float32(0.0), np.float32(0.0)]",-4.0,99687.0,5
2025-08-14_08-18-36,3917,"[np.float32(0.0), np.float32(1.0), np.float32(1.0), np.float32(1.0), np.float32(1.0), np.float32(1.0), np.float32(0.0), np.float32(1.0), np.float32(1.0), np.float32(0.0), np.float32(1.0), np.float32(0.0), np.float32(0.0), np.float32(0.0), np.float32(1.0), np.float32(0.0)]",-2.0,99685.0,34
2025-08-14_08-18-36,3918,"[np.float32(1.0), np.float32(0.0), np.float32(1.0), np.float32(0.0), np.float32(0.0), np.float32(1.0), np.float32(0.0), np.float32(1.0), np.float32(1.0), np.float32(1.0), np.float32(1.0), np.float32(0.0), np.float32(0.0), np.float32(0.0), np.float32(0.0), np.float32(1.0)]",-4.0,99681.0,12
2025-08-14_08-18-36,3919,"[np.float32(0.0), np.float32(0.0), np.float32(0.0), np.float32(1.0), np.float32(1.0), np.float32(0.0), np.float32(0.0), np.float32(0.0), np.float32(0.0), np.float32(1.0), np.float32(0.0), np.float32(0.0), np.float32(0.0), np.float32(0.0), np.float32(1.0), np.float32(0.0)]",0.0,99681.0,3
2025-08-14_08-18-36,3920,"[np.float32(1.0), np.float32(1.0), np.float32(1.0), np.float32(1.0), np.float32(0.0), np.float32(0.0), np.float32(1.0), np.float32(0.0), np.float32(0.0), np.float32(0.0), np.float32(0.0), np.float32(0.0), np.float32(0.0), np.float32(1.0), np.float32(1.0), np.float32(1.0)]",2.0,99683.0,11
2025-08-14_08-18-36,3921,"[np.float32(0.0), np.float32(0.0), np.float32(0.0), np.float32(0.0), np.float32(1.0), np.float32(0.0), np.float32(1.0), np.float32(1.0), np.float32(1.0), np.float32(1.0), np.float32(1.0), np.float32(1.0), np.float32(0.0), np.float32(1.0), np.float32(1.0), np.float32(0.0)]",-3.0,99680.0,20
2025-08-14_08-18-36,3922,"[np.float32(0.0), np.float32(0.0), np.float32(0.0), np.float32(1.0), np.float32(0.0), np.float32(1.0), np.float32(1.0), np.float32(0.0), np.float32(1.0), np.float32(1.0), np.float32(1.0), np.float32(1.0), np.float32(1.0), np.float32(0.0), np.float32(1.0), np.float32(1.0)]",-4.0,99676.0,14
2025-08-14_08-18-36,3923,"[np.float32(0.0), np.float32(1.0), np.float32(1.0), np.float32(1.0), np.float32(0.0), np.float32(1.0), np.float32(0.0), np.float32(1.0), np.float32(0.0), np.float32(0.0), np.float32(1.0), np.float32(0.0), np.float32(1.0), np.float32(0.0), np.float32(0.0), np.float32(1.0)]",-1.0,99675.0,2
2025-08-14_08-18-36,3924,"[np.float32(1.0), np.float32(0.0), np.float32(1.0), np.float32(0.0), np.float32(0.0), np.float32(0.0), np.float32(1.0), np.float32(0.0), np.float32(0.0), np.float32(1.0), np.float32(1.0), np.float32(1.0), np.float32(0.0), np.float32(1.0), np.float32(0.0), np.float32(0.0)]",4.0,99679.0,4
2025-08-14_08-18-36,3925,"[np.float32(1.0), np.float32(1.0), np.float32(1.0), np.float32(0.0), np.float32(1.0), np.float32(0.0), np.float32(1.0), np.float32(1.0), np.float32(1.0), np.float32(0.0), np.float32(0.0), np.float32(0.0), np.float32(1.0), np.float32(1.0), np.float32(1.0), np.float32(0.0)]",2.0,99681.0,4
2025-08-14_08-18-36,3926,"[np.float32(1.0), np.float32(1.0), np.float32(1.0), np.float32(0.0), np.float32(0.0), np.float32(1.0), np.float32(1.0), np.float32(0.0), np.float32(1.0), np.float32(1.0), np.float32(1.0), np.float32(0.0), np.float32(1.0), np.float32(1.0), np.float32(1.0), np.float32(1.0)]",3.0,99684.0,26
2025-08-14_08-18-36,3927,"[np.float32(0.0), np.float32(1.0), np.float32(1.0), np.float32(0.0), np.float32(1.0), np.float32(1.0), np.float32(0.0), np.float32(0.0), np.float32(0.0), np.float32(1.0), np.float32(0.0), np.float32(1.0), np.float32(1.0), np.float32(1.0), np.float32(0.0), np.float32(1.0)]",0.0,99684.0,26
2025-08-14_08-18-36,3928,"[np.float32(0.0), np.float32(1.0), np.float32(1.0), np.float32(1.0), np.float32(1.0), np.float32(1.0), np.float32(0.0), np.float32(1.0), np.float32(0.0), np.float32(0.0), np.float32(1.0), np.float32(0.0), np.float32(1.0), np.float32(1.0), np.float32(1.0), np.float32(1.0)]",-2.0,99682.0,6
2025-08-14_08-18-36,3929,"[np.float32(0.0), np.float32(1.0), np.float32(1.0), np.float32(1.0), np.float32(1.0), np.float32(0.0), np.float32(1.0), np.float32(0.0), np.float32(0.0), np.float32(1.0), np.float32(0.0), np.float32(1.0), np.float32(0.0), np.float32(0.0), np.float32(0.0), np.float32(0.0)]",0.0,99682.0,5
2025-08-14_08-18-36,3930,"[np.float32(1.0), np.float32(1.0), np.float32(1.0), np.float32(0.0), np.float32(1.0), np.float32(1.0), np.float32(1.0), np.float32(1.0), np.float32(0.0), np.float32(1.0), np.float32(0.0), np.float32(1.0), np.float32(1.0), np.float32(0.0), np.float32(0.0), np.float32(0.0)]",-4.0,99678.0,32
2025-08-14_08-18-36,3931,"[np.float32(0.0), np.float32(0.0), np.float32(1.0), np.float32(1.0), np.float32(0.0), np.float32(0.0), np.float32(1.0), np.float32(1.0), np.float32(0.0), np.float32(1.0), np.float32(0.0), np.float32(1.0), np.float32(1.0), np.float32(0.0), np.float32(1.0), np.float32(0.0)]",0.0,99678.0,19
2025-08-14_08-18-36,3932,"[np.float32(0.0), np.float32(1.0), np.float32(0.0), np.float32(1.0), np.float32(1.0), np.float32(0.0), np.float32(1.0), np.float32(1.0), np.float32(0.0), np.float32(1.0), np.float32(0.0), np.float32(0.0), np.float32(1.0), np.float32(0.0), np.float32(0.0), np.float32(0.0)]",0.0,99678.0,6
2025-08-14_08-18-36,3933,"[np.float32(1.0), np.float32(0.0), np.float32(1.0), np.float32(0.0), np.float32(1.0), np.float32(1.0), np.float32(0.0), np.float32(1.0), np.float32(1.0), np.float32(1.0), np.float32(1.0), np.float32(1.0), np.float32(1.0), np.float32(0.0), np.float32(1.0), np.float32(1.0)]",-2.0,99676.0,19
2025-08-14_08-18-36,3934,"[np.float32(1.0), np.float32(1.0), np.float32(1.0), np.float32(0.0), np.float32(0.0), np.float32(0.0), np.float32(1.0), np.float32(1.0), np.float32(1.0), np.float32(1.0), np.float32(1.0), np.float32(0.0), np.float32(1.0), np.float32(0.0), np.float32(0.0), np.float32(0.0)]",1.0,99677.0,4
2025-08-14_08-18-36,3935,"[np.float32(0.0), np.float32(0.0), np.float32(0.0), np.float32(1.0), np.float32(0.0), np.float32(1.0), np.float32(1.0), np.float32(1.0), np.float32(1.0), np.float32(0.0), np.float32(0.0), np.float32(0.0), np.float32(1.0), np.float32(0.0), np.float32(1.0), np.float32(0.0)]",0.0,99677.0,25
2025-08-14_08-18-36,3936,"[np.float32(0.0), np.float32(0.0), np.float32(0.0), np.float32(0.0), np.float32(0.0), np.float32(0.0), np.float32(0.0), np.float32(1.0), np.float32(1.0), np.float32(0.0), np.float32(1.0), np.float32(0.0), np.float32(0.0), np.float32(1.0), np.float32(1.0), np.float32(0.0)]",1.0,99678.0,15
2025-08-14_08-18-36,3937,"[np.float32(0.0), np.float32(1.0), np.float32(1.0), np.float32(1.0), np.float32(1.0), np.float32(0.0), np.float32(1.0), np.float32(1.0), np.float32(1.0), np.float32(0.0), np.float32(0.0), np.float32(0.0), np.float32(1.0), np.float32(0.0), np.float32(0.0), np.float32(0.0)]",1.0,99679.0,8
2025-08-14_08-18-36,3938,"[np.float32(0.0), np.float32(0.0), np.float32(1.0), np.float32(0.0), np.float32(0.0), np.float32(1.0), np.float32(0.0), np.float32(1.0), np.float32(1.0), np.float32(1.0), np.float32(0.0), np.float32(0.0), np.float32(0.0), np.float32(1.0), np.float32(0.0), np.float32(0.0)]",-4.0,99675.0,6
2025-08-14_08-18-36,3939,"[np.float32(1.0), np.float32(1.0), np.float32(1.0), np.float32(1.0), np.float32(1.0), np.float32(0.0), np.float32(1.0), np.float32(1.0), np.float32(0.0), np.float32(1.0), np.float32(0.0), np.float32(1.0), np.float32(1.0), np.float32(0.0), np.float32(1.0), np.float32(0.0)]",-2.0,99673.0,14
2025-08-14_08-18-36,3940,"[np.float32(0.0), np.float32(1.0), np.float32(0.0), np.float32(0.0), np.float32(1.0), np.float32(1.0), np.float32(0.0), np.float32(1.0), np.float32(0.0), np.float32(1.0), np.float32(0.0), np.float32(1.0), np.float32(0.0), np.float32(1.0), np.float32(1.0), np.float32(1.0)]",-2.0,99671.0,35
2025-08-14_08-18-36,3941,"[np.float32(1.0), np.float32(1.0), np.float32(0.0), np.float32(0.0), np.float32(1.0), np.float32(1.0), np.float32(0.0), np.float32(0.0), np.float32(1.0), np.float32(1.0), np.float32(0.0), np.float32(0.0), np.float32(1.0), np.float32(1.0), np.float32(1.0), np.float32(0.0)]",-2.0,99669.0,8
2025-08-14_08-18-36,3942,"[np.float32(0.0), np.float32(1.0), np.float32(0.0), np.float32(0.0), np.float32(0.0), np.float32(1.0), np.float32(1.0), np.float32(0.0), np.float32(1.0), np.float32(1.0), np.float32(0.0), np.float32(0.0), np.float32(1.0), np.float32(0.0), np.float32(0.0), np.float32(0.0)]",-4.0,99665.0,21
2025-08-14_08-18-36,3943,"[np.float32(1.0), np.float32(0.0), np.float32(0.0), np.float32(0.0), np.float32(0.0), np.float32(0.0), np.float32(0.0), np.float32(1.0), np.float32(1.0), np.float32(1.0), np.float32(1.0), np.float32(0.0), np.float32(0.0), np.float32(1.0), np.float32(0.0), np.float32(1.0)]",1.0,99666.0,16
2025-08-14_08-18-36,3944,"[np.float32(1.0), np.float32(0.0), np.float32(0.0), np.float32(0.0), np.float32(1.0), np.float32(0.0), np.float32(0.0), np.float32(1.0), np.float32(1.0), np.float32(1.0), np.float32(0.0), np.float32(1.0), np.float32(0.0), np.float32(1.0), np.float32(0.0), np.float32(0.0)]",-2.0,99664.0,2
2025-08-14_08-18-36,3945,"[np.float32(1.0), np.float32(0.0), np.float32(0.0), np.float32(1.0), np.float32(0.0), np.float32(1.0), np.float32(1.0), np.float32(0.0), np.float32(1.0), np.float32(1.0), np.float32(1.0), np.float32(1.0), np.float32(1.0), np.float32(0.0), np.float32(0.0), np.float32(1.0)]",3.0,99667.0,1
2025-08-14_08-18-36,3946,"[np.float32(0.0), np.float32(1.0), np.float32(0.0), np.float32(1.0), np.float32(0.0), np.float32(0.0), np.float32(1.0), np.float32(1.0), np.float32(1.0), np.float32(1.0), np.float32(0.0), np.float32(1.0), np.float32(0.0), np.float32(0.0), np.float32(0.0), np.float32(0.0)]",-1.0,99666.0,16
2025-08-14_08-18-36,3947,"[np.float32(1.0), np.float32(1.0), np.float32(1.0), np.float32(1.0), np.float32(0.0), np.float32(1.0), np.float32(1.0), np.float32(0.0), np.float32(1.0), np.float32(0.0), np.float32(0.0), np.float32(1.0), np.float32(1.0), np.float32(1.0), np.float32(1.0), np.float32(0.0)]",-1.0,99665.0,4
2025-08-14_08-18-36,3948,"[np.float32(0.0), np.float32(1.0), np.float32(0.0), np.float32(1.0), np.float32(0.0), np.float32(1.0), np.float32(0.0), np.float32(0.0), np.float32(1.0), np.float32(0.0), np.float32(1.0), np.float32(0.0), np.float32(0.0), np.float32(1.0), np.float32(1.0), np.float32(0.0)]",0.0,99665.0,15
2025-08-14_08-18-36,3949,"[np.float32(1.0), np.float32(1.0), np.float32(0.0), np.float32(1.0), np.float32(0.0), np.float32(1.0), np.float32(0.0), np.float32(0.0), np.float32(1.0), np.float32(0.0), np.float32(1.0), np.float32(1.0), np.float32(0.0), np.float32(1.0), np.float32(0.0), np.float32(0.0)]",7.0,99672.0,35
2025-08-14_08-18-36,3950,"[np.float32(1.0), np.float32(0.0), np.float32(0.0), np.float32(1.0), np.float32(1.0), np.float32(0.0), np.float32(0.0), np.float32(0.0), np.float32(1.0), np.float32(0.0), np.float32(1.0), np.float32(1.0), np.float32(1.0), np.float32(0.0), np.float32(1.0), np.float32(0.0)]",3.0,99675.0,36
2025-08-14_08-18-36,3951,"[np.float32(0.0), np.float32(1.0), np.float32(0.0), np.float32(1.0), np.float32(1.0), np.float32(1.0), np.float32(0.0), np.float32(1.0), np.float32(0.0), np.float32(1.0), np.float32(1.0), np.float32(0.0), np.float32(0.0), np.float32(1.0), np.float32(0.0), np.float32(0.0)]",4.0,99679.0,29
2025-08-14_08-18-36,3952,"[np.float32(1.0), np.float32(0.0), np.float32(1.0), np.float32(1.0), np.float32(0.0), np.float32(1.0), np.float32(1.0), np.float32(1.0), np.float32(1.0), np.float32(1.0), np.float32(0.0), np.float32(0.0), np.float32(1.0), np.float32(1.0), np.float32(0.0), np.float32(1.0)]",1.0,99680.0,21
2025-08-14_08-18-36,3953,"[np.float32(0.0), np.float32(1.0), np.float32(0.0), np.float32(0.0), np.float32(0.0), np.float32(0.0), np.float32(1.0), np.float32(0.0), np.float32(1.0), np.float32(0.0), np.float32(0.0), np.float32(1.0), np.float32(0.0), np.float32(0.0), np.float32(1.0), np.float32(0.0)]",-3.0,99677.0,20
2025-08-14_08-18-36,3954,"[np.float32(0.0), np.float32(1.0), np.float32(0.0), np.float32(0.0), np.float32(1.0), np.float32(1.0), np.float32(0.0), np.float32(1.0), np.float32(0.0), np.float32(1.0), np.float32(1.0), np.float32(0.0), np.float32(0.0), np.float32(1.0), np.float32(0.0), np.float32(0.0)]",-3.0,99674.0,33
2025-08-14_08-18-36,3955,"[np.float32(0.0), np.float32(0.0), np.float32(1.0), np.float32(1.0), np.float32(0.0), np.float32(1.0), np.float32(0.0), np.float32(1.0), np.float32(0.0), np.float32(0.0), np.float32(0.0), np.float32(0.0), np.float32(1.0), np.float32(1.0), np.float32(0.0), np.float32(1.0)]",1.0,99675.0,18
2025-08-14_08-18-36,3956,"[np.float32(0.0), np.float32(0.0), np.float32(0.0), np.float32(0.0), np.float32(1.0), np.float32(0.0), np.float32(0.0), np.float32(0.0), np.float32(1.0), np.float32(1.0), np.float32(1.0), np.float32(1.0), np.float32(1.0), np.float32(0.0), np.float32(0.0), np.float32(1.0)]",2.0,99677.0,34
2025-08-14_08-18-36,3957,"[np.float32(0.0), np.float32(0.0), np.float32(1.0), np.float32(1.0), np.float32(1.0), np.float32(1.0), np.float32(0.0), np.float32(1.0), np.float32(0.0), np.float32(1.0), np.float32(1.0), np.float32(1.0), np.float32(0.0), np.float32(1.0), np.float32(0.0), np.float32(0.0)]",-2.0,99675.0,11
2025-08-14_08-18-36,3958,"[np.float32(1.0), np.float32(0.0), np.float32(0.0), np.float32(1.0), np.float32(0.0), np.float32(0.0), np.float32(1.0), np.float32(0.0), np.float32(1.0), np.float32(1.0), np.float32(1.0), np.float32(1.0), np.float32(0.0), np.float32(0.0), np.float32(0.0), np.float32(1.0)]",-2.0,99673.0,10
2025-08-14_08-18-36,3959,"[np.float32(1.0), np.float32(0.0), np.float32(1.0), np.float32(0.0), np.float32(1.0), np.float32(0.0), np.float32(0.0), np.float32(1.0), np.float32(0.0), np.float32(1.0), np.float32(1.0), np.float32(1.0), np.float32(1.0), np.float32(0.0), np.float32(0.0), np.float32(1.0)]",2.0,99675.0,17
2025-08-14_08-18-36,3960,"[np.float32(0.0), np.float32(1.0), np.float32(0.0), np.float32(1.0), np.float32(0.0), np.float32(0.0), np.float32(0.0), np.float32(1.0), np.float32(1.0), np.float32(1.0), np.float32(1.0), np.float32(0.0), np.float32(0.0), np.float32(1.0), np.float32(1.0), np.float32(0.0)]",1.0,99676.0,16
2025-08-14_08-18-36,3961,"[np.float32(0.0), np.float32(1.0), np.float32(1.0), np.float32(1.0), np.float32(0.0), np.float32(1.0), np.float32(1.0), np.float32(1.0), np.float32(1.0), np.float32(0.0), np.float32(1.0), np.float32(1.0), np.float32(0.0), np.float32(1.0), np.float32(0.0), np.float32(0.0)]",0.0,99676.0,8
2025-08-14_08-18-36,3962,"[np.float32(0.0), np.float32(0.0), np.float32(1.0), np.float32(1.0), np.float32(1.0), np.float32(0.0), np.float32(1.0), np.float32(0.0), np.float32(1.0), np.float32(1.0), np.float32(1.0), np.float32(0.0), np.float32(1.0), np.float32(1.0), np.float32(0.0), np.float32(0.0)]",-2.0,99674.0,13
2025-08-14_08-18-36,3963,"[np.float32(0.0), np.float32(1.0), np.float32(0.0), np.float32(1.0), np.float32(1.0), np.float32(1.0), np.float32(0.0), np.float32(1.0), np.float32(1.0), np.float32(0.0), np.float32(1.0), np.float32(0.0), np.float32(0.0), np.float32(1.0), np.float32(0.0), np.float32(0.0)]",1.0,99675.0,31
2025-08-14_08-18-36,3964,"[np.float32(1.0), np.float32(0.0), np.float32(0.0), np.float32(0.0), np.float32(1.0), np.float32(0.0), np.float32(1.0), np.float32(1.0), np.float32(1.0), np.float32(1.0), np.float32(0.0), np.float32(1.0), np.float32(0.0), np.float32(1.0), np.float32(0.0), np.float32(1.0)]",4.0,99679.0,3
2025-08-14_08-18-36,3965,"[np.float32(1.0), np.float32(1.0), np.float32(1.0), np.float32(0.0), np.float32(0.0), np.float32(1.0), np.float32(0.0), np.float32(1.0), np.float32(0.0), np.float32(1.0), np.float32(1.0), np.float32(0.0), np.float32(1.0), np.float32(1.0), np.float32(1.0), np.float32(0.0)]",2.0,99681.0,28
2025-08-14_08-18-36,3966,"[np.float32(1.0), np.float32(0.0), np.float32(1.0), np.float32(0.0), np.float32(0.0), np.float32(1.0), np.float32(1.0), np.float32(0.0), np.float32(0.0), np.float32(1.0), np.float32(0.0), np.float32(0.0), np.float32(0.0), np.float32(0.0), np.float32(1.0), np.float32(1.0)]",-3.0,99678.0,26
2025-08-14_08-18-36,3967,"[np.float32(0.0), np.float32(0.0), np.float32(0.0), np.float32(0.0), np.float32(1.0), np.float32(0.0), np.float32(0.0), np.float32(1.0), np.float32(1.0), np.float32(1.0), np.float32(0.0), np.float32(1.0), np.float32(1.0), np.float32(0.0), np.float32(0.0), np.float32(0.0)]",0.0,99678.0,21
2025-08-14_08-18-36,3968,"[np.float32(1.0), np.float32(1.0), np.float32(1.0), np.float32(1.0), np.float32(0.0), np.float32(1.0), np.float32(0.0), np.float32(1.0), np.float32(1.0), np.float32(0.0), np.float32(1.0), np.float32(1.0), np.float32(1.0), np.float32(1.0), np.float32(0.0), np.float32(0.0)]",-7.0,99671.0,10
2025-08-14_08-18-36,3969,"[np.float32(0.0), np.float32(0.0), np.float32(1.0), np.float32(1.0), np.float32(1.0), np.float32(0.0), np.float32(1.0), np.float32(1.0), np.float32(0.0), np.float32(1.0), np.float32(0.0), np.float32(1.0), np.float32(1.0), np.float32(0.0), np.float32(1.0), np.float32(1.0)]",-2.0,99669.0,27
2025-08-14_08-18-36,3970,"[np.float32(0.0), np.float32(1.0), np.float32(1.0), np.float32(1.0), np.float32(0.0), np.float32(1.0), np.float32(1.0), np.float32(0.0), np.float32(1.0), np.float32(1.0), np.float32(0.0), np.float32(1.0), np.float32(0.0), np.float32(0.0), np.float32(0.0), np.float32(0.0)]",2.0,99671.0,34
2025-08-14_08-18-36,3971,"[np.float32(1.0), np.float32(0.0), np.float32(0.0), np.float32(0.0), np.float32(1.0), np.float32(0.0), np.float32(0.0), np.float32(0.0), np.float32(1.0), np.float32(1.0), np.float32(0.0), np.float32(1.0), np.float32(0.0), np.float32(0.0), np.float32(1.0), np.float32(1.0)]",2.0,99673.0,33
2025-08-14_08-18-36,3972,"[np.float32(1.0), np.float32(1.0), np.float32(1.0), np.float32(0.0), np.float32(0.0), np.float32(0.0), np.float32(0.0), np.float32(0.0), np.float32(1.0), np.float32(0.0), np.float32(1.0), np.float32(1.0), np.float32(1.0), np.float32(0.0), np.float32(0.0), np.float32(0.0)]",0.0,99673.0,8
2025-08-14_08-18-36,3973,"[np.float32(1.0), np.float32(1.0), np.float32(0.0), np.float32(0.0), np.float32(0.0), np.float32(1.0), np.float32(0.0), np.float32(0.0), np.float32(0.0), np.float32(0.0), np.float32(1.0), np.float32(1.0), np.float32(0.0), np.float32(0.0), np.float32(0.0), np.float32(1.0)]",1.0,99674.0,30
2025-08-14_08-18-36,3974,"[np.float32(1.0), np.float32(0.0), np.float32(0.0), np.float32(0.0), np.float32(0.0), np.float32(1.0), np.float32(1.0), np.float32(1.0), np.float32(1.0), np.float32(0.0), np.float32(0.0), np.float32(0.0), np.float32(1.0), np.float32(1.0), np.float32(1.0), np.float32(0.0)]",2.0,99676.0,32
2025-08-14_08-18-36,3975,"[np.float32(0.0), np.float32(0.0), np.float32(1.0), np.float32(0.0), np.float32(0.0), np.float32(1.0), np.float32(1.0), np.float32(1.0), np.float32(1.0), np.float32(0.0), np.float32(0.0), np.float32(1.0), np.float32(1.0), np.float32(0.0), np.float32(0.0), np.float32(0.0)]",-2.0,99674.0,2
2025-08-14_08-18-36,3976,"[np.float32(0.0), np.float32(1.0), np.float32(0.0), np.float32(1.0), np.float32(1.0), np.float32(0.0), np.float32(0.0), np.float32(0.0), np.float32(0.0), np.float32(1.0), np.float32(1.0), np.float32(1.0), np.float32(0.0), np.float32(1.0), np.float32(1.0), np.float32(1.0)]",-1.0,99673.0,14
2025-08-14_08-18-36,3977,"[np.float32(0.0), np.float32(0.0), np.float32(0.0), np.float32(1.0), np.float32(0.0), np.float32(0.0), np.float32(1.0), np.float32(0.0), np.float32(0.0), np.float32(1.0), np.float32(0.0), np.float32(0.0), np.float32(1.0), np.float32(0.0), np.float32(1.0), np.float32(0.0)]",-2.0,99671.0,28
2025-08-14_08-18-36,3978,"[np.float32(0.0), np.float32(0.0), np.float32(0.0), np.float32(0.0), np.float32(1.0), np.float32(0.0), np.float32(0.0), np.float32(1.0), np.float32(0.0), np.float32(1.0), np.float32(0.0), np.float32(0.0), np.float32(0.0), np.float32(0.0), np.float32(0.0), np.float32(1.0)]",-1.0,99670.0,21
2025-08-14_08-18-36,3979,"[np.float32(0.0), np.float32(1.0), np.float32(1.0), np.float32(1.0), np.float32(0.0), np.float32(1.0), np.float32(1.0), np.float32(0.0), np.float32(0.0), np.float32(1.0), np.float32(1.0), np.float32(1.0), np.float32(0.0), np.float32(0.0), np.float32(1.0), np.float32(1.0)]",2.0,99672.0,31
2025-08-14_08-18-36,3980,"[np.float32(1.0), np.float32(0.0), np.float32(1.0), np.float32(1.0), np.float32(0.0), np.float32(1.0), np.float32(0.0), np.float32(1.0), np.float32(1.0), np.float32(1.0), np.float32(1.0), np.float32(0.0), np.float32(0.0), np.float32(1.0), np.float32(0.0), np.float32(1.0)]",0.0,99672.0,1
2025-08-14_08-18-36,3981,"[np.float32(0.0), np.float32(1.0), np.float32(1.0), np.float32(0.0), np.float32(1.0), np.float32(0.0), np.float32(0.0), np.float32(0.0), np.float32(1.0), np.float32(0.0), np.float32(0.0), np.float32(1.0), np.float32(0.0), np.float32(0.0), np.float32(0.0), np.float32(1.0)]",1.0,99673.0,15
2025-08-14_08-18-36,3982,"[np.float32(1.0), np.float32(0.0), np.float32(1.0), np.float32(1.0), np.float32(0.0), np.float32(0.0), np.float32(1.0), np.float32(1.0), np.float32(1.0), np.float32(1.0), np.float32(0.0), np.float32(0.0), np.float32(1.0), np.float32(1.0), np.float32(0.0), np.float32(1.0)]",1.0,99674.0,31
2025-08-14_08-18-36,3983,"[np.float32(1.0), np.float32(0.0), np.float32(1.0), np.float32(1.0), np.float32(1.0), np.float32(0.0), np.float32(1.0), np.float32(1.0), np.float32(1.0), np.float32(1.0), np.float32(0.0), np.float32(1.0), np.float32(1.0), np.float32(1.0), np.float32(1.0), np.float32(0.0)]",1.0,99675.0,19
2025-08-14_08-18-36,3984,"[np.float32(1.0), np.float32(0.0), np.float32(1.0), np.float32(1.0), np.float32(0.0), np.float32(0.0), np.float32(1.0), np.float32(0.0), np.float32(0.0), np.float32(1.0), np.float32(1.0), np.float32(1.0), np.float32(1.0), np.float32(0.0), np.float32(0.0), np.float32(1.0)]",-4.0,99671.0,29
2025-08-14_08-18-36,3985,"[np.float32(1.0), np.float32(1.0), np.float32(0.0), np.float32(1.0), np.float32(0.0), np.float32(1.0), np.float32(0.0), np.float32(1.0), np.float32(0.0), np.float32(0.0), np.float32(1.0), np.float32(0.0), np.float32(0.0), np.float32(0.0), np.float32(0.0), np.float32(1.0)]",-5.0,99666.0,12
2025-08-14_08-18-36,3986,"[np.float32(0.0), np.float32(1.0), np.float32(0.0), np.float32(1.0), np.float32(0.0), np.float32(0.0), np.float32(1.0), np.float32(0.0), np.float32(1.0), np.float32(0.0), np.float32(1.0), np.float32(1.0), np.float32(0.0), np.float32(1.0), np.float32(0.0), np.float32(1.0)]",-3.0,99663.0,19
2025-08-14_08-18-36,3987,"[np.float32(1.0), np.float32(0.0), np.float32(1.0), np.float32(1.0), np.float32(1.0), np.float32(0.0), np.float32(0.0), np.float32(0.0), np.float32(0.0), np.float32(1.0), np.float32(1.0), np.float32(1.0), np.float32(1.0), np.float32(0.0), np.float32(1.0), np.float32(0.0)]",36.0,99699.0,7
2025-08-14_08-18-36,3988,"[np.float32(0.0), np.float32(1.0), np.float32(1.0), np.float32(0.0), np.float32(0.0), np.float32(0.0), np.float32(1.0), np.float32(0.0), np.float32(1.0), np.float32(1.0), np.float32(0.0), np.float32(1.0), np.float32(1.0), np.float32(1.0), np.float32(1.0), np.float32(1.0)]",-1.0,99698.0,9
2025-08-14_08-18-36,3989,"[np.float32(1.0), np.float32(1.0), np.float32(1.0), np.float32(1.0), np.float32(0.0), np.float32(1.0), np.float32(1.0), np.float32(1.0), np.float32(1.0), np.float32(1.0), np.float32(0.0), np.float32(1.0), np.float32(1.0), np.float32(1.0), np.float32(0.0), np.float32(1.0)]",-1.0,99697.0,29
2025-08-14_08-18-36,3990,"[np.float32(1.0), np.float32(0.0), np.float32(1.0), np.float32(1.0), np.float32(0.0), np.float32(1.0), np.float32(1.0), np.float32(1.0), np.float32(1.0), np.float32(1.0), np.float32(0.0), np.float32(0.0), np.float32(0.0), np.float32(0.0), np.float32(0.0), np.float32(0.0)]",-1.0,99696.0,26
2025-08-14_08-18-36,3991,"[np.float32(1.0), np.float32(0.0), np.float32(0.0), np.float32(0.0), np.float32(0.0), np.float32(1.0), np.float32(0.0), np.float32(0.0), np.float32(0.0), np.float32(0.0), np.float32(0.0), np.float32(0.0), np.float32(0.0), np.float32(1.0), np.float32(1.0), np.float32(0.0)]",3.0,99699.0,25
2025-08-14_08-18-36,3992,"[np.float32(0.0), np.float32(1.0), np.float32(0.0), np.float32(1.0), np.float32(0.0), np.float32(0.0), np.float32(1.0), np.float32(0.0), np.float32(1.0), np.float32(0.0), np.float32(0.0), np.float32(0.0), np.float32(1.0), np.float32(0.0), np.float32(1.0), np.float32(0.0)]",-4.0,99695.0,22
2025-08-14_08-18-36,3993,"[np.float32(0.0), np.float32(0.0), np.float32(1.0), np.float32(0.0), np.float32(0.0), np.float32(1.0), np.float32(1.0), np.float32(1.0), np.float32(0.0), np.float32(0.0), np.float32(1.0), np.float32(0.0), np.float32(0.0), np.float32(1.0), np.float32(1.0), np.float32(0.0)]",-1.0,99694.0,13
2025-08-14_08-18-36,3994,"[np.float32(0.0), np.float32(0.0), np.float32(0.0), np.float32(1.0), np.float32(0.0), np.float32(1.0), np.float32(1.0), np.float32(0.0), np.float32(0.0), np.float32(0.0), np.float32(1.0), np.float32(0.0), np.float32(1.0), np.float32(1.0), np.float32(1.0), np.float32(1.0)]",-1.0,99693.0,27
2025-08-14_08-18-36,3995,"[np.float32(0.0), np.float32(1.0), np.float32(0.0), np.float32(0.0), np.float32(0.0), np.float32(1.0), np.float32(0.0), np.float32(0.0), np.float32(1.0), np.float32(1.0), np.float32(1.0), np.float32(0.0), np.float32(0.0), np.float32(1.0), np.float32(1.0), np.float32(1.0)]",-2.0,99691.0,1
2025-08-14_08-18-36,3996,"[np.float32(0.0), np.float32(0.0), np.float32(0.0), np.float32(0.0), np.float32(1.0), np.float32(1.0), np.float32(1.0), np.float32(1.0), np.float32(0.0), np.float32(1.0), np.float32(1.0), np.float32(1.0), np.float32(0.0), np.float32(0.0), np.float32(1.0), np.float32(1.0)]",2.0,99693.0,6
2025-08-14_08-18-36,3997,"[np.float32(0.0), np.float32(1.0), np.float32(1.0), np.float32(0.0), np.float32(0.0), np.float32(1.0), np.float32(0.0), np.float32(0.0), np.float32(1.0), np.float32(1.0), np.float32(1.0), np.float32(0.0), np.float32(0.0), np.float32(0.0), np.float32(0.0), np.float32(0.0)]",1.0,99694.0,30
2025-08-14_08-18-36,3998,"[np.float32(0.0), np.float32(0.0), np.float32(1.0), np.float32(1.0), np.float32(1.0), np.float32(1.0), np.float32(0.0), np.float32(1.0), np.float32(0.0), np.float32(1.0), np.float32(0.0), np.float32(1.0), np.float32(0.0), np.float32(0.0), np.float32(0.0), np.float32(0.0)]",0.0,99694.0,3
2025-08-14_08-18-36,3999,"[np.float32(1.0), np.float32(0.0), np.float32(1.0), np.float32(0.0), np.float32(1.0), np.float32(1.0), np.float32(1.0), np.float32(1.0), np.float32(0.0), np.float32(1.0), np.float32(1.0), np.float32(0.0), np.float32(0.0), np.float32(1.0), np.float32(0.0), np.float32(1.0)]",-3.0,99691.0,24
2025-08-14_08-18-36,4000,"[np.float32(1.0), np.float32(0.0), np.float32(1.0), np.float32(0.0), np.float32(1.0), np.float32(1.0), np.float32(0.0), np.float32(1.0), np.float32(0.0), np.float32(0.0), np.float32(0.0), np.float32(0.0), np.float32(1.0), np.float32(1.0), np.float32(0.0), np.float32(0.0)]",-1.0,99690.0,34
2025-08-14_08-18-36,4001,"[np.float32(1.0), np.float32(1.0), np.float32(1.0), np.float32(0.0), np.float32(0.0), np.float32(0.0), np.float32(1.0), np.float32(1.0), np.float32(1.0), np.float32(0.0), np.float32(0.0), np.float32(1.0), np.float32(1.0), np.float32(1.0), np.float32(0.0), np.float32(0.0)]",4.0,99641.0,18
2025-08-14_08-18-36,4002,"[np.float32(0.0), np.float32(1.0), np.float32(0.0), np.float32(1.0), np.float32(0.0), np.float32(1.0), np.float32(1.0), np.float32(0.0), np.float32(1.0), np.float32(0.0), np.float32(0.0), np.float32(0.0), np.float32(1.0), np.float32(1.0), np.float32(0.0), np.float32(0.0)]",3.0,99644.0,25
2025-08-14_08-18-36,4003,"[np.float32(1.0), np.float32(0.0), np.float32(0.0), np.float32(0.0), np.float32(0.0), np.float32(1.0), np.float32(0.0), np.float32(1.0), np.float32(0.0), np.float32(0.0), np.float32(0.0), np.float32(1.0), np.float32(1.0), np.float32(1.0), np.float32(0.0), np.float32(1.0)]",6.0,99650.0,21
2025-08-14_08-18-36,4004,"[np.float32(0.0), np.float32(0.0), np.float32(1.0), np.float32(1.0), np.float32(1.0), np.float32(0.0), np.float32(1.0), np.float32(1.0), np.float32(1.0), np.float32(1.0), np.float32(1.0), np.float32(1.0), np.float32(0.0), np.float32(0.0), np.float32(0.0), np.float32(0.0)]",1.0,99651.0,12
2025-08-14_08-18-36,4005,"[np.float32(0.0), np.float32(1.0), np.float32(0.0), np.float32(0.0), np.float32(0.0), np.float32(1.0), np.float32(1.0), np.float32(0.0), np.float32(1.0), np.float32(1.0), np.float32(0.0), np.float32(0.0), np.float32(1.0), np.float32(1.0), np.float32(0.0), np.float32(1.0)]",0.0,99651.0,6
2025-08-14_08-18-36,4006,"[np.float32(0.0), np.float32(0.0), np.float32(1.0), np.float32(0.0), np.float32(0.0), np.float32(0.0), np.float32(1.0), np.float32(1.0), np.float32(0.0), np.float32(1.0), np.float32(0.0), np.float32(0.0), np.float32(1.0), np.float32(1.0), np.float32(0.0), np.float32(0.0)]",2.0,99653.0,16
2025-08-14_08-18-36,4007,"[np.float32(1.0), np.float32(0.0), np.float32(0.0), np.float32(0.0), np.float32(1.0), np.float32(1.0), np.float32(0.0), np.float32(1.0), np.float32(1.0), np.float32(1.0), np.float32(1.0), np.float32(0.0), np.float32(1.0), np.float32(0.0), np.float32(1.0), np.float32(1.0)]",1.0,99654.0,17
2025-08-14_08-18-36,4008,"[np.float32(0.0), np.float32(1.0), np.float32(1.0), np.float32(1.0), np.float32(0.0), np.float32(0.0), np.float32(1.0), np.float32(1.0), np.float32(1.0), np.float32(0.0), np.float32(1.0), np.float32(0.0), np.float32(0.0), np.float32(0.0), np.float32(1.0), np.float32(1.0)]",-2.0,99652.0,4
2025-08-14_08-18-36,4009,"[np.float32(0.0), np.float32(1.0), np.float32(0.0), np.float32(1.0), np.float32(1.0), np.float32(1.0), np.float32(1.0), np.float32(0.0), np.float32(1.0), np.float32(0.0), np.float32(0.0), np.float32(0.0), np.float32(1.0), np.float32(0.0), np.float32(0.0), np.float32(1.0)]",-4.0,99648.0,23
2025-08-14_08-18-36,4010,"[np.float32(0.0), np.float32(0.0), np.float32(0.0), np.float32(0.0), np.float32(0.0), np.float32(0.0), np.float32(1.0), np.float32(0.0), np.float32(1.0), np.float32(1.0), np.float32(1.0), np.float32(0.0), np.float32(1.0), np.float32(1.0), np.float32(1.0), np.float32(1.0)]",1.0,99649.0,4
2025-08-14_08-18-36,4011,"[np.float32(1.0), np.float32(1.0), np.float32(1.0), np.float32(0.0), np.float32(0.0), np.float32(1.0), np.float32(1.0), np.float32(1.0), np.float32(0.0), np.float32(1.0), np.float32(0.0), np.float32(0.0), np.float32(1.0), np.float32(0.0), np.float32(1.0), np.float32(1.0)]",-1.0,99648.0,28
2025-08-14_08-18-36,4012,"[np.float32(0.0), np.float32(0.0), np.float32(0.0), np.float32(0.0), np.float32(1.0), np.float32(1.0), np.float32(1.0), np.float32(0.0), np.float32(0.0), np.float32(1.0), np.float32(0.0), np.float32(0.0), np.float32(0.0), np.float32(0.0), np.float32(0.0), np.float32(1.0)]",3.0,99651.0,4
2025-08-14_08-18-36,4013,"[np.float32(0.0), np.float32(0.0), np.float32(1.0), np.float32(0.0), np.float32(1.0), np.float32(0.0), np.float32(1.0), np.float32(1.0), np.float32(1.0), np.float32(1.0), np.float32(0.0), np.float32(1.0), np.float32(1.0), np.float32(1.0), np.float32(0.0), np.float32(0.0)]",-4.0,99647.0,11
2025-08-14_08-18-36,4014,"[np.float32(0.0), np.float32(0.0), np.float32(1.0), np.float32(1.0), np.float32(0.0), np.float32(1.0), np.float32(0.0), np.float32(1.0), np.float32(1.0), np.float32(0.0), np.float32(0.0), np.float32(0.0), np.float32(0.0), np.float32(0.0), np.float32(0.0), np.float32(0.0)]",0.0,99647.0,15
2025-08-14_08-18-36,4015,"[np.float32(0.0), np.float32(1.0), np.float32(1.0), np.float32(0.0), np.float32(0.0), np.float32(1.0), np.float32(1.0), np.float32(0.0), np.float32(1.0), np.float32(1.0), np.float32(1.0), np.float32(0.0), np.float32(0.0), np.float32(1.0), np.float32(0.0), np.float32(0.0)]",-5.0,99642.0,9
2025-08-14_08-18-36,4016,"[np.float32(0.0), np.float32(0.0), np.float32(1.0), np.float32(1.0), np.float32(0.0), np.float32(0.0), np.float32(0.0), np.float32(0.0), np.float32(0.0), np.float32(0.0), np.float32(0.0), np.float32(1.0), np.float32(0.0), np.float32(0.0), np.float32(1.0), np.float32(1.0)]",-3.0,99639.0,29
2025-08-14_08-18-36,4017,"[np.float32(1.0), np.float32(1.0), np.float32(0.0), np.float32(1.0), np.float32(1.0), np.float32(1.0), np.float32(0.0), np.float32(0.0), np.float32(0.0), np.float32(0.0), np.float32(0.0), np.float32(1.0), np.float32(1.0), np.float32(1.0), np.float32(1.0), np.float32(0.0)]",1.0,99640.0,30
2025-08-14_08-18-36,4018,"[np.float32(0.0), np.float32(0.0), np.float32(0.0), np.float32(0.0), np.float32(0.0), np.float32(0.0), np.float32(1.0), np.float32(1.0), np.float32(1.0), np.float32(0.0), np.float32(0.0), np.float32(0.0), np.float32(0.0), np.float32(1.0), np.float32(0.0), np.float32(0.0)]",2.0,99642.0,2
2025-08-14_08-18-36,4019,"[np.float32(0.0), np.float32(0.0), np.float32(0.0), np.float32(1.0), np.float32(0.0), np.float32(1.0), np.float32(0.0), np.float32(1.0), np.float32(1.0), np.float32(1.0), np.float32(1.0), np.float32(0.0), np.float32(1.0), np.float32(0.0), np.float32(0.0), np.float32(1.0)]",1.0,99643.0,14
2025-08-14_08-18-36,4020,"[np.float32(0.0), np.float32(1.0), np.float32(1.0), np.float32(0.0), np.float32(0.0), np.float32(1.0), np.float32(1.0), np.float32(1.0), np.float32(1.0), np.float32(1.0), np.float32(0.0), np.float32(0.0), np.float32(1.0), np.float32(0.0), np.float32(0.0), np.float32(0.0)]",0.0,99643.0,16
2025-08-14_08-18-36,4021,"[np.float32(1.0), np.float32(1.0), np.float32(0.0), np.float32(0.0), np.float32(1.0), np.float32(0.0), np.float32(1.0), np.float32(1.0), np.float32(1.0), np.float32(1.0), np.float32(0.0), np.float32(0.0), np.float32(0.0), np.float32(0.0), np.float32(0.0), np.float32(1.0)]",2.0,99645.0,4
2025-08-14_08-18-36,4022,"[np.float32(1.0), np.float32(1.0), np.float32(1.0), np.float32(0.0), np.float32(0.0), np.float32(1.0), np.float32(1.0), np.float32(1.0), np.float32(1.0), np.float32(1.0), np.float32(1.0), np.float32(0.0), np.float32(1.0), np.float32(0.0), np.float32(0.0), np.float32(0.0)]",-2.0,99643.0,11
2025-08-14_08-18-36,4023,"[np.float32(1.0), np.float32(0.0), np.float32(0.0), np.float32(0.0), np.float32(0.0), np.float32(1.0), np.float32(1.0), np.float32(1.0), np.float32(0.0), np.float32(0.0), np.float32(1.0), np.float32(0.0), np.float32(0.0), np.float32(0.0), np.float32(0.0), np.float32(0.0)]",1.0,99644.0,2
2025-08-14_08-18-36,4024,"[np.float32(0.0), np.float32(1.0), np.float32(0.0), np.float32(0.0), np.float32(0.0), np.float32(0.0), np.float32(0.0), np.float32(0.0), np.float32(1.0), np.float32(0.0), np.float32(1.0), np.float32(0.0), np.float32(1.0), np.float32(1.0), np.float32(1.0), np.float32(1.0)]",32.0,99676.0,7
2025-08-14_08-18-36,4025,"[np.float32(0.0), np.float32(1.0), np.float32(0.0), np.float32(0.0), np.float32(0.0), np.float32(0.0), np.float32(1.0), np.float32(0.0), np.float32(1.0), np.float32(0.0), np.float32(1.0), np.float32(1.0), np.float32(1.0), np.float32(0.0), np.float32(1.0), np.float32(0.0)]",-2.0,99674.0,31
2025-08-14_08-18-36,4026,"[np.float32(0.0), np.float32(1.0), np.float32(0.0), np.float32(1.0), np.float32(0.0), np.float32(1.0), np.float32(1.0), np.float32(0.0), np.float32(1.0), np.float32(0.0), np.float32(1.0), np.float32(0.0), np.float32(1.0), np.float32(1.0), np.float32(0.0), np.float32(0.0)]",-1.0,99673.0,22
2025-08-14_08-18-36,4027,"[np.float32(1.0), np.float32(1.0), np.float32(1.0), np.float32(0.0), np.float32(1.0), np.float32(0.0), np.float32(1.0), np.float32(1.0), np.float32(0.0), np.float32(1.0), np.float32(0.0), np.float32(0.0), np.float32(1.0), np.float32(0.0), np.float32(1.0), np.float32(0.0)]",3.0,99676.0,4
2025-08-14_08-18-36,4028,"[np.float32(0.0), np.float32(0.0), np.float32(1.0), np.float32(0.0), np.float32(1.0), np.float32(0.0), np.float32(0.0), np.float32(1.0), np.float32(0.0), np.float32(1.0), np.float32(0.0), np.float32(1.0), np.float32(0.0), np.float32(1.0), np.float32(1.0), np.float32(0.0)]",1.0,99677.0,30
2025-08-14_08-18-36,4029,"[np.float32(0.0), np.float32(0.0), np.float32(1.0), np.float32(0.0), np.float32(1.0), np.float32(0.0), np.float32(1.0), np.float32(0.0), np.float32(0.0), np.float32(0.0), np.float32(1.0), np.float32(0.0), np.float32(0.0), np.float32(1.0), np.float32(1.0), np.float32(0.0)]",2.0,99679.0,32
2025-08-14_08-18-36,4030,"[np.float32(1.0), np.float32(1.0), np.float32(0.0), np.float32(1.0), np.float32(1.0), np.float32(1.0), np.float32(1.0), np.float32(0.0), np.float32(1.0), np.float32(0.0), np.float32(1.0), np.float32(0.0), np.float32(0.0), np.float32(1.0), np.float32(0.0), np.float32(1.0)]",-3.0,99676.0,36
2025-08-14_08-18-36,4031,"[np.float32(1.0), np.float32(0.0), np.float32(1.0), np.float32(0.0), np.float32(1.0), np.float32(0.0), np.float32(1.0), np.float32(1.0), np.float32(0.0), np.float32(0.0), np.float32(0.0), np.float32(1.0), np.float32(0.0), np.float32(1.0), np.float32(0.0), np.float32(0.0)]",3.0,99679.0,2
2025-08-14_08-18-36,4032,"[np.float32(0.0), np.float32(1.0), np.float32(1.0), np.float32(0.0), np.float32(0.0), np.float32(1.0), np.float32(1.0), np.float32(0.0), np.float32(1.0), np.float32(0.0), np.float32(1.0), np.float32(0.0), np.float32(0.0), np.float32(0.0), np.float32(1.0), np.float32(0.0)]",-2.0,99677.0,14
2025-08-14_08-18-36,4033,"[np.float32(0.0), np.float32(1.0), np.float32(1.0), np.float32(1.0), np.float32(1.0), np.float32(1.0), np.float32(1.0), np.float32(0.0), np.float32(1.0), np.float32(0.0), np.float32(1.0), np.float32(0.0), np.float32(1.0), np.float32(1.0), np.float32(0.0), np.float32(0.0)]",-3.0,99674.0,36
2025-08-14_08-18-36,4034,"[np.float32(0.0), np.float32(1.0), np.float32(1.0), np.float32(1.0), np.float32(0.0), np.float32(1.0), np.float32(0.0), np.float32(1.0), np.float32(0.0), np.float32(1.0), np.float32(0.0), np.float32(1.0), np.float32(1.0), np.float32(1.0), np.float32(0.0), np.float32(0.0)]",-4.0,99670.0,9
2025-08-14_08-18-36,4035,"[np.float32(0.0), np.float32(0.0), np.float32(1.0), np.float32(0.0), np.float32(0.0), np.float32(0.0), np.float32(1.0), np.float32(0.0), np.float32(1.0), np.float32(0.0), np.float32(1.0), np.float32(0.0), np.float32(0.0), np.float32(0.0), np.float32(0.0), np.float32(1.0)]",1.0,99671.0,11
2025-08-14_08-18-36,4036,"[np.float32(1.0), np.float32(0.0), np.float32(0.0), np.float32(1.0), np.float32(0.0), np.float32(1.0), np.float32(0.0), np.float32(0.0), np.float32(1.0), np.float32(0.0), np.float32(1.0), np.float32(1.0), np.float32(0.0), np.float32(1.0), np.float32(1.0), np.float32(0.0)]",-2.0,99669.0,2
2025-08-14_08-18-36,4037,"[np.float32(1.0), np.float32(1.0), np.float32(1.0), np.float32(0.0), np.float32(1.0), np.float32(0.0), np.float32(1.0), np.float32(1.0), np.float32(1.0), np.float32(0.0), np.float32(0.0), np.float32(1.0), np.float32(0.0), np.float32(0.0), np.float32(0.0), np.float32(1.0)]",-2.0,99667.0,13
2025-08-14_08-18-36,4038,"[np.float32(1.0), np.float32(0.0), np.float32(1.0), np.float32(1.0), np.float32(0.0), np.float32(1.0), np.float32(0.0), np.float32(0.0), np.float32(0.0), np.float32(1.0), np.float32(0.0), np.float32(0.0), np.float32(1.0), np.float32(0.0), np.float32(1.0), np.float32(0.0)]",2.0,99669.0,25
2025-08-14_08-18-36,4039,"[np.float32(0.0), np.float32(0.0), np.float32(0.0), np.float32(0.0), np.float32(1.0), np.float32(0.0), np.float32(0.0), np.float32(0.0), np.float32(1.0), np.float32(0.0), np.float32(1.0), np.float32(1.0), np.float32(1.0), np.float32(0.0), np.float32(1.0), np.float32(0.0)]",3.0,99672.0,36
2025-08-14_08-18-36,4040,"[np.float32(1.0), np.float32(1.0), np.float32(0.0), np.float32(1.0), np.float32(1.0), np.float32(0.0), np.float32(1.0), np.float32(0.0), np.float32(0.0), np.float32(0.0), np.float32(1.0), np.float32(1.0), np.float32(0.0), np.float32(1.0), np.float32(0.0), np.float32(1.0)]",3.0,99675.0,15
2025-08-14_08-18-36,4041,"[np.float32(0.0), np.float32(1.0), np.float32(1.0), np.float32(1.0), np.float32(0.0), np.float32(1.0), np.float32(1.0), np.float32(0.0), np.float32(1.0), np.float32(1.0), np.float32(1.0), np.float32(1.0), np.float32(0.0), np.float32(1.0), np.float32(1.0), np.float32(0.0)]",0.0,99675.0,3
2025-08-14_08-18-36,4042,"[np.float32(1.0), np.float32(0.0), np.float32(0.0), np.float32(1.0), np.float32(0.0), np.float32(0.0), np.float32(1.0), np.float32(0.0), np.float32(1.0), np.float32(1.0), np.float32(0.0), np.float32(1.0), np.float32(0.0), np.float32(1.0), np.float32(1.0), np.float32(0.0)]",-2.0,99673.0,24
2025-08-14_08-18-36,4043,"[np.float32(0.0), np.float32(1.0), np.float32(1.0), np.float32(1.0), np.float32(0.0), np.float32(1.0), np.float32(1.0), np.float32(0.0), np.float32(1.0), np.float32(1.0), np.float32(0.0), np.float32(0.0), np.float32(0.0), np.float32(1.0), np.float32(0.0), np.float32(0.0)]",-2.0,99671.0,24
2025-08-14_08-18-36,4044,"[np.float32(1.0), np.float32(1.0), np.float32(0.0), np.float32(0.0), np.float32(1.0), np.float32(0.0), np.float32(0.0), np.float32(1.0), np.float32(0.0), np.float32(0.0), np.float32(0.0), np.float32(0.0), np.float32(0.0), np.float32(0.0), np.float32(0.0), np.float32(1.0)]",0.0,99671.0,34
2025-08-14_08-18-36,4045,"[np.float32(1.0), np.float32(1.0), np.float32(0.0), np.float32(1.0), np.float32(1.0), np.float32(0.0), np.float32(1.0), np.float32(1.0), np.float32(1.0), np.float32(1.0), np.float32(1.0), np.float32(1.0), np.float32(1.0), np.float32(1.0), np.float32(0.0), np.float32(1.0)]",-1.0,99670.0,11
2025-08-14_08-18-36,4046,"[np.float32(0.0), np.float32(0.0), np.float32(0.0), np.float32(0.0), np.float32(1.0), np.float32(0.0), np.float32(1.0), np.float32(1.0), np.float32(0.0), np.float32(0.0), np.float32(1.0), np.float32(1.0), np.float32(1.0), np.float32(0.0), np.float32(0.0), np.float32(0.0)]",-3.0,99667.0,22
2025-08-14_08-18-36,4047,"[np.float32(0.0), np.float32(0.0), np.float32(1.0), np.float32(0.0), np.float32(0.0), np.float32(1.0), np.float32(0.0), np.float32(1.0), np.float32(1.0), np.float32(0.0), np.float32(0.0), np.float32(1.0), np.float32(1.0), np.float32(0.0), np.float32(0.0), np.float32(0.0)]",2.0,99669.0,18
2025-08-14_08-18-36,4048,"[np.float32(0.0), np.float32(1.0), np.float32(0.0), np.float32(0.0), np.float32(0.0), np.float32(1.0), np.float32(1.0), np.float32(1.0), np.float32(0.0), np.float32(1.0), np.float32(0.0), np.float32(0.0), np.float32(0.0), np.float32(1.0), np.float32(0.0), np.float32(0.0)]",7.0,99676.0,22
2025-08-14_08-18-36,4049,"[np.float32(0.0), np.float32(1.0), np.float32(0.0), np.float32(0.0), np.float32(1.0), np.float32(0.0), np.float32(1.0), np.float32(0.0), np.float32(1.0), np.float32(0.0), np.float32(1.0), np.float32(0.0), np.float32(1.0), np.float32(1.0), np.float32(0.0), np.float32(0.0)]",-3.0,99673.0,13
2025-08-14_08-18-36,4050,"[np.float32(0.0), np.float32(1.0), np.float32(1.0), np.float32(1.0), np.float32(1.0), np.float32(1.0), np.float32(1.0), np.float32(1.0), np.float32(1.0), np.float32(0.0), np.float32(1.0), np.float32(0.0), np.float32(0.0), np.float32(1.0), np.float32(0.0), np.float32(0.0)]",2.0,99675.0,17
2025-08-14_08-18-36,4051,"[np.float32(1.0), np.float32(0.0), np.float32(1.0), np.float32(1.0), np.float32(1.0), np.float32(0.0), np.float32(0.0), np.float32(1.0), np.float32(1.0), np.float32(0.0), np.float32(1.0), np.float32(0.0), np.float32(0.0), np.float32(1.0), np.float32(1.0), np.float32(0.0)]",-4.0,99671.0,31
2025-08-14_08-18-36,4052,"[np.float32(0.0), np.float32(0.0), np.float32(0.0), np.float32(1.0), np.float32(0.0), np.float32(0.0), np.float32(1.0), np.float32(0.0), np.float32(1.0), np.float32(0.0), np.float32(0.0), np.float32(0.0), np.float32(1.0), np.float32(1.0), np.float32(0.0), np.float32(1.0)]",2.0,99673.0,9
2025-08-14_08-18-36,4053,"[np.float32(1.0), np.float32(1.0), np.float32(1.0), np.float32(1.0), np.float32(0.0), np.float32(0.0), np.float32(1.0), np.float32(1.0), np.float32(1.0), np.float32(1.0), np.float32(0.0), np.float32(0.0), np.float32(0.0), np.float32(1.0), np.float32(1.0), np.float32(0.0)]",0.0,99673.0,3
2025-08-14_08-18-36,4054,"[np.float32(1.0), np.float32(1.0), np.float32(0.0), np.float32(1.0), np.float32(1.0), np.float32(1.0), np.float32(0.0), np.float32(1.0), np.float32(0.0), np.float32(0.0), np.float32(0.0), np.float32(1.0), np.float32(0.0), np.float32(0.0), np.float32(0.0), np.float32(1.0)]",2.0,99675.0,14
2025-08-14_08-18-36,4055,"[np.float32(0.0), np.float32(1.0), np.float32(1.0), np.float32(0.0), np.float32(0.0), np.float32(0.0), np.float32(0.0), np.float32(1.0), np.float32(0.0), np.float32(1.0), np.float32(1.0), np.float32(0.0), np.float32(0.0), np.float32(0.0), np.float32(0.0), np.float32(0.0)]",0.0,99675.0,18
2025-08-14_08-18-36,4056,"[np.float32(0.0), np.float32(0.0), np.float32(0.0), np.float32(1.0), np.float32(0.0), np.float32(0.0), np.float32(1.0), np.float32(1.0), np.float32(0.0), np.float32(0.0), np.float32(1.0), np.float32(0.0), np.float32(0.0), np.float32(0.0), np.float32(1.0), np.float32(1.0)]",3.0,99678.0,20
2025-08-14_08-18-36,4057,"[np.float32(0.0), np.float32(0.0), np.float32(0.0), np.float32(0.0), np.float32(0.0), np.float32(1.0), np.float32(1.0), np.float32(1.0), np.float32(1.0), np.float32(0.0), np.float32(0.0), np.float32(1.0), np.float32(1.0), np.float32(1.0), np.float32(0.0), np.float32(0.0)]",-2.0,99676.0,34
2025-08-14_08-18-36,4058,"[np.float32(0.0), np.float32(0.0), np.float32(1.0), np.float32(0.0), np.float32(0.0), np.float32(1.0), np.float32(1.0), np.float32(1.0), np.float32(0.0), np.float32(0.0), np.float32(0.0), np.float32(1.0), np.float32(0.0), np.float32(0.0), np.float32(1.0), np.float32(1.0)]",1.0,99677.0,21
2025-08-14_08-18-36,4059,"[np.float32(0.0), np.float32(0.0), np.float32(0.0), np.float32(0.0), np.float32(0.0), np.float32(0.0), np.float32(0.0), np.float32(0.0), np.float32(1.0), np.float32(1.0), np.float32(0.0), np.float32(1.0), np.float32(1.0), np.float32(0.0), np.float32(0.0), np.float32(1.0)]",-2.0,99675.0,16
2025-08-14_08-18-36,4060,"[np.float32(0.0), np.float32(1.0), np.float32(0.0), np.float32(0.0), np.float32(1.0), np.float32(1.0), np.float32(0.0), np.float32(1.0), np.float32(0.0), np.float32(1.0), np.float32(0.0), np.float32(0.0), np.float32(1.0), np.float32(1.0), np.float32(0.0), np.float32(1.0)]",-6.0,99669.0,30
2025-08-14_08-18-36,4061,"[np.float32(1.0), np.float32(1.0), np.float32(0.0), np.float32(1.0), np.float32(1.0), np.float32(1.0), np.float32(0.0), np.float32(1.0), np.float32(1.0), np.float32(1.0), np.float32(0.0), np.float32(1.0), np.float32(0.0), np.float32(0.0), np.float32(0.0), np.float32(0.0)]",-2.0,99667.0,14
2025-08-14_08-18-36,4062,"[np.float32(1.0), np.float32(0.0), np.float32(0.0), np.float32(0.0), np.float32(1.0), np.float32(1.0), np.float32(1.0), np.float32(1.0), np.float32(1.0), np.float32(1.0), np.float32(0.0), np.float32(0.0), np.float32(0.0), np.float32(1.0), np.float32(0.0), np.float32(0.0)]",0.0,99667.0,10
2025-08-14_08-18-36,4063,"[np.float32(1.0), np.float32(1.0), np.float32(1.0), np.float32(0.0), np.float32(0.0), np.float32(1.0), np.float32(0.0), np.float32(1.0), np.float32(0.0), np.float32(1.0), np.float32(1.0), np.float32(0.0), np.float32(0.0), np.float32(0.0), np.float32(1.0), np.float32(0.0)]",1.0,99668.0,26
2025-08-14_08-18-36,4064,"[np.float32(1.0), np.float32(0.0), np.float32(0.0), np.float32(1.0), np.float32(0.0), np.float32(0.0), np.float32(1.0), np.float32(1.0), np.float32(1.0), np.float32(1.0), np.float32(0.0), np.float32(1.0), np.float32(1.0), np.float32(1.0), np.float32(0.0), np.float32(0.0)]",0.0,99668.0,4
2025-08-14_08-18-36,4065,"[np.float32(0.0), np.float32(0.0), np.float32(0.0), np.float32(1.0), np.float32(0.0), np.float32(0.0), np.float32(1.0), np.float32(1.0), np.float32(1.0), np.float32(0.0), np.float32(1.0), np.float32(1.0), np.float32(0.0), np.float32(1.0), np.float32(1.0), np.float32(0.0)]",-2.0,99666.0,28
2025-08-14_08-18-36,4066,"[np.float32(0.0), np.float32(1.0), np.float32(0.0), np.float32(1.0), np.float32(1.0), np.float32(0.0), np.float32(1.0), np.float32(1.0), np.float32(1.0), np.float32(0.0), np.float32(0.0), np.float32(0.0), np.float32(0.0), np.float32(0.0), np.float32(0.0), np.float32(0.0)]",-3.0,99663.0,36
2025-08-14_08-18-36,4067,"[np.float32(0.0), np.float32(0.0), np.float32(0.0), np.float32(1.0), np.float32(0.0), np.float32(1.0), np.float32(0.0), np.float32(0.0), np.float32(1.0), np.float32(0.0), np.float32(0.0), np.float32(1.0), np.float32(0.0), np.float32(0.0), np.float32(0.0), np.float32(1.0)]",-2.0,99661.0,18
2025-08-14_08-18-36,4068,"[np.float32(1.0), np.float32(1.0), np.float32(0.0), np.float32(1.0), np.float32(0.0), np.float32(1.0), np.float32(0.0), np.float32(0.0), np.float32(0.0), np.float32(1.0), np.float32(1.0), np.float32(0.0), np.float32(1.0), np.float32(1.0), np.float32(0.0), np.float32(0.0)]",1.0,99662.0,21
2025-08-14_08-18-36,4069,"[np.float32(0.0), np.float32(1.0), np.float32(0.0), np.float32(0.0), np.float32(0.0), np.float32(1.0), np.float32(0.0), np.float32(1.0), np.float32(0.0), np.float32(0.0), np.float32(0.0), np.float32(0.0), np.float32(1.0), np.float32(0.0), np.float32(0.0), np.float32(1.0)]",0.0,99662.0,15
2025-08-14_08-18-36,4070,"[np.float32(0.0), np.float32(0.0), np.float32(0.0), np.float32(0.0), np.float32(0.0), np.float32(0.0), np.float32(0.0), np.float32(1.0), np.float32(0.0), np.float32(0.0), np.float32(0.0), np.float32(0.0), np.float32(0.0), np.float32(1.0), np.float32(1.0), np.float32(0.0)]",-3.0,99659.0,9
2025-08-14_08-18-36,4071,"[np.float32(0.0), np.float32(1.0), np.float32(0.0), np.float32(0.0), np.float32(0.0), np.float32(0.0), np.float32(1.0), np.float32(1.0), np.float32(0.0), np.float32(0.0), np.float32(0.0), np.float32(1.0), np.float32(0.0), np.float32(1.0), np.float32(0.0), np.float32(0.0)]",4.0,99663.0,21
2025-08-14_08-18-36,4072,"[np.float32(0.0), np.float32(0.0), np.float32(1.0), np.float32(1.0), np.float32(0.0), np.float32(1.0), np.float32(0.0), np.float32(0.0), np.float32(1.0), np.float32(0.0), np.float32(1.0), np.float32(1.0), np.float32(1.0), np.float32(0.0), np.float32(0.0), np.float32(0.0)]",-3.0,99660.0,22
2025-08-14_08-18-36,4073,"[np.float32(0.0), np.float32(1.0), np.float32(0.0), np.float32(0.0), np.float32(0.0), np.float32(0.0), np.float32(0.0), np.float32(0.0), np.float32(1.0), np.float32(1.0), np.float32(1.0), np.float32(0.0), np.float32(0.0), np.float32(0.0), np.float32(1.0), np.float32(1.0)]",-6.0,99654.0,18
2025-08-14_08-18-36,4074,"[np.float32(1.0), np.float32(1.0), np.float32(0.0), np.float32(0.0), np.float32(0.0), np.float32(1.0), np.float32(0.0), np.float32(1.0), np.float32(1.0), np.float32(1.0), np.float32(1.0), np.float32(0.0), np.float32(1.0), np.float32(1.0), np.float32(0.0), np.float32(0.0)]",-4.0,99650.0,12
2025-08-14_08-18-36,4075,"[np.float32(0.0), np.float32(0.0), np.float32(0.0), np.float32(0.0), np.float32(1.0), np.float32(0.0), np.float32(0.0), np.float32(1.0), np.float32(0.0), np.float32(0.0), np.float32(1.0), np.float32(1.0), np.float32(0.0), np.float32(1.0), np.float32(1.0), np.float32(0.0)]",-3.0,99647.0,25
2025-08-14_08-18-36,4076,"[np.float32(1.0), np.float32(1.0), np.float32(0.0), np.float32(1.0), np.float32(1.0), np.float32(1.0), np.float32(0.0), np.float32(0.0), np.float32(1.0), np.float32(1.0), np.float32(1.0), np.float32(0.0), np.float32(1.0), np.float32(0.0), np.float32(0.0), np.float32(0.0)]",0.0,99647.0,5
2025-08-14_08-18-36,4077,"[np.float32(0.0), np.float32(0.0), np.float32(1.0), np.float32(0.0), np.float32(0.0), np.float32(0.0), np.float32(1.0), np.float32(0.0), np.float32(1.0), np.float32(1.0), np.float32(1.0), np.float32(0.0), np.float32(0.0), np.float32(0.0), np.float32(0.0), np.float32(0.0)]",3.0,99650.0,8
2025-08-14_08-18-36,4078,"[np.float32(0.0), np.float32(1.0), np.float32(1.0), np.float32(1.0), np.float32(0.0), np.float32(1.0), np.float32(0.0), np.float32(0.0), np.float32(1.0), np.float32(1.0), np.float32(0.0), np.float32(0.0), np.float32(0.0), np.float32(1.0), np.float32(1.0), np.float32(0.0)]",0.0,99650.0,7
2025-08-14_08-18-36,4079,"[np.float32(1.0), np.float32(0.0), np.float32(1.0), np.float32(0.0), np.float32(0.0), np.float32(0.0), np.float32(1.0), np.float32(1.0), np.float32(0.0), np.float32(0.0), np.float32(0.0), np.float32(0.0), np.float32(1.0), np.float32(0.0), np.float32(1.0), np.float32(0.0)]",-2.0,99648.0,34
2025-08-14_08-18-36,4080,"[np.float32(1.0), np.float32(1.0), np.float32(0.0), np.float32(0.0), np.float32(0.0), np.float32(0.0), np.float32(0.0), np.float32(0.0), np.float32(1.0), np.float32(0.0), np.float32(1.0), np.float32(0.0), np.float32(0.0), np.float32(0.0), np.float32(0.0), np.float32(0.0)]",-2.0,99646.0,21
2025-08-14_08-18-36,4081,"[np.float32(1.0), np.float32(1.0), np.float32(1.0), np.float32(0.0), np.float32(1.0), np.float32(1.0), np.float32(0.0), np.float32(1.0), np.float32(1.0), np.float32(0.0), np.float32(1.0), np.float32(1.0), np.float32(0.0), np.float32(0.0), np.float32(1.0), np.float32(0.0)]",0.0,99646.0,21
2025-08-14_08-18-36,4082,"[np.float32(0.0), np.float32(1.0), np.float32(0.0), np.float32(1.0), np.float32(0.0), np.float32(1.0), np.float32(1.0), np.float32(1.0), np.float32(1.0), np.float32(0.0), np.float32(1.0), np.float32(1.0), np.float32(1.0), np.float32(1.0), np.float32(0.0), np.float32(1.0)]",-3.0,99643.0,5
2025-08-14_08-18-36,4083,"[np.float32(0.0), np.float32(1.0), np.float32(1.0), np.float32(0.0), np.float32(0.0), np.float32(1.0), np.float32(1.0), np.float32(0.0), np.float32(0.0), np.float32(0.0), np.float32(1.0), np.float32(0.0), np.float32(1.0), np.float32(0.0), np.float32(0.0), np.float32(1.0)]",-5.0,99638.0,16
2025-08-14_08-18-36,4084,"[np.float32(0.0), np.float32(1.0), np.float32(0.0), np.float32(0.0), np.float32(1.0), np.float32(0.0), np.float32(0.0), np.float32(0.0), np.float32(1.0), np.float32(0.0), np.float32(0.0), np.float32(1.0), np.float32(1.0), np.float32(0.0), np.float32(1.0), np.float32(0.0)]",-1.0,99637.0,28
2025-08-14_08-18-36,4085,"[np.float32(1.0), np.float32(1.0), np.float32(0.0), np.float32(0.0), np.float32(1.0), np.float32(0.0), np.float32(1.0), np.float32(0.0), np.float32(1.0), np.float32(0.0), np.float32(1.0), np.float32(1.0), np.float32(0.0), np.float32(0.0), np.float32(0.0), np.float32(0.0)]",3.0,99640.0,3
2025-08-14_08-18-36,4086,"[np.float32(1.0), np.float32(1.0), np.float32(1.0), np.float32(1.0), np.float32(1.0), np.float32(0.0), np.float32(1.0), np.float32(1.0), np.float32(1.0), np.float32(1.0), np.float32(0.0), np.float32(0.0), np.float32(0.0), np.float32(1.0), np.float32(0.0), np.float32(0.0)]",3.0,99643.0,25
2025-08-14_08-18-36,4087,"[np.float32(1.0), np.float32(0.0), np.float32(1.0), np.float32(0.0), np.float32(1.0), np.float32(0.0), np.float32(1.0), np.float32(1.0), np.float32(0.0), np.float32(1.0), np.float32(0.0), np.float32(0.0), np.float32(0.0), np.float32(0.0), np.float32(1.0), np.float32(1.0)]",-3.0,99640.0,27
2025-08-14_08-18-36,4088,"[np.float32(1.0), np.float32(0.0), np.float32(1.0), np.float32(0.0), np.float32(0.0), np.float32(1.0), np.float32(0.0), np.float32(0.0), np.float32(1.0), np.float32(1.0), np.float32(1.0), np.float32(0.0), np.float32(1.0), np.float32(1.0), np.float32(0.0), np.float32(1.0)]",-5.0,99635.0,24
2025-08-14_08-18-36,4089,"[np.float32(0.0), np.float32(0.0), np.float32(0.0), np.float32(1.0), np.float32(0.0), np.float32(0.0), np.float32(1.0), np.float32(1.0), np.float32(0.0), np.float32(0.0), np.float32(0.0), np.float32(1.0), np.float32(0.0), np.float32(1.0), np.float32(0.0), np.float32(0.0)]",-2.0,99633.0,10
2025-08-14_08-18-36,4090,"[np.float32(1.0), np.float32(0.0), np.float32(1.0), np.float32(1.0), np.float32(1.0), np.float32(1.0), np.float32(0.0), np.float32(0.0), np.float32(0.0), np.float32(1.0), np.float32(0.0), np.float32(1.0), np.float32(0.0), np.float32(0.0), np.float32(0.0), np.float32(0.0)]",0.0,99633.0,4
2025-08-14_08-18-36,4091,"[np.float32(0.0), np.float32(1.0), np.float32(0.0), np.float32(0.0), np.float32(1.0), np.float32(1.0), np.float32(0.0), np.float32(0.0), np.float32(1.0), np.float32(1.0), np.float32(1.0), np.float32(1.0), np.float32(1.0), np.float32(1.0), np.float32(0.0), np.float32(0.0)]",-1.0,99632.0,12
2025-08-14_08-18-36,4092,"[np.float32(0.0), np.float32(1.0), np.float32(1.0), np.float32(0.0), np.float32(0.0), np.float32(0.0), np.float32(0.0), np.float32(1.0), np.float32(0.0), np.float32(0.0), np.float32(0.0), np.float32(0.0), np.float32(0.0), np.float32(0.0), np.float32(0.0), np.float32(1.0)]",0.0,99632.0,28
2025-08-14_08-18-36,4093,"[np.float32(0.0), np.float32(1.0), np.float32(1.0), np.float32(0.0), np.float32(1.0), np.float32(1.0), np.float32(0.0), np.float32(0.0), np.float32(1.0), np.float32(0.0), np.float32(0.0), np.float32(1.0), np.float32(1.0), np.float32(0.0), np.float32(1.0), np.float32(1.0)]",-4.0,99628.0,25
2025-08-14_08-18-36,4094,"[np.float32(0.0), np.float32(1.0), np.float32(0.0), np.float32(0.0), np.float32(0.0), np.float32(0.0), np.float32(0.0), np.float32(1.0), np.float32(0.0), np.float32(0.0), np.float32(0.0), np.float32(0.0), np.float32(0.0), np.float32(1.0), np.float32(1.0), np.float32(1.0)]",0.0,99628.0,8
2025-08-14_08-18-36,4095,"[np.float32(1.0), np.float32(1.0), np.float32(1.0), np.float32(0.0), np.float32(0.0), np.float32(0.0), np.float32(0.0), np.float32(0.0), np.float32(1.0), np.float32(0.0), np.float32(1.0), np.float32(0.0), np.float32(0.0), np.float32(1.0), np.float32(0.0), np.float32(1.0)]",1.0,99629.0,31
2025-08-14_08-18-36,4096,"[np.float32(0.0), np.float32(1.0), np.float32(1.0), np.float32(0.0), np.float32(0.0), np.float32(1.0), np.float32(0.0), np.float32(1.0), np.float32(1.0), np.float32(1.0), np.float32(0.0), np.float32(0.0), np.float32(0.0), np.float32(1.0), np.float32(0.0), np.float32(0.0)]",2.0,99631.0,20
2025-08-14_08-18-36,4097,"[np.float32(0.0), np.float32(0.0), np.float32(0.0), np.float32(0.0), np.float32(0.0), np.float32(0.0), np.float32(1.0), np.float32(1.0), np.float32(0.0), np.float32(0.0), np.float32(0.0), np.float32(1.0), np.float32(0.0), np.float32(0.0), np.float32(0.0), np.float32(0.0)]",-3.0,99628.0,32
2025-08-14_08-18-36,4098,"[np.float32(1.0), np.float32(0.0), np.float32(1.0), np.float32(0.0), np.float32(0.0), np.float32(1.0), np.float32(1.0), np.float32(1.0), np.float32(1.0), np.float32(0.0), np.float32(0.0), np.float32(1.0), np.float32(0.0), np.float32(1.0), np.float32(0.0), np.float32(1.0)]",-1.0,99627.0,1
2025-08-14_08-18-36,4099,"[np.float32(0.0), np.float32(1.0), np.float32(0.0), np.float32(1.0), np.float32(0.0), np.float32(0.0), np.float32(1.0), np.float32(0.0), np.float32(0.0), np.float32(1.0), np.float32(0.0), np.float32(1.0), np.float32(1.0), np.float32(1.0), np.float32(1.0), np.float32(0.0)]",0.0,99627.0,25
2025-08-14_08-18-36,4100,"[np.float32(0.0), np.float32(0.0), np.float32(0.0), np.float32(1.0), np.float32(1.0), np.float32(1.0), np.float32(0.0), np.float32(1.0), np.float32(0.0), np.float32(0.0), np.float32(0.0), np.float32(0.0), np.float32(1.0), np.float32(0.0), np.float32(1.0), np.float32(0.0)]",1.0,99628.0,17
2025-08-14_08-18-36,4101,"[np.float32(0.0), np.float32(1.0), np.float32(1.0), np.float32(0.0), np.float32(1.0), np.float32(1.0), np.float32(1.0), np.float32(0.0), np.float32(1.0), np.float32(1.0), np.float32(1.0), np.float32(1.0), np.float32(1.0), np.float32(0.0), np.float32(0.0), np.float32(0.0)]",2.0,99630.0,26
2025-08-14_08-18-36,4102,"[np.float32(1.0), np.float32(0.0), np.float32(0.0), np.float32(0.0), np.float32(1.0), np.float32(0.0), np.float32(0.0), np.float32(1.0), np.float32(0.0), np.float32(0.0), np.float32(1.0), np.float32(0.0), np.float32(1.0), np.float32(1.0), np.float32(1.0), np.float32(0.0)]",-2.0,99628.0,4
2025-08-14_08-18-36,4103,"[np.float32(1.0), np.float32(1.0), np.float32(1.0), np.float32(0.0), np.float32(0.0), np.float32(0.0), np.float32(1.0), np.float32(0.0), np.float32(0.0), np.float32(1.0), np.float32(1.0), np.float32(1.0), np.float32(1.0), np.float32(0.0), np.float32(0.0), np.float32(0.0)]",-1.0,99627.0,32
2025-08-14_08-18-36,4104,"[np.float32(1.0), np.float32(0.0), np.float32(1.0), np.float32(1.0), np.float32(0.0), np.float32(1.0), np.float32(1.0), np.float32(1.0), np.float32(1.0), np.float32(0.0), np.float32(1.0), np.float32(1.0), np.float32(0.0), np.float32(0.0), np.float32(0.0), np.float32(1.0)]",-3.0,99624.0,22
2025-08-14_08-18-36,4105,"[np.float32(0.0), np.float32(0.0), np.float32(0.0), np.float32(0.0), np.float32(0.0), np.float32(0.0), np.float32(0.0), np.float32(0.0), np.float32(0.0), np.float32(0.0), np.float32(1.0), np.float32(0.0), np.float32(1.0), np.float32(1.0), np.float32(1.0), np.float32(0.0)]",-1.0,99623.0,3
2025-08-14_08-18-36,4106,"[np.float32(1.0), np.float32(1.0), np.float32(1.0), np.float32(0.0), np.float32(0.0), np.float32(0.0), np.float32(0.0), np.float32(0.0), np.float32(1.0), np.float32(0.0), np.float32(0.0), np.float32(0.0), np.float32(1.0), np.float32(1.0), np.float32(0.0), np.float32(1.0)]",-2.0,99621.0,17
2025-08-14_08-18-36,4107,"[np.float32(0.0), np.float32(0.0), np.float32(0.0), np.float32(0.0), np.float32(0.0), np.float32(0.0), np.float32(1.0), np.float32(1.0), np.float32(1.0), np.float32(0.0), np.float32(0.0), np.float32(0.0), np.float32(1.0), np.float32(1.0), np.float32(1.0), np.float32(0.0)]",0.0,99621.0,35
2025-08-14_08-18-36,4108,"[np.float32(0.0), np.float32(0.0), np.float32(1.0), np.float32(1.0), np.float32(0.0), np.float32(0.0), np.float32(1.0), np.float32(1.0), np.float32(1.0), np.float32(1.0), np.float32(0.0), np.float32(0.0), np.float32(0.0), np.float32(1.0), np.float32(0.0), np.float32(0.0)]",1.0,99622.0,1
2025-08-14_08-18-36,4109,"[np.float32(0.0), np.float32(1.0), np.float32(0.0), np.float32(1.0), np.float32(0.0), np.float32(0.0), np.float32(1.0), np.float32(1.0), np.float32(1.0), np.float32(0.0), np.float32(0.0), np.float32(0.0), np.float32(1.0), np.float32(1.0), np.float32(1.0), np.float32(0.0)]",-5.0,99617.0,34
2025-08-14_08-18-36,4110,"[np.float32(1.0), np.float32(1.0), np.float32(1.0), np.float32(1.0), np.float32(1.0), np.float32(0.0), np.float32(1.0), np.float32(1.0), np.float32(1.0), np.float32(1.0), np.float32(1.0), np.float32(0.0), np.float32(1.0), np.float32(1.0), np.float32(1.0), np.float32(1.0)]",-2.0,99615.0,6
2025-08-14_08-18-36,4111,"[np.float32(0.0), np.float32(1.0), np.float32(0.0), np.float32(1.0), np.float32(0.0), np.float32(0.0), np.float32(1.0), np.float32(0.0), np.float32(0.0), np.float32(1.0), np.float32(0.0), np.float32(0.0), np.float32(1.0), np.float32(0.0), np.float32(0.0), np.float32(1.0)]",-4.0,99611.0,0
2025-08-14_08-18-36,4112,"[np.float32(0.0), np.float32(0.0), np.float32(1.0), np.float32(1.0), np.float32(0.0), np.float32(0.0), np.float32(1.0), np.float32(0.0), np.float32(1.0), np.float32(0.0), np.float32(1.0), np.float32(0.0), np.float32(1.0), np.float32(0.0), np.float32(1.0), np.float32(1.0)]",-3.0,99608.0,16
2025-08-14_08-18-36,4113,"[np.float32(1.0), np.float32(0.0), np.float32(0.0), np.float32(1.0), np.float32(1.0), np.float32(0.0), np.float32(0.0), np.float32(0.0), np.float32(0.0), np.float32(1.0), np.float32(1.0), np.float32(1.0), np.float32(0.0), np.float32(0.0), np.float32(0.0), np.float32(1.0)]",1.0,99609.0,34
2025-08-14_08-18-36,4114,"[np.float32(1.0), np.float32(0.0), np.float32(0.0), np.float32(1.0), np.float32(1.0), np.float32(1.0), np.float32(0.0), np.float32(0.0), np.float32(1.0), np.float32(0.0), np.float32(0.0), np.float32(1.0), np.float32(0.0), np.float32(0.0), np.float32(0.0), np.float32(1.0)]",-1.0,99608.0,23
2025-08-14_08-18-36,4115,"[np.float32(0.0), np.float32(1.0), np.float32(0.0), np.float32(0.0), np.float32(0.0), np.float32(1.0), np.float32(1.0), np.float32(1.0), np.float32(1.0), np.float32(1.0), np.float32(1.0), np.float32(1.0), np.float32(1.0), np.float32(0.0), np.float32(1.0), np.float32(1.0)]",0.0,99608.0,36
2025-08-14_08-18-36,4116,"[np.float32(0.0), np.float32(1.0), np.float32(1.0), np.float32(0.0), np.float32(1.0), np.float32(0.0), np.float32(1.0), np.float32(1.0), np.float32(0.0), np.float32(0.0), np.float32(1.0), np.float32(1.0), np.float32(0.0), np.float32(1.0), np.float32(1.0), np.float32(0.0)]",1.0,99609.0,22
2025-08-14_08-18-36,4117,"[np.float32(1.0), np.float32(1.0), np.float32(1.0), np.float32(1.0), np.float32(0.0), np.float32(0.0), np.float32(0.0), np.float32(1.0), np.float32(1.0), np.float32(1.0), np.float32(1.0), np.float32(0.0), np.float32(0.0), np.float32(0.0), np.float32(1.0), np.float32(1.0)]",0.0,99609.0,11
2025-08-14_08-18-36,4118,"[np.float32(0.0), np.float32(1.0), np.float32(0.0), np.float32(1.0), np.float32(0.0), np.float32(0.0), np.float32(1.0), np.float32(1.0), np.float32(0.0), np.float32(1.0), np.float32(1.0), np.float32(0.0), np.float32(1.0), np.float32(1.0), np.float32(1.0), np.float32(0.0)]",-1.0,99608.0,1
2025-08-14_08-18-36,4119,"[np.float32(0.0), np.float32(0.0), np.float32(1.0), np.float32(0.0), np.float32(1.0), np.float32(0.0), np.float32(1.0), np.float32(1.0), np.float32(1.0), np.float32(1.0), np.float32(0.0), np.float32(0.0), np.float32(0.0), np.float32(0.0), np.float32(1.0), np.float32(0.0)]",-5.0,99603.0,0
2025-08-14_08-18-36,4120,"[np.float32(0.0), np.float32(0.0), np.float32(0.0), np.float32(0.0), np.float32(0.0), np.float32(1.0), np.float32(0.0), np.float32(0.0), np.float32(1.0), np.float32(0.0), np.float32(0.0), np.float32(0.0), np.float32(0.0), np.float32(1.0), np.float32(0.0), np.float32(1.0)]",4.0,99607.0,34
2025-08-14_08-18-36,4121,"[np.float32(0.0), np.float32(1.0), np.float32(1.0), np.float32(0.0), np.float32(0.0), np.float32(0.0), np.float32(1.0), np.float32(0.0), np.float32(0.0), np.float32(0.0), np.float32(0.0), np.float32(1.0), np.float32(0.0), np.float32(0.0), np.float32(0.0), np.float32(0.0)]",0.0,99607.0,0
2025-08-14_08-18-36,4122,"[np.float32(0.0), np.float32(1.0), np.float32(1.0), np.float32(0.0), np.float32(1.0), np.float32(0.0), np.float32(0.0), np.float32(1.0), np.float32(1.0), np.float32(1.0), np.float32(0.0), np.float32(1.0), np.float32(1.0), np.float32(0.0), np.float32(0.0), np.float32(1.0)]",1.0,99608.0,28
2025-08-14_08-18-36,4123,"[np.float32(0.0), np.float32(1.0), np.float32(0.0), np.float32(0.0), np.float32(0.0), np.float32(1.0), np.float32(1.0), np.float32(1.0), np.float32(1.0), np.float32(1.0), np.float32(1.0), np.float32(0.0), np.float32(0.0), np.float32(0.0), np.float32(0.0), np.float32(0.0)]",-2.0,99606.0,15
2025-08-14_08-18-36,4124,"[np.float32(0.0), np.float32(0.0), np.float32(0.0), np.float32(1.0), np.float32(0.0), np.float32(0.0), np.float32(1.0), np.float32(0.0), np.float32(0.0), np.float32(0.0), np.float32(0.0), np.float32(1.0), np.float32(0.0), np.float32(1.0), np.float32(0.0), np.float32(1.0)]",4.0,99610.0,12
2025-08-14_08-18-36,4125,"[np.float32(1.0), np.float32(1.0), np.float32(1.0), np.float32(0.0), np.float32(1.0), np.float32(1.0), np.float32(1.0), np.float32(1.0), np.float32(0.0), np.float32(0.0), np.float32(0.0), np.float32(1.0), np.float32(1.0), np.float32(1.0), np.float32(1.0), np.float32(0.0)]",-1.0,99609.0,5
2025-08-14_08-18-36,4126,"[np.float32(0.0), np.float32(1.0), np.float32(0.0), np.float32(1.0), np.float32(1.0), np.float32(1.0), np.float32(1.0), np.float32(0.0), np.float32(1.0), np.float32(0.0), np.float32(1.0), np.float32(1.0), np.float32(1.0), np.float32(0.0), np.float32(1.0), np.float32(1.0)]",-1.0,99608.0,1
2025-08-14_08-18-36,4127,"[np.float32(1.0), np.float32(1.0), np.float32(0.0), np.float32(1.0), np.float32(1.0), np.float32(0.0), np.float32(0.0), np.float32(1.0), np.float32(1.0), np.float32(1.0), np.float32(0.0), np.float32(0.0), np.float32(0.0), np.float32(1.0), np.float32(0.0), np.float32(0.0)]",-2.0,99606.0,11
2025-08-14_08-18-36,4128,"[np.float32(1.0), np.float32(0.0), np.float32(1.0), np.float32(0.0), np.float32(1.0), np.float32(1.0), np.float32(1.0), np.float32(0.0), np.float32(0.0), np.float32(1.0), np.float32(0.0), np.float32(1.0), np.float32(0.0), np.float32(1.0), np.float32(1.0), np.float32(0.0)]",1.0,99607.0,27
2025-08-14_08-18-36,4129,"[np.float32(1.0), np.float32(0.0), np.float32(0.0), np.float32(0.0), np.float32(0.0), np.float32(0.0), np.float32(1.0), np.float32(0.0), np.float32(0.0), np.float32(0.0), np.float32(0.0), np.float32(1.0), np.float32(1.0), np.float32(1.0), np.float32(0.0), np.float32(0.0)]",1.0,99608.0,2
2025-08-14_08-18-36,4130,"[np.float32(1.0), np.float32(0.0), np.float32(0.0), np.float32(1.0), np.float32(1.0), np.float32(0.0), np.float32(0.0), np.float32(1.0), np.float32(0.0), np.float32(1.0), np.float32(0.0), np.float32(1.0), np.float32(1.0), np.float32(1.0), np.float32(1.0), np.float32(0.0)]",-1.0,99607.0,4
2025-08-14_08-18-36,4131,"[np.float32(0.0), np.float32(0.0), np.float32(1.0), np.float32(0.0), np.float32(1.0), np.float32(1.0), np.float32(0.0), np.float32(1.0), np.float32(0.0), np.float32(1.0), np.float32(1.0), np.float32(0.0), np.float32(1.0), np.float32(0.0), np.float32(0.0), np.float32(1.0)]",-3.0,99604.0,21
2025-08-14_08-18-36,4132,"[np.float32(1.0), np.float32(0.0), np.float32(1.0), np.float32(0.0), np.float32(1.0), np.float32(0.0), np.float32(1.0), np.float32(1.0), np.float32(1.0), np.float32(0.0), np.float32(1.0), np.float32(1.0), np.float32(0.0), np.float32(0.0), np.float32(1.0), np.float32(0.0)]",3.0,99607.0,12
2025-08-14_08-18-36,4133,"[np.float32(0.0), np.float32(1.0), np.float32(0.0), np.float32(1.0), np.float32(0.0), np.float32(0.0), np.float32(1.0), np.float32(0.0), np.float32(1.0), np.float32(0.0), np.float32(0.0), np.float32(0.0), np.float32(0.0), np.float32(0.0), np.float32(1.0), np.float32(0.0)]",0.0,99607.0,28
2025-08-14_08-18-36,4134,"[np.float32(0.0), np.float32(1.0), np.float32(0.0), np.float32(0.0), np.float32(1.0), np.float32(0.0), np.float32(1.0), np.float32(1.0), np.float32(1.0), np.float32(0.0), np.float32(0.0), np.float32(0.0), np.float32(1.0), np.float32(0.0), np.float32(0.0), np.float32(1.0)]",-2.0,99605.0,26
2025-08-14_08-18-36,4135,"[np.float32(0.0), np.float32(1.0), np.float32(1.0), np.float32(1.0), np.float32(1.0), np.float32(0.0), np.float32(0.0), np.float32(1.0), np.float32(1.0), np.float32(0.0), np.float32(0.0), np.float32(0.0), np.float32(1.0), np.float32(1.0), np.float32(1.0), np.float32(0.0)]",3.0,99608.0,13
2025-08-14_08-18-36,4136,"[np.float32(1.0), np.float32(0.0), np.float32(1.0), np.float32(1.0), np.float32(1.0), np.float32(0.0), np.float32(0.0), np.float32(1.0), np.float32(0.0), np.float32(0.0), np.float32(1.0), np.float32(1.0), np.float32(0.0), np.float32(0.0), np.float32(0.0), np.float32(0.0)]",2.0,99610.0,16
2025-08-14_08-18-36,4137,"[np.float32(0.0), np.float32(1.0), np.float32(0.0), np.float32(0.0), np.float32(0.0), np.float32(1.0), np.float32(1.0), np.float32(1.0), np.float32(0.0), np.float32(1.0), np.float32(0.0), np.float32(1.0), np.float32(0.0), np.float32(0.0), np.float32(0.0), np.float32(0.0)]",0.0,99610.0,1
2025-08-14_08-18-36,4138,"[np.float32(0.0), np.float32(0.0), np.float32(0.0), np.float32(1.0), np.float32(0.0), np.float32(0.0), np.float32(0.0), np.float32(1.0), np.float32(1.0), np.float32(1.0), np.float32(1.0), np.float32(0.0), np.float32(0.0), np.float32(1.0), np.float32(0.0), np.float32(1.0)]",-2.0,99608.0,27
2025-08-14_08-18-36,4139,"[np.float32(0.0), np.float32(1.0), np.float32(1.0), np.float32(1.0), np.float32(0.0), np.float32(0.0), np.float32(0.0), np.float32(1.0), np.float32(1.0), np.float32(0.0), np.float32(0.0), np.float32(0.0), np.float32(1.0), np.float32(0.0), np.float32(0.0), np.float32(0.0)]",-1.0,99607.0,19
2025-08-14_08-18-36,4140,"[np.float32(0.0), np.float32(0.0), np.float32(1.0), np.float32(0.0), np.float32(0.0), np.float32(1.0), np.float32(1.0), np.float32(1.0), np.float32(1.0), np.float32(0.0), np.float32(1.0), np.float32(1.0), np.float32(0.0), np.float32(0.0), np.float32(0.0), np.float32(0.0)]",1.0,99608.0,6
2025-08-14_08-18-36,4141,"[np.float32(0.0), np.float32(1.0), np.float32(0.0), np.float32(0.0), np.float32(0.0), np.float32(0.0), np.float32(0.0), np.float32(1.0), np.float32(0.0), np.float32(0.0), np.float32(0.0), np.float32(0.0), np.float32(1.0), np.float32(0.0), np.float32(0.0), np.float32(0.0)]",-3.0,99605.0,36
2025-08-14_08-18-36,4142,"[np.float32(0.0), np.float32(0.0), np.float32(0.0), np.float32(0.0), np.float32(0.0), np.float32(0.0), np.float32(1.0), np.float32(1.0), np.float32(1.0), np.float32(0.0), np.float32(1.0), np.float32(0.0), np.float32(1.0), np.float32(0.0), np.float32(0.0), np.float32(0.0)]",-2.0,99603.0,21
2025-08-14_08-18-36,4143,"[np.float32(0.0), np.float32(1.0), np.float32(0.0), np.float32(0.0), np.float32(0.0), np.float32(0.0), np.float32(0.0), np.float32(1.0), np.float32(1.0), np.float32(0.0), np.float32(0.0), np.float32(1.0), np.float32(0.0), np.float32(0.0), np.float32(1.0), np.float32(0.0)]",-2.0,99601.0,14
2025-08-14_08-18-36,4144,"[np.float32(1.0), np.float32(1.0), np.float32(1.0), np.float32(0.0), np.float32(1.0), np.float32(0.0), np.float32(1.0), np.float32(1.0), np.float32(0.0), np.float32(0.0), np.float32(1.0), np.float32(0.0), np.float32(0.0), np.float32(0.0), np.float32(0.0), np.float32(0.0)]",3.0,99604.0,17
2025-08-14_08-18-36,4145,"[np.float32(0.0), np.float32(0.0), np.float32(0.0), np.float32(0.0), np.float32(0.0), np.float32(1.0), np.float32(1.0), np.float32(1.0), np.float32(0.0), np.float32(0.0), np.float32(1.0), np.float32(0.0), np.float32(0.0), np.float32(0.0), np.float32(1.0), np.float32(1.0)]",0.0,99604.0,16
2025-08-14_08-18-36,4146,"[np.float32(1.0), np.float32(1.0), np.float32(0.0), np.float32(1.0), np.float32(0.0), np.float32(0.0), np.float32(1.0), np.float32(0.0), np.float32(1.0), np.float32(0.0), np.float32(0.0), np.float32(0.0), np.float32(1.0), np.float32(1.0), np.float32(0.0), np.float32(1.0)]",-1.0,99603.0,33
2025-08-14_08-18-36,4147,"[np.float32(1.0), np.float32(1.0), np.float32(1.0), np.float32(1.0), np.float32(0.0), np.float32(1.0), np.float32(0.0), np.float32(1.0), np.float32(0.0), np.float32(0.0), np.float32(1.0), np.float32(0.0), np.float32(1.0), np.float32(0.0), np.float32(0.0), np.float32(0.0)]",-2.0,99601.0,0
2025-08-14_08-18-36,4148,"[np.float32(0.0), np.float32(1.0), np.float32(0.0), np.float32(1.0), np.float32(0.0), np.float32(0.0), np.float32(0.0), np.float32(0.0), np.float32(1.0), np.float32(1.0), np.float32(1.0), np.float32(0.0), np.float32(1.0), np.float32(1.0), np.float32(0.0), np.float32(1.0)]",0.0,99601.0,1
2025-08-14_08-18-36,4149,"[np.float32(1.0), np.float32(1.0), np.float32(1.0), np.float32(1.0), np.float32(1.0), np.float32(0.0), np.float32(1.0), np.float32(1.0), np.float32(0.0), np.float32(0.0), np.float32(0.0), np.float32(0.0), np.float32(1.0), np.float32(1.0), np.float32(1.0), np.float32(1.0)]",1.0,99602.0,3
2025-08-14_08-18-36,4150,"[np.float32(0.0), np.float32(0.0), np.float32(1.0), np.float32(1.0), np.float32(0.0), np.float32(1.0), np.float32(1.0), np.float32(1.0), np.float32(1.0), np.float32(1.0), np.float32(0.0), np.float32(1.0), np.float32(1.0), np.float32(0.0), np.float32(0.0), np.float32(1.0)]",1.0,99603.0,6
2025-08-14_08-18-36,4151,"[np.float32(1.0), np.float32(0.0), np.float32(1.0), np.float32(0.0), np.float32(1.0), np.float32(1.0), np.float32(0.0), np.float32(1.0), np.float32(1.0), np.float32(1.0), np.float32(0.0), np.float32(0.0), np.float32(1.0), np.float32(0.0), np.float32(1.0), np.float32(1.0)]",-6.0,99597.0,3
2025-08-14_08-18-36,4152,"[np.float32(1.0), np.float32(1.0), np.float32(1.0), np.float32(1.0), np.float32(1.0), np.float32(1.0), np.float32(1.0), np.float32(0.0), np.float32(0.0), np.float32(1.0), np.float32(0.0), np.float32(0.0), np.float32(1.0), np.float32(0.0), np.float32(0.0), np.float32(1.0)]",-1.0,99596.0,11
2025-08-14_08-18-36,4153,"[np.float32(1.0), np.float32(1.0), np.float32(1.0), np.float32(1.0), np.float32(0.0), np.float32(1.0), np.float32(0.0), np.float32(0.0), np.float32(0.0), np.float32(1.0), np.float32(0.0), np.float32(1.0), np.float32(1.0), np.float32(1.0), np.float32(1.0), np.float32(0.0)]",-3.0,99593.0,11
2025-08-14_08-18-36,4154,"[np.float32(0.0), np.float32(0.0), np.float32(1.0), np.float32(1.0), np.float32(0.0), np.float32(1.0), np.float32(1.0), np.float32(1.0), np.float32(1.0), np.float32(0.0), np.float32(0.0), np.float32(0.0), np.float32(1.0), np.float32(1.0), np.float32(1.0), np.float32(0.0)]",35.0,99628.0,7
2025-08-14_08-18-36,4155,"[np.float32(0.0), np.float32(1.0), np.float32(1.0), np.float32(0.0), np.float32(1.0), np.float32(0.0), np.float32(1.0), np.float32(1.0), np.float32(0.0), np.float32(0.0), np.float32(0.0), np.float32(0.0), np.float32(1.0), np.float32(0.0), np.float32(0.0), np.float32(1.0)]",0.0,99628.0,15
2025-08-14_08-18-36,4156,"[np.float32(0.0), np.float32(1.0), np.float32(0.0), np.float32(0.0), np.float32(0.0), np.float32(1.0), np.float32(0.0), np.float32(1.0), np.float32(1.0), np.float32(1.0), np.float32(0.0), np.float32(1.0), np.float32(1.0), np.float32(1.0), np.float32(1.0), np.float32(0.0)]",-3.0,99625.0,12
2025-08-14_08-18-36,4157,"[np.float32(1.0), np.float32(1.0), np.float32(1.0), np.float32(0.0), np.float32(1.0), np.float32(0.0), np.float32(1.0), np.float32(0.0), np.float32(0.0), np.float32(1.0), np.float32(0.0), np.float32(0.0), np.float32(0.0), np.float32(0.0), np.float32(0.0), np.float32(0.0)]",-1.0,99624.0,31
2025-08-14_08-18-36,4158,"[np.float32(0.0), np.float32(0.0), np.float32(0.0), np.float32(1.0), np.float32(0.0), np.float32(1.0), np.float32(1.0), np.float32(1.0), np.float32(0.0), np.float32(1.0), np.float32(0.0), np.float32(1.0), np.float32(1.0), np.float32(0.0), np.float32(1.0), np.float32(1.0)]",-7.0,99617.0,0
2025-08-14_08-18-36,4159,"[np.float32(0.0), np.float32(1.0), np.float32(1.0), np.float32(0.0), np.float32(0.0), np.float32(1.0), np.float32(0.0), np.float32(1.0), np.float32(0.0), np.float32(0.0), np.float32(1.0), np.float32(0.0), np.float32(1.0), np.float32(0.0), np.float32(0.0), np.float32(1.0)]",-4.0,99613.0,5
2025-08-14_08-18-36,4160,"[np.float32(0.0), np.float32(1.0), np.float32(1.0), np.float32(0.0), np.float32(0.0), np.float32(0.0), np.float32(0.0), np.float32(0.0), np.float32(1.0), np.float32(0.0), np.float32(1.0), np.float32(1.0), np.float32(1.0), np.float32(1.0), np.float32(1.0), np.float32(1.0)]",1.0,99614.0,24
2025-08-14_08-18-36,4161,"[np.float32(0.0), np.float32(0.0), np.float32(0.0), np.float32(1.0), np.float32(0.0), np.float32(0.0), np.float32(1.0), np.float32(1.0), np.float32(0.0), np.float32(0.0), np.float32(1.0), np.float32(1.0), np.float32(0.0), np.float32(1.0), np.float32(0.0), np.float32(0.0)]",-1.0,99613.0,25
2025-08-14_08-18-36,4162,"[np.float32(1.0), np.float32(0.0), np.float32(0.0), np.float32(0.0), np.float32(1.0), np.float32(1.0), np.float32(0.0), np.float32(1.0), np.float32(0.0), np.float32(0.0), np.float32(0.0), np.float32(1.0), np.float32(1.0), np.float32(1.0), np.float32(1.0), np.float32(1.0)]",4.0,99617.0,18
2025-08-14_08-18-36,4163,"[np.float32(0.0), np.float32(0.0), np.float32(1.0), np.float32(0.0), np.float32(1.0), np.float32(0.0), np.float32(0.0), np.float32(0.0), np.float32(0.0), np.float32(1.0), np.float32(0.0), np.float32(0.0), np.float32(0.0), np.float32(1.0), np.float32(0.0), np.float32(0.0)]",-4.0,99613.0,27
2025-08-14_08-18-36,4164,"[np.float32(1.0), np.float32(0.0), np.float32(0.0), np.float32(0.0), np.float32(0.0), np.float32(1.0), np.float32(0.0), np.float32(0.0), np.float32(1.0), np.float32(1.0), np.float32(1.0), np.float32(0.0), np.float32(0.0), np.float32(1.0), np.float32(1.0), np.float32(0.0)]",-4.0,99609.0,15
2025-08-14_08-18-36,4165,"[np.float32(0.0), np.float32(1.0), np.float32(1.0), np.float32(1.0), np.float32(0.0), np.float32(1.0), np.float32(1.0), np.float32(0.0), np.float32(0.0), np.float32(0.0), np.float32(1.0), np.float32(1.0), np.float32(1.0), np.float32(1.0), np.float32(0.0), np.float32(0.0)]",0.0,99609.0,0
2025-08-14_08-18-36,4166,"[np.float32(0.0), np.float32(1.0), np.float32(1.0), np.float32(1.0), np.float32(1.0), np.float32(0.0), np.float32(1.0), np.float32(1.0), np.float32(1.0), np.float32(0.0), np.float32(0.0), np.float32(0.0), np.float32(0.0), np.float32(1.0), np.float32(1.0), np.float32(0.0)]",0.0,99609.0,6
2025-08-14_08-18-36,4167,"[np.float32(1.0), np.float32(1.0), np.float32(1.0), np.float32(1.0), np.float32(0.0), np.float32(1.0), np.float32(0.0), np.float32(0.0), np.float32(1.0), np.float32(0.0), np.float32(0.0), np.float32(0.0), np.float32(0.0), np.float32(1.0), np.float32(1.0), np.float32(1.0)]",-2.0,99607.0,12
2025-08-14_08-18-36,4168,"[np.float32(0.0), np.float32(1.0), np.float32(0.0), np.float32(1.0), np.float32(1.0), np.float32(0.0), np.float32(1.0), np.float32(1.0), np.float32(0.0), np.float32(1.0), np.float32(0.0), np.float32(0.0), np.float32(0.0), np.float32(0.0), np.float32(1.0), np.float32(1.0)]",-6.0,99601.0,0
2025-08-14_08-18-36,4169,"[np.float32(1.0), np.float32(0.0), np.float32(0.0), np.float32(1.0), np.float32(0.0), np.float32(0.0), np.float32(1.0), np.float32(0.0), np.float32(1.0), np.float32(0.0), np.float32(1.0), np.float32(1.0), np.float32(0.0), np.float32(0.0), np.float32(0.0), np.float32(0.0)]",-4.0,99597.0,16
2025-08-14_08-18-36,4170,"[np.float32(0.0), np.float32(0.0), np.float32(1.0), np.float32(1.0), np.float32(0.0), np.float32(0.0), np.float32(1.0), np.float32(1.0), np.float32(1.0), np.float32(1.0), np.float32(1.0), np.float32(1.0), np.float32(1.0), np.float32(0.0), np.float32(0.0), np.float32(1.0)]",-2.0,99595.0,29
2025-08-14_08-18-36,4171,"[np.float32(0.0), np.float32(1.0), np.float32(0.0), np.float32(1.0), np.float32(0.0), np.float32(1.0), np.float32(1.0), np.float32(1.0), np.float32(1.0), np.float32(0.0), np.float32(0.0), np.float32(1.0), np.float32(0.0), np.float32(0.0), np.float32(0.0), np.float32(1.0)]",1.0,99596.0,29
2025-08-14_08-18-36,4172,"[np.float32(0.0), np.float32(0.0), np.float32(0.0), np.float32(1.0), np.float32(0.0), np.float32(0.0), np.float32(0.0), np.float32(1.0), np.float32(0.0), np.float32(0.0), np.float32(1.0), np.float32(1.0), np.float32(1.0), np.float32(0.0), np.float32(0.0), np.float32(0.0)]",0.0,99596.0,19
2025-08-14_08-18-36,4173,"[np.float32(1.0), np.float32(1.0), np.float32(1.0), np.float32(1.0), np.float32(1.0), np.float32(1.0), np.float32(0.0), np.float32(1.0), np.float32(0.0), np.float32(0.0), np.float32(0.0), np.float32(0.0), np.float32(0.0), np.float32(0.0), np.float32(0.0), np.float32(0.0)]",-1.0,99595.0,27
2025-08-14_08-18-36,4174,"[np.float32(0.0), np.float32(1.0), np.float32(1.0), np.float32(0.0), np.float32(1.0), np.float32(0.0), np.float32(1.0), np.float32(0.0), np.float32(0.0), np.float32(1.0), np.float32(0.0), np.float32(1.0), np.float32(1.0), np.float32(0.0), np.float32(1.0), np.float32(0.0)]",-3.0,99592.0,34
2025-08-14_08-18-36,4175,"[np.float32(1.0), np.float32(0.0), np.float32(1.0), np.float32(0.0), np.float32(1.0), np.float32(1.0), np.float32(0.0), np.float32(0.0), np.float32(1.0), np.float32(1.0), np.float32(1.0), np.float32(1.0), np.float32(0.0), np.float32(1.0), np.float32(0.0), np.float32(0.0)]",1.0,99593.0,22
2025-08-14_08-18-36,4176,"[np.float32(1.0), np.float32(1.0), np.float32(0.0), np.float32(0.0), np.float32(0.0), np.float32(0.0), np.float32(1.0), np.float32(1.0), np.float32(1.0), np.float32(1.0), np.float32(1.0), np.float32(0.0), np.float32(0.0), np.float32(0.0), np.float32(1.0), np.float32(1.0)]",2.0,99595.0,5
2025-08-14_08-18-36,4177,"[np.float32(0.0), np.float32(1.0), np.float32(1.0), np.float32(1.0), np.float32(1.0), np.float32(0.0), np.float32(1.0), np.float32(0.0), np.float32(0.0), np.float32(0.0), np.float32(1.0), np.float32(0.0), np.float32(1.0), np.float32(0.0), np.float32(0.0), np.float32(0.0)]",0.0,99595.0,26
2025-08-14_08-18-36,4178,"[np.float32(0.0), np.float32(1.0), np.float32(1.0), np.float32(1.0), np.float32(0.0), np.float32(1.0), np.float32(0.0), np.float32(0.0), np.float32(0.0), np.float32(0.0), np.float32(0.0), np.float32(1.0), np.float32(1.0), np.float32(1.0), np.float32(0.0), np.float32(1.0)]",0.0,99595.0,12
2025-08-14_08-18-36,4179,"[np.float32(1.0), np.float32(0.0), np.float32(1.0), np.float32(1.0), np.float32(0.0), np.float32(1.0), np.float32(0.0), np.float32(0.0), np.float32(0.0), np.float32(1.0), np.float32(0.0), np.float32(0.0), np.float32(0.0), np.float32(1.0), np.float32(0.0), np.float32(0.0)]",1.0,99596.0,1
2025-08-14_08-18-36,4180,"[np.float32(1.0), np.float32(0.0), np.float32(1.0), np.float32(1.0), np.float32(1.0), np.float32(0.0), np.float32(0.0), np.float32(0.0), np.float32(1.0), np.float32(1.0), np.float32(1.0), np.float32(0.0), np.float32(1.0), np.float32(0.0), np.float32(1.0), np.float32(1.0)]",0.0,99596.0,36
2025-08-14_08-18-36,4181,"[np.float32(1.0), np.float32(1.0), np.float32(0.0), np.float32(0.0), np.float32(0.0), np.float32(0.0), np.float32(1.0), np.float32(0.0), np.float32(0.0), np.float32(0.0), np.float32(0.0), np.float32(1.0), np.float32(1.0), np.float32(0.0), np.float32(1.0), np.float32(1.0)]",1.0,99597.0,1
2025-08-14_08-18-36,4182,"[np.float32(1.0), np.float32(1.0), np.float32(1.0), np.float32(1.0), np.float32(0.0), np.float32(1.0), np.float32(1.0), np.float32(0.0), np.float32(0.0), np.float32(0.0), np.float32(1.0), np.float32(1.0), np.float32(1.0), np.float32(0.0), np.float32(0.0), np.float32(1.0)]",0.0,99597.0,17
2025-08-14_08-18-36,4183,"[np.float32(1.0), np.float32(0.0), np.float32(1.0), np.float32(1.0), np.float32(0.0), np.float32(0.0), np.float32(0.0), np.float32(1.0), np.float32(0.0), np.float32(1.0), np.float32(1.0), np.float32(0.0), np.float32(0.0), np.float32(1.0), np.float32(1.0), np.float32(0.0)]",2.0,99599.0,7
2025-08-14_08-18-36,4184,"[np.float32(0.0), np.float32(0.0), np.float32(1.0), np.float32(1.0), np.float32(1.0), np.float32(1.0), np.float32(1.0), np.float32(0.0), np.float32(1.0), np.float32(1.0), np.float32(0.0), np.float32(1.0), np.float32(0.0), np.float32(1.0), np.float32(1.0), np.float32(0.0)]",3.0,99602.0,3
2025-08-14_08-18-36,4185,"[np.float32(0.0), np.float32(0.0), np.float32(0.0), np.float32(1.0), np.float32(0.0), np.float32(1.0), np.float32(0.0), np.float32(0.0), np.float32(1.0), np.float32(1.0), np.float32(0.0), np.float32(1.0), np.float32(0.0), np.float32(1.0), np.float32(0.0), np.float32(0.0)]",2.0,99604.0,26
2025-08-14_08-18-36,4186,"[np.float32(0.0), np.float32(1.0), np.float32(0.0), np.float32(0.0), np.float32(1.0), np.float32(0.0), np.float32(0.0), np.float32(1.0), np.float32(0.0), np.float32(0.0), np.float32(1.0), np.float32(1.0), np.float32(0.0), np.float32(0.0), np.float32(1.0), np.float32(1.0)]",4.0,99608.0,20
2025-08-14_08-18-36,4187,"[np.float32(0.0), np.float32(1.0), np.float32(1.0), np.float32(0.0), np.float32(1.0), np.float32(1.0), np.float32(0.0), np.float32(0.0), np.float32(0.0), np.float32(0.0), np.float32(0.0), np.float32(1.0), np.float32(1.0), np.float32(1.0), np.float32(0.0), np.float32(0.0)]",-1.0,99607.0,10
2025-08-14_08-18-36,4188,"[np.float32(0.0), np.float32(1.0), np.float32(0.0), np.float32(1.0), np.float32(0.0), np.float32(0.0), np.float32(0.0), np.float32(0.0), np.float32(1.0), np.float32(1.0), np.float32(1.0), np.float32(0.0), np.float32(1.0), np.float32(0.0), np.float32(0.0), np.float32(0.0)]",1.0,99608.0,11
2025-08-14_08-18-36,4189,"[np.float32(0.0), np.float32(0.0), np.float32(0.0), np.float32(1.0), np.float32(0.0), np.float32(1.0), np.float32(0.0), np.float32(1.0), np.float32(1.0), np.float32(1.0), np.float32(0.0), np.float32(0.0), np.float32(0.0), np.float32(1.0), np.float32(0.0), np.float32(1.0)]",-1.0,99607.0,16
2025-08-14_08-18-36,4190,"[np.float32(1.0), np.float32(1.0), np.float32(0.0), np.float32(0.0), np.float32(1.0), np.float32(0.0), np.float32(1.0), np.float32(0.0), np.float32(1.0), np.float32(0.0), np.float32(1.0), np.float32(1.0), np.float32(0.0), np.float32(1.0), np.float32(1.0), np.float32(1.0)]",-2.0,99605.0,23
2025-08-14_08-18-36,4191,"[np.float32(0.0), np.float32(1.0), np.float32(0.0), np.float32(0.0), np.float32(1.0), np.float32(0.0), np.float32(1.0), np.float32(1.0), np.float32(1.0), np.float32(0.0), np.float32(0.0), np.float32(0.0), np.float32(0.0), np.float32(0.0), np.float32(0.0), np.float32(1.0)]",2.0,99607.0,20
2025-08-14_08-18-36,4192,"[np.float32(1.0), np.float32(1.0), np.float32(1.0), np.float32(0.0), np.float32(1.0), np.float32(1.0), np.float32(1.0), np.float32(0.0), np.float32(0.0), np.float32(0.0), np.float32(1.0), np.float32(0.0), np.float32(0.0), np.float32(0.0), np.float32(0.0), np.float32(0.0)]",5.0,99612.0,8
2025-08-14_08-18-36,4193,"[np.float32(1.0), np.float32(0.0), np.float32(0.0), np.float32(0.0), np.float32(0.0), np.float32(1.0), np.float32(1.0), np.float32(0.0), np.float32(1.0), np.float32(0.0), np.float32(1.0), np.float32(1.0), np.float32(0.0), np.float32(1.0), np.float32(0.0), np.float32(1.0)]",3.0,99615.0,9
2025-08-14_08-18-36,4194,"[np.float32(0.0), np.float32(0.0), np.float32(1.0), np.float32(0.0), np.float32(1.0), np.float32(1.0), np.float32(0.0), np.float32(1.0), np.float32(1.0), np.float32(1.0), np.float32(1.0), np.float32(0.0), np.float32(0.0), np.float32(1.0), np.float32(0.0), np.float32(0.0)]",3.0,99618.0,35
2025-08-14_08-18-36,4195,"[np.float32(0.0), np.float32(0.0), np.float32(1.0), np.float32(1.0), np.float32(1.0), np.float32(1.0), np.float32(1.0), np.float32(1.0), np.float32(1.0), np.float32(1.0), np.float32(0.0), np.float32(0.0), np.float32(0.0), np.float32(0.0), np.float32(0.0), np.float32(1.0)]",-2.0,99616.0,18
2025-08-14_08-18-36,4196,"[np.float32(0.0), np.float32(0.0), np.float32(0.0), np.float32(1.0), np.float32(0.0), np.float32(1.0), np.float32(0.0), np.float32(0.0), np.float32(1.0), np.float32(0.0), np.float32(0.0), np.float32(1.0), np.float32(0.0), np.float32(0.0), np.float32(0.0), np.float32(1.0)]",-2.0,99614.0,14
2025-08-14_08-18-36,4197,"[np.float32(0.0), np.float32(1.0), np.float32(0.0), np.float32(1.0), np.float32(1.0), np.float32(0.0), np.float32(1.0), np.float32(0.0), np.float32(1.0), np.float32(0.0), np.float32(1.0), np.float32(1.0), np.float32(1.0), np.float32(1.0), np.float32(1.0), np.float32(0.0)]",5.0,99619.0,11
2025-08-14_08-18-36,4198,"[np.float32(1.0), np.float32(1.0), np.float32(0.0), np.float32(0.0), np.float32(1.0), np.float32(1.0), np.float32(0.0), np.float32(1.0), np.float32(1.0), np.float32(0.0), np.float32(0.0), np.float32(0.0), np.float32(1.0), np.float32(0.0), np.float32(0.0), np.float32(0.0)]",0.0,99619.0,27
2025-08-14_08-18-36,4199,"[np.float32(1.0), np.float32(1.0), np.float32(0.0), np.float32(0.0), np.float32(0.0), np.float32(0.0), np.float32(1.0), np.float32(1.0), np.float32(0.0), np.float32(0.0), np.float32(0.0), np.float32(0.0), np.float32(1.0), np.float32(1.0), np.float32(0.0), np.float32(0.0)]",2.0,99621.0,21
2025-08-14_08-18-36,4200,"[np.float32(0.0), np.float32(1.0), np.float32(1.0), np.float32(1.0), np.float32(1.0), np.float32(1.0), np.float32(1.0), np.float32(1.0), np.float32(0.0), np.float32(0.0), np.float32(1.0), np.float32(1.0), np.float32(1.0), np.float32(1.0), np.float32(1.0), np.float32(0.0)]",0.0,99621.0,35
2025-08-14_08-18-36,4201,"[np.float32(1.0), np.float32(0.0), np.float32(0.0), np.float32(0.0), np.float32(0.0), np.float32(0.0), np.float32(0.0), np.float32(1.0), np.float32(0.0), np.float32(0.0), np.float32(0.0), np.float32(0.0), np.float32(1.0), np.float32(0.0), np.float32(0.0), np.float32(0.0)]",-3.0,99618.0,2
2025-08-14_08-18-36,4202,"[np.float32(1.0), np.float32(0.0), np.float32(0.0), np.float32(1.0), np.float32(0.0), np.float32(1.0), np.float32(0.0), np.float32(1.0), np.float32(1.0), np.float32(0.0), np.float32(1.0), np.float32(1.0), np.float32(0.0), np.float32(0.0), np.float32(1.0), np.float32(1.0)]",4.0,99622.0,30
2025-08-14_08-18-36,4203,"[np.float32(1.0), np.float32(1.0), np.float32(0.0), np.float32(0.0), np.float32(1.0), np.float32(1.0), np.float32(1.0), np.float32(0.0), np.float32(1.0), np.float32(1.0), np.float32(1.0), np.float32(0.0), np.float32(1.0), np.float32(1.0), np.float32(1.0), np.float32(0.0)]",2.0,99624.0,4
2025-08-14_08-18-36,4204,"[np.float32(0.0), np.float32(1.0), np.float32(1.0), np.float32(0.0), np.float32(0.0), np.float32(0.0), np.float32(0.0), np.float32(0.0), np.float32(1.0), np.float32(1.0), np.float32(0.0), np.float32(1.0), np.float32(1.0), np.float32(0.0), np.float32(0.0), np.float32(0.0)]",-1.0,99623.0,18
2025-08-14_08-18-36,4205,"[np.float32(0.0), np.float32(1.0), np.float32(1.0), np.float32(1.0), np.float32(0.0), np.float32(1.0), np.float32(0.0), np.float32(1.0), np.float32(1.0), np.float32(1.0), np.float32(1.0), np.float32(1.0), np.float32(0.0), np.float32(0.0), np.float32(0.0), np.float32(0.0)]",-2.0,99621.0,8
2025-08-14_08-18-36,4206,"[np.float32(1.0), np.float32(0.0), np.float32(0.0), np.float32(1.0), np.float32(1.0), np.float32(1.0), np.float32(1.0), np.float32(1.0), np.float32(1.0), np.float32(0.0), np.float32(0.0), np.float32(0.0), np.float32(1.0), np.float32(1.0), np.float32(0.0), np.float32(1.0)]",-2.0,99619.0,2
2025-08-14_08-18-36,4207,"[np.float32(0.0), np.float32(0.0), np.float32(0.0), np.float32(0.0), np.float32(1.0), np.float32(0.0), np.float32(1.0), np.float32(1.0), np.float32(1.0), np.float32(1.0), np.float32(0.0), np.float32(0.0), np.float32(1.0), np.float32(0.0), np.float32(1.0), np.float32(0.0)]",-1.0,99618.0,33
2025-08-14_08-18-36,4208,"[np.float32(0.0), np.float32(0.0), np.float32(0.0), np.float32(0.0), np.float32(1.0), np.float32(0.0), np.float32(0.0), np.float32(0.0), np.float32(0.0), np.float32(1.0), np.float32(0.0), np.float32(0.0), np.float32(0.0), np.float32(0.0), np.float32(1.0), np.float32(1.0)]",4.0,99622.0,16
2025-08-14_08-18-36,4209,"[np.float32(1.0), np.float32(1.0), np.float32(0.0), np.float32(0.0), np.float32(0.0), np.float32(1.0), np.float32(1.0), np.float32(1.0), np.float32(0.0), np.float32(1.0), np.float32(1.0), np.float32(0.0), np.float32(1.0), np.float32(1.0), np.float32(0.0), np.float32(1.0)]",1.0,99623.0,1
2025-08-14_08-18-36,4210,"[np.float32(1.0), np.float32(1.0), np.float32(0.0), np.float32(0.0), np.float32(1.0), np.float32(0.0), np.float32(0.0), np.float32(0.0), np.float32(1.0), np.float32(1.0), np.float32(1.0), np.float32(1.0), np.float32(1.0), np.float32(0.0), np.float32(0.0), np.float32(0.0)]",-1.0,99622.0,5
2025-08-14_08-18-36,4211,"[np.float32(1.0), np.float32(0.0), np.float32(1.0), np.float32(0.0), np.float32(1.0), np.float32(0.0), np.float32(1.0), np.float32(1.0), np.float32(1.0), np.float32(1.0), np.float32(0.0), np.float32(0.0), np.float32(1.0), np.float32(0.0), np.float32(1.0), np.float32(0.0)]",-4.0,99618.0,26
2025-08-14_08-18-36,4212,"[np.float32(1.0), np.float32(0.0), np.float32(1.0), np.float32(1.0), np.float32(0.0), np.float32(1.0), np.float32(1.0), np.float32(0.0), np.float32(0.0), np.float32(1.0), np.float32(0.0), np.float32(1.0), np.float32(0.0), np.float32(1.0), np.float32(1.0), np.float32(0.0)]",3.0,99621.0,19
2025-08-14_08-18-36,4213,"[np.float32(1.0), np.float32(1.0), np.float32(1.0), np.float32(1.0), np.float32(1.0), np.float32(1.0), np.float32(1.0), np.float32(1.0), np.float32(1.0), np.float32(0.0), np.float32(0.0), np.float32(1.0), np.float32(1.0), np.float32(0.0), np.float32(0.0), np.float32(1.0)]",0.0,99621.0,24
2025-08-14_08-18-36,4214,"[np.float32(1.0), np.float32(0.0), np.float32(1.0), np.float32(0.0), np.float32(0.0), np.float32(1.0), np.float32(0.0), np.float32(1.0), np.float32(0.0), np.float32(1.0), np.float32(1.0), np.float32(0.0), np.float32(1.0), np.float32(1.0), np.float32(0.0), np.float32(1.0)]",1.0,99622.0,26
2025-08-14_08-18-36,4215,"[np.float32(1.0), np.float32(0.0), np.float32(1.0), np.float32(1.0), np.float32(0.0), np.float32(0.0), np.float32(1.0), np.float32(1.0), np.float32(1.0), np.float32(1.0), np.float32(1.0), np.float32(1.0), np.float32(1.0), np.float32(0.0), np.float32(1.0), np.float32(0.0)]",-3.0,99619.0,31
2025-08-14_08-18-36,4216,"[np.float32(0.0), np.float32(0.0), np.float32(0.0), np.float32(1.0), np.float32(1.0), np.float32(1.0), np.float32(0.0), np.float32(0.0), np.float32(0.0), np.float32(0.0), np.float32(0.0), np.float32(0.0), np.float32(1.0), np.float32(0.0), np.float32(0.0), np.float32(0.0)]",0.0,99619.0,29
2025-08-14_08-18-36,4217,"[np.float32(1.0), np.float32(0.0), np.float32(1.0), np.float32(1.0), np.float32(0.0), np.float32(1.0), np.float32(1.0), np.float32(1.0), np.float32(1.0), np.float32(1.0), np.float32(0.0), np.float32(1.0), np.float32(0.0), np.float32(0.0), np.float32(1.0), np.float32(1.0)]",-1.0,99618.0,7
2025-08-14_08-18-36,4218,"[np.float32(1.0), np.float32(1.0), np.float32(0.0), np.float32(1.0), np.float32(0.0), np.float32(1.0), np.float32(0.0), np.float32(1.0), np.float32(0.0), np.float32(0.0), np.float32(1.0), np.float32(1.0), np.float32(1.0), np.float32(0.0), np.float32(0.0), np.float32(0.0)]",-1.0,99617.0,32
2025-08-14_08-18-36,4219,"[np.float32(0.0), np.float32(0.0), np.float32(0.0), np.float32(0.0), np.float32(0.0), np.float32(0.0), np.float32(0.0), np.float32(1.0), np.float32(0.0), np.float32(0.0), np.float32(0.0), np.float32(0.0), np.float32(0.0), np.float32(1.0), np.float32(0.0), np.float32(0.0)]",1.0,99618.0,17
2025-08-14_08-18-36,4220,"[np.float32(1.0), np.float32(0.0), np.float32(0.0), np.float32(0.0), np.float32(1.0), np.float32(0.0), np.float32(1.0), np.float32(1.0), np.float32(0.0), np.float32(1.0), np.float32(0.0), np.float32(0.0), np.float32(0.0), np.float32(1.0), np.float32(1.0), np.float32(0.0)]",3.0,99621.0,12
2025-08-14_08-18-36,4221,"[np.float32(1.0), np.float32(1.0), np.float32(0.0), np.float32(0.0), np.float32(0.0), np.float32(1.0), np.float32(1.0), np.float32(0.0), np.float32(1.0), np.float32(0.0), np.float32(1.0), np.float32(1.0), np.float32(1.0), np.float32(1.0), np.float32(0.0), np.float32(1.0)]",0.0,99621.0,28
2025-08-14_08-18-36,4222,"[np.float32(0.0), np.float32(1.0), np.float32(0.0), np.float32(1.0), np.float32(0.0), np.float32(1.0), np.float32(0.0), np.float32(1.0), np.float32(1.0), np.float32(1.0), np.float32(1.0), np.float32(0.0), np.float32(0.0), np.float32(1.0), np.float32(0.0), np.float32(0.0)]",7.0,99628.0,35
2025-08-14_08-18-36,4223,"[np.float32(0.0), np.float32(0.0), np.float32(0.0), np.float32(0.0), np.float32(1.0), np.float32(0.0), np.float32(1.0), np.float32(1.0), np.float32(1.0), np.float32(0.0), np.float32(1.0), np.float32(1.0), np.float32(0.0), np.float32(1.0), np.float32(1.0), np.float32(0.0)]",-3.0,99625.0,1
2025-08-14_08-18-36,4224,"[np.float32(1.0), np.float32(0.0), np.float32(0.0), np.float32(0.0), np.float32(1.0), np.float32(1.0), np.float32(1.0), np.float32(1.0), np.float32(1.0), np.float32(1.0), np.float32(0.0), np.float32(0.0), np.float32(1.0), np.float32(1.0), np.float32(0.0), np.float32(0.0)]",40.0,99665.0,7
2025-08-14_08-18-36,4225,"[np.float32(0.0), np.float32(0.0), np.float32(1.0), np.float32(1.0), np.float32(1.0), np.float32(1.0), np.float32(1.0), np.float32(1.0), np.float32(0.0), np.float32(0.0), np.float32(0.0), np.float32(0.0), np.float32(0.0), np.float32(0.0), np.float32(0.0), np.float32(1.0)]",0.0,99665.0,13
2025-08-14_08-18-36,4226,"[np.float32(0.0), np.float32(0.0), np.float32(0.0), np.float32(0.0), np.float32(1.0), np.float32(1.0), np.float32(0.0), np.float32(1.0), np.float32(1.0), np.float32(0.0), np.float32(1.0), np.float32(1.0), np.float32(0.0), np.float32(0.0), np.float32(0.0), np.float32(0.0)]",2.0,99667.0,23
2025-08-14_08-18-36,4227,"[np.float32(1.0), np.float32(1.0), np.float32(0.0), np.float32(1.0), np.float32(1.0), np.float32(1.0), np.float32(1.0), np.float32(1.0), np.float32(0.0), np.float32(1.0), np.float32(0.0), np.float32(0.0), np.float32(1.0), np.float32(1.0), np.float32(0.0), np.float32(0.0)]",-3.0,99664.0,32
2025-08-14_08-18-36,4228,"[np.float32(0.0), np.float32(0.0), np.float32(1.0), np.float32(1.0), np.float32(0.0), np.float32(0.0), np.float32(0.0), np.float32(1.0), np.float32(1.0), np.float32(1.0), np.float32(1.0), np.float32(1.0), np.float32(0.0), np.float32(1.0), np.float32(1.0), np.float32(0.0)]",2.0,99666.0,26
2025-08-14_08-18-36,4229,"[np.float32(1.0), np.float32(1.0), np.float32(0.0), np.float32(0.0), np.float32(0.0), np.float32(1.0), np.float32(0.0), np.float32(0.0), np.float32(1.0), np.float32(0.0), np.float32(0.0), np.float32(0.0), np.float32(0.0), np.float32(1.0), np.float32(0.0), np.float32(1.0)]",-4.0,99662.0,8
2025-08-14_08-18-36,4230,"[np.float32(1.0), np.float32(0.0), np.float32(0.0), np.float32(0.0), np.float32(1.0), np.float32(1.0), np.float32(1.0), np.float32(1.0), np.float32(0.0), np.float32(0.0), np.float32(0.0), np.float32(0.0), np.float32(1.0), np.float32(1.0), np.float32(0.0), np.float32(0.0)]",1.0,99663.0,15
2025-08-14_08-18-36,4231,"[np.float32(1.0), np.float32(1.0), np.float32(1.0), np.float32(0.0), np.float32(0.0), np.float32(1.0), np.float32(0.0), np.float32(1.0), np.float32(1.0), np.float32(1.0), np.float32(0.0), np.float32(1.0), np.float32(1.0), np.float32(1.0), np.float32(0.0), np.float32(0.0)]",3.0,99666.0,18
2025-08-14_08-18-36,4232,"[np.float32(1.0), np.float32(0.0), np.float32(1.0), np.float32(1.0), np.float32(0.0), np.float32(1.0), np.float32(0.0), np.float32(1.0), np.float32(0.0), np.float32(1.0), np.float32(1.0), np.float32(0.0), np.float32(0.0), np.float32(0.0), np.float32(0.0), np.float32(0.0)]",0.0,99666.0,24
2025-08-14_08-18-36,4233,"[np.float32(1.0), np.float32(0.0), np.float32(1.0), np.float32(1.0), np.float32(1.0), np.float32(1.0), np.float32(0.0), np.float32(0.0), np.float32(1.0), np.float32(1.0), np.float32(0.0), np.float32(1.0), np.float32(1.0), np.float32(1.0), np.float32(1.0), np.float32(1.0)]",0.0,99666.0,12
2025-08-14_08-18-36,4234,"[np.float32(0.0), np.float32(0.0), np.float32(0.0), np.float32(1.0), np.float32(1.0), np.float32(0.0), np.float32(1.0), np.float32(1.0), np.float32(1.0), np.float32(1.0), np.float32(1.0), np.float32(0.0), np.float32(1.0), np.float32(1.0), np.float32(1.0), np.float32(0.0)]",1.0,99667.0,25
2025-08-14_08-18-36,4235,"[np.float32(1.0), np.float32(1.0), np.float32(1.0), np.float32(1.0), np.float32(0.0), np.float32(0.0), np.float32(0.0), np.float32(0.0), np.float32(1.0), np.float32(1.0), np.float32(1.0), np.float32(0.0), np.float32(1.0), np.float32(1.0), np.float32(1.0), np.float32(0.0)]",0.0,99667.0,34
2025-08-14_08-18-36,4236,"[np.float32(1.0), np.float32(1.0), np.float32(0.0), np.float32(0.0), np.float32(1.0), np.float32(0.0), np.float32(1.0), np.float32(1.0), np.float32(1.0), np.float32(1.0), np.float32(1.0), np.float32(0.0), np.float32(1.0), np.float32(0.0), np.float32(1.0), np.float32(0.0)]",-2.0,99665.0,29
2025-08-14_08-18-36,4237,"[np.float32(0.0), np.float32(1.0), np.float32(0.0), np.float32(1.0), np.float32(1.0), np.float32(0.0), np.float32(1.0), np.float32(1.0), np.float32(0.0), np.float32(0.0), np.float32(1.0), np.float32(1.0), np.float32(1.0), np.float32(1.0), np.float32(0.0), np.float32(0.0)]",4.0,99669.0,2
2025-08-14_08-18-36,4238,"[np.float32(0.0), np.float32(0.0), np.float32(0.0), np.float32(0.0), np.float32(0.0), np.float32(0.0), np.float32(1.0), np.float32(1.0), np.float32(0.0), np.float32(1.0), np.float32(0.0), np.float32(0.0), np.float32(1.0), np.float32(1.0), np.float32(0.0), np.float32(0.0)]",-2.0,99667.0,35
2025-08-14_08-18-36,4239,"[np.float32(1.0), np.float32(1.0), np.float32(1.0), np.float32(0.0), np.float32(0.0), np.float32(0.0), np.float32(1.0), np.float32(0.0), np.float32(1.0), np.float32(0.0), np.float32(1.0), np.float32(0.0), np.float32(0.0), np.float32(0.0), np.float32(0.0), np.float32(1.0)]",1.0,99668.0,9
2025-08-14_08-18-36,4240,"[np.float32(0.0), np.float32(1.0), np.float32(1.0), np.float32(0.0), np.float32(0.0), np.float32(0.0), np.float32(0.0), np.float32(1.0), np.float32(1.0), np.float32(1.0), np.float32(0.0), np.float32(1.0), np.float32(0.0), np.float32(0.0), np.float32(1.0), np.float32(0.0)]",0.0,99668.0,4
2025-08-14_08-18-36,4241,"[np.float32(1.0), np.float32(0.0), np.float32(0.0), np.float32(0.0), np.float32(1.0), np.float32(1.0), np.float32(1.0), np.float32(1.0), np.float32(0.0), np.float32(1.0), np.float32(1.0), np.float32(1.0), np.float32(0.0), np.float32(1.0), np.float32(0.0), np.float32(1.0)]",-3.0,99665.0,30
2025-08-14_08-18-36,4242,"[np.float32(0.0), np.float32(0.0), np.float32(1.0), np.float32(1.0), np.float32(0.0), np.float32(1.0), np.float32(1.0), np.float32(1.0), np.float32(0.0), np.float32(1.0), np.float32(0.0), np.float32(1.0), np.float32(1.0), np.float32(0.0), np.float32(0.0), np.float32(0.0)]",0.0,99665.0,1
2025-08-14_08-18-36,4243,"[np.float32(1.0), np.float32(0.0), np.float32(0.0), np.float32(0.0), np.float32(1.0), np.float32(0.0), np.float32(0.0), np.float32(1.0), np.float32(1.0), np.float32(1.0), np.float32(1.0), np.float32(0.0), np.float32(1.0), np.float32(0.0), np.float32(1.0), np.float32(0.0)]",-1.0,99664.0,1
2025-08-14_08-18-36,4244,"[np.float32(0.0), np.float32(0.0), np.float32(1.0), np.float32(0.0), np.float32(0.0), np.float32(0.0), np.float32(0.0), np.float32(1.0), np.float32(0.0), np.float32(0.0), np.float32(1.0), np.float32(0.0), np.float32(0.0), np.float32(1.0), np.float32(1.0), np.float32(0.0)]",1.0,99665.0,13
2025-08-14_08-18-36,4245,"[np.float32(1.0), np.float32(0.0), np.float32(1.0), np.float32(0.0), np.float32(0.0), np.float32(1.0), np.float32(0.0), np.float32(1.0), np.float32(0.0), np.float32(0.0), np.float32(0.0), np.float32(1.0), np.float32(0.0), np.float32(1.0), np.float32(0.0), np.float32(0.0)]",1.0,99666.0,23
2025-08-14_08-18-36,4246,"[np.float32(0.0), np.float32(0.0), np.float32(0.0), np.float32(1.0), np.float32(1.0), np.float32(1.0), np.float32(0.0), np.float32(0.0), np.float32(1.0), np.float32(1.0), np.float32(0.0), np.float32(0.0), np.float32(0.0), np.float32(0.0), np.float32(1.0), np.float32(0.0)]",4.0,99670.0,25
2025-08-14_08-18-36,4247,"[np.float32(0.0), np.float32(1.0), np.float32(1.0), np.float32(1.0), np.float32(0.0), np.float32(1.0), np.float32(1.0), np.float32(1.0), np.float32(1.0), np.float32(0.0), np.float32(0.0), np.float32(0.0), np.float32(1.0), np.float32(0.0), np.float32(1.0), np.float32(1.0)]",0.0,99670.0,13
2025-08-14_08-18-36,4248,"[np.float32(0.0), np.float32(0.0), np.float32(0.0), np.float32(0.0), np.float32(0.0), np.float32(0.0), np.float32(1.0), np.float32(0.0), np.float32(1.0), np.float32(1.0), np.float32(1.0), np.float32(0.0), np.float32(0.0), np.float32(0.0), np.float32(1.0), np.float32(0.0)]",-2.0,99668.0,19
2025-08-14_08-18-36,4249,"[np.float32(1.0), np.float32(1.0), np.float32(0.0), np.float32(1.0), np.float32(0.0), np.float32(1.0), np.float32(1.0), np.float32(0.0), np.float32(1.0), np.float32(1.0), np.float32(0.0), np.float32(0.0), np.float32(1.0), np.float32(1.0), np.float32(0.0), np.float32(1.0)]",3.0,99671.0,34
2025-08-14_08-18-36,4250,"[np.float32(1.0), np.float32(0.0), np.float32(0.0), np.float32(0.0), np.float32(0.0), np.float32(0.0), np.float32(0.0), np.float32(1.0), np.float32(0.0), np.float32(0.0), np.float32(0.0), np.float32(0.0), np.float32(0.0), np.float32(1.0), np.float32(0.0), np.float32(1.0)]",-4.0,99667.0,11
2025-08-14_08-18-36,4251,"[np.float32(0.0), np.float32(1.0), np.float32(1.0), np.float32(1.0), np.float32(0.0), np.float32(1.0), np.float32(0.0), np.float32(1.0), np.float32(1.0), np.float32(1.0), np.float32(0.0), np.float32(1.0), np.float32(1.0), np.float32(1.0), np.float32(0.0), np.float32(1.0)]",-1.0,99666.0,13
2025-08-14_08-18-36,4252,"[np.float32(1.0), np.float32(0.0), np.float32(0.0), np.float32(1.0), np.float32(1.0), np.float32(0.0), np.float32(0.0), np.float32(1.0), np.float32(0.0), np.float32(0.0), np.float32(1.0), np.float32(1.0), np.float32(1.0), np.float32(1.0), np.float32(0.0), np.float32(1.0)]",-2.0,99664.0,27
2025-08-14_08-18-36,4253,"[np.float32(1.0), np.float32(1.0), np.float32(1.0), np.float32(1.0), np.float32(1.0), np.float32(1.0), np.float32(0.0), np.float32(1.0), np.float32(0.0), np.float32(0.0), np.float32(0.0), np.float32(1.0), np.float32(1.0), np.float32(0.0), np.float32(1.0), np.float32(1.0)]",1.0,99665.0,20
2025-08-14_08-18-36,4254,"[np.float32(0.0), np.float32(0.0), np.float32(1.0), np.float32(0.0), np.float32(0.0), np.float32(0.0), np.float32(0.0), np.float32(1.0), np.float32(0.0), np.float32(0.0), np.float32(1.0), np.float32(1.0), np.float32(1.0), np.float32(1.0), np.float32(0.0), np.float32(1.0)]",-2.0,99663.0,36
2025-08-14_08-18-36,4255,"[np.float32(1.0), np.float32(1.0), np.float32(1.0), np.float32(1.0), np.float32(0.0), np.float32(0.0), np.float32(1.0), np.float32(0.0), np.float32(1.0), np.float32(0.0), np.float32(1.0), np.float32(1.0), np.float32(0.0), np.float32(0.0), np.float32(1.0), np.float32(1.0)]",-3.0,99660.0,21
2025-08-14_08-18-36,4256,"[np.float32(0.0), np.float32(1.0), np.float32(0.0), np.float32(0.0), np.float32(1.0), np.float32(1.0), np.float32(1.0), np.float32(0.0), np.float32(0.0), np.float32(1.0), np.float32(1.0), np.float32(1.0), np.float32(0.0), np.float32(1.0), np.float32(0.0), np.float32(0.0)]",2.0,99662.0,29
2025-08-14_08-18-36,4257,"[np.float32(1.0), np.float32(1.0), np.float32(0.0), np.float32(0.0), np.float32(1.0), np.float32(0.0), np.float32(1.0), np.float32(1.0), np.float32(1.0), np.float32(0.0), np.float32(0.0), np.float32(0.0), np.float32(0.0), np.float32(1.0), np.float32(1.0), np.float32(0.0)]",2.0,99664.0,18
2025-08-14_08-18-36,4258,"[np.float32(0.0), np.float32(0.0), np.float32(1.0), np.float32(0.0), np.float32(0.0), np.float32(1.0), np.float32(1.0), np.float32(0.0), np.float32(0.0), np.float32(0.0), np.float32(1.0), np.float32(1.0), np.float32(1.0), np.float32(1.0), np.float32(1.0), np.float32(1.0)]",-4.0,99660.0,19
2025-08-14_08-18-36,4259,"[np.float32(1.0), np.float32(0.0), np.float32(1.0), np.float32(0.0), np.float32(1.0), np.float32(0.0), np.float32(0.0), np.float32(1.0), np.float32(0.0), np.float32(0.0), np.float32(1.0), np.float32(1.0), np.float32(0.0), np.float32(0.0), np.float32(1.0), np.float32(0.0)]",-2.0,99658.0,22
2025-08-14_08-18-36,4260,"[np.float32(0.0), np.float32(1.0), np.float32(1.0), np.float32(1.0), np.float32(0.0), np.float32(1.0), np.float32(1.0), np.float32(1.0), np.float32(1.0), np.float32(1.0), np.float32(1.0), np.float32(0.0), np.float32(1.0), np.float32(1.0), np.float32(0.0), np.float32(0.0)]",-2.0,99656.0,33
2025-08-14_08-18-36,4261,"[np.float32(0.0), np.float32(0.0), np.float32(0.0), np.float32(0.0), np.float32(1.0), np.float32(0.0), np.float32(0.0), np.float32(1.0), np.float32(1.0), np.float32(0.0), np.float32(1.0), np.float32(1.0), np.float32(1.0), np.float32(1.0), np.float32(1.0), np.float32(0.0)]",3.0,99659.0,15
2025-08-14_08-18-36,4262,"[np.float32(0.0), np.float32(0.0), np.float32(1.0), np.float32(1.0), np.float32(1.0), np.float32(0.0), np.float32(0.0), np.float32(0.0), np.float32(1.0), np.float32(0.0), np.float32(1.0), np.float32(0.0), np.float32(1.0), np.float32(0.0), np.float32(0.0), np.float32(1.0)]",-2.0,99657.0,25
2025-08-14_08-18-36,4263,"[np.float32(0.0), np.float32(1.0), np.float32(0.0), np.float32(1.0), np.float32(0.0), np.float32(1.0), np.float32(1.0), np.float32(1.0), np.float32(0.0), np.float32(0.0), np.float32(1.0), np.float32(1.0), np.float32(1.0), np.float32(1.0), np.float32(0.0), np.float32(0.0)]",-4.0,99653.0,10
2025-08-14_08-18-36,4264,"[np.float32(1.0), np.float32(0.0), np.float32(0.0), np.float32(0.0), np.float32(1.0), np.float32(1.0), np.float32(0.0), np.float32(1.0), np.float32(0.0), np.float32(0.0), np.float32(1.0), np.float32(0.0), np.float32(1.0), np.float32(1.0), np.float32(1.0), np.float32(1.0)]",-1.0,99652.0,24
2025-08-14_08-18-36,4265,"[np.float32(0.0), np.float32(1.0), np.float32(1.0), np.float32(0.0), np.float32(1.0), np.float32(0.0), np.float32(0.0), np.float32(1.0), np.float32(1.0), np.float32(1.0), np.float32(1.0), np.float32(1.0), np.float32(0.0), np.float32(0.0), np.float32(0.0), np.float32(1.0)]",1.0,99653.0,24
2025-08-14_08-18-36,4266,"[np.float32(1.0), np.float32(1.0), np.float32(1.0), np.float32(1.0), np.float32(0.0), np.float32(1.0), np.float32(1.0), np.float32(1.0), np.float32(1.0), np.float32(0.0), np.float32(0.0), np.float32(1.0), np.float32(0.0), np.float32(0.0), np.float32(0.0), np.float32(0.0)]",3.0,99656.0,24
2025-08-14_08-18-36,4267,"[np.float32(1.0), np.float32(1.0), np.float32(1.0), np.float32(1.0), np.float32(1.0), np.float32(1.0), np.float32(0.0), np.float32(0.0), np.float32(0.0), np.float32(0.0), np.float32(0.0), np.float32(1.0), np.float32(0.0), np.float32(0.0), np.float32(1.0), np.float32(0.0)]",1.0,99657.0,6
2025-08-14_08-18-36,4268,"[np.float32(0.0), np.float32(1.0), np.float32(1.0), np.float32(0.0), np.float32(0.0), np.float32(0.0), np.float32(1.0), np.float32(0.0), np.float32(1.0), np.float32(1.0), np.float32(1.0), np.float32(1.0), np.float32(1.0), np.float32(0.0), np.float32(1.0), np.float32(0.0)]",1.0,99658.0,24
2025-08-14_08-18-36,4269,"[np.float32(0.0), np.float32(0.0), np.float32(1.0), np.float32(0.0), np.float32(0.0), np.float32(1.0), np.float32(1.0), np.float32(1.0), np.float32(1.0), np.float32(1.0), np.float32(1.0), np.float32(1.0), np.float32(0.0), np.float32(0.0), np.float32(0.0), np.float32(0.0)]",-2.0,99656.0,9
2025-08-14_08-18-36,4270,"[np.float32(0.0), np.float32(1.0), np.float32(1.0), np.float32(1.0), np.float32(1.0), np.float32(0.0), np.float32(1.0), np.float32(0.0), np.float32(0.0), np.float32(1.0), np.float32(1.0), np.float32(0.0), np.float32(0.0), np.float32(1.0), np.float32(1.0), np.float32(0.0)]",6.0,99662.0,2
2025-08-14_08-18-36,4271,"[np.float32(0.0), np.float32(1.0), np.float32(0.0), np.float32(1.0), np.float32(1.0), np.float32(1.0), np.float32(0.0), np.float32(1.0), np.float32(1.0), np.float32(0.0), np.float32(0.0), np.float32(1.0), np.float32(1.0), np.float32(0.0), np.float32(0.0), np.float32(1.0)]",1.0,99663.0,21
2025-08-14_08-18-36,4272,"[np.float32(0.0), np.float32(1.0), np.float32(0.0), np.float32(1.0), np.float32(0.0), np.float32(1.0), np.float32(0.0), np.float32(0.0), np.float32(0.0), np.float32(0.0), np.float32(1.0), np.float32(0.0), np.float32(0.0), np.float32(0.0), np.float32(0.0), np.float32(0.0)]",0.0,99663.0,27
2025-08-14_08-18-36,4273,"[np.float32(1.0), np.float32(1.0), np.float32(1.0), np.float32(0.0), np.float32(0.0), np.float32(1.0), np.float32(1.0), np.float32(1.0), np.float32(0.0), np.float32(1.0), np.float32(1.0), np.float32(1.0), np.float32(0.0), np.float32(1.0), np.float32(1.0), np.float32(1.0)]",0.0,99663.0,32
2025-08-14_08-18-36,4274,"[np.float32(0.0), np.float32(0.0), np.float32(0.0), np.float32(1.0), np.float32(1.0), np.float32(1.0), np.float32(0.0), np.float32(0.0), np.float32(1.0), np.float32(1.0), np.float32(0.0), np.float32(0.0), np.float32(0.0), np.float32(1.0), np.float32(0.0), np.float32(1.0)]",-2.0,99661.0,14
2025-08-14_08-18-36,4275,"[np.float32(0.0), np.float32(0.0), np.float32(1.0), np.float32(0.0), np.float32(0.0), np.float32(0.0), np.float32(1.0), np.float32(1.0), np.float32(1.0), np.float32(1.0), np.float32(0.0), np.float32(0.0), np.float32(1.0), np.float32(0.0), np.float32(1.0), np.float32(0.0)]",-1.0,99660.0,23
2025-08-14_08-18-36,4276,"[np.float32(1.0), np.float32(0.0), np.float32(0.0), np.float32(0.0), np.float32(0.0), np.float32(1.0), np.float32(1.0), np.float32(0.0), np.float32(1.0), np.float32(1.0), np.float32(1.0), np.float32(1.0), np.float32(0.0), np.float32(0.0), np.float32(1.0), np.float32(1.0)]",4.0,99664.0,30
2025-08-14_08-18-36,4277,"[np.float32(1.0), np.float32(0.0), np.float32(1.0), np.float32(0.0), np.float32(0.0), np.float32(0.0), np.float32(1.0), np.float32(1.0), np.float32(1.0), np.float32(1.0), np.float32(1.0), np.float32(0.0), np.float32(0.0), np.float32(0.0), np.float32(0.0), np.float32(1.0)]",-5.0,99659.0,33
2025-08-14_08-18-36,4278,"[np.float32(0.0), np.float32(1.0), np.float32(0.0), np.float32(1.0), np.float32(1.0), np.float32(0.0), np.float32(0.0), np.float32(0.0), np.float32(0.0), np.float32(1.0), np.float32(0.0), np.float32(1.0), np.float32(1.0), np.float32(1.0), np.float32(1.0), np.float32(1.0)]",-3.0,99656.0,34
2025-08-14_08-18-36,4279,"[np.float32(0.0), np.float32(1.0), np.float32(1.0), np.float32(0.0), np.float32(0.0), np.float32(1.0), np.float32(1.0), np.float32(1.0), np.float32(1.0), np.float32(1.0), np.float32(1.0), np.float32(0.0), np.float32(0.0), np.float32(1.0), np.float32(0.0), np.float32(0.0)]",-2.0,99654.0,6
2025-08-14_08-18-36,4280,"[np.float32(0.0), np.float32(1.0), np.float32(1.0), np.float32(1.0), np.float32(0.0), np.float32(1.0), np.float32(1.0), np.float32(1.0), np.float32(0.0), np.float32(1.0), np.float32(0.0), np.float32(0.0), np.float32(1.0), np.float32(1.0), np.float32(0.0), np.float32(0.0)]",4.0,99658.0,19
2025-08-14_08-18-36,4281,"[np.float32(1.0), np.float32(1.0), np.float32(0.0), np.float32(0.0), np.float32(0.0), np.float32(1.0), np.float32(1.0), np.float32(1.0), np.float32(1.0), np.float32(1.0), np.float32(1.0), np.float32(0.0), np.float32(1.0), np.float32(1.0), np.float32(1.0), np.float32(0.0)]",-3.0,99655.0,17
2025-08-14_08-18-36,4282,"[np.float32(1.0), np.float32(0.0), np.float32(0.0), np.float32(1.0), np.float32(0.0), np.float32(1.0), np.float32(1.0), np.float32(1.0), np.float32(1.0), np.float32(1.0), np.float32(0.0), np.float32(0.0), np.float32(1.0), np.float32(1.0), np.float32(1.0), np.float32(0.0)]",-2.0,99653.0,15
2025-08-14_08-18-36,4283,"[np.float32(1.0), np.float32(0.0), np.float32(1.0), np.float32(0.0), np.float32(1.0), np.float32(0.0), np.float32(0.0), np.float32(0.0), np.float32(0.0), np.float32(0.0), np.float32(0.0), np.float32(0.0), np.float32(1.0), np.float32(1.0), np.float32(0.0), np.float32(0.0)]",0.0,99653.0,22
2025-08-14_08-18-36,4284,"[np.float32(1.0), np.float32(1.0), np.float32(0.0), np.float32(0.0), np.float32(1.0), np.float32(1.0), np.float32(0.0), np.float32(1.0), np.float32(1.0), np.float32(0.0), np.float32(1.0), np.float32(0.0), np.float32(0.0), np.float32(0.0), np.float32(0.0), np.float32(0.0)]",0.0,99653.0,15
2025-08-14_08-18-36,4285,"[np.float32(0.0), np.float32(1.0), np.float32(1.0), np.float32(1.0), np.float32(1.0), np.float32(1.0), np.float32(0.0), np.float32(1.0), np.float32(1.0), np.float32(1.0), np.float32(0.0), np.float32(1.0), np.float32(1.0), np.float32(0.0), np.float32(1.0), np.float32(0.0)]",2.0,99655.0,16
2025-08-14_08-18-36,4286,"[np.float32(0.0), np.float32(1.0), np.float32(1.0), np.float32(1.0), np.float32(0.0), np.float32(1.0), np.float32(1.0), np.float32(1.0), np.float32(0.0), np.float32(0.0), np.float32(0.0), np.float32(0.0), np.float32(0.0), np.float32(0.0), np.float32(0.0), np.float32(0.0)]",-1.0,99654.0,12
2025-08-14_08-18-36,4287,"[np.float32(1.0), np.float32(0.0), np.float32(0.0), np.float32(0.0), np.float32(0.0), np.float32(1.0), np.float32(0.0), np.float32(0.0), np.float32(0.0), np.float32(1.0), np.float32(0.0), np.float32(0.0), np.float32(1.0), np.float32(0.0), np.float32(0.0), np.float32(0.0)]",3.0,99657.0,19
2025-08-14_08-18-36,4288,"[np.float32(1.0), np.float32(1.0), np.float32(0.0), np.float32(0.0), np.float32(0.0), np.float32(1.0), np.float32(0.0), np.float32(0.0), np.float32(1.0), np.float32(1.0), np.float32(0.0), np.float32(0.0), np.float32(1.0), np.float32(1.0), np.float32(0.0), np.float32(1.0)]",-1.0,99656.0,21
2025-08-14_08-18-36,4289,"[np.float32(1.0), np.float32(0.0), np.float32(1.0), np.float32(0.0), np.float32(0.0), np.float32(0.0), np.float32(0.0), np.float32(0.0), np.float32(1.0), np.float32(1.0), np.float32(0.0), np.float32(0.0), np.float32(1.0), np.float32(0.0), np.float32(1.0), np.float32(1.0)]",-4.0,99652.0,29
2025-08-14_08-18-36,4290,"[np.float32(1.0), np.float32(0.0), np.float32(0.0), np.float32(0.0), np.float32(0.0), np.float32(1.0), np.float32(1.0), np.float32(0.0), np.float32(1.0), np.float32(1.0), np.float32(1.0), np.float32(1.0), np.float32(0.0), np.float32(0.0), np.float32(0.0), np.float32(0.0)]",-2.0,99650.0,22
2025-08-14_08-18-36,4291,"[np.float32(1.0), np.float32(1.0), np.float32(1.0), np.float32(1.0), np.float32(0.0), np.float32(1.0), np.float32(1.0), np.float32(1.0), np.float32(1.0), np.float32(1.0), np.float32(1.0), np.float32(0.0), np.float32(1.0), np.float32(0.0), np.float32(0.0), np.float32(0.0)]",-1.0,99649.0,8
2025-08-14_08-18-36,4292,"[np.float32(0.0), np.float32(1.0), np.float32(0.0), np.float32(1.0), np.float32(0.0), np.float32(0.0), np.float32(0.0), np.float32(1.0), np.float32(0.0), np.float32(1.0), np.float32(1.0), np.float32(0.0), np.float32(0.0), np.float32(0.0), np.float32(1.0), np.float32(1.0)]",4.0,99653.0,23
2025-08-14_08-18-36,4293,"[np.float32(1.0), np.float32(1.0), np.float32(0.0), np.float32(0.0), np.float32(1.0), np.float32(1.0), np.float32(1.0), np.float32(0.0), np.float32(1.0), np.float32(0.0), np.float32(1.0), np.float32(1.0), np.float32(0.0), np.float32(0.0), np.float32(0.0), np.float32(0.0)]",-1.0,99652.0,14
2025-08-14_08-18-36,4294,"[np.float32(1.0), np.float32(0.0), np.float32(1.0), np.float32(1.0), np.float32(1.0), np.float32(1.0), np.float32(0.0), np.float32(1.0), np.float32(1.0), np.float32(1.0), np.float32(1.0), np.float32(1.0), np.float32(1.0), np.float32(1.0), np.float32(1.0), np.float32(0.0)]",-3.0,99649.0,20
2025-08-14_08-18-36,4295,"[np.float32(0.0), np.float32(1.0), np.float32(0.0), np.float32(0.0), np.float32(1.0), np.float32(0.0), np.float32(1.0), np.float32(1.0), np.float32(1.0), np.float32(1.0), np.float32(0.0), np.float32(0.0), np.float32(0.0), np.float32(1.0), np.float32(0.0), np.float32(1.0)]",-3.0,99646.0,24
2025-08-14_08-18-36,4296,"[np.float32(0.0), np.float32(1.0), np.float32(0.0), np.float32(1.0), np.float32(0.0), np.float32(0.0), np.float32(0.0), np.float32(1.0), np.float32(1.0), np.float32(1.0), np.float32(1.0), np.float32(1.0), np.float32(0.0), np.float32(0.0), np.float32(0.0), np.float32(0.0)]",-1.0,99645.0,18
2025-08-14_08-18-36,4297,"[np.float32(1.0), np.float32(1.0), np.float32(1.0), np.float32(1.0), np.float32(0.0), np.float32(1.0), np.float32(1.0), np.float32(0.0), np.float32(1.0), np.float32(0.0), np.float32(0.0), np.float32(0.0), np.float32(0.0), np.float32(0.0), np.float32(0.0), np.float32(0.0)]",0.0,99645.0,3
2025-08-14_08-18-36,4298,"[np.float32(1.0), np.float32(0.0), np.float32(1.0), np.float32(0.0), np.float32(0.0), np.float32(1.0), np.float32(1.0), np.float32(0.0), np.float32(1.0), np.float32(1.0), np.float32(0.0), np.float32(1.0), np.float32(0.0), np.float32(0.0), np.float32(0.0), np.float32(1.0)]",0.0,99645.0,33
2025-08-14_08-18-36,4299,"[np.float32(1.0), np.float32(1.0), np.float32(1.0), np.float32(1.0), np.float32(0.0), np.float32(0.0), np.float32(1.0), np.float32(1.0), np.float32(1.0), np.float32(1.0), np.float32(0.0), np.float32(0.0), np.float32(0.0), np.float32(1.0), np.float32(0.0), np.float32(0.0)]",4.0,99649.0,4
2025-08-14_08-18-36,4300,"[np.float32(1.0), np.float32(1.0), np.float32(0.0), np.float32(0.0), np.float32(0.0), np.float32(1.0), np.float32(1.0), np.float32(1.0), np.float32(0.0), np.float32(0.0), np.float32(1.0), np.float32(0.0), np.float32(1.0), np.float32(0.0), np.float32(0.0), np.float32(0.0)]",-3.0,99646.0,31
2025-08-14_08-18-36,4301,"[np.float32(0.0), np.float32(1.0), np.float32(0.0), np.float32(1.0), np.float32(0.0), np.float32(1.0), np.float32(1.0), np.float32(1.0), np.float32(1.0), np.float32(0.0), np.float32(1.0), np.float32(1.0), np.float32(1.0), np.float32(1.0), np.float32(0.0), np.float32(0.0)]",3.0,99649.0,21
2025-08-14_08-18-36,4302,"[np.float32(1.0), np.float32(0.0), np.float32(0.0), np.float32(1.0), np.float32(1.0), np.float32(1.0), np.float32(1.0), np.float32(1.0), np.float32(0.0), np.float32(0.0), np.float32(1.0), np.float32(1.0), np.float32(0.0), np.float32(1.0), np.float32(1.0), np.float32(0.0)]",0.0,99649.0,30
2025-08-14_08-18-36,4303,"[np.float32(1.0), np.float32(1.0), np.float32(0.0), np.float32(1.0), np.float32(0.0), np.float32(1.0), np.float32(0.0), np.float32(1.0), np.float32(1.0), np.float32(0.0), np.float32(0.0), np.float32(0.0), np.float32(1.0), np.float32(1.0), np.float32(1.0), np.float32(1.0)]",-2.0,99647.0,16
2025-08-14_08-18-36,4304,"[np.float32(1.0), np.float32(1.0), np.float32(1.0), np.float32(0.0), np.float32(1.0), np.float32(1.0), np.float32(1.0), np.float32(0.0), np.float32(0.0), np.float32(0.0), np.float32(1.0), np.float32(0.0), np.float32(1.0), np.float32(0.0), np.float32(1.0), np.float32(1.0)]",33.0,99680.0,7
2025-08-14_08-18-36,4305,"[np.float32(1.0), np.float32(1.0), np.float32(0.0), np.float32(0.0), np.float32(1.0), np.float32(0.0), np.float32(0.0), np.float32(1.0), np.float32(1.0), np.float32(0.0), np.float32(1.0), np.float32(0.0), np.float32(0.0), np.float32(1.0), np.float32(0.0), np.float32(1.0)]",2.0,99682.0,15
2025-08-14_08-18-36,4306,"[np.float32(0.0), np.float32(0.0), np.float32(1.0), np.float32(1.0), np.float32(0.0), np.float32(0.0), np.float32(0.0), np.float32(1.0), np.float32(0.0), np.float32(1.0), np.float32(0.0), np.float32(0.0), np.float32(0.0), np.float32(0.0), np.float32(0.0), np.float32(0.0)]",1.0,99683.0,15
2025-08-14_08-18-36,4307,"[np.float32(1.0), np.float32(0.0), np.float32(0.0), np.float32(0.0), np.float32(1.0), np.float32(1.0), np.float32(0.0), np.float32(1.0), np.float32(0.0), np.float32(0.0), np.float32(0.0), np.float32(0.0), np.float32(0.0), np.float32(0.0), np.float32(0.0), np.float32(1.0)]",2.0,99685.0,18
2025-08-14_08-18-36,4308,"[np.float32(1.0), np.float32(0.0), np.float32(0.0), np.float32(1.0), np.float32(0.0), np.float32(1.0), np.float32(0.0), np.float32(1.0), np.float32(1.0), np.float32(0.0), np.float32(0.0), np.float32(0.0), np.float32(0.0), np.float32(0.0), np.float32(1.0), np.float32(0.0)]",-6.0,99679.0,6
2025-08-14_08-18-36,4309,"[np.float32(1.0), np.float32(1.0), np.float32(0.0), np.float32(0.0), np.float32(1.0), np.float32(1.0), np.float32(0.0), np.float32(1.0), np.float32(1.0), np.float32(0.0), np.float32(1.0), np.float32(1.0), np.float32(1.0), np.float32(1.0), np.float32(0.0), np.float32(0.0)]",0.0,99679.0,25
2025-08-14_08-18-36,4310,"[np.float32(0.0), np.float32(0.0), np.float32(1.0), np.float32(1.0), np.float32(0.0), np.float32(0.0), np.float32(1.0), np.float32(1.0), np.float32(0.0), np.float32(0.0), np.float32(0.0), np.float32(0.0), np.float32(1.0), np.float32(1.0), np.float32(0.0), np.float32(0.0)]",-1.0,99678.0,32
2025-08-14_08-18-36,4311,"[np.float32(1.0), np.float32(1.0), np.float32(0.0), np.float32(0.0), np.float32(1.0), np.float32(0.0), np.float32(1.0), np.float32(1.0), np.float32(0.0), np.float32(0.0), np.float32(0.0), np.float32(0.0), np.float32(1.0), np.float32(1.0), np.float32(1.0), np.float32(1.0)]",1.0,99679.0,10
2025-08-14_08-18-36,4312,"[np.float32(1.0), np.float32(0.0), np.float32(1.0), np.float32(0.0), np.float32(1.0), np.float32(0.0), np.float32(0.0), np.float32(1.0), np.float32(0.0), np.float32(1.0), np.float32(1.0), np.float32(1.0), np.float32(0.0), np.float32(1.0), np.float32(0.0), np.float32(0.0)]",0.0,99679.0,24
2025-08-14_08-18-36,4313,"[np.float32(0.0), np.float32(1.0), np.float32(1.0), np.float32(0.0), np.float32(1.0), np.float32(1.0), np.float32(1.0), np.float32(1.0), np.float32(0.0), np.float32(0.0), np.float32(1.0), np.float32(0.0), np.float32(0.0), np.float32(1.0), np.float32(0.0), np.float32(1.0)]",-5.0,99674.0,33
2025-08-14_08-18-36,4314,"[np.float32(1.0), np.float32(1.0), np.float32(1.0), np.float32(1.0), np.float32(1.0), np.float32(0.0), np.float32(0.0), np.float32(1.0), np.float32(1.0), np.float32(1.0), np.float32(1.0), np.float32(0.0), np.float32(0.0), np.float32(1.0), np.float32(1.0), np.float32(1.0)]",1.0,99675.0,20
2025-08-14_08-18-36,4315,"[np.float32(0.0), np.float32(0.0), np.float32(1.0), np.float32(1.0), np.float32(0.0), np.float32(1.0), np.float32(1.0), np.float32(0.0), np.float32(0.0), np.float32(0.0), np.float32(1.0), np.float32(0.0), np.float32(1.0), np.float32(0.0), np.float32(1.0), np.float32(0.0)]",0.0,99675.0,29
2025-08-14_08-18-36,4316,"[np.float32(1.0), np.float32(1.0), np.float32(1.0), np.float32(0.0), np.float32(0.0), np.float32(0.0), np.float32(0.0), np.float32(0.0), np.float32(1.0), np.float32(0.0), np.float32(0.0), np.float32(1.0), np.float32(1.0), np.float32(1.0), np.float32(1.0), np.float32(1.0)]",2.0,99677.0,33
2025-08-14_08-18-36,4317,"[np.float32(1.0), np.float32(1.0), np.float32(1.0), np.float32(0.0), np.float32(1.0), np.float32(0.0), np.float32(0.0), np.float32(0.0), np.float32(1.0), np.float32(0.0), np.float32(0.0), np.float32(1.0), np.float32(0.0), np.float32(0.0), np.float32(0.0), np.float32(0.0)]",0.0,99677.0,4
2025-08-14_08-18-36,4318,"[np.float32(0.0), np.float32(0.0), np.float32(1.0), np.float32(1.0), np.float32(1.0), np.float32(1.0), np.float32(0.0), np.float32(1.0), np.float32(1.0), np.float32(1.0), np.float32(1.0), np.float32(1.0), np.float32(0.0), np.float32(0.0), np.float32(1.0), np.float32(0.0)]",0.0,99677.0,5
2025-08-14_08-18-36,4319,"[np.float32(0.0), np.float32(0.0), np.float32(1.0), np.float32(0.0), np.float32(0.0), np.float32(0.0), np.float32(1.0), np.float32(1.0), np.float32(1.0), np.float32(1.0), np.float32(1.0), np.float32(1.0), np.float32(0.0), np.float32(1.0), np.float32(0.0), np.float32(1.0)]",-3.0,99674.0,33
2025-08-14_08-18-36,4320,"[np.float32(1.0), np.float32(0.0), np.float32(1.0), np.float32(1.0), np.float32(1.0), np.float32(1.0), np.float32(1.0), np.float32(0.0), np.float32(1.0), np.float32(1.0), np.float32(0.0), np.float32(0.0), np.float32(0.0), np.float32(0.0), np.float32(0.0), np.float32(0.0)]",1.0,99675.0,12
2025-08-14_08-18-36,4321,"[np.float32(1.0), np.float32(1.0), np.float32(1.0), np.float32(1.0), np.float32(0.0), np.float32(0.0), np.float32(1.0), np.float32(1.0), np.float32(0.0), np.float32(1.0), np.float32(1.0), np.float32(1.0), np.float32(1.0), np.float32(1.0), np.float32(1.0), np.float32(0.0)]",-2.0,99673.0,33
2025-08-14_08-18-36,4322,"[np.float32(1.0), np.float32(1.0), np.float32(1.0), np.float32(1.0), np.float32(0.0), np.float32(1.0), np.float32(0.0), np.float32(1.0), np.float32(1.0), np.float32(1.0), np.float32(1.0), np.float32(0.0), np.float32(0.0), np.float32(1.0), np.float32(1.0), np.float32(1.0)]",0.0,99673.0,33
2025-08-14_08-18-36,4323,"[np.float32(0.0), np.float32(1.0), np.float32(1.0), np.float32(1.0), np.float32(0.0), np.float32(1.0), np.float32(1.0), np.float32(1.0), np.float32(1.0), np.float32(1.0), np.float32(1.0), np.float32(0.0), np.float32(1.0), np.float32(1.0), np.float32(1.0), np.float32(0.0)]",3.0,99676.0,28
2025-08-14_08-18-36,4324,"[np.float32(0.0), np.float32(0.0), np.float32(0.0), np.float32(1.0), np.float32(0.0), np.float32(1.0), np.float32(1.0), np.float32(1.0), np.float32(1.0), np.float32(1.0), np.float32(1.0), np.float32(0.0), np.float32(0.0), np.float32(0.0), np.float32(1.0), np.float32(0.0)]",0.0,99676.0,17
2025-08-14_08-18-36,4325,"[np.float32(1.0), np.float32(1.0), np.float32(1.0), np.float32(0.0), np.float32(0.0), np.float32(1.0), np.float32(1.0), np.float32(1.0), np.float32(0.0), np.float32(0.0), np.float32(1.0), np.float32(0.0), np.float32(1.0), np.float32(1.0), np.float32(1.0), np.float32(0.0)]",3.0,99679.0,8
2025-08-14_08-18-36,4326,"[np.float32(1.0), np.float32(1.0), np.float32(0.0), np.float32(1.0), np.float32(0.0), np.float32(0.0), np.float32(1.0), np.float32(0.0), np.float32(0.0), np.float32(1.0), np.float32(1.0), np.float32(1.0), np.float32(1.0), np.float32(0.0), np.float32(0.0), np.float32(0.0)]",-3.0,99676.0,20
2025-08-14_08-18-36,4327,"[np.float32(1.0), np.float32(0.0), np.float32(0.0), np.float32(1.0), np.float32(0.0), np.float32(0.0), np.float32(1.0), np.float32(0.0), np.float32(1.0), np.float32(1.0), np.float32(0.0), np.float32(1.0), np.float32(0.0), np.float32(0.0), np.float32(0.0), np.float32(0.0)]",-4.0,99672.0,14
2025-08-14_08-18-36,4328,"[np.float32(1.0), np.float32(1.0), np.float32(0.0), np.float32(1.0), np.float32(0.0), np.float32(0.0), np.float32(0.0), np.float32(1.0), np.float32(1.0), np.float32(1.0), np.float32(0.0), np.float32(0.0), np.float32(0.0), np.float32(1.0), np.float32(0.0), np.float32(0.0)]",0.0,99672.0,17
2025-08-14_08-18-36,4329,"[np.float32(1.0), np.float32(1.0), np.float32(0.0), np.float32(0.0), np.float32(0.0), np.float32(1.0), np.float32(0.0), np.float32(0.0), np.float32(1.0), np.float32(0.0), np.float32(0.0), np.float32(0.0), np.float32(1.0), np.float32(1.0), np.float32(1.0), np.float32(0.0)]",-5.0,99667.0,1
2025-08-14_08-18-36,4330,"[np.float32(1.0), np.float32(1.0), np.float32(1.0), np.float32(0.0), np.float32(0.0), np.float32(1.0), np.float32(0.0), np.float32(0.0), np.float32(1.0), np.float32(1.0), np.float32(0.0), np.float32(1.0), np.float32(0.0), np.float32(0.0), np.float32(0.0), np.float32(0.0)]",0.0,99667.0,4
2025-08-14_08-18-36,4331,"[np.float32(0.0), np.float32(1.0), np.float32(1.0), np.float32(0.0), np.float32(1.0), np.float32(1.0), np.float32(0.0), np.float32(1.0), np.float32(1.0), np.float32(1.0), np.float32(0.0), np.float32(1.0), np.float32(0.0), np.float32(1.0), np.float32(1.0), np.float32(1.0)]",2.0,99669.0,31
2025-08-14_08-18-36,4332,"[np.float32(1.0), np.float32(1.0), np.float32(1.0), np.float32(0.0), np.float32(1.0), np.float32(0.0), np.float32(0.0), np.float32(0.0), np.float32(0.0), np.float32(0.0), np.float32(1.0), np.float32(0.0), np.float32(1.0), np.float32(0.0), np.float32(0.0), np.float32(0.0)]",1.0,99670.0,32
2025-08-14_08-18-36,4333,"[np.float32(0.0), np.float32(0.0), np.float32(1.0), np.float32(1.0), np.float32(1.0), np.float32(0.0), np.float32(1.0), np.float32(0.0), np.float32(1.0), np.float32(1.0), np.float32(1.0), np.float32(1.0), np.float32(0.0), np.float32(0.0), np.float32(0.0), np.float32(1.0)]",-7.0,99663.0,0
2025-08-14_08-18-36,4334,"[np.float32(0.0), np.float32(1.0), np.float32(0.0), np.float32(0.0), np.float32(1.0), np.float32(0.0), np.float32(0.0), np.float32(1.0), np.float32(1.0), np.float32(0.0), np.float32(1.0), np.float32(0.0), np.float32(1.0), np.float32(1.0), np.float32(0.0), np.float32(1.0)]",-5.0,99658.0,30
2025-08-14_08-18-36,4335,"[np.float32(1.0), np.float32(0.0), np.float32(0.0), np.float32(1.0), np.float32(0.0), np.float32(0.0), np.float32(0.0), np.float32(1.0), np.float32(0.0), np.float32(0.0), np.float32(1.0), np.float32(1.0), np.float32(1.0), np.float32(0.0), np.float32(0.0), np.float32(0.0)]",-1.0,99657.0,11
2025-08-14_08-18-36,4336,"[np.float32(1.0), np.float32(1.0), np.float32(0.0), np.float32(0.0), np.float32(0.0), np.float32(1.0), np.float32(0.0), np.float32(0.0), np.float32(1.0), np.float32(1.0), np.float32(0.0), np.float32(0.0), np.float32(1.0), np.float32(1.0), np.float32(1.0), np.float32(1.0)]",-2.0,99655.0,24
2025-08-14_08-18-36,4337,"[np.float32(1.0), np.float32(0.0), np.float32(0.0), np.float32(0.0), np.float32(1.0), np.float32(1.0), np.float32(1.0), np.float32(1.0), np.float32(1.0), np.float32(0.0), np.float32(0.0), np.float32(1.0), np.float32(1.0), np.float32(0.0), np.float32(0.0), np.float32(0.0)]",-3.0,99652.0,13
2025-08-14_08-18-36,4338,"[np.float32(0.0), np.float32(0.0), np.float32(0.0), np.float32(0.0), np.float32(0.0), np.float32(1.0), np.float32(0.0), np.float32(0.0), np.float32(0.0), np.float32(1.0), np.float32(1.0), np.float32(0.0), np.float32(0.0), np.float32(0.0), np.float32(1.0), np.float32(0.0)]",2.0,99654.0,8
2025-08-14_08-18-36,4339,"[np.float32(1.0), np.float32(0.0), np.float32(1.0), np.float32(1.0), np.float32(0.0), np.float32(0.0), np.float32(0.0), np.float32(1.0), np.float32(0.0), np.float32(1.0), np.float32(0.0), np.float32(1.0), np.float32(1.0), np.float32(0.0), np.float32(1.0), np.float32(0.0)]",-1.0,99653.0,1
2025-08-14_08-18-36,4340,"[np.float32(0.0), np.float32(1.0), np.float32(1.0), np.float32(1.0), np.float32(0.0), np.float32(0.0), np.float32(1.0), np.float32(1.0), np.float32(1.0), np.float32(1.0), np.float32(0.0), np.float32(1.0), np.float32(0.0), np.float32(1.0), np.float32(0.0), np.float32(0.0)]",-1.0,99652.0,27
2025-08-14_08-18-36,4341,"[np.float32(1.0), np.float32(1.0), np.float32(0.0), np.float32(1.0), np.float32(0.0), np.float32(0.0), np.float32(0.0), np.float32(1.0), np.float32(1.0), np.float32(1.0), np.float32(0.0), np.float32(0.0), np.float32(1.0), np.float32(0.0), np.float32(1.0), np.float32(0.0)]",5.0,99657.0,13
2025-08-14_08-18-36,4342,"[np.float32(0.0), np.float32(1.0), np.float32(1.0), np.float32(0.0), np.float32(0.0), np.float32(0.0), np.float32(1.0), np.float32(1.0), np.float32(1.0), np.float32(1.0), np.float32(0.0), np.float32(1.0), np.float32(1.0), np.float32(1.0), np.float32(0.0), np.float32(0.0)]",0.0,99657.0,21
2025-08-14_08-18-36,4343,"[np.float32(1.0), np.float32(1.0), np.float32(0.0), np.float32(1.0), np.float32(1.0), np.float32(1.0), np.float32(0.0), np.float32(1.0), np.float32(0.0), np.float32(1.0), np.float32(0.0), np.float32(0.0), np.float32(1.0), np.float32(1.0), np.float32(0.0), np.float32(0.0)]",-5.0,99652.0,36
2025-08-14_08-18-36,4344,"[np.float32(0.0), np.float32(1.0), np.float32(0.0), np.float32(0.0), np.float32(1.0), np.float32(1.0), np.float32(0.0), np.float32(1.0), np.float32(1.0), np.float32(0.0), np.float32(0.0), np.float32(0.0), np.float32(0.0), np.float32(0.0), np.float32(0.0), np.float32(0.0)]",0.0,99652.0,14
2025-08-14_08-18-36,4345,"[np.float32(1.0), np.float32(1.0), np.float32(1.0), np.float32(0.0), np.float32(1.0), np.float32(1.0), np.float32(0.0), np.float32(0.0), np.float32(1.0), np.float32(1.0), np.float32(0.0), np.float32(0.0), np.float32(0.0), np.float32(0.0), np.float32(0.0), np.float32(1.0)]",1.0,99653.0,10
2025-08-14_08-18-36,4346,"[np.float32(0.0), np.float32(0.0), np.float32(1.0), np.float32(1.0), np.float32(0.0), np.float32(0.0), np.float32(1.0), np.float32(0.0), np.float32(0.0), np.float32(0.0), np.float32(0.0), np.float32(0.0), np.float32(0.0), np.float32(1.0), np.float32(1.0), np.float32(0.0)]",0.0,99653.0,13
2025-08-14_08-18-36,4347,"[np.float32(1.0), np.float32(1.0), np.float32(0.0), np.float32(0.0), np.float32(1.0), np.float32(1.0), np.float32(0.0), np.float32(1.0), np.float32(0.0), np.float32(0.0), np.float32(1.0), np.float32(0.0), np.float32(0.0), np.float32(1.0), np.float32(0.0), np.float32(0.0)]",-3.0,99650.0,10
2025-08-14_08-18-36,4348,"[np.float32(1.0), np.float32(1.0), np.float32(1.0), np.float32(1.0), np.float32(1.0), np.float32(1.0), np.float32(1.0), np.float32(1.0), np.float32(1.0), np.float32(1.0), np.float32(0.0), np.float32(0.0), np.float32(1.0), np.float32(0.0), np.float32(0.0), np.float32(0.0)]",-2.0,99648.0,8
2025-08-14_08-18-36,4349,"[np.float32(1.0), np.float32(1.0), np.float32(0.0), np.float32(1.0), np.float32(0.0), np.float32(0.0), np.float32(1.0), np.float32(0.0), np.float32(1.0), np.float32(0.0), np.float32(1.0), np.float32(1.0), np.float32(0.0), np.float32(0.0), np.float32(0.0), np.float32(1.0)]",2.0,99650.0,17
2025-08-14_08-18-36,4350,"[np.float32(1.0), np.float32(1.0), np.float32(0.0), np.float32(0.0), np.float32(1.0), np.float32(0.0), np.float32(0.0), np.float32(0.0), np.float32(0.0), np.float32(0.0), np.float32(1.0), np.float32(1.0), np.float32(0.0), np.float32(1.0), np.float32(1.0), np.float32(1.0)]",0.0,99650.0,21
2025-08-14_08-18-36,4351,"[np.float32(0.0), np.float32(0.0), np.float32(1.0), np.float32(0.0), np.float32(1.0), np.float32(1.0), np.float32(0.0), np.float32(0.0), np.float32(0.0), np.float32(0.0), np.float32(0.0), np.float32(0.0), np.float32(0.0), np.float32(1.0), np.float32(0.0), np.float32(0.0)]",-2.0,99648.0,33
2025-08-14_08-18-36,4352,"[np.float32(1.0), np.float32(0.0), np.float32(1.0), np.float32(0.0), np.float32(1.0), np.float32(1.0), np.float32(1.0), np.float32(0.0), np.float32(1.0), np.float32(0.0), np.float32(0.0), np.float32(1.0), np.float32(1.0), np.float32(0.0), np.float32(1.0), np.float32(1.0)]",-5.0,99643.0,17
2025-08-14_08-18-36,4353,"[np.float32(1.0), np.float32(1.0), np.float32(0.0), np.float32(0.0), np.float32(0.0), np.float32(1.0), np.float32(0.0), np.float32(0.0), np.float32(0.0), np.float32(1.0), np.float32(1.0), np.float32(0.0), np.float32(1.0), np.float32(0.0), np.float32(1.0), np.float32(1.0)]",-1.0,99642.0,27
2025-08-14_08-18-36,4354,"[np.float32(1.0), np.float32(0.0), np.float32(1.0), np.float32(0.0), np.float32(1.0), np.float32(1.0), np.float32(0.0), np.float32(1.0), np.float32(1.0), np.float32(1.0), np.float32(1.0), np.float32(0.0), np.float32(1.0), np.float32(0.0), np.float32(1.0), np.float32(1.0)]",2.0,99644.0,20
2025-08-14_08-18-36,4355,"[np.float32(1.0), np.float32(0.0), np.float32(0.0), np.float32(0.0), np.float32(0.0), np.float32(1.0), np.float32(0.0), np.float32(0.0), np.float32(1.0), np.float32(1.0), np.float32(0.0), np.float32(0.0), np.float32(1.0), np.float32(1.0), np.float32(1.0), np.float32(0.0)]",-2.0,99642.0,1
2025-08-14_08-18-36,4356,"[np.float32(1.0), np.float32(0.0), np.float32(1.0), np.float32(1.0), np.float32(0.0), np.float32(1.0), np.float32(1.0), np.float32(1.0), np.float32(1.0), np.float32(0.0), np.float32(1.0), np.float32(1.0), np.float32(1.0), np.float32(0.0), np.float32(1.0), np.float32(1.0)]",-7.0,99635.0,4
2025-08-14_08-18-36,4357,"[np.float32(0.0), np.float32(0.0), np.float32(1.0), np.float32(1.0), np.float32(1.0), np.float32(1.0), np.float32(1.0), np.float32(1.0), np.float32(0.0), np.float32(0.0), np.float32(1.0), np.float32(1.0), np.float32(0.0), np.float32(0.0), np.float32(0.0), np.float32(1.0)]",4.0,99639.0,20
2025-08-14_08-18-36,4358,"[np.float32(0.0), np.float32(0.0), np.float32(0.0), np.float32(0.0), np.float32(0.0), np.float32(1.0), np.float32(1.0), np.float32(1.0), np.float32(0.0), np.float32(0.0), np.float32(0.0), np.float32(0.0), np.float32(1.0), np.float32(0.0), np.float32(1.0), np.float32(0.0)]",-2.0,99637.0,6
2025-08-14_08-18-36,4359,"[np.float32(0.0), np.float32(0.0), np.float32(1.0), np.float32(0.0), np.float32(0.0), np.float32(1.0), np.float32(0.0), np.float32(1.0), np.float32(0.0), np.float32(0.0), np.float32(0.0), np.float32(0.0), np.float32(1.0), np.float32(1.0), np.float32(1.0), np.float32(0.0)]",-1.0,99636.0,27
2025-08-14_08-18-36,4360,"[np.float32(0.0), np.float32(1.0), np.float32(1.0), np.float32(0.0), np.float32(0.0), np.float32(1.0), np.float32(1.0), np.float32(0.0), np.float32(1.0), np.float32(1.0), np.float32(0.0), np.float32(0.0), np.float32(1.0), np.float32(1.0), np.float32(1.0), np.float32(0.0)]",-1.0,99635.0,13
2025-08-14_08-18-36,4361,"[np.float32(0.0), np.float32(1.0), np.float32(0.0), np.float32(0.0), np.float32(0.0), np.float32(0.0), np.float32(0.0), np.float32(1.0), np.float32(0.0), np.float32(0.0), np.float32(0.0), np.float32(1.0), np.float32(0.0), np.float32(1.0), np.float32(0.0), np.float32(1.0)]",-5.0,99630.0,5
2025-08-14_08-18-36,4362,"[np.float32(1.0), np.float32(0.0), np.float32(0.0), np.float32(1.0), np.float32(1.0), np.float32(1.0), np.float32(1.0), np.float32(1.0), np.float32(1.0), np.float32(1.0), np.float32(1.0), np.float32(0.0), np.float32(0.0), np.float32(0.0), np.float32(1.0), np.float32(0.0)]",0.0,99630.0,33
2025-08-14_08-18-36,4363,"[np.float32(0.0), np.float32(0.0), np.float32(1.0), np.float32(0.0), np.float32(0.0), np.float32(1.0), np.float32(1.0), np.float32(1.0), np.float32(1.0), np.float32(0.0), np.float32(0.0), np.float32(0.0), np.float32(0.0), np.float32(0.0), np.float32(0.0), np.float32(0.0)]",2.0,99632.0,28
2025-08-14_08-18-36,4364,"[np.float32(1.0), np.float32(1.0), np.float32(1.0), np.float32(1.0), np.float32(0.0), np.float32(1.0), np.float32(0.0), np.float32(0.0), np.float32(1.0), np.float32(1.0), np.float32(1.0), np.float32(1.0), np.float32(0.0), np.float32(1.0), np.float32(0.0), np.float32(0.0)]",-1.0,99631.0,23
2025-08-14_08-18-36,4365,"[np.float32(1.0), np.float32(1.0), np.float32(0.0), np.float32(1.0), np.float32(1.0), np.float32(1.0), np.float32(1.0), np.float32(1.0), np.float32(1.0), np.float32(0.0), np.float32(0.0), np.float32(1.0), np.float32(0.0), np.float32(0.0), np.float32(1.0), np.float32(0.0)]",-1.0,99630.0,35
2025-08-14_08-18-36,4366,"[np.float32(1.0), np.float32(1.0), np.float32(0.0), np.float32(1.0), np.float32(1.0), np.float32(0.0), np.float32(1.0), np.float32(0.0), np.float32(0.0), np.float32(0.0), np.float32(1.0), np.float32(0.0), np.float32(0.0), np.float32(1.0), np.float32(0.0), np.float32(1.0)]",4.0,99634.0,7
2025-08-14_08-18-36,4367,"[np.float32(0.0), np.float32(1.0), np.float32(1.0), np.float32(1.0), np.float32(0.0), np.float32(0.0), np.float32(0.0), np.float32(1.0), np.float32(1.0), np.float32(0.0), np.float32(1.0), np.float32(0.0), np.float32(1.0), np.float32(1.0), np.float32(0.0), np.float32(1.0)]",-4.0,99630.0,16
2025-08-14_08-18-36,4368,"[np.float32(0.0), np.float32(1.0), np.float32(1.0), np.float32(0.0), np.float32(0.0), np.float32(1.0), np.float32(0.0), np.float32(1.0), np.float32(0.0), np.float32(0.0), np.float32(0.0), np.float32(1.0), np.float32(0.0), np.float32(1.0), np.float32(0.0), np.float32(1.0)]",1.0,99631.0,14
2025-08-14_08-18-36,4369,"[np.float32(1.0), np.float32(1.0), np.float32(0.0), np.float32(0.0), np.float32(1.0), np.float32(0.0), np.float32(1.0), np.float32(0.0), np.float32(1.0), np.float32(1.0), np.float32(0.0), np.float32(1.0), np.float32(0.0), np.float32(1.0), np.float32(0.0), np.float32(1.0)]",1.0,99632.0,18
2025-08-14_08-18-36,4370,"[np.float32(1.0), np.float32(0.0), np.float32(1.0), np.float32(1.0), np.float32(0.0), np.float32(0.0), np.float32(1.0), np.float32(1.0), np.float32(0.0), np.float32(1.0), np.float32(0.0), np.float32(0.0), np.float32(1.0), np.float32(0.0), np.float32(1.0), np.float32(0.0)]",-4.0,99628.0,32
2025-08-14_08-18-36,4371,"[np.float32(1.0), np.float32(1.0), np.float32(0.0), np.float32(1.0), np.float32(1.0), np.float32(1.0), np.float32(0.0), np.float32(0.0), np.float32(1.0), np.float32(0.0), np.float32(1.0), np.float32(0.0), np.float32(1.0), np.float32(1.0), np.float32(1.0), np.float32(0.0)]",0.0,99628.0,2
2025-08-14_08-18-36,4372,"[np.float32(1.0), np.float32(1.0), np.float32(1.0), np.float32(1.0), np.float32(1.0), np.float32(0.0), np.float32(0.0), np.float32(0.0), np.float32(0.0), np.float32(1.0), np.float32(1.0), np.float32(0.0), np.float32(0.0), np.float32(0.0), np.float32(1.0), np.float32(1.0)]",-2.0,99626.0,25
2025-08-14_08-18-36,4373,"[np.float32(0.0), np.float32(1.0), np.float32(0.0), np.float32(1.0), np.float32(0.0), np.float32(1.0), np.float32(0.0), np.float32(1.0), np.float32(0.0), np.float32(0.0), np.float32(0.0), np.float32(0.0), np.float32(0.0), np.float32(1.0), np.float32(1.0), np.float32(0.0)]",1.0,99627.0,26
2025-08-14_08-18-36,4374,"[np.float32(1.0), np.float32(1.0), np.float32(0.0), np.float32(1.0), np.float32(0.0), np.float32(1.0), np.float32(1.0), np.float32(0.0), np.float32(1.0), np.float32(0.0), np.float32(1.0), np.float32(1.0), np.float32(0.0), np.float32(0.0), np.float32(1.0), np.float32(0.0)]",-5.0,99622.0,22
2025-08-14_08-18-36,4375,"[np.float32(1.0), np.float32(1.0), np.float32(0.0), np.float32(1.0), np.float32(0.0), np.float32(1.0), np.float32(1.0), np.float32(1.0), np.float32(1.0), np.float32(0.0), np.float32(0.0), np.float32(0.0), np.float32(1.0), np.float32(1.0), np.float32(0.0), np.float32(0.0)]",1.0,99623.0,28
2025-08-14_08-18-36,4376,"[np.float32(1.0), np.float32(0.0), np.float32(0.0), np.float32(0.0), np.float32(1.0), np.float32(1.0), np.float32(0.0), np.float32(1.0), np.float32(0.0), np.float32(1.0), np.float32(0.0), np.float32(0.0), np.float32(1.0), np.float32(0.0), np.float32(1.0), np.float32(0.0)]",-2.0,99621.0,33
2025-08-14_08-18-36,4377,"[np.float32(0.0), np.float32(1.0), np.float32(1.0), np.float32(1.0), np.float32(1.0), np.float32(1.0), np.float32(1.0), np.float32(1.0), np.float32(0.0), np.float32(0.0), np.float32(1.0), np.float32(1.0), np.float32(0.0), np.float32(1.0), np.float32(1.0), np.float32(0.0)]",2.0,99623.0,5
2025-08-14_08-18-36,4378,"[np.float32(0.0), np.float32(0.0), np.float32(1.0), np.float32(1.0), np.float32(1.0), np.float32(1.0), np.float32(0.0), np.float32(1.0), np.float32(1.0), np.float32(1.0), np.float32(0.0), np.float32(0.0), np.float32(0.0), np.float32(1.0), np.float32(0.0), np.float32(1.0)]",-2.0,99621.0,24
2025-08-14_08-18-36,4379,"[np.float32(1.0), np.float32(0.0), np.float32(1.0), np.float32(1.0), np.float32(1.0), np.float32(1.0), np.float32(0.0), np.float32(1.0), np.float32(0.0), np.float32(1.0), np.float32(0.0), np.float32(1.0), np.float32(0.0), np.float32(1.0), np.float32(1.0), np.float32(0.0)]",-1.0,99620.0,1
2025-08-14_08-18-36,4380,"[np.float32(0.0), np.float32(1.0), np.float32(1.0), np.float32(1.0), np.float32(0.0), np.float32(1.0), np.float32(1.0), np.float32(0.0), np.float32(1.0), np.float32(1.0), np.float32(1.0), np.float32(0.0), np.float32(0.0), np.float32(1.0), np.float32(1.0), np.float32(0.0)]",2.0,99622.0,33
2025-08-14_08-18-36,4381,"[np.float32(1.0), np.float32(0.0), np.float32(0.0), np.float32(0.0), np.float32(1.0), np.float32(1.0), np.float32(0.0), np.float32(1.0), np.float32(1.0), np.float32(0.0), np.float32(1.0), np.float32(0.0), np.float32(0.0), np.float32(1.0), np.float32(0.0), np.float32(0.0)]",3.0,99625.0,25
2025-08-14_08-18-36,4382,"[np.float32(1.0), np.float32(0.0), np.float32(1.0), np.float32(0.0), np.float32(0.0), np.float32(0.0), np.float32(1.0), np.float32(1.0), np.float32(1.0), np.float32(1.0), np.float32(0.0), np.float32(1.0), np.float32(1.0), np.float32(1.0), np.float32(0.0), np.float32(1.0)]",-5.0,99620.0,23
2025-08-14_08-18-36,4383,"[np.float32(1.0), np.float32(1.0), np.float32(1.0), np.float32(0.0), np.float32(0.0), np.float32(1.0), np.float32(1.0), np.float32(0.0), np.float32(0.0), np.float32(1.0), np.float32(1.0), np.float32(0.0), np.float32(1.0), np.float32(1.0), np.float32(0.0), np.float32(1.0)]",3.0,99623.0,2
2025-08-14_08-18-36,4384,"[np.float32(1.0), np.float32(0.0), np.float32(0.0), np.float32(0.0), np.float32(0.0), np.float32(1.0), np.float32(0.0), np.float32(1.0), np.float32(0.0), np.float32(1.0), np.float32(0.0), np.float32(1.0), np.float32(1.0), np.float32(0.0), np.float32(0.0), np.float32(0.0)]",-2.0,99621.0,32
2025-08-14_08-18-36,4385,"[np.float32(1.0), np.float32(1.0), np.float32(0.0), np.float32(0.0), np.float32(0.0), np.float32(0.0), np.float32(1.0), np.float32(0.0), np.float32(1.0), np.float32(0.0), np.float32(1.0), np.float32(0.0), np.float32(1.0), np.float32(1.0), np.float32(0.0), np.float32(1.0)]",0.0,99621.0,28
2025-08-14_08-18-36,4386,"[np.float32(1.0), np.float32(1.0), np.float32(0.0), np.float32(1.0), np.float32(1.0), np.float32(1.0), np.float32(0.0), np.float32(1.0), np.float32(1.0), np.float32(1.0), np.float32(1.0), np.float32(1.0), np.float32(1.0), np.float32(0.0), np.float32(1.0), np.float32(1.0)]",-6.0,99615.0,12
2025-08-14_08-18-36,4387,"[np.float32(1.0), np.float32(0.0), np.float32(0.0), np.float32(1.0), np.float32(0.0), np.float32(1.0), np.float32(1.0), np.float32(1.0), np.float32(0.0), np.float32(1.0), np.float32(1.0), np.float32(0.0), np.float32(1.0), np.float32(0.0), np.float32(0.0), np.float32(1.0)]",-2.0,99613.0,35
2025-08-14_08-18-36,4388,"[np.float32(1.0), np.float32(0.0), np.float32(1.0), np.float32(1.0), np.float32(0.0), np.float32(1.0), np.float32(0.0), np.float32(0.0), np.float32(0.0), np.float32(1.0), np.float32(0.0), np.float32(0.0), np.float32(1.0), np.float32(0.0), np.float32(0.0), np.float32(0.0)]",3.0,99616.0,19
2025-08-14_08-18-36,4389,"[np.float32(0.0), np.float32(1.0), np.float32(1.0), np.float32(0.0), np.float32(0.0), np.float32(1.0), np.float32(0.0), np.float32(1.0), np.float32(0.0), np.float32(0.0), np.float32(0.0), np.float32(1.0), np.float32(1.0), np.float32(0.0), np.float32(1.0), np.float32(1.0)]",0.0,99616.0,13
2025-08-14_08-18-36,4390,"[np.float32(0.0), np.float32(0.0), np.float32(0.0), np.float32(1.0), np.float32(1.0), np.float32(0.0), np.float32(0.0), np.float32(1.0), np.float32(1.0), np.float32(0.0), np.float32(1.0), np.float32(0.0), np.float32(0.0), np.float32(1.0), np.float32(1.0), np.float32(1.0)]",1.0,99617.0,26
2025-08-14_08-18-36,4391,"[np.float32(1.0), np.float32(0.0), np.float32(1.0), np.float32(1.0), np.float32(1.0), np.float32(1.0), np.float32(1.0), np.float32(1.0), np.float32(1.0), np.float32(0.0), np.float32(1.0), np.float32(0.0), np.float32(1.0), np.float32(0.0), np.float32(0.0), np.float32(0.0)]",0.0,99617.0,35
2025-08-14_08-18-36,4392,"[np.float32(0.0), np.float32(0.0), np.float32(1.0), np.float32(0.0), np.float32(1.0), np.float32(0.0), np.float32(0.0), np.float32(1.0), np.float32(1.0), np.float32(0.0), np.float32(0.0), np.float32(0.0), np.float32(0.0), np.float32(0.0), np.float32(0.0), np.float32(0.0)]",-1.0,99616.0,31
2025-08-14_08-18-36,4393,"[np.float32(0.0), np.float32(0.0), np.float32(1.0), np.float32(0.0), np.float32(0.0), np.float32(1.0), np.float32(0.0), np.float32(0.0), np.float32(1.0), np.float32(0.0), np.float32(0.0), np.float32(1.0), np.float32(1.0), np.float32(1.0), np.float32(0.0), np.float32(1.0)]",0.0,99616.0,0
2025-08-14_08-18-36,4394,"[np.float32(0.0), np.float32(0.0), np.float32(1.0), np.float32(0.0), np.float32(0.0), np.float32(1.0), np.float32(1.0), np.float32(0.0), np.float32(0.0), np.float32(1.0), np.float32(0.0), np.float32(0.0), np.float32(0.0), np.float32(1.0), np.float32(0.0), np.float32(0.0)]",2.0,99618.0,34
2025-08-14_08-18-36,4395,"[np.float32(1.0), np.float32(0.0), np.float32(0.0), np.float32(1.0), np.float32(1.0), np.float32(1.0), np.float32(1.0), np.float32(0.0), np.float32(0.0), np.float32(1.0), np.float32(1.0), np.float32(1.0), np.float32(1.0), np.float32(0.0), np.float32(0.0), np.float32(0.0)]",0.0,99618.0,23
2025-08-14_08-18-36,4396,"[np.float32(1.0), np.float32(0.0), np.float32(1.0), np.float32(0.0), np.float32(1.0), np.float32(0.0), np.float32(0.0), np.float32(0.0), np.float32(1.0), np.float32(1.0), np.float32(1.0), np.float32(1.0), np.float32(0.0), np.float32(1.0), np.float32(0.0), np.float32(0.0)]",-3.0,99615.0,20
2025-08-14_08-18-36,4397,"[np.float32(0.0), np.float32(1.0), np.float32(1.0), np.float32(1.0), np.float32(0.0), np.float32(1.0), np.float32(1.0), np.float32(1.0), np.float32(1.0), np.float32(0.0), np.float32(1.0), np.float32(0.0), np.float32(0.0), np.float32(0.0), np.float32(0.0), np.float32(0.0)]",-1.0,99614.0,19
2025-08-14_08-18-36,4398,"[np.float32(1.0), np.float32(1.0), np.float32(0.0), np.float32(1.0), np.float32(0.0), np.float32(1.0), np.float32(1.0), np.float32(1.0), np.float32(1.0), np.float32(0.0), np.float32(1.0), np.float32(1.0), np.float32(0.0), np.float32(1.0), np.float32(1.0), np.float32(0.0)]",-1.0,99613.0,9
2025-08-14_08-18-36,4399,"[np.float32(0.0), np.float32(0.0), np.float32(0.0), np.float32(1.0), np.float32(0.0), np.float32(0.0), np.float32(1.0), np.float32(1.0), np.float32(0.0), np.float32(1.0), np.float32(0.0), np.float32(1.0), np.float32(1.0), np.float32(1.0), np.float32(1.0), np.float32(1.0)]",2.0,99615.0,15
2025-08-14_08-18-36,4400,"[np.float32(0.0), np.float32(0.0), np.float32(1.0), np.float32(0.0), np.float32(0.0), np.float32(1.0), np.float32(0.0), np.float32(1.0), np.float32(1.0), np.float32(0.0), np.float32(1.0), np.float32(1.0), np.float32(1.0), np.float32(1.0), np.float32(0.0), np.float32(0.0)]",-2.0,99613.0,17
2025-08-14_08-18-36,4401,"[np.float32(1.0), np.float32(0.0), np.float32(1.0), np.float32(1.0), np.float32(1.0), np.float32(0.0), np.float32(1.0), np.float32(1.0), np.float32(0.0), np.float32(1.0), np.float32(1.0), np.float32(0.0), np.float32(0.0), np.float32(1.0), np.float32(1.0), np.float32(1.0)]",-1.0,99612.0,6
2025-08-14_08-18-36,4402,"[np.float32(0.0), np.float32(1.0), np.float32(1.0), np.float32(1.0), np.float32(1.0), np.float32(0.0), np.float32(1.0), np.float32(1.0), np.float32(0.0), np.float32(0.0), np.float32(0.0), np.float32(0.0), np.float32(1.0), np.float32(1.0), np.float32(0.0), np.float32(1.0)]",0.0,99612.0,8
2025-08-14_08-18-36,4403,"[np.float32(0.0), np.float32(1.0), np.float32(1.0), np.float32(0.0), np.float32(1.0), np.float32(0.0), np.float32(0.0), np.float32(1.0), np.float32(0.0), np.float32(0.0), np.float32(0.0), np.float32(1.0), np.float32(1.0), np.float32(0.0), np.float32(0.0), np.float32(0.0)]",-1.0,99611.0,33
2025-08-14_08-18-36,4404,"[np.float32(1.0), np.float32(1.0), np.float32(0.0), np.float32(0.0), np.float32(0.0), np.float32(0.0), np.float32(0.0), np.float32(1.0), np.float32(0.0), np.float32(0.0), np.float32(1.0), np.float32(1.0), np.float32(0.0), np.float32(1.0), np.float32(0.0), np.float32(0.0)]",5.0,99616.0,15
2025-08-14_08-18-36,4405,"[np.float32(0.0), np.float32(0.0), np.float32(1.0), np.float32(0.0), np.float32(0.0), np.float32(1.0), np.float32(0.0), np.float32(0.0), np.float32(1.0), np.float32(0.0), np.float32(1.0), np.float32(1.0), np.float32(1.0), np.float32(1.0), np.float32(0.0), np.float32(0.0)]",-4.0,99612.0,11
2025-08-14_08-18-36,4406,"[np.float32(1.0), np.float32(0.0), np.float32(0.0), np.float32(1.0), np.float32(1.0), np.float32(1.0), np.float32(0.0), np.float32(0.0), np.float32(1.0), np.float32(0.0), np.float32(1.0), np.float32(1.0), np.float32(0.0), np.float32(0.0), np.float32(0.0), np.float32(0.0)]",2.0,99614.0,23
2025-08-14_08-18-36,4407,"[np.float32(1.0), np.float32(0.0), np.float32(1.0), np.float32(1.0), np.float32(1.0), np.float32(1.0), np.float32(0.0), np.float32(0.0), np.float32(1.0), np.float32(0.0), np.float32(1.0), np.float32(1.0), np.float32(0.0), np.float32(0.0), np.float32(1.0), np.float32(1.0)]",3.0,99617.0,33
2025-08-14_08-18-36,4408,"[np.float32(0.0), np.float32(0.0), np.float32(1.0), np.float32(1.0), np.float32(0.0), np.float32(1.0), np.float32(0.0), np.float32(1.0), np.float32(1.0), np.float32(1.0), np.float32(0.0), np.float32(0.0), np.float32(0.0), np.float32(0.0), np.float32(0.0), np.float32(1.0)]",-5.0,99612.0,3
2025-08-14_08-18-36,4409,"[np.float32(0.0), np.float32(0.0), np.float32(0.0), np.float32(0.0), np.float32(0.0), np.float32(0.0), np.float32(0.0), np.float32(0.0), np.float32(0.0), np.float32(1.0), np.float32(0.0), np.float32(1.0), np.float32(0.0), np.float32(0.0), np.float32(0.0), np.float32(0.0)]",1.0,99613.0,13
2025-08-14_08-18-36,4410,"[np.float32(1.0), np.float32(1.0), np.float32(0.0), np.float32(1.0), np.float32(0.0), np.float32(0.0), np.float32(0.0), np.float32(0.0), np.float32(0.0), np.float32(1.0), np.float32(1.0), np.float32(1.0), np.float32(1.0), np.float32(1.0), np.float32(1.0), np.float32(0.0)]",-1.0,99612.0,32
2025-08-14_08-18-36,4411,"[np.float32(0.0), np.float32(1.0), np.float32(0.0), np.float32(0.0), np.float32(1.0), np.float32(1.0), np.float32(0.0), np.float32(1.0), np.float32(1.0), np.float32(0.0), np.float32(1.0), np.float32(1.0), np.float32(0.0), np.float32(1.0), np.float32(1.0), np.float32(0.0)]",-1.0,99611.0,19
2025-08-14_08-18-36,4412,"[np.float32(1.0), np.float32(0.0), np.float32(0.0), np.float32(1.0), np.float32(0.0), np.float32(1.0), np.float32(1.0), np.float32(1.0), np.float32(1.0), np.float32(1.0), np.float32(0.0), np.float32(0.0), np.float32(1.0), np.float32(1.0), np.float32(1.0), np.float32(0.0)]",-2.0,99609.0,24
2025-08-14_08-18-36,4413,"[np.float32(1.0), np.float32(0.0), np.float32(1.0), np.float32(1.0), np.float32(0.0), np.float32(1.0), np.float32(1.0), np.float32(1.0), np.float32(1.0), np.float32(0.0), np.float32(1.0), np.float32(0.0), np.float32(0.0), np.float32(1.0), np.float32(0.0), np.float32(0.0)]",0.0,99609.0,34
2025-08-14_08-18-36,4414,"[np.float32(0.0), np.float32(0.0), np.float32(0.0), np.float32(1.0), np.float32(0.0), np.float32(0.0), np.float32(0.0), np.float32(0.0), np.float32(0.0), np.float32(1.0), np.float32(0.0), np.float32(1.0), np.float32(0.0), np.float32(1.0), np.float32(0.0), np.float32(1.0)]",-3.0,99606.0,11
2025-08-14_08-18-36,4415,"[np.float32(1.0), np.float32(1.0), np.float32(1.0), np.float32(0.0), np.float32(0.0), np.float32(0.0), np.float32(1.0), np.float32(0.0), np.float32(0.0), np.float32(1.0), np.float32(1.0), np.float32(0.0), np.float32(0.0), np.float32(1.0), np.float32(0.0), np.float32(1.0)]",2.0,99608.0,12
2025-08-14_08-18-36,4416,"[np.float32(1.0), np.float32(1.0), np.float32(0.0), np.float32(0.0), np.float32(0.0), np.float32(0.0), np.float32(0.0), np.float32(1.0), np.float32(0.0), np.float32(1.0), np.float32(1.0), np.float32(0.0), np.float32(0.0), np.float32(1.0), np.float32(0.0), np.float32(0.0)]",2.0,99610.0,35
2025-08-14_08-18-36,4417,"[np.float32(0.0), np.float32(0.0), np.float32(1.0), np.float32(1.0), np.float32(0.0), np.float32(1.0), np.float32(0.0), np.float32(1.0), np.float32(1.0), np.float32(1.0), np.float32(0.0), np.float32(0.0), np.float32(0.0), np.float32(0.0), np.float32(0.0), np.float32(0.0)]",-1.0,99609.0,14
2025-08-14_08-18-36,4418,"[np.float32(0.0), np.float32(1.0), np.float32(1.0), np.float32(1.0), np.float32(1.0), np.float32(1.0), np.float32(0.0), np.float32(1.0), np.float32(1.0), np.float32(0.0), np.float32(1.0), np.float32(0.0), np.float32(1.0), np.float32(1.0), np.float32(0.0), np.float32(1.0)]",2.0,99611.0,14
2025-08-14_08-18-36,4419,"[np.float32(0.0), np.float32(1.0), np.float32(0.0), np.float32(1.0), np.float32(0.0), np.float32(1.0), np.float32(1.0), np.float32(0.0), np.float32(0.0), np.float32(0.0), np.float32(1.0), np.float32(0.0), np.float32(1.0), np.float32(1.0), np.float32(0.0), np.float32(0.0)]",0.0,99611.0,0
2025-08-14_08-18-36,4420,"[np.float32(0.0), np.float32(0.0), np.float32(1.0), np.float32(0.0), np.float32(1.0), np.float32(1.0), np.float32(1.0), np.float32(1.0), np.float32(0.0), np.float32(1.0), np.float32(1.0), np.float32(0.0), np.float32(1.0), np.float32(1.0), np.float32(0.0), np.float32(0.0)]",-2.0,99609.0,6
2025-08-14_08-18-36,4421,"[np.float32(0.0), np.float32(0.0), np.float32(0.0), np.float32(0.0), np.float32(0.0), np.float32(0.0), np.float32(0.0), np.float32(0.0), np.float32(1.0), np.float32(1.0), np.float32(0.0), np.float32(1.0), np.float32(1.0), np.float32(1.0), np.float32(1.0), np.float32(1.0)]",-1.0,99608.0,21
2025-08-14_08-18-36,4422,"[np.float32(0.0), np.float32(1.0), np.float32(0.0), np.float32(0.0), np.float32(0.0), np.float32(1.0), np.float32(0.0), np.float32(0.0), np.float32(0.0), np.float32(1.0), np.float32(0.0), np.float32(1.0), np.float32(0.0), np.float32(1.0), np.float32(0.0), np.float32(0.0)]",1.0,99609.0,3
2025-08-14_08-18-36,4423,"[np.float32(0.0), np.float32(1.0), np.float32(1.0), np.float32(0.0), np.float32(0.0), np.float32(0.0), np.float32(1.0), np.float32(1.0), np.float32(1.0), np.float32(1.0), np.float32(1.0), np.float32(0.0), np.float32(1.0), np.float32(1.0), np.float32(1.0), np.float32(1.0)]",-5.0,99604.0,3
2025-08-14_08-18-36,4424,"[np.float32(0.0), np.float32(0.0), np.float32(0.0), np.float32(1.0), np.float32(1.0), np.float32(1.0), np.float32(1.0), np.float32(1.0), np.float32(0.0), np.float32(0.0), np.float32(0.0), np.float32(1.0), np.float32(1.0), np.float32(0.0), np.float32(0.0), np.float32(0.0)]",0.0,99604.0,23
2025-08-14_08-18-36,4425,"[np.float32(0.0), np.float32(1.0), np.float32(1.0), np.float32(0.0), np.float32(1.0), np.float32(0.0), np.float32(1.0), np.float32(0.0), np.float32(1.0), np.float32(0.0), np.float32(0.0), np.float32(1.0), np.float32(0.0), np.float32(0.0), np.float32(0.0), np.float32(1.0)]",-2.0,99602.0,29
2025-08-14_08-18-36,4426,"[np.float32(0.0), np.float32(1.0), np.float32(1.0), np.float32(0.0), np.float32(0.0), np.float32(0.0), np.float32(1.0), np.float32(0.0), np.float32(1.0), np.float32(0.0), np.float32(0.0), np.float32(0.0), np.float32(0.0), np.float32(1.0), np.float32(0.0), np.float32(0.0)]",2.0,99604.0,22
2025-08-14_08-18-36,4427,"[np.float32(0.0), np.float32(1.0), np.float32(1.0), np.float32(1.0), np.float32(0.0), np.float32(0.0), np.float32(1.0), np.float32(0.0), np.float32(1.0), np.float32(0.0), np.float32(1.0), np.float32(0.0), np.float32(0.0), np.float32(1.0), np.float32(1.0), np.float32(1.0)]",-1.0,99603.0,7
2025-08-14_08-18-36,4428,"[np.float32(1.0), np.float32(0.0), np.float32(0.0), np.float32(1.0), np.float32(0.0), np.float32(0.0), np.float32(1.0), np.float32(0.0), np.float32(1.0), np.float32(1.0), np.float32(1.0), np.float32(1.0), np.float32(1.0), np.float32(1.0), np.float32(1.0), np.float32(1.0)]",-2.0,99601.0,26
2025-08-14_08-18-36,4429,"[np.float32(1.0), np.float32(1.0), np.float32(0.0), np.float32(0.0), np.float32(0.0), np.float32(0.0), np.float32(0.0), np.float32(0.0), np.float32(1.0), np.float32(1.0), np.float32(0.0), np.float32(0.0), np.float32(0.0), np.float32(0.0), np.float32(0.0), np.float32(1.0)]",-3.0,99598.0,5
2025-08-14_08-18-36,4430,"[np.float32(1.0), np.float32(0.0), np.float32(1.0), np.float32(1.0), np.float32(0.0), np.float32(1.0), np.float32(1.0), np.float32(0.0), np.float32(1.0), np.float32(0.0), np.float32(0.0), np.float32(1.0), np.float32(0.0), np.float32(1.0), np.float32(0.0), np.float32(1.0)]",1.0,99599.0,1
2025-08-14_08-18-36,4431,"[np.float32(1.0), np.float32(0.0), np.float32(1.0), np.float32(1.0), np.float32(0.0), np.float32(0.0), np.float32(1.0), np.float32(0.0), np.float32(1.0), np.float32(0.0), np.float32(0.0), np.float32(0.0), np.float32(1.0), np.float32(0.0), np.float32(0.0), np.float32(0.0)]",37.0,99636.0,7
2025-08-14_08-18-36,4432,"[np.float32(1.0), np.float32(1.0), np.float32(0.0), np.float32(1.0), np.float32(0.0), np.float32(1.0), np.float32(1.0), np.float32(0.0), np.float32(0.0), np.float32(0.0), np.float32(1.0), np.float32(1.0), np.float32(1.0), np.float32(0.0), np.float32(1.0), np.float32(0.0)]",-2.0,99634.0,13
2025-08-14_08-18-36,4433,"[np.float32(1.0), np.float32(1.0), np.float32(1.0), np.float32(1.0), np.float32(0.0), np.float32(1.0), np.float32(1.0), np.float32(1.0), np.float32(1.0), np.float32(0.0), np.float32(1.0), np.float32(0.0), np.float32(1.0), np.float32(1.0), np.float32(1.0), np.float32(1.0)]",2.0,99636.0,32
2025-08-14_08-18-36,4434,"[np.float32(1.0), np.float32(1.0), np.float32(1.0), np.float32(1.0), np.float32(0.0), np.float32(1.0), np.float32(1.0), np.float32(0.0), np.float32(1.0), np.float32(0.0), np.float32(1.0), np.float32(0.0), np.float32(0.0), np.float32(0.0), np.float32(1.0), np.float32(1.0)]",2.0,99638.0,32
2025-08-14_08-18-36,4435,"[np.float32(1.0), np.float32(0.0), np.float32(0.0), np.float32(1.0), np.float32(1.0), np.float32(1.0), np.float32(0.0), np.float32(1.0), np.float32(1.0), np.float32(1.0), np.float32(0.0), np.float32(0.0), np.float32(1.0), np.float32(1.0), np.float32(1.0), np.float32(1.0)]",-3.0,99635.0,26
2025-08-14_08-18-36,4436,"[np.float32(0.0), np.float32(1.0), np.float32(0.0), np.float32(0.0), np.float32(0.0), np.float32(1.0), np.float32(1.0), np.float32(0.0), np.float32(1.0), np.float32(1.0), np.float32(0.0), np.float32(1.0), np.float32(1.0), np.float32(0.0), np.float32(1.0), np.float32(0.0)]",-4.0,99631.0,0
2025-08-14_08-18-36,4437,"[np.float32(1.0), np.float32(1.0), np.float32(1.0), np.float32(1.0), np.float32(1.0), np.float32(1.0), np.float32(1.0), np.float32(0.0), np.float32(0.0), np.float32(1.0), np.float32(1.0), np.float32(0.0), np.float32(1.0), np.float32(1.0), np.float32(0.0), np.float32(0.0)]",4.0,99635.0,4
2025-08-14_08-18-36,4438,"[np.float32(1.0), np.float32(0.0), np.float32(0.0), np.float32(0.0), np.float32(0.0), np.float32(0.0), np.float32(0.0), np.float32(0.0), np.float32(1.0), np.float32(0.0), np.float32(0.0), np.float32(1.0), np.float32(0.0), np.float32(0.0), np.float32(0.0), np.float32(0.0)]",-1.0,99634.0,5
2025-08-14_08-18-36,4439,"[np.float32(1.0), np.float32(0.0), np.float32(1.0), np.float32(0.0), np.float32(1.0), np.float32(0.0), np.float32(1.0), np.float32(1.0), np.float32(1.0), np.float32(0.0), np.float32(1.0), np.float32(0.0), np.float32(1.0), np.float32(0.0), np.float32(1.0), np.float32(0.0)]",-1.0,99633.0,13
2025-08-14_08-18-36,4440,"[np.float32(1.0), np.float32(1.0), np.float32(0.0), np.float32(0.0), np.float32(0.0), np.float32(1.0), np.float32(1.0), np.float32(1.0), np.float32(0.0), np.float32(0.0), np.float32(1.0), np.float32(0.0), np.float32(1.0), np.float32(1.0), np.float32(1.0), np.float32(1.0)]",0.0,99633.0,26
2025-08-14_08-18-36,4441,"[np.float32(1.0), np.float32(1.0), np.float32(1.0), np.float32(1.0), np.float32(0.0), np.float32(0.0), np.float32(0.0), np.float32(0.0), np.float32(1.0), np.float32(0.0), np.float32(1.0), np.float32(0.0), np.float32(1.0), np.float32(0.0), np.float32(0.0), np.float32(0.0)]",0.0,99633.0,17
2025-08-14_08-18-36,4442,"[np.float32(0.0), np.float32(1.0), np.float32(0.0), np.float32(1.0), np.float32(1.0), np.float32(1.0), np.float32(0.0), np.float32(0.0), np.float32(0.0), np.float32(0.0), np.float32(0.0), np.float32(1.0), np.float32(1.0), np.float32(0.0), np.float32(0.0), np.float32(1.0)]",3.0,99636.0,6
2025-08-14_08-18-36,4443,"[np.float32(1.0), np.float32(1.0), np.float32(0.0), np.float32(0.0), np.float32(1.0), np.float32(1.0), np.float32(1.0), np.float32(0.0), np.float32(0.0), np.float32(1.0), np.float32(0.0), np.float32(0.0), np.float32(1.0), np.float32(1.0), np.float32(0.0), np.float32(1.0)]",-2.0,99634.0,15
2025-08-14_08-18-36,4444,"[np.float32(1.0), np.float32(1.0), np.float32(0.0), np.float32(1.0), np.float32(1.0), np.float32(1.0), np.float32(0.0), np.float32(1.0), np.float32(1.0), np.float32(1.0), np.float32(0.0), np.float32(1.0), np.float32(1.0), np.float32(0.0), np.float32(0.0), np.float32(1.0)]",-1.0,99633.0,30
2025-08-14_08-18-36,4445,"[np.float32(1.0), np.float32(0.0), np.float32(1.0), np.float32(1.0), np.float32(1.0), np.float32(1.0), np.float32(1.0), np.float32(0.0), np.float32(1.0), np.float32(0.0), np.float32(0.0), np.float32(0.0), np.float32(1.0), np.float32(1.0), np.float32(1.0), np.float32(0.0)]",-3.0,99630.0,24
2025-08-14_08-18-36,4446,"[np.float32(0.0), np.float32(1.0), np.float32(0.0), np.float32(0.0), np.float32(0.0), np.float32(1.0), np.float32(1.0), np.float32(0.0), np.float32(1.0), np.float32(1.0), np.float32(0.0), np.float32(0.0), np.float32(1.0), np.float32(1.0), np.float32(0.0), np.float32(0.0)]",-2.0,99628.0,27
2025-08-14_08-18-36,4447,"[np.float32(0.0), np.float32(1.0), np.float32(1.0), np.float32(1.0), np.float32(0.0), np.float32(0.0), np.float32(1.0), np.float32(1.0), np.float32(1.0), np.float32(0.0), np.float32(0.0), np.float32(0.0), np.float32(0.0), np.float32(1.0), np.float32(0.0), np.float32(0.0)]",1.0,99629.0,12
2025-08-14_08-18-36,4448,"[np.float32(0.0), np.float32(1.0), np.float32(1.0), np.float32(0.0), np.float32(1.0), np.float32(1.0), np.float32(0.0), np.float32(1.0), np.float32(0.0), np.float32(1.0), np.float32(1.0), np.float32(1.0), np.float32(0.0), np.float32(0.0), np.float32(0.0), np.float32(0.0)]",-3.0,99626.0,3
2025-08-14_08-18-36,4449,"[np.float32(0.0), np.float32(0.0), np.float32(1.0), np.float32(1.0), np.float32(1.0), np.float32(1.0), np.float32(1.0), np.float32(1.0), np.float32(1.0), np.float32(0.0), np.float32(0.0), np.float32(0.0), np.float32(0.0), np.float32(1.0), np.float32(0.0), np.float32(0.0)]",2.0,99628.0,2
2025-08-14_08-18-36,4450,"[np.float32(0.0), np.float32(0.0), np.float32(0.0), np.float32(0.0), np.float32(0.0), np.float32(1.0), np.float32(1.0), np.float32(1.0), np.float32(0.0), np.float32(1.0), np.float32(0.0), np.float32(0.0), np.float32(1.0), np.float32(0.0), np.float32(1.0), np.float32(0.0)]",3.0,99631.0,13
2025-08-14_08-18-36,4451,"[np.float32(1.0), np.float32(0.0), np.float32(0.0), np.float32(1.0), np.float32(0.0), np.float32(0.0), np.float32(0.0), np.float32(1.0), np.float32(0.0), np.float32(1.0), np.float32(1.0), np.float32(0.0), np.float32(0.0), np.float32(0.0), np.float32(1.0), np.float32(0.0)]",0.0,99631.0,20
2025-08-14_08-18-36,4452,"[np.float32(0.0), np.float32(0.0), np.float32(1.0), np.float32(0.0), np.float32(1.0), np.float32(0.0), np.float32(0.0), np.float32(1.0), np.float32(1.0), np.float32(0.0), np.float32(0.0), np.float32(0.0), np.float32(0.0), np.float32(1.0), np.float32(1.0), np.float32(0.0)]",2.0,99633.0,28
2025-08-14_08-18-36,4453,"[np.float32(0.0), np.float32(0.0), np.float32(0.0), np.float32(1.0), np.float32(0.0), np.float32(1.0), np.float32(1.0), np.float32(1.0), np.float32(0.0), np.float32(0.0), np.float32(1.0), np.float32(0.0), np.float32(1.0), np.float32(0.0), np.float32(0.0), np.float32(1.0)]",0.0,99633.0,19
2025-08-14_08-18-36,4454,"[np.float32(0.0), np.float32(0.0), np.float32(0.0), np.float32(1.0), np.float32(0.0), np.float32(0.0), np.float32(0.0), np.float32(0.0), np.float32(1.0), np.float32(1.0), np.float32(0.0), np.float32(1.0), np.float32(0.0), np.float32(1.0), np.float32(0.0), np.float32(1.0)]",-3.0,99630.0,24
2025-08-14_08-18-36,4455,"[np.float32(1.0), np.float32(1.0), np.float32(0.0), np.float32(1.0), np.float32(1.0), np.float32(1.0), np.float32(0.0), np.float32(0.0), np.float32(0.0), np.float32(1.0), np.float32(0.0), np.float32(1.0), np.float32(1.0), np.float32(1.0), np.float32(0.0), np.float32(0.0)]",3.0,99633.0,19
2025-08-14_08-18-36,4456,"[np.float32(0.0), np.float32(0.0), np.float32(0.0), np.float32(0.0), np.float32(0.0), np.float32(1.0), np.float32(1.0), np.float32(1.0), np.float32(1.0), np.float32(0.0), np.float32(0.0), np.float32(0.0), np.float32(1.0), np.float32(1.0), np.float32(1.0), np.float32(1.0)]",-2.0,99631.0,16
2025-08-14_08-18-36,4457,"[np.float32(1.0), np.float32(1.0), np.float32(0.0), np.float32(0.0), np.float32(1.0), np.float32(0.0), np.float32(1.0), np.float32(1.0), np.float32(1.0), np.float32(0.0), np.float32(0.0), np.float32(1.0), np.float32(0.0), np.float32(1.0), np.float32(0.0), np.float32(0.0)]",2.0,99633.0,9
2025-08-14_08-18-36,4458,"[np.float32(1.0), np.float32(0.0), np.float32(1.0), np.float32(1.0), np.float32(1.0), np.float32(1.0), np.float32(1.0), np.float32(1.0), np.float32(1.0), np.float32(1.0), np.float32(1.0), np.float32(0.0), np.float32(1.0), np.float32(1.0), np.float32(0.0), np.float32(0.0)]",0.0,99633.0,14
2025-08-14_08-18-36,4459,"[np.float32(0.0), np.float32(1.0), np.float32(1.0), np.float32(0.0), np.float32(0.0), np.float32(0.0), np.float32(1.0), np.float32(1.0), np.float32(0.0), np.float32(0.0), np.float32(1.0), np.float32(0.0), np.float32(1.0), np.float32(1.0), np.float32(0.0), np.float32(1.0)]",0.0,99633.0,15
2025-08-14_08-18-36,4460,"[np.float32(0.0), np.float32(1.0), np.float32(0.0), np.float32(0.0), np.float32(0.0), np.float32(0.0), np.float32(0.0), np.float32(0.0), np.float32(0.0), np.float32(1.0), np.float32(0.0), np.float32(0.0), np.float32(1.0), np.float32(1.0), np.float32(0.0), np.float32(1.0)]",0.0,99633.0,0
2025-08-14_08-18-36,4461,"[np.float32(0.0), np.float32(0.0), np.float32(0.0), np.float32(0.0), np.float32(0.0), np.float32(1.0), np.float32(1.0), np.float32(1.0), np.float32(1.0), np.float32(0.0), np.float32(1.0), np.float32(0.0), np.float32(1.0), np.float32(1.0), np.float32(0.0), np.float32(0.0)]",-4.0,99629.0,6
2025-08-14_08-18-36,4462,"[np.float32(0.0), np.float32(0.0), np.float32(0.0), np.float32(0.0), np.float32(1.0), np.float32(1.0), np.float32(1.0), np.float32(1.0), np.float32(1.0), np.float32(1.0), np.float32(1.0), np.float32(1.0), np.float32(1.0), np.float32(1.0), np.float32(1.0), np.float32(0.0)]",36.0,99665.0,7
2025-08-14_08-18-36,4463,"[np.float32(1.0), np.float32(1.0), np.float32(1.0), np.float32(1.0), np.float32(1.0), np.float32(1.0), np.float32(1.0), np.float32(0.0), np.float32(1.0), np.float32(0.0), np.float32(1.0), np.float32(1.0), np.float32(1.0), np.float32(1.0), np.float32(1.0), np.float32(1.0)]",1.0,99666.0,9
2025-08-14_08-18-36,4464,"[np.float32(1.0), np.float32(0.0), np.float32(0.0), np.float32(1.0), np.float32(0.0), np.float32(1.0), np.float32(0.0), np.float32(1.0), np.float32(0.0), np.float32(1.0), np.float32(1.0), np.float32(1.0), np.float32(0.0), np.float32(0.0), np.float32(0.0), np.float32(0.0)]",0.0,99666.0,34
2025-08-14_08-18-36,4465,"[np.float32(1.0), np.float32(1.0), np.float32(0.0), np.float32(0.0), np.float32(1.0), np.float32(1.0), np.float32(1.0), np.float32(1.0), np.float32(1.0), np.float32(0.0), np.float32(1.0), np.float32(1.0), np.float32(0.0), np.float32(0.0), np.float32(0.0), np.float32(0.0)]",1.0,99667.0,14
2025-08-14_08-18-36,4466,"[np.float32(0.0), np.float32(1.0), np.float32(1.0), np.float32(0.0), np.float32(0.0), np.float32(0.0), np.float32(1.0), np.float32(1.0), np.float32(1.0), np.float32(1.0), np.float32(0.0), np.float32(0.0), np.float32(1.0), np.float32(0.0), np.float32(0.0), np.float32(1.0)]",-5.0,99662.0,23
2025-08-14_08-18-36,4467,"[np.float32(0.0), np.float32(0.0), np.float32(1.0), np.float32(0.0), np.float32(0.0), np.float32(0.0), np.float32(1.0), np.float32(0.0), np.float32(1.0), np.float32(0.0), np.float32(1.0), np.float32(0.0), np.float32(1.0), np.float32(1.0), np.float32(0.0), np.float32(0.0)]",-3.0,99659.0,33
2025-08-14_08-18-36,4468,"[np.float32(1.0), np.float32(0.0), np.float32(1.0), np.float32(0.0), np.float32(0.0), np.float32(0.0), np.float32(0.0), np.float32(0.0), np.float32(0.0), np.float32(0.0), np.float32(0.0), np.float32(0.0), np.float32(0.0), np.float32(0.0), np.float32(0.0), np.float32(0.0)]",0.0,99659.0,21
2025-08-14_08-18-36,4469,"[np.float32(0.0), np.float32(0.0), np.float32(1.0), np.float32(0.0), np.float32(0.0), np.float32(0.0), np.float32(0.0), np.float32(1.0), np.float32(1.0), np.float32(1.0), np.float32(0.0), np.float32(0.0), np.float32(1.0), np.float32(1.0), np.float32(0.0), np.float32(0.0)]",0.0,99659.0,21
2025-08-14_08-18-36,4470,"[np.float32(1.0), np.float32(1.0), np.float32(1.0), np.float32(1.0), np.float32(1.0), np.float32(1.0), np.float32(0.0), np.float32(1.0), np.float32(1.0), np.float32(1.0), np.float32(1.0), np.float32(0.0), np.float32(1.0), np.float32(1.0), np.float32(0.0), np.float32(0.0)]",0.0,99659.0,15
2025-08-14_08-18-36,4471,"[np.float32(1.0), np.float32(0.0), np.float32(1.0), np.float32(1.0), np.float32(1.0), np.float32(0.0), np.float32(1.0), np.float32(0.0), np.float32(0.0), np.float32(0.0), np.float32(1.0), np.float32(0.0), np.float32(0.0), np.float32(1.0), np.float32(1.0), np.float32(0.0)]",0.0,99659.0,29
2025-08-14_08-18-36,4472,"[np.float32(0.0), np.float32(0.0), np.float32(1.0), np.float32(0.0), np.float32(0.0), np.float32(1.0), np.float32(1.0), np.float32(0.0), np.float32(1.0), np.float32(1.0), np.float32(1.0), np.float32(0.0), np.float32(1.0), np.float32(0.0), np.float32(1.0), np.float32(1.0)]",-4.0,99655.0,19
2025-08-14_08-18-36,4473,"[np.float32(1.0), np.float32(0.0), np.float32(0.0), np.float32(0.0), np.float32(1.0), np.float32(0.0), np.float32(0.0), np.float32(0.0), np.float32(1.0), np.float32(0.0), np.float32(0.0), np.float32(0.0), np.float32(0.0), np.float32(0.0), np.float32(1.0), np.float32(1.0)]",3.0,99658.0,36
2025-08-14_08-18-36,4474,"[np.float32(1.0), np.float32(1.0), np.float32(1.0), np.float32(0.0), np.float32(1.0), np.float32(1.0), np.float32(0.0), np.float32(1.0), np.float32(1.0), np.float32(1.0), np.float32(0.0), np.float32(0.0), np.float32(1.0), np.float32(1.0), np.float32(0.0), np.float32(0.0)]",0.0,99658.0,31
2025-08-14_08-18-36,4475,"[np.float32(0.0), np.float32(0.0), np.float32(1.0), np.float32(1.0), np.float32(0.0), np.float32(1.0), np.float32(0.0), np.float32(1.0), np.float32(0.0), np.float32(0.0), np.float32(1.0), np.float32(0.0), np.float32(0.0), np.float32(1.0), np.float32(1.0), np.float32(0.0)]",3.0,99661.0,32
2025-08-14_08-18-36,4476,"[np.float32(1.0), np.float32(1.0), np.float32(1.0), np.float32(0.0), np.float32(1.0), np.float32(0.0), np.float32(0.0), np.float32(0.0), np.float32(1.0), np.float32(1.0), np.float32(0.0), np.float32(1.0), np.float32(0.0), np.float32(0.0), np.float32(0.0), np.float32(0.0)]",-2.0,99659.0,35
2025-08-14_08-18-36,4477,"[np.float32(0.0), np.float32(1.0), np.float32(1.0), np.float32(0.0), np.float32(0.0), np.float32(1.0), np.float32(0.0), np.float32(1.0), np.float32(0.0), np.float32(1.0), np.float32(0.0), np.float32(0.0), np.float32(0.0), np.float32(1.0), np.float32(0.0), np.float32(1.0)]",8.0,99667.0,22
2025-08-14_08-18-36,4478,"[np.float32(0.0), np.float32(1.0), np.float32(0.0), np.float32(0.0), np.float32(1.0), np.float32(1.0), np.float32(1.0), np.float32(0.0), np.float32(0.0), np.float32(0.0), np.float32(0.0), np.float32(1.0), np.float32(0.0), np.float32(1.0), np.float32(1.0), np.float32(1.0)]",-3.0,99664.0,34
2025-08-14_08-18-36,4479,"[np.float32(1.0), np.float32(1.0), np.float32(0.0), np.float32(1.0), np.float32(1.0), np.float32(1.0), np.float32(0.0), np.float32(1.0), np.float32(0.0), np.float32(1.0), np.float32(0.0), np.float32(1.0), np.float32(0.0), np.float32(1.0), np.float32(1.0), np.float32(0.0)]",-1.0,99663.0,11
2025-08-14_08-18-36,4480,"[np.float32(0.0), np.float32(1.0), np.float32(1.0), np.float32(0.0), np.float32(0.0), np.float32(0.0), np.float32(0.0), np.float32(1.0), np.float32(0.0), np.float32(1.0), np.float32(0.0), np.float32(1.0), np.float32(1.0), np.float32(1.0), np.float32(0.0), np.float32(0.0)]",0.0,99663.0,0
2025-08-14_08-18-36,4481,"[np.float32(1.0), np.float32(0.0), np.float32(1.0), np.float32(0.0), np.float32(0.0), np.float32(0.0), np.float32(0.0), np.float32(0.0), np.float32(1.0), np.float32(0.0), np.float32(1.0), np.float32(0.0), np.float32(0.0), np.float32(0.0), np.float32(1.0), np.float32(1.0)]",2.0,99665.0,27
2025-08-14_08-18-36,4482,"[np.float32(1.0), np.float32(0.0), np.float32(1.0), np.float32(1.0), np.float32(0.0), np.float32(1.0), np.float32(0.0), np.float32(0.0), np.float32(0.0), np.float32(1.0), np.float32(1.0), np.float32(1.0), np.float32(1.0), np.float32(1.0), np.float32(1.0), np.float32(0.0)]",-5.0,99660.0,17
2025-08-14_08-18-36,4483,"[np.float32(0.0), np.float32(1.0), np.float32(0.0), np.float32(0.0), np.float32(0.0), np.float32(1.0), np.float32(0.0), np.float32(1.0), np.float32(1.0), np.float32(1.0), np.float32(0.0), np.float32(1.0), np.float32(0.0), np.float32(1.0), np.float32(1.0), np.float32(0.0)]",0.0,99660.0,32
2025-08-14_08-18-36,4484,"[np.float32(0.0), np.float32(1.0), np.float32(0.0), np.float32(1.0), np.float32(1.0), np.float32(1.0), np.float32(1.0), np.float32(0.0), np.float32(0.0), np.float32(0.0), np.float32(0.0), np.float32(0.0), np.float32(0.0), np.float32(1.0), np.float32(0.0), np.float32(1.0)]",3.0,99663.0,6
2025-08-14_08-18-36,4485,"[np.float32(0.0), np.float32(1.0), np.float32(1.0), np.float32(1.0), np.float32(0.0), np.float32(0.0), np.float32(1.0), np.float32(1.0), np.float32(0.0), np.float32(1.0), np.float32(1.0), np.float32(1.0), np.float32(0.0), np.float32(0.0), np.float32(1.0), np.float32(1.0)]",-2.0,99661.0,19
2025-08-14_08-18-36,4486,"[np.float32(0.0), np.float32(1.0), np.float32(1.0), np.float32(0.0), np.float32(0.0), np.float32(0.0), np.float32(1.0), np.float32(0.0), np.float32(1.0), np.float32(0.0), np.float32(0.0), np.float32(1.0), np.float32(1.0), np.float32(0.0), np.float32(1.0), np.float32(1.0)]",-3.0,99658.0,16
2025-08-14_08-18-36,4487,"[np.float32(1.0), np.float32(0.0), np.float32(1.0), np.float32(0.0), np.float32(1.0), np.float32(0.0), np.float32(0.0), np.float32(1.0), np.float32(0.0), np.float32(0.0), np.float32(1.0), np.float32(1.0), np.float32(0.0), np.float32(0.0), np.float32(0.0), np.float32(1.0)]",3.0,99661.0,9
2025-08-14_08-18-36,4488,"[np.float32(0.0), np.float32(1.0), np.float32(1.0), np.float32(1.0), np.float32(0.0), np.float32(1.0), np.float32(0.0), np.float32(0.0), np.float32(0.0), np.float32(0.0), np.float32(0.0), np.float32(0.0), np.float32(1.0), np.float32(1.0), np.float32(0.0), np.float32(0.0)]",-2.0,99659.0,23
2025-08-14_08-18-36,4489,"[np.float32(1.0), np.float32(0.0), np.float32(0.0), np.float32(0.0), np.float32(1.0), np.float32(1.0), np.float32(0.0), np.float32(1.0), np.float32(0.0), np.float32(0.0), np.float32(0.0), np.float32(1.0), np.float32(1.0), np.float32(0.0), np.float32(1.0), np.float32(1.0)]",-3.0,99656.0,11
2025-08-14_08-18-36,4490,"[np.float32(1.0), np.float32(1.0), np.float32(1.0), np.float32(0.0), np.float32(0.0), np.float32(1.0), np.float32(1.0), np.float32(1.0), np.float32(0.0), np.float32(1.0), np.float32(1.0), np.float32(0.0), np.float32(1.0), np.float32(1.0), np.float32(0.0), np.float32(0.0)]",-2.0,99654.0,13
2025-08-14_08-18-36,4491,"[np.float32(1.0), np.float32(1.0), np.float32(1.0), np.float32(0.0), np.float32(1.0), np.float32(1.0), np.float32(1.0), np.float32(1.0), np.float32(1.0), np.float32(0.0), np.float32(0.0), np.float32(1.0), np.float32(1.0), np.float32(1.0), np.float32(0.0), np.float32(0.0)]",-1.0,99653.0,25
2025-08-14_08-18-36,4492,"[np.float32(0.0), np.float32(0.0), np.float32(0.0), np.float32(0.0), np.float32(0.0), np.float32(1.0), np.float32(1.0), np.float32(1.0), np.float32(0.0), np.float32(0.0), np.float32(1.0), np.float32(1.0), np.float32(0.0), np.float32(1.0), np.float32(1.0), np.float32(1.0)]",3.0,99656.0,21
2025-08-14_08-18-36,4493,"[np.float32(1.0), np.float32(0.0), np.float32(1.0), np.float32(1.0), np.float32(1.0), np.float32(1.0), np.float32(1.0), np.float32(1.0), np.float32(0.0), np.float32(0.0), np.float32(1.0), np.float32(1.0), np.float32(0.0), np.float32(1.0), np.float32(0.0), np.float32(0.0)]",0.0,99656.0,11
2025-08-14_08-18-36,4494,"[np.float32(1.0), np.float32(0.0), np.float32(0.0), np.float32(1.0), np.float32(0.0), np.float32(0.0), np.float32(0.0), np.float32(0.0), np.float32(1.0), np.float32(1.0), np.float32(0.0), np.float32(1.0), np.float32(1.0), np.float32(0.0), np.float32(0.0), np.float32(1.0)]",-4.0,99652.0,10
2025-08-14_08-18-36,4495,"[np.float32(1.0), np.float32(0.0), np.float32(0.0), np.float32(0.0), np.float32(0.0), np.float32(0.0), np.float32(0.0), np.float32(1.0), np.float32(1.0), np.float32(0.0), np.float32(0.0), np.float32(1.0), np.float32(0.0), np.float32(1.0), np.float32(0.0), np.float32(0.0)]",-2.0,99650.0,4
2025-08-14_08-18-36,4496,"[np.float32(0.0), np.float32(0.0), np.float32(1.0), np.float32(1.0), np.float32(1.0), np.float32(1.0), np.float32(0.0), np.float32(1.0), np.float32(1.0), np.float32(0.0), np.float32(0.0), np.float32(0.0), np.float32(0.0), np.float32(0.0), np.float32(0.0), np.float32(0.0)]",1.0,99651.0,33
2025-08-14_08-18-36,4497,"[np.float32(0.0), np.float32(1.0), np.float32(0.0), np.float32(0.0), np.float32(0.0), np.float32(1.0), np.float32(1.0), np.float32(1.0), np.float32(0.0), np.float32(1.0), np.float32(0.0), np.float32(0.0), np.float32(0.0), np.float32(1.0), np.float32(0.0), np.float32(0.0)]",2.0,99653.0,2
2025-08-14_08-18-36,4498,"[np.float32(0.0), np.float32(0.0), np.float32(1.0), np.float32(0.0), np.float32(0.0), np.float32(1.0), np.float32(0.0), np.float32(0.0), np.float32(1.0), np.float32(0.0), np.float32(1.0), np.float32(0.0), np.float32(0.0), np.float32(1.0), np.float32(1.0), np.float32(1.0)]",0.0,99653.0,22
2025-08-14_08-18-36,4499,"[np.float32(1.0), np.float32(0.0), np.float32(1.0), np.float32(0.0), np.float32(1.0), np.float32(0.0), np.float32(0.0), np.float32(0.0), np.float32(0.0), np.float32(1.0), np.float32(0.0), np.float32(0.0), np.float32(0.0), np.float32(1.0), np.float32(1.0), np.float32(1.0)]",0.0,99653.0,6
2025-08-14_08-18-36,4500,"[np.float32(1.0), np.float32(0.0), np.float32(0.0), np.float32(0.0), np.float32(1.0), np.float32(0.0), np.float32(1.0), np.float32(0.0), np.float32(1.0), np.float32(1.0), np.float32(1.0), np.float32(0.0), np.float32(1.0), np.float32(1.0), np.float32(1.0), np.float32(1.0)]",0.0,99653.0,3
2025-08-14_08-18-36,4501,"[np.float32(1.0), np.float32(0.0), np.float32(0.0), np.float32(0.0), np.float32(0.0), np.float32(1.0), np.float32(1.0), np.float32(0.0), np.float32(1.0), np.float32(1.0), np.float32(1.0), np.float32(0.0), np.float32(0.0), np.float32(1.0), np.float32(0.0), np.float32(0.0)]",-2.0,99651.0,16
2025-08-14_08-18-36,4502,"[np.float32(0.0), np.float32(0.0), np.float32(1.0), np.float32(0.0), np.float32(0.0), np.float32(1.0), np.float32(0.0), np.float32(1.0), np.float32(0.0), np.float32(0.0), np.float32(1.0), np.float32(0.0), np.float32(0.0), np.float32(0.0), np.float32(0.0), np.float32(1.0)]",0.0,99651.0,21
2025-08-14_08-18-36,4503,"[np.float32(0.0), np.float32(0.0), np.float32(1.0), np.float32(1.0), np.float32(0.0), np.float32(1.0), np.float32(1.0), np.float32(1.0), np.float32(0.0), np.float32(0.0), np.float32(1.0), np.float32(1.0), np.float32(0.0), np.float32(0.0), np.float32(1.0), np.float32(0.0)]",-1.0,99650.0,26
2025-08-14_08-18-36,4504,"[np.float32(0.0), np.float32(0.0), np.float32(1.0), np.float32(0.0), np.float32(0.0), np.float32(0.0), np.float32(1.0), np.float32(0.0), np.float32(1.0), np.float32(1.0), np.float32(0.0), np.float32(1.0), np.float32(1.0), np.float32(1.0), np.float32(1.0), np.float32(1.0)]",-3.0,99647.0,5
2025-08-14_08-18-36,4505,"[np.float32(0.0), np.float32(0.0), np.float32(1.0), np.float32(0.0), np.float32(0.0), np.float32(1.0), np.float32(1.0), np.float32(1.0), np.float32(0.0), np.float32(1.0), np.float32(0.0), np.float32(1.0), np.float32(0.0), np.float32(1.0), np.float32(1.0), np.float32(1.0)]",2.0,99649.0,12
2025-08-14_08-18-36,4506,"[np.float32(1.0), np.float32(1.0), np.float32(1.0), np.float32(0.0), np.float32(1.0), np.float32(0.0), np.float32(0.0), np.float32(1.0), np.float32(1.0), np.float32(0.0), np.float32(1.0), np.float32(1.0), np.float32(0.0), np.float32(0.0), np.float32(1.0), np.float32(1.0)]",0.0,99649.0,26
2025-08-14_08-18-36,4507,"[np.float32(0.0), np.float32(1.0), np.float32(1.0), np.float32(0.0), np.float32(0.0), np.float32(0.0), np.float32(0.0), np.float32(1.0), np.float32(1.0), np.float32(1.0), np.float32(1.0), np.float32(0.0), np.float32(1.0), np.float32(1.0), np.float32(1.0), np.float32(0.0)]",2.0,99651.0,32
2025-08-14_08-18-36,4508,"[np.float32(1.0), np.float32(0.0), np.float32(1.0), np.float32(0.0), np.float32(0.0), np.float32(1.0), np.float32(1.0), np.float32(1.0), np.float32(1.0), np.float32(1.0), np.float32(0.0), np.float32(1.0), np.float32(0.0), np.float32(0.0), np.float32(0.0), np.float32(1.0)]",-1.0,99650.0,7
2025-08-14_08-18-36,4509,"[np.float32(0.0), np.float32(0.0), np.float32(1.0), np.float32(0.0), np.float32(1.0), np.float32(1.0), np.float32(1.0), np.float32(1.0), np.float32(1.0), np.float32(1.0), np.float32(1.0), np.float32(1.0), np.float32(1.0), np.float32(0.0), np.float32(1.0), np.float32(0.0)]",-3.0,99647.0,29
2025-08-14_08-18-36,4510,"[np.float32(1.0), np.float32(0.0), np.float32(1.0), np.float32(0.0), np.float32(1.0), np.float32(1.0), np.float32(0.0), np.float32(0.0), np.float32(1.0), np.float32(0.0), np.float32(0.0), np.float32(0.0), np.float32(1.0), np.float32(1.0), np.float32(0.0), np.float32(1.0)]",-1.0,99646.0,4
2025-08-14_08-18-36,4511,"[np.float32(1.0), np.float32(1.0), np.float32(0.0), np.float32(0.0), np.float32(0.0), np.float32(0.0), np.float32(0.0), np.float32(0.0), np.float32(0.0), np.float32(0.0), np.float32(0.0), np.float32(1.0), np.float32(0.0), np.float32(1.0), np.float32(1.0), np.float32(0.0)]",0.0,99646.0,5
2025-08-14_08-18-36,4512,"[np.float32(0.0), np.float32(0.0), np.float32(1.0), np.float32(0.0), np.float32(0.0), np.float32(1.0), np.float32(1.0), np.float32(1.0), np.float32(0.0), np.float32(0.0), np.float32(1.0), np.float32(0.0), np.float32(0.0), np.float32(0.0), np.float32(0.0), np.float32(0.0)]",-1.0,99645.0,34
2025-08-14_08-18-36,4513,"[np.float32(0.0), np.float32(0.0), np.float32(0.0), np.float32(0.0), np.float32(0.0), np.float32(1.0), np.float32(0.0), np.float32(0.0), np.float32(1.0), np.float32(0.0), np.float32(0.0), np.float32(0.0), np.float32(1.0), np.float32(0.0), np.float32(1.0), np.float32(0.0)]",1.0,99646.0,28
2025-08-14_08-18-36,4514,"[np.float32(0.0), np.float32(0.0), np.float32(0.0), np.float32(0.0), np.float32(0.0), np.float32(0.0), np.float32(0.0), np.float32(1.0), np.float32(0.0), np.float32(1.0), np.float32(0.0), np.float32(0.0), np.float32(1.0), np.float32(1.0), np.float32(0.0), np.float32(1.0)]",1.0,99647.0,20
2025-08-14_08-18-36,4515,"[np.float32(0.0), np.float32(0.0), np.float32(1.0), np.float32(1.0), np.float32(0.0), np.float32(1.0), np.float32(1.0), np.float32(1.0), np.float32(0.0), np.float32(0.0), np.float32(1.0), np.float32(1.0), np.float32(0.0), np.float32(1.0), np.float32(0.0), np.float32(0.0)]",-4.0,99643.0,34
2025-08-14_08-18-36,4516,"[np.float32(0.0), np.float32(0.0), np.float32(0.0), np.float32(1.0), np.float32(1.0), np.float32(1.0), np.float32(0.0), np.float32(1.0), np.float32(0.0), np.float32(0.0), np.float32(0.0), np.float32(1.0), np.float32(0.0), np.float32(1.0), np.float32(0.0), np.float32(0.0)]",-4.0,99639.0,34
2025-08-14_08-18-36,4517,"[np.float32(0.0), np.float32(0.0), np.float32(1.0), np.float32(1.0), np.float32(1.0), np.float32(1.0), np.float32(1.0), np.float32(1.0), np.float32(0.0), np.float32(1.0), np.float32(0.0), np.float32(0.0), np.float32(1.0), np.float32(0.0), np.float32(0.0), np.float32(0.0)]",-1.0,99638.0,34
2025-08-14_08-18-36,4518,"[np.float32(0.0), np.float32(0.0), np.float32(0.0), np.float32(1.0), np.float32(0.0), np.float32(1.0), np.float32(0.0), np.float32(1.0), np.float32(1.0), np.float32(0.0), np.float32(0.0), np.float32(1.0), np.float32(0.0), np.float32(1.0), np.float32(0.0), np.float32(0.0)]",2.0,99640.0,30
2025-08-14_08-18-36,4519,"[np.float32(0.0), np.float32(1.0), np.float32(1.0), np.float32(0.0), np.float32(0.0), np.float32(1.0), np.float32(1.0), np.float32(0.0), np.float32(1.0), np.float32(0.0), np.float32(1.0), np.float32(0.0), np.float32(1.0), np.float32(0.0), np.float32(0.0), np.float32(0.0)]",0.0,99640.0,31
2025-08-14_08-18-36,4520,"[np.float32(1.0), np.float32(1.0), np.float32(1.0), np.float32(0.0), np.float32(0.0), np.float32(1.0), np.float32(0.0), np.float32(1.0), np.float32(0.0), np.float32(1.0), np.float32(1.0), np.float32(0.0), np.float32(0.0), np.float32(1.0), np.float32(0.0), np.float32(0.0)]",2.0,99642.0,25
2025-08-14_08-18-36,4521,"[np.float32(1.0), np.float32(1.0), np.float32(0.0), np.float32(0.0), np.float32(1.0), np.float32(0.0), np.float32(1.0), np.float32(1.0), np.float32(1.0), np.float32(0.0), np.float32(0.0), np.float32(0.0), np.float32(1.0), np.float32(0.0), np.float32(0.0), np.float32(1.0)]",-1.0,99641.0,16
2025-08-14_08-18-36,4522,"[np.float32(1.0), np.float32(1.0), np.float32(1.0), np.float32(0.0), np.float32(0.0), np.float32(1.0), np.float32(0.0), np.float32(1.0), np.float32(1.0), np.float32(0.0), np.float32(0.0), np.float32(0.0), np.float32(0.0), np.float32(0.0), np.float32(0.0), np.float32(0.0)]",-2.0,99639.0,8
2025-08-14_08-18-36,4523,"[np.float32(0.0), np.float32(0.0), np.float32(0.0), np.float32(0.0), np.float32(0.0), np.float32(0.0), np.float32(1.0), np.float32(0.0), np.float32(0.0), np.float32(1.0), np.float32(0.0), np.float32(0.0), np.float32(1.0), np.float32(1.0), np.float32(0.0), np.float32(1.0)]",1.0,99640.0,2
2025-08-14_08-18-36,4524,"[np.float32(0.0), np.float32(0.0), np.float32(0.0), np.float32(1.0), np.float32(1.0), np.float32(0.0), np.float32(0.0), np.float32(0.0), np.float32(0.0), np.float32(1.0), np.float32(0.0), np.float32(1.0), np.float32(0.0), np.float32(1.0), np.float32(0.0), np.float32(0.0)]",0.0,99640.0,31
2025-08-14_08-18-36,4525,"[np.float32(0.0), np.float32(1.0), np.float32(0.0), np.float32(1.0), np.float32(0.0), np.float32(0.0), np.float32(1.0), np.float32(1.0), np.float32(1.0), np.float32(1.0), np.float32(0.0), np.float32(1.0), np.float32(0.0), np.float32(0.0), np.float32(0.0), np.float32(1.0)]",-2.0,99638.0,12
2025-08-14_08-18-36,4526,"[np.float32(1.0), np.float32(0.0), np.float32(1.0), np.float32(0.0), np.float32(1.0), np.float32(0.0), np.float32(1.0), np.float32(0.0), np.float32(1.0), np.float32(0.0), np.float32(0.0), np.float32(0.0), np.float32(1.0), np.float32(0.0), np.float32(1.0), np.float32(1.0)]",1.0,99639.0,14
2025-08-14_08-18-36,4527,"[np.float32(1.0), np.float32(0.0), np.float32(0.0), np.float32(1.0), np.float32(1.0), np.float32(1.0), np.float32(0.0), np.float32(0.0), np.float32(0.0), np.float32(1.0), np.float32(1.0), np.float32(1.0), np.float32(1.0), np.float32(1.0), np.float32(0.0), np.float32(1.0)]",-1.0,99638.0,5
2025-08-14_08-18-36,4528,"[np.float32(0.0), np.float32(1.0), np.float32(0.0), np.float32(1.0), np.float32(0.0), np.float32(0.0), np.float32(1.0), np.float32(0.0), np.float32(1.0), np.float32(1.0), np.float32(1.0), np.float32(1.0), np.float32(0.0), np.float32(1.0), np.float32(0.0), np.float32(0.0)]",5.0,99643.0,29
2025-08-14_08-18-36,4529,"[np.float32(0.0), np.float32(0.0), np.float32(1.0), np.float32(1.0), np.float32(0.0), np.float32(1.0), np.float32(0.0), np.float32(1.0), np.float32(0.0), np.float32(1.0), np.float32(0.0), np.float32(0.0), np.float32(1.0), np.float32(1.0), np.float32(1.0), np.float32(1.0)]",1.0,99644.0,31
2025-08-14_08-18-36,4530,"[np.float32(0.0), np.float32(1.0), np.float32(0.0), np.float32(1.0), np.float32(1.0), np.float32(0.0), np.float32(0.0), np.float32(1.0), np.float32(1.0), np.float32(0.0), np.float32(0.0), np.float32(1.0), np.float32(1.0), np.float32(1.0), np.float32(1.0), np.float32(0.0)]",-1.0,99643.0,26
2025-08-14_08-18-36,4531,"[np.float32(1.0), np.float32(0.0), np.float32(0.0), np.float32(1.0), np.float32(0.0), np.float32(0.0), np.float32(0.0), np.float32(1.0), np.float32(1.0), np.float32(1.0), np.float32(0.0), np.float32(1.0), np.float32(1.0), np.float32(1.0), np.float32(0.0), np.float32(1.0)]",0.0,99643.0,22
2025-08-14_08-18-36,4532,"[np.float32(0.0), np.float32(1.0), np.float32(1.0), np.float32(0.0), np.float32(1.0), np.float32(0.0), np.float32(1.0), np.float32(0.0), np.float32(1.0), np.float32(1.0), np.float32(1.0), np.float32(0.0), np.float32(0.0), np.float32(0.0), np.float32(0.0), np.float32(0.0)]",1.0,99644.0,34
2025-08-14_08-18-36,4533,"[np.float32(1.0), np.float32(1.0), np.float32(1.0), np.float32(1.0), np.float32(1.0), np.float32(1.0), np.float32(0.0), np.float32(0.0), np.float32(1.0), np.float32(1.0), np.float32(1.0), np.float32(1.0), np.float32(0.0), np.float32(0.0), np.float32(0.0), np.float32(0.0)]",-1.0,99643.0,1
2025-08-14_08-18-36,4534,"[np.float32(1.0), np.float32(0.0), np.float32(0.0), np.float32(1.0), np.float32(0.0), np.float32(1.0), np.float32(0.0), np.float32(1.0), np.float32(1.0), np.float32(1.0), np.float32(0.0), np.float32(0.0), np.float32(1.0), np.float32(1.0), np.float32(1.0), np.float32(1.0)]",0.0,99643.0,32
2025-08-14_08-18-36,4535,"[np.float32(1.0), np.float32(1.0), np.float32(0.0), np.float32(1.0), np.float32(1.0), np.float32(1.0), np.float32(1.0), np.float32(0.0), np.float32(0.0), np.float32(1.0), np.float32(1.0), np.float32(1.0), np.float32(0.0), np.float32(0.0), np.float32(0.0), np.float32(1.0)]",-1.0,99642.0,23
2025-08-14_08-18-36,4536,"[np.float32(1.0), np.float32(1.0), np.float32(1.0), np.float32(1.0), np.float32(1.0), np.float32(1.0), np.float32(1.0), np.float32(0.0), np.float32(1.0), np.float32(1.0), np.float32(0.0), np.float32(0.0), np.float32(1.0), np.float32(0.0), np.float32(1.0), np.float32(0.0)]",-2.0,99640.0,6
2025-08-14_08-18-36,4537,"[np.float32(0.0), np.float32(1.0), np.float32(1.0), np.float32(0.0), np.float32(0.0), np.float32(1.0), np.float32(1.0), np.float32(0.0), np.float32(1.0), np.float32(1.0), np.float32(1.0), np.float32(0.0), np.float32(0.0), np.float32(1.0), np.float32(0.0), np.float32(0.0)]",-2.0,99638.0,1
2025-08-14_08-18-36,4538,"[np.float32(0.0), np.float32(0.0), np.float32(1.0), np.float32(0.0), np.float32(0.0), np.float32(0.0), np.float32(1.0), np.float32(0.0), np.float32(0.0), np.float32(0.0), np.float32(0.0), np.float32(1.0), np.float32(0.0), np.float32(1.0), np.float32(1.0), np.float32(0.0)]",-5.0,99633.0,17
2025-08-14_08-18-36,4539,"[np.float32(1.0), np.float32(0.0), np.float32(0.0), np.float32(1.0), np.float32(0.0), np.float32(1.0), np.float32(0.0), np.float32(1.0), np.float32(1.0), np.float32(1.0), np.float32(0.0), np.float32(0.0), np.float32(1.0), np.float32(1.0), np.float32(1.0), np.float32(0.0)]",-4.0,99629.0,11
2025-08-14_08-18-36,4540,"[np.float32(0.0), np.float32(0.0), np.float32(0.0), np.float32(1.0), np.float32(0.0), np.float32(0.0), np.float32(0.0), np.float32(1.0), np.float32(0.0), np.float32(0.0), np.float32(1.0), np.float32(0.0), np.float32(1.0), np.float32(0.0), np.float32(0.0), np.float32(1.0)]",0.0,99629.0,35
2025-08-14_08-18-36,4541,"[np.float32(0.0), np.float32(0.0), np.float32(0.0), np.float32(1.0), np.float32(1.0), np.float32(0.0), np.float32(1.0), np.float32(0.0), np.float32(1.0), np.float32(0.0), np.float32(1.0), np.float32(1.0), np.float32(1.0), np.float32(1.0), np.float32(1.0), np.float32(0.0)]",4.0,99633.0,3
2025-08-14_08-18-36,4542,"[np.float32(1.0), np.float32(0.0), np.float32(1.0), np.float32(1.0), np.float32(1.0), np.float32(1.0), np.float32(1.0), np.float32(1.0), np.float32(1.0), np.float32(0.0), np.float32(0.0), np.float32(1.0), np.float32(1.0), np.float32(1.0), np.float32(0.0), np.float32(1.0)]",0.0,99633.0,36
2025-08-14_08-18-36,4543,"[np.float32(1.0), np.float32(1.0), np.float32(0.0), np.float32(0.0), np.float32(0.0), np.float32(1.0), np.float32(0.0), np.float32(0.0), np.float32(0.0), np.float32(1.0), np.float32(1.0), np.float32(1.0), np.float32(1.0), np.float32(1.0), np.float32(0.0), np.float32(0.0)]",2.0,99635.0,32
2025-08-14_08-18-36,4544,"[np.float32(1.0), np.float32(1.0), np.float32(0.0), np.float32(0.0), np.float32(1.0), np.float32(1.0), np.float32(0.0), np.float32(1.0), np.float32(1.0), np.float32(0.0), np.float32(1.0), np.float32(0.0), np.float32(0.0), np.float32(1.0), np.float32(1.0), np.float32(0.0)]",1.0,99636.0,24
2025-08-14_08-18-36,4545,"[np.float32(0.0), np.float32(0.0), np.float32(0.0), np.float32(0.0), np.float32(1.0), np.float32(0.0), np.float32(1.0), np.float32(1.0), np.float32(0.0), np.float32(0.0), np.float32(1.0), np.float32(1.0), np.float32(0.0), np.float32(1.0), np.float32(1.0), np.float32(1.0)]",0.0,99636.0,10
2025-08-14_08-18-36,4546,"[np.float32(0.0), np.float32(0.0), np.float32(0.0), np.float32(0.0), np.float32(1.0), np.float32(1.0), np.float32(1.0), np.float32(1.0), np.float32(1.0), np.float32(0.0), np.float32(1.0), np.float32(1.0), np.float32(0.0), np.float32(0.0), np.float32(0.0), np.float32(0.0)]",1.0,99637.0,6
2025-08-14_08-18-36,4547,"[np.float32(0.0), np.float32(0.0), np.float32(1.0), np.float32(0.0), np.float32(1.0), np.float32(1.0), np.float32(1.0), np.float32(1.0), np.float32(0.0), np.float32(0.0), np.float32(0.0), np.float32(1.0), np.float32(1.0), np.float32(1.0), np.float32(0.0), np.float32(0.0)]",2.0,99639.0,6
2025-08-14_08-18-36,4548,"[np.float32(1.0), np.float32(0.0), np.float32(0.0), np.float32(1.0), np.float32(0.0), np.float32(1.0), np.float32(1.0), np.float32(1.0), np.float32(1.0), np.float32(1.0), np.float32(0.0), np.float32(1.0), np.float32(0.0), np.float32(1.0), np.float32(0.0), np.float32(0.0)]",-3.0,99636.0,2
2025-08-14_08-18-36,4549,"[np.float32(1.0), np.float32(0.0), np.float32(1.0), np.float32(1.0), np.float32(0.0), np.float32(0.0), np.float32(0.0), np.float32(1.0), np.float32(1.0), np.float32(0.0), np.float32(0.0), np.float32(0.0), np.float32(1.0), np.float32(1.0), np.float32(0.0), np.float32(0.0)]",-2.0,99634.0,31
2025-08-14_08-18-36,4550,"[np.float32(0.0), np.float32(1.0), np.float32(0.0), np.float32(1.0), np.float32(1.0), np.float32(1.0), np.float32(0.0), np.float32(1.0), np.float32(1.0), np.float32(0.0), np.float32(1.0), np.float32(0.0), np.float32(0.0), np.float32(1.0), np.float32(1.0), np.float32(0.0)]",-5.0,99629.0,9
2025-08-14_08-18-36,4551,"[np.float32(1.0), np.float32(0.0), np.float32(1.0), np.float32(0.0), np.float32(0.0), np.float32(1.0), np.float32(0.0), np.float32(0.0), np.float32(0.0), np.float32(1.0), np.float32(0.0), np.float32(0.0), np.float32(1.0), np.float32(1.0), np.float32(1.0), np.float32(1.0)]",4.0,99633.0,34
2025-08-14_08-18-36,4552,"[np.float32(0.0), np.float32(0.0), np.float32(1.0), np.float32(0.0), np.float32(0.0), np.float32(1.0), np.float32(0.0), np.float32(1.0), np.float32(1.0), np.float32(1.0), np.float32(1.0), np.float32(1.0), np.float32(1.0), np.float32(0.0), np.float32(0.0), np.float32(1.0)]",1.0,99634.0,26
2025-08-14_08-18-36,4553,"[np.float32(0.0), np.float32(0.0), np.float32(1.0), np.float32(0.0), np.float32(1.0), np.float32(1.0), np.float32(0.0), np.float32(0.0), np.float32(0.0), np.float32(1.0), np.float32(0.0), np.float32(1.0), np.float32(1.0), np.float32(1.0), np.float32(1.0), np.float32(0.0)]",0.0,99634.0,13
2025-08-14_08-18-36,4554,"[np.float32(0.0), np.float32(0.0), np.float32(1.0), np.float32(1.0), np.float32(0.0), np.float32(1.0), np.float32(0.0), np.float32(1.0), np.float32(0.0), np.float32(1.0), np.float32(1.0), np.float32(0.0), np.float32(1.0), np.float32(0.0), np.float32(1.0), np.float32(1.0)]",-2.0,99632.0,21
2025-08-14_08-18-36,4555,"[np.float32(1.0), np.float32(0.0), np.float32(0.0), np.float32(0.0), np.float32(1.0), np.float32(1.0), np.float32(0.0), np.float32(0.0), np.float32(1.0), np.float32(0.0), np.float32(0.0), np.float32(1.0), np.float32(0.0), np.float32(0.0), np.float32(0.0), np.float32(1.0)]",2.0,99634.0,6
2025-08-14_08-18-36,4556,"[np.float32(1.0), np.float32(0.0), np.float32(0.0), np.float32(0.0), np.float32(0.0), np.float32(1.0), np.float32(0.0), np.float32(0.0), np.float32(1.0), np.float32(0.0), np.float32(0.0), np.float32(0.0), np.float32(1.0), np.float32(1.0), np.float32(0.0), np.float32(0.0)]",-2.0,99632.0,4
2025-08-14_08-18-36,4557,"[np.float32(0.0), np.float32(0.0), np.float32(0.0), np.float32(1.0), np.float32(1.0), np.float32(0.0), np.float32(1.0), np.float32(0.0), np.float32(0.0), np.float32(0.0), np.float32(0.0), np.float32(0.0), np.float32(1.0), np.float32(1.0), np.float32(1.0), np.float32(0.0)]",-1.0,99631.0,33
2025-08-14_08-18-36,4558,"[np.float32(0.0), np.float32(1.0), np.float32(1.0), np.float32(1.0), np.float32(1.0), np.float32(0.0), np.float32(1.0), np.float32(1.0), np.float32(0.0), np.float32(0.0), np.float32(0.0), np.float32(1.0), np.float32(0.0), np.float32(1.0), np.float32(0.0), np.float32(0.0)]",-3.0,99628.0,23
2025-08-14_08-18-36,4559,"[np.float32(0.0), np.float32(0.0), np.float32(1.0), np.float32(1.0), np.float32(1.0), np.float32(0.0), np.float32(1.0), np.float32(0.0), np.float32(0.0), np.float32(0.0), np.float32(1.0), np.float32(1.0), np.float32(1.0), np.float32(0.0), np.float32(1.0), np.float32(0.0)]",35.0,99663.0,7
2025-08-14_08-18-36,4560,"[np.float32(0.0), np.float32(0.0), np.float32(1.0), np.float32(1.0), np.float32(0.0), np.float32(1.0), np.float32(1.0), np.float32(1.0), np.float32(0.0), np.float32(0.0), np.float32(0.0), np.float32(0.0), np.float32(1.0), np.float32(1.0), np.float32(0.0), np.float32(1.0)]",-1.0,99662.0,23
2025-08-14_08-18-36,4561,"[np.float32(0.0), np.float32(0.0), np.float32(1.0), np.float32(0.0), np.float32(0.0), np.float32(1.0), np.float32(1.0), np.float32(1.0), np.float32(1.0), np.float32(1.0), np.float32(0.0), np.float32(1.0), np.float32(1.0), np.float32(0.0), np.float32(1.0), np.float32(0.0)]",0.0,99662.0,13
2025-08-14_08-18-36,4562,"[np.float32(1.0), np.float32(0.0), np.float32(0.0), np.float32(0.0), np.float32(1.0), np.float32(1.0), np.float32(1.0), np.float32(1.0), np.float32(1.0), np.float32(1.0), np.float32(0.0), np.float32(0.0), np.float32(0.0), np.float32(0.0), np.float32(0.0), np.float32(1.0)]",5.0,99667.0,34
2025-08-14_08-18-36,4563,"[np.float32(0.0), np.float32(0.0), np.float32(1.0), np.float32(1.0), np.float32(0.0), np.float32(0.0), np.float32(1.0), np.float32(0.0), np.float32(0.0), np.float32(1.0), np.float32(0.0), np.float32(0.0), np.float32(1.0), np.float32(1.0), np.float32(0.0), np.float32(0.0)]",2.0,99669.0,12
2025-08-14_08-18-36,4564,"[np.float32(0.0), np.float32(1.0), np.float32(0.0), np.float32(1.0), np.float32(1.0), np.float32(0.0), np.float32(1.0), np.float32(1.0), np.float32(1.0), np.float32(0.0), np.float32(0.0), np.float32(1.0), np.float32(1.0), np.float32(1.0), np.float32(1.0), np.float32(0.0)]",0.0,99669.0,4
2025-08-14_08-18-36,4565,"[np.float32(0.0), np.float32(0.0), np.float32(1.0), np.float32(1.0), np.float32(0.0), np.float32(1.0), np.float32(0.0), np.float32(1.0), np.float32(1.0), np.float32(1.0), np.float32(1.0), np.float32(0.0), np.float32(0.0), np.float32(1.0), np.float32(0.0), np.float32(0.0)]",-1.0,99668.0,30
2025-08-14_08-18-36,4566,"[np.float32(0.0), np.float32(0.0), np.float32(1.0), np.float32(1.0), np.float32(0.0), np.float32(0.0), np.float32(1.0), np.float32(1.0), np.float32(1.0), np.float32(0.0), np.float32(0.0), np.float32(0.0), np.float32(1.0), np.float32(1.0), np.float32(1.0), np.float32(1.0)]",-1.0,99667.0,24
2025-08-14_08-18-36,4567,"[np.float32(0.0), np.float32(1.0), np.float32(0.0), np.float32(0.0), np.float32(0.0), np.float32(1.0), np.float32(1.0), np.float32(1.0), np.float32(0.0), np.float32(0.0), np.float32(1.0), np.float32(1.0), np.float32(0.0), np.float32(0.0), np.float32(0.0), np.float32(0.0)]",0.0,99667.0,14
2025-08-14_08-18-36,4568,"[np.float32(0.0), np.float32(1.0), np.float32(1.0), np.float32(0.0), np.float32(1.0), np.float32(1.0), np.float32(0.0), np.float32(1.0), np.float32(1.0), np.float32(0.0), np.float32(1.0), np.float32(0.0), np.float32(1.0), np.float32(0.0), np.float32(0.0), np.float32(1.0)]",-4.0,99663.0,5
2025-08-14_08-18-36,4569,"[np.float32(0.0), np.float32(0.0), np.float32(0.0), np.float32(0.0), np.float32(0.0), np.float32(1.0), np.float32(1.0), np.float32(0.0), np.float32(1.0), np.float32(1.0), np.float32(0.0), np.float32(0.0), np.float32(0.0), np.float32(0.0), np.float32(0.0), np.float32(1.0)]",3.0,99666.0,25
2025-08-14_08-18-36,4570,"[np.float32(0.0), np.float32(1.0), np.float32(1.0), np.float32(0.0), np.float32(0.0), np.float32(1.0), np.float32(0.0), np.float32(0.0), np.float32(0.0), np.float32(0.0), np.float32(0.0), np.float32(0.0), np.float32(1.0), np.float32(0.0), np.float32(0.0), np.float32(1.0)]",-3.0,99663.0,27
2025-08-14_08-18-36,4571,"[np.float32(0.0), np.float32(1.0), np.float32(0.0), np.float32(0.0), np.float32(1.0), np.float32(1.0), np.float32(0.0), np.float32(1.0), np.float32(1.0), np.float32(1.0), np.float32(0.0), np.float32(0.0), np.float32(0.0), np.float32(0.0), np.float32(0.0), np.float32(0.0)]",-1.0,99662.0,36
2025-08-14_08-18-36,4572,"[np.float32(1.0), np.float32(1.0), np.float32(0.0), np.float32(0.0), np.float32(0.0), np.float32(1.0), np.float32(1.0), np.float32(0.0), np.float32(0.0), np.float32(0.0), np.float32(1.0), np.float32(1.0), np.float32(1.0), np.float32(0.0), np.float32(0.0), np.float32(0.0)]",1.0,99663.0,6
2025-08-14_08-18-36,4573,"[np.float32(0.0), np.float32(0.0), np.float32(0.0), np.float32(0.0), np.float32(1.0), np.float32(0.0), np.float32(0.0), np.float32(0.0), np.float32(1.0), np.float32(0.0), np.float32(0.0), np.float32(1.0), np.float32(0.0), np.float32(1.0), np.float32(0.0), np.float32(0.0)]",2.0,99665.0,27
2025-08-14_08-18-36,4574,"[np.float32(0.0), np.float32(0.0), np.float32(0.0), np.float32(0.0), np.float32(0.0), np.float32(0.0), np.float32(1.0), np.float32(0.0), np.float32(1.0), np.float32(1.0), np.float32(1.0), np.float32(1.0), np.float32(0.0), np.float32(1.0), np.float32(1.0), np.float32(0.0)]",2.0,99667.0,28
2025-08-14_08-18-36,4575,"[np.float32(1.0), np.float32(1.0), np.float32(0.0), np.float32(0.0), np.float32(1.0), np.float32(1.0), np.float32(1.0), np.float32(1.0), np.float32(1.0), np.float32(0.0), np.float32(1.0), np.float32(0.0), np.float32(0.0), np.float32(0.0), np.float32(0.0), np.float32(0.0)]",2.0,99669.0,32
2025-08-14_08-18-36,4576,"[np.float32(0.0), np.float32(0.0), np.float32(0.0), np.float32(1.0), np.float32(1.0), np.float32(1.0), np.float32(0.0), np.float32(0.0), np.float32(0.0), np.float32(1.0), np.float32(1.0), np.float32(0.0), np.float32(1.0), np.float32(1.0), np.float32(0.0), np.float32(0.0)]",3.0,99672.0,35
2025-08-14_08-18-36,4577,"[np.float32(0.0), np.float32(0.0), np.float32(0.0), np.float32(1.0), np.float32(0.0), np.float32(1.0), np.float32(1.0), np.float32(1.0), np.float32(0.0), np.float32(0.0), np.float32(0.0), np.float32(0.0), np.float32(0.0), np.float32(1.0), np.float32(0.0), np.float32(0.0)]",1.0,99673.0,4
2025-08-14_08-18-36,4578,"[np.float32(0.0), np.float32(1.0), np.float32(0.0), np.float32(0.0), np.float32(0.0), np.float32(0.0), np.float32(1.0), np.float32(1.0), np.float32(0.0), np.float32(0.0), np.float32(1.0), np.float32(0.0), np.float32(0.0), np.float32(1.0), np.float32(0.0), np.float32(0.0)]",-2.0,99671.0,16
2025-08-14_08-18-36,4579,"[np.float32(1.0), np.float32(1.0), np.float32(1.0), np.float32(0.0), np.float32(0.0), np.float32(1.0), np.float32(1.0), np.float32(0.0), np.float32(1.0), np.float32(0.0), np.float32(0.0), np.float32(0.0), np.float32(1.0), np.float32(0.0), np.float32(1.0), np.float32(1.0)]",1.0,99672.0,33
2025-08-14_08-18-36,4580,"[np.float32(0.0), np.float32(0.0), np.float32(1.0), np.float32(0.0), np.float32(0.0), np.float32(0.0), np.float32(0.0), np.float32(0.0), np.float32(1.0), np.float32(1.0), np.float32(1.0), np.float32(1.0), np.float32(1.0), np.float32(1.0), np.float32(1.0), np.float32(0.0)]",-3.0,99669.0,6
2025-08-14_08-18-36,4581,"[np.float32(1.0), np.float32(0.0), np.float32(1.0), np.float32(0.0), np.float32(0.0), np.float32(0.0), np.float32(0.0), np.float32(1.0), np.float32(0.0), np.float32(1.0), np.float32(1.0), np.float32(1.0), np.float32(0.0), np.float32(1.0), np.float32(0.0), np.float32(0.0)]",-4.0,99665.0,31
2025-08-14_08-18-36,4582,"[np.float32(1.0), np.float32(1.0), np.float32(0.0), np.float32(0.0), np.float32(0.0), np.float32(1.0), np.float32(0.0), np.float32(1.0), np.float32(0.0), np.float32(0.0), np.float32(1.0), np.float32(0.0), np.float32(0.0), np.float32(1.0), np.float32(0.0), np.float32(0.0)]",4.0,99669.0,19
2025-08-14_08-18-36,4583,"[np.float32(1.0), np.float32(1.0), np.float32(1.0), np.float32(1.0), np.float32(0.0), np.float32(1.0), np.float32(1.0), np.float32(1.0), np.float32(1.0), np.float32(1.0), np.float32(0.0), np.float32(1.0), np.float32(0.0), np.float32(0.0), np.float32(0.0), np.float32(1.0)]",1.0,99670.0,21
2025-08-14_08-18-36,4584,"[np.float32(0.0), np.float32(1.0), np.float32(0.0), np.float32(0.0), np.float32(0.0), np.float32(1.0), np.float32(1.0), np.float32(1.0), np.float32(0.0), np.float32(1.0), np.float32(1.0), np.float32(1.0), np.float32(1.0), np.float32(1.0), np.float32(0.0), np.float32(1.0)]",1.0,99671.0,17
2025-08-14_08-18-36,4585,"[np.float32(1.0), np.float32(1.0), np.float32(1.0), np.float32(0.0), np.float32(1.0), np.float32(1.0), np.float32(0.0), np.float32(1.0), np.float32(0.0), np.float32(0.0), np.float32(1.0), np.float32(0.0), np.float32(1.0), np.float32(0.0), np.float32(0.0), np.float32(1.0)]",6.0,99677.0,14
2025-08-14_08-18-36,4586,"[np.float32(1.0), np.float32(0.0), np.float32(1.0), np.float32(0.0), np.float32(0.0), np.float32(0.0), np.float32(0.0), np.float32(1.0), np.float32(0.0), np.float32(1.0), np.float32(1.0), np.float32(1.0), np.float32(1.0), np.float32(0.0), np.float32(0.0), np.float32(0.0)]",3.0,99680.0,18
2025-08-14_08-18-36,4587,"[np.float32(1.0), np.float32(1.0), np.float32(0.0), np.float32(1.0), np.float32(0.0), np.float32(1.0), np.float32(0.0), np.float32(1.0), np.float32(1.0), np.float32(1.0), np.float32(0.0), np.float32(0.0), np.float32(0.0), np.float32(0.0), np.float32(1.0), np.float32(1.0)]",-2.0,99678.0,26
2025-08-14_08-18-36,4588,"[np.float32(1.0), np.float32(0.0), np.float32(1.0), np.float32(1.0), np.float32(0.0), np.float32(1.0), np.float32(1.0), np.float32(0.0), np.float32(0.0), np.float32(1.0), np.float32(1.0), np.float32(1.0), np.float32(0.0), np.float32(1.0), np.float32(1.0), np.float32(1.0)]",0.0,99678.0,6
2025-08-14_08-18-36,4589,"[np.float32(1.0), np.float32(0.0), np.float32(1.0), np.float32(1.0), np.float32(0.0), np.float32(1.0), np.float32(0.0), np.float32(1.0), np.float32(1.0), np.float32(0.0), np.float32(1.0), np.float32(0.0), np.float32(0.0), np.float32(0.0), np.float32(0.0), np.float32(1.0)]",-3.0,99675.0,6
2025-08-14_08-18-36,4590,"[np.float32(0.0), np.float32(0.0), np.float32(1.0), np.float32(1.0), np.float32(0.0), np.float32(0.0), np.float32(1.0), np.float32(0.0), np.float32(1.0), np.float32(1.0), np.float32(0.0), np.float32(0.0), np.float32(0.0), np.float32(0.0), np.float32(0.0), np.float32(0.0)]",-3.0,99672.0,21
2025-08-14_08-18-36,4591,"[np.float32(1.0), np.float32(0.0), np.float32(0.0), np.float32(0.0), np.float32(0.0), np.float32(1.0), np.float32(1.0), np.float32(1.0), np.float32(0.0), np.float32(0.0), np.float32(0.0), np.float32(0.0), np.float32(0.0), np.float32(1.0), np.float32(0.0), np.float32(1.0)]",-1.0,99671.0,29
2025-08-14_08-18-36,4592,"[np.float32(0.0), np.float32(0.0), np.float32(1.0), np.float32(0.0), np.float32(0.0), np.float32(1.0), np.float32(1.0), np.float32(0.0), np.float32(0.0), np.float32(1.0), np.float32(0.0), np.float32(1.0), np.float32(1.0), np.float32(1.0), np.float32(0.0), np.float32(1.0)]",0.0,99671.0,25
2025-08-14_08-18-36,4593,"[np.float32(0.0), np.float32(1.0), np.float32(1.0), np.float32(0.0), np.float32(0.0), np.float32(1.0), np.float32(1.0), np.float32(0.0), np.float32(0.0), np.float32(1.0), np.float32(0.0), np.float32(1.0), np.float32(1.0), np.float32(0.0), np.float32(0.0), np.float32(0.0)]",-2.0,99669.0,15
2025-08-14_08-18-36,4594,"[np.float32(0.0), np.float32(1.0), np.float32(0.0), np.float32(0.0), np.float32(1.0), np.float32(0.0), np.float32(1.0), np.float32(1.0), np.float32(1.0), np.float32(0.0), np.float32(0.0), np.float32(0.0), np.float32(0.0), np.float32(0.0), np.float32(0.0), np.float32(1.0)]",0.0,99669.0,34
2025-08-14_08-18-36,4595,"[np.float32(1.0), np.float32(0.0), np.float32(0.0), np.float32(0.0), np.float32(1.0), np.float32(0.0), np.float32(1.0), np.float32(1.0), np.float32(1.0), np.float32(0.0), np.float32(1.0), np.float32(0.0), np.float32(1.0), np.float32(1.0), np.float32(0.0), np.float32(0.0)]",-5.0,99664.0,0
2025-08-14_08-18-36,4596,"[np.float32(0.0), np.float32(1.0), np.float32(1.0), np.float32(0.0), np.float32(0.0), np.float32(0.0), np.float32(0.0), np.float32(1.0), np.float32(0.0), np.float32(0.0), np.float32(1.0), np.float32(0.0), np.float32(1.0), np.float32(0.0), np.float32(1.0), np.float32(0.0)]",-3.0,99661.0,19
2025-08-14_08-18-36,4597,"[np.float32(1.0), np.float32(0.0), np.float32(0.0), np.float32(1.0), np.float32(0.0), np.float32(0.0), np.float32(0.0), np.float32(1.0), np.float32(1.0), np.float32(1.0), np.float32(0.0), np.float32(1.0), np.float32(0.0), np.float32(0.0), np.float32(1.0), np.float32(0.0)]",1.0,99662.0,31
2025-08-14_08-18-36,4598,"[np.float32(0.0), np.float32(1.0), np.float32(1.0), np.float32(0.0), np.float32(0.0), np.float32(1.0), np.float32(0.0), np.float32(1.0), np.float32(1.0), np.float32(1.0), np.float32(0.0), np.float32(1.0), np.float32(1.0), np.float32(1.0), np.float32(1.0), np.float32(1.0)]",1.0,99663.0,20
2025-08-14_08-18-36,4599,"[np.float32(1.0), np.float32(0.0), np.float32(0.0), np.float32(0.0), np.float32(0.0), np.float32(0.0), np.float32(1.0), np.float32(0.0), np.float32(0.0), np.float32(0.0), np.float32(0.0), np.float32(1.0), np.float32(0.0), np.float32(0.0), np.float32(0.0), np.float32(0.0)]",3.0,99666.0,6
2025-08-14_08-18-36,4600,"[np.float32(1.0), np.float32(1.0), np.float32(0.0), np.float32(1.0), np.float32(1.0), np.float32(1.0), np.float32(1.0), np.float32(0.0), np.float32(1.0), np.float32(0.0), np.float32(1.0), np.float32(0.0), np.float32(1.0), np.float32(0.0), np.float32(0.0), np.float32(0.0)]",3.0,99669.0,11
2025-08-14_08-18-36,4601,"[np.float32(1.0), np.float32(1.0), np.float32(0.0), np.float32(0.0), np.float32(0.0), np.float32(1.0), np.float32(0.0), np.float32(1.0), np.float32(0.0), np.float32(0.0), np.float32(0.0), np.float32(1.0), np.float32(1.0), np.float32(0.0), np.float32(0.0), np.float32(1.0)]",-5.0,99664.0,2
2025-08-14_08-18-36,4602,"[np.float32(1.0), np.float32(0.0), np.float32(0.0), np.float32(0.0), np.float32(0.0), np.float32(1.0), np.float32(1.0), np.float32(0.0), np.float32(1.0), np.float32(1.0), np.float32(1.0), np.float32(0.0), np.float32(0.0), np.float32(1.0), np.float32(0.0), np.float32(1.0)]",-2.0,99662.0,8
2025-08-14_08-18-36,4603,"[np.float32(0.0), np.float32(0.0), np.float32(0.0), np.float32(1.0), np.float32(0.0), np.float32(0.0), np.float32(0.0), np.float32(0.0), np.float32(1.0), np.float32(1.0), np.float32(1.0), np.float32(1.0), np.float32(1.0), np.float32(0.0), np.float32(0.0), np.float32(1.0)]",1.0,99663.0,33
2025-08-14_08-18-36,4604,"[np.float32(0.0), np.float32(0.0), np.float32(0.0), np.float32(0.0), np.float32(1.0), np.float32(1.0), np.float32(0.0), np.float32(0.0), np.float32(1.0), np.float32(0.0), np.float32(0.0), np.float32(0.0), np.float32(1.0), np.float32(0.0), np.float32(1.0), np.float32(0.0)]",33.0,99696.0,7
2025-08-14_08-18-36,4605,"[np.float32(1.0), np.float32(0.0), np.float32(1.0), np.float32(1.0), np.float32(0.0), np.float32(1.0), np.float32(0.0), np.float32(1.0), np.float32(1.0), np.float32(1.0), np.float32(1.0), np.float32(0.0), np.float32(0.0), np.float32(1.0), np.float32(0.0), np.float32(0.0)]",-2.0,99694.0,0
2025-08-14_08-18-36,4606,"[np.float32(0.0), np.float32(1.0), np.float32(1.0), np.float32(1.0), np.float32(0.0), np.float32(1.0), np.float32(1.0), np.float32(1.0), np.float32(0.0), np.float32(0.0), np.float32(0.0), np.float32(1.0), np.float32(1.0), np.float32(0.0), np.float32(1.0), np.float32(0.0)]",-5.0,99689.0,32
2025-08-14_08-18-36,4607,"[np.float32(1.0), np.float32(0.0), np.float32(1.0), np.float32(1.0), np.float32(1.0), np.float32(1.0), np.float32(1.0), np.float32(1.0), np.float32(0.0), np.float32(0.0), np.float32(1.0), np.float32(1.0), np.float32(1.0), np.float32(1.0), np.float32(0.0), np.float32(0.0)]",-5.0,99684.0,34
2025-08-14_08-18-36,4608,"[np.float32(1.0), np.float32(0.0), np.float32(1.0), np.float32(1.0), np.float32(0.0), np.float32(0.0), np.float32(1.0), np.float32(1.0), np.float32(1.0), np.float32(1.0), np.float32(0.0), np.float32(0.0), np.float32(1.0), np.float32(1.0), np.float32(0.0), np.float32(0.0)]",-4.0,99680.0,24
2025-08-14_08-18-36,4609,"[np.float32(0.0), np.float32(0.0), np.float32(0.0), np.float32(1.0), np.float32(0.0), np.float32(0.0), np.float32(1.0), np.float32(1.0), np.float32(0.0), np.float32(0.0), np.float32(0.0), np.float32(0.0), np.float32(0.0), np.float32(0.0), np.float32(0.0), np.float32(1.0)]",1.0,99681.0,7
2025-08-14_08-18-36,4610,"[np.float32(0.0), np.float32(0.0), np.float32(1.0), np.float32(0.0), np.float32(0.0), np.float32(0.0), np.float32(1.0), np.float32(1.0), np.float32(0.0), np.float32(0.0), np.float32(1.0), np.float32(1.0), np.float32(1.0), np.float32(1.0), np.float32(1.0), np.float32(0.0)]",-8.0,99673.0,31
2025-08-14_08-18-36,4611,"[np.float32(1.0), np.float32(0.0), np.float32(1.0), np.float32(1.0), np.float32(1.0), np.float32(1.0), np.float32(0.0), np.float32(0.0), np.float32(1.0), np.float32(0.0), np.float32(1.0), np.float32(0.0), np.float32(0.0), np.float32(0.0), np.float32(0.0), np.float32(1.0)]",1.0,99674.0,25
2025-08-14_08-18-36,4612,"[np.float32(0.0), np.float32(0.0), np.float32(0.0), np.float32(1.0), np.float32(0.0), np.float32(1.0), np.float32(1.0), np.float32(1.0), np.float32(0.0), np.float32(0.0), np.float32(0.0), np.float32(0.0), np.float32(0.0), np.float32(0.0), np.float32(0.0), np.float32(0.0)]",0.0,99674.0,31
2025-08-14_08-18-36,4613,"[np.float32(1.0), np.float32(1.0), np.float32(1.0), np.float32(1.0), np.float32(0.0), np.float32(0.0), np.float32(1.0), np.float32(1.0), np.float32(1.0), np.float32(0.0), np.float32(1.0), np.float32(0.0), np.float32(0.0), np.float32(1.0), np.float32(1.0), np.float32(0.0)]",-3.0,99671.0,31
2025-08-14_08-18-36,4614,"[np.float32(1.0), np.float32(0.0), np.float32(1.0), np.float32(0.0), np.float32(1.0), np.float32(1.0), np.float32(0.0), np.float32(1.0), np.float32(0.0), np.float32(0.0), np.float32(1.0), np.float32(0.0), np.float32(1.0), np.float32(0.0), np.float32(0.0), np.float32(1.0)]",-1.0,99670.0,9
2025-08-14_08-18-36,4615,"[np.float32(1.0), np.float32(1.0), np.float32(0.0), np.float32(0.0), np.float32(0.0), np.float32(1.0), np.float32(1.0), np.float32(1.0), np.float32(1.0), np.float32(0.0), np.float32(0.0), np.float32(0.0), np.float32(1.0), np.float32(1.0), np.float32(0.0), np.float32(0.0)]",-3.0,99667.0,6
2025-08-14_08-18-36,4616,"[np.float32(0.0), np.float32(0.0), np.float32(1.0), np.float32(1.0), np.float32(1.0), np.float32(1.0), np.float32(1.0), np.float32(1.0), np.float32(0.0), np.float32(0.0), np.float32(1.0), np.float32(1.0), np.float32(1.0), np.float32(0.0), np.float32(1.0), np.float32(0.0)]",3.0,99670.0,8
2025-08-14_08-18-36,4617,"[np.float32(1.0), np.float32(1.0), np.float32(0.0), np.float32(1.0), np.float32(1.0), np.float32(0.0), np.float32(1.0), np.float32(0.0), np.float32(0.0), np.float32(0.0), np.float32(0.0), np.float32(0.0), np.float32(1.0), np.float32(1.0), np.float32(1.0), np.float32(0.0)]",-3.0,99667.0,28
2025-08-14_08-18-36,4618,"[np.float32(0.0), np.float32(1.0), np.float32(1.0), np.float32(1.0), np.float32(1.0), np.float32(0.0), np.float32(0.0), np.float32(1.0), np.float32(1.0), np.float32(1.0), np.float32(1.0), np.float32(1.0), np.float32(1.0), np.float32(1.0), np.float32(0.0), np.float32(1.0)]",1.0,99668.0,14
2025-08-14_08-18-36,4619,"[np.float32(0.0), np.float32(0.0), np.float32(1.0), np.float32(1.0), np.float32(0.0), np.float32(1.0), np.float32(0.0), np.float32(0.0), np.float32(0.0), np.float32(0.0), np.float32(0.0), np.float32(0.0), np.float32(0.0), np.float32(0.0), np.float32(0.0), np.float32(1.0)]",-2.0,99666.0,11
2025-08-14_08-18-36,4620,"[np.float32(1.0), np.float32(1.0), np.float32(1.0), np.float32(1.0), np.float32(0.0), np.float32(1.0), np.float32(0.0), np.float32(0.0), np.float32(0.0), np.float32(1.0), np.float32(0.0), np.float32(0.0), np.float32(0.0), np.float32(0.0), np.float32(0.0), np.float32(1.0)]",0.0,99666.0,9
2025-08-14_08-18-36,4621,"[np.float32(1.0), np.float32(0.0), np.float32(0.0), np.float32(0.0), np.float32(1.0), np.float32(0.0), np.float32(0.0), np.float32(1.0), np.float32(1.0), np.float32(0.0), np.float32(0.0), np.float32(1.0), np.float32(1.0), np.float32(1.0), np.float32(0.0), np.float32(0.0)]",1.0,99667.0,32
2025-08-14_08-18-36,4622,"[np.float32(0.0), np.float32(0.0), np.float32(1.0), np.float32(0.0), np.float32(1.0), np.float32(0.0), np.float32(1.0), np.float32(1.0), np.float32(0.0), np.float32(0.0), np.float32(0.0), np.float32(0.0), np.float32(0.0), np.float32(1.0), np.float32(0.0), np.float32(0.0)]",2.0,99669.0,8
2025-08-14_08-18-36,4623,"[np.float32(0.0), np.float32(1.0), np.float32(1.0), np.float32(1.0), np.float32(0.0), np.float32(0.0), np.float32(0.0), np.float32(1.0), np.float32(1.0), np.float32(0.0), np.float32(0.0), np.float32(0.0), np.float32(0.0), np.float32(0.0), np.float32(0.0), np.float32(0.0)]",-1.0,99668.0,2
2025-08-14_08-18-36,4624,"[np.float32(0.0), np.float32(1.0), np.float32(1.0), np.float32(0.0), np.float32(0.0), np.float32(1.0), np.float32(0.0), np.float32(0.0), np.float32(1.0), np.float32(1.0), np.float32(0.0), np.float32(0.0), np.float32(0.0), np.float32(0.0), np.float32(1.0), np.float32(1.0)]",1.0,99669.0,25
2025-08-14_08-18-36,4625,"[np.float32(0.0), np.float32(0.0), np.float32(1.0), np.float32(0.0), np.float32(0.0), np.float32(0.0), np.float32(1.0), np.float32(1.0), np.float32(0.0), np.float32(0.0), np.float32(1.0), np.float32(1.0), np.float32(1.0), np.float32(0.0), np.float32(0.0), np.float32(1.0)]",-1.0,99668.0,23
2025-08-14_08-18-36,4626,"[np.float32(1.0), np.float32(1.0), np.float32(1.0), np.float32(0.0), np.float32(1.0), np.float32(0.0), np.float32(0.0), np.float32(1.0), np.float32(1.0), np.float32(0.0), np.float32(1.0), np.float32(1.0), np.float32(0.0), np.float32(1.0), np.float32(0.0), np.float32(1.0)]",-3.0,99665.0,5
2025-08-14_08-18-36,4627,"[np.float32(1.0), np.float32(1.0), np.float32(0.0), np.float32(0.0), np.float32(1.0), np.float32(0.0), np.float32(0.0), np.float32(0.0), np.float32(1.0), np.float32(0.0), np.float32(1.0), np.float32(0.0), np.float32(0.0), np.float32(1.0), np.float32(0.0), np.float32(1.0)]",0.0,99665.0,15
2025-08-14_08-18-36,4628,"[np.float32(0.0), np.float32(0.0), np.float32(0.0), np.float32(0.0), np.float32(0.0), np.float32(0.0), np.float32(1.0), np.float32(1.0), np.float32(1.0), np.float32(0.0), np.float32(0.0), np.float32(1.0), np.float32(1.0), np.float32(0.0), np.float32(1.0), np.float32(0.0)]",0.0,99665.0,15
2025-08-14_08-18-36,4629,"[np.float32(0.0), np.float32(1.0), np.float32(0.0), np.float32(1.0), np.float32(0.0), np.float32(0.0), np.float32(1.0), np.float32(1.0), np.float32(0.0), np.float32(1.0), np.float32(1.0), np.float32(0.0), np.float32(1.0), np.float32(1.0), np.float32(1.0), np.float32(0.0)]",-6.0,99659.0,36
2025-08-14_08-18-36,4630,"[np.float32(0.0), np.float32(0.0), np.float32(1.0), np.float32(1.0), np.float32(0.0), np.float32(1.0), np.float32(1.0), np.float32(1.0), np.float32(0.0), np.float32(0.0), np.float32(0.0), np.float32(1.0), np.float32(1.0), np.float32(0.0), np.float32(1.0), np.float32(0.0)]",-3.0,99656.0,2
2025-08-14_08-18-36,4631,"[np.float32(1.0), np.float32(0.0), np.float32(1.0), np.float32(1.0), np.float32(0.0), np.float32(0.0), np.float32(0.0), np.float32(1.0), np.float32(1.0), np.float32(0.0), np.float32(1.0), np.float32(0.0), np.float32(1.0), np.float32(1.0), np.float32(0.0), np.float32(1.0)]",-4.0,99652.0,24
2025-08-14_08-18-36,4632,"[np.float32(0.0), np.float32(0.0), np.float32(1.0), np.float32(1.0), np.float32(1.0), np.float32(1.0), np.float32(0.0), np.float32(0.0), np.float32(0.0), np.float32(1.0), np.float32(1.0), np.float32(1.0), np.float32(1.0), np.float32(0.0), np.float32(0.0), np.float32(0.0)]",-1.0,99651.0,30
2025-08-14_08-18-36,4633,"[np.float32(1.0), np.float32(0.0), np.float32(0.0), np.float32(0.0), np.float32(1.0), np.float32(1.0), np.float32(0.0), np.float32(1.0), np.float32(1.0), np.float32(0.0), np.float32(0.0), np.float32(1.0), np.float32(0.0), np.float32(0.0), np.float32(0.0), np.float32(0.0)]",4.0,99655.0,18
2025-08-14_08-18-36,4634,"[np.float32(0.0), np.float32(0.0), np.float32(0.0), np.float32(1.0), np.float32(0.0), np.float32(1.0), np.float32(0.0), np.float32(0.0), np.float32(1.0), np.float32(0.0), np.float32(1.0), np.float32(0.0), np.float32(0.0), np.float32(1.0), np.float32(0.0), np.float32(1.0)]",-4.0,99651.0,24
2025-08-14_08-18-36,4635,"[np.float32(0.0), np.float32(0.0), np.float32(1.0), np.float32(1.0), np.float32(1.0), np.float32(1.0), np.float32(0.0), np.float32(0.0), np.float32(0.0), np.float32(0.0), np.float32(0.0), np.float32(1.0), np.float32(1.0), np.float32(0.0), np.float32(0.0), np.float32(0.0)]",-2.0,99649.0,22
2025-08-14_08-18-36,4636,"[np.float32(0.0), np.float32(1.0), np.float32(0.0), np.float32(1.0), np.float32(0.0), np.float32(1.0), np.float32(1.0), np.float32(1.0), np.float32(1.0), np.float32(1.0), np.float32(0.0), np.float32(0.0), np.float32(1.0), np.float32(0.0), np.float32(1.0), np.float32(0.0)]",1.0,99650.0,22
2025-08-14_08-18-36,4637,"[np.float32(1.0), np.float32(0.0), np.float32(0.0), np.float32(0.0), np.float32(1.0), np.float32(0.0), np.float32(1.0), np.float32(1.0), np.float32(0.0), np.float32(1.0), np.float32(0.0), np.float32(1.0), np.float32(1.0), np.float32(0.0), np.float32(0.0), np.float32(1.0)]",-1.0,99649.0,5
2025-08-14_08-18-36,4638,"[np.float32(0.0), np.float32(1.0), np.float32(0.0), np.float32(1.0), np.float32(1.0), np.float32(1.0), np.float32(1.0), np.float32(1.0), np.float32(0.0), np.float32(1.0), np.float32(0.0), np.float32(0.0), np.float32(1.0), np.float32(0.0), np.float32(0.0), np.float32(1.0)]",3.0,99652.0,13
2025-08-14_08-18-36,4639,"[np.float32(1.0), np.float32(1.0), np.float32(1.0), np.float32(1.0), np.float32(1.0), np.float32(1.0), np.float32(1.0), np.float32(0.0), np.float32(1.0), np.float32(1.0), np.float32(0.0), np.float32(0.0), np.float32(1.0), np.float32(1.0), np.float32(0.0), np.float32(0.0)]",-2.0,99650.0,16
2025-08-14_08-18-36,4640,"[np.float32(0.0), np.float32(1.0), np.float32(0.0), np.float32(0.0), np.float32(0.0), np.float32(0.0), np.float32(0.0), np.float32(1.0), np.float32(1.0), np.float32(0.0), np.float32(0.0), np.float32(0.0), np.float32(0.0), np.float32(0.0), np.float32(1.0), np.float32(0.0)]",1.0,99651.0,28
2025-08-14_08-18-36,4641,"[np.float32(0.0), np.float32(0.0), np.float32(1.0), np.float32(0.0), np.float32(0.0), np.float32(0.0), np.float32(0.0), np.float32(0.0), np.float32(1.0), np.float32(1.0), np.float32(0.0), np.float32(0.0), np.float32(1.0), np.float32(0.0), np.float32(0.0), np.float32(0.0)]",-4.0,99647.0,9
2025-08-14_08-18-36,4642,"[np.float32(0.0), np.float32(1.0), np.float32(0.0), np.float32(1.0), np.float32(0.0), np.float32(0.0), np.float32(1.0), np.float32(0.0), np.float32(1.0), np.float32(0.0), np.float32(0.0), np.float32(0.0), np.float32(1.0), np.float32(1.0), np.float32(0.0), np.float32(0.0)]",1.0,99648.0,11
2025-08-14_08-18-36,4643,"[np.float32(0.0), np.float32(1.0), np.float32(1.0), np.float32(0.0), np.float32(1.0), np.float32(0.0), np.float32(0.0), np.float32(1.0), np.float32(1.0), np.float32(0.0), np.float32(0.0), np.float32(1.0), np.float32(1.0), np.float32(1.0), np.float32(0.0), np.float32(0.0)]",-6.0,99642.0,1
2025-08-14_08-18-36,4644,"[np.float32(0.0), np.float32(1.0), np.float32(1.0), np.float32(1.0), np.float32(0.0), np.float32(0.0), np.float32(0.0), np.float32(1.0), np.float32(1.0), np.float32(1.0), np.float32(0.0), np.float32(0.0), np.float32(0.0), np.float32(1.0), np.float32(0.0), np.float32(0.0)]",-2.0,99640.0,36
2025-08-14_08-18-36,4645,"[np.float32(0.0), np.float32(0.0), np.float32(1.0), np.float32(0.0), np.float32(1.0), np.float32(0.0), np.float32(0.0), np.float32(1.0), np.float32(1.0), np.float32(1.0), np.float32(0.0), np.float32(1.0), np.float32(1.0), np.float32(1.0), np.float32(0.0), np.float32(0.0)]",0.0,99640.0,26
2025-08-14_08-18-36,4646,"[np.float32(1.0), np.float32(0.0), np.float32(1.0), np.float32(1.0), np.float32(1.0), np.float32(1.0), np.float32(0.0), np.float32(0.0), np.float32(1.0), np.float32(1.0), np.float32(1.0), np.float32(1.0), np.float32(0.0), np.float32(1.0), np.float32(1.0), np.float32(1.0)]",3.0,99643.0,27
2025-08-14_08-18-36,4647,"[np.float32(0.0), np.float32(0.0), np.float32(1.0), np.float32(0.0), np.float32(0.0), np.float32(1.0), np.float32(0.0), np.float32(1.0), np.float32(0.0), np.float32(0.0), np.float32(1.0), np.float32(0.0), np.float32(1.0), np.float32(1.0), np.float32(1.0), np.float32(1.0)]",31.0,99674.0,7
2025-08-14_08-18-36,4648,"[np.float32(1.0), np.float32(1.0), np.float32(1.0), np.float32(0.0), np.float32(0.0), np.float32(1.0), np.float32(0.0), np.float32(1.0), np.float32(0.0), np.float32(1.0), np.float32(1.0), np.float32(1.0), np.float32(1.0), np.float32(0.0), np.float32(1.0), np.float32(1.0)]",0.0,99674.0,17
2025-08-14_08-18-36,4649,"[np.float32(1.0), np.float32(0.0), np.float32(0.0), np.float32(1.0), np.float32(0.0), np.float32(0.0), np.float32(0.0), np.float32(0.0), np.float32(1.0), np.float32(0.0), np.float32(1.0), np.float32(1.0), np.float32(0.0), np.float32(1.0), np.float32(0.0), np.float32(1.0)]",-5.0,99669.0,13
2025-08-14_08-18-36,4650,"[np.float32(0.0), np.float32(0.0), np.float32(1.0), np.float32(1.0), np.float32(1.0), np.float32(1.0), np.float32(1.0), np.float32(0.0), np.float32(1.0), np.float32(1.0), np.float32(0.0), np.float32(0.0), np.float32(1.0), np.float32(1.0), np.float32(0.0), np.float32(0.0)]",1.0,99670.0,29
2025-08-14_08-18-36,4651,"[np.float32(0.0), np.float32(1.0), np.float32(0.0), np.float32(0.0), np.float32(0.0), np.float32(0.0), np.float32(0.0), np.float32(0.0), np.float32(1.0), np.float32(0.0), np.float32(0.0), np.float32(1.0), np.float32(0.0), np.float32(1.0), np.float32(0.0), np.float32(1.0)]",1.0,99671.0,27
2025-08-14_08-18-36,4652,"[np.float32(1.0), np.float32(1.0), np.float32(0.0), np.float32(0.0), np.float32(0.0), np.float32(1.0), np.float32(1.0), np.float32(1.0), np.float32(1.0), np.float32(1.0), np.float32(0.0), np.float32(1.0), np.float32(1.0), np.float32(0.0), np.float32(0.0), np.float32(0.0)]",-4.0,99667.0,17
2025-08-14_08-18-36,4653,"[np.float32(0.0), np.float32(1.0), np.float32(1.0), np.float32(1.0), np.float32(1.0), np.float32(0.0), np.float32(1.0), np.float32(1.0), np.float32(1.0), np.float32(1.0), np.float32(0.0), np.float32(1.0), np.float32(1.0), np.float32(0.0), np.float32(1.0), np.float32(0.0)]",1.0,99668.0,15
2025-08-14_08-18-36,4654,"[np.float32(1.0), np.float32(1.0), np.float32(1.0), np.float32(0.0), np.float32(1.0), np.float32(1.0), np.float32(1.0), np.float32(1.0), np.float32(0.0), np.float32(1.0), np.float32(0.0), np.float32(0.0), np.float32(0.0), np.float32(1.0), np.float32(0.0), np.float32(0.0)]",1.0,99669.0,3
2025-08-14_08-18-36,4655,"[np.float32(1.0), np.float32(1.0), np.float32(0.0), np.float32(0.0), np.float32(1.0), np.float32(0.0), np.float32(1.0), np.float32(0.0), np.float32(0.0), np.float32(1.0), np.float32(0.0), np.float32(0.0), np.float32(0.0), np.float32(0.0), np.float32(1.0), np.float32(1.0)]",6.0,99675.0,10
2025-08-14_08-18-36,4656,"[np.float32(0.0), np.float32(1.0), np.float32(1.0), np.float32(1.0), np.float32(0.0), np.float32(1.0), np.float32(0.0), np.float32(1.0), np.float32(1.0), np.float32(0.0), np.float32(1.0), np.float32(0.0), np.float32(0.0), np.float32(0.0), np.float32(1.0), np.float32(1.0)]",1.0,99676.0,11
2025-08-14_08-18-36,4657,"[np.float32(0.0), np.float32(1.0), np.float32(1.0), np.float32(1.0), np.float32(1.0), np.float32(0.0), np.float32(1.0), np.float32(1.0), np.float32(1.0), np.float32(0.0), np.float32(0.0), np.float32(0.0), np.float32(1.0), np.float32(1.0), np.float32(0.0), np.float32(0.0)]",-4.0,99672.0,34
2025-08-14_08-18-36,4658,"[np.float32(1.0), np.float32(1.0), np.float32(0.0), np.float32(0.0), np.float32(0.0), np.float32(1.0), np.float32(1.0), np.float32(0.0), np.float32(0.0), np.float32(1.0), np.float32(1.0), np.float32(1.0), np.float32(1.0), np.float32(0.0), np.float32(0.0), np.float32(0.0)]",36.0,99708.0,7
2025-08-14_08-18-36,4659,"[np.float32(1.0), np.float32(0.0), np.float32(0.0), np.float32(0.0), np.float32(1.0), np.float32(1.0), np.float32(0.0), np.float32(1.0), np.float32(0.0), np.float32(0.0), np.float32(0.0), np.float32(0.0), np.float32(1.0), np.float32(0.0), np.float32(0.0), np.float32(1.0)]",-4.0,99704.0,33
2025-08-14_08-18-36,4660,"[np.float32(1.0), np.float32(1.0), np.float32(1.0), np.float32(0.0), np.float32(1.0), np.float32(0.0), np.float32(1.0), np.float32(0.0), np.float32(0.0), np.float32(1.0), np.float32(1.0), np.float32(0.0), np.float32(1.0), np.float32(1.0), np.float32(0.0), np.float32(1.0)]",0.0,99704.0,11
2025-08-14_08-18-36,4661,"[np.float32(1.0), np.float32(0.0), np.float32(1.0), np.float32(1.0), np.float32(1.0), np.float32(0.0), np.float32(1.0), np.float32(1.0), np.float32(0.0), np.float32(0.0), np.float32(0.0), np.float32(0.0), np.float32(0.0), np.float32(0.0), np.float32(0.0), np.float32(1.0)]",-5.0,99699.0,33
2025-08-14_08-18-36,4662,"[np.float32(1.0), np.float32(1.0), np.float32(1.0), np.float32(1.0), np.float32(1.0), np.float32(1.0), np.float32(0.0), np.float32(1.0), np.float32(0.0), np.float32(0.0), np.float32(0.0), np.float32(0.0), np.float32(0.0), np.float32(0.0), np.float32(0.0), np.float32(0.0)]",-1.0,99698.0,25
2025-08-14_08-18-36,4663,"[np.float32(0.0), np.float32(1.0), np.float32(1.0), np.float32(0.0), np.float32(0.0), np.float32(0.0), np.float32(0.0), np.float32(0.0), np.float32(0.0), np.float32(0.0), np.float32(1.0), np.float32(1.0), np.float32(0.0), np.float32(0.0), np.float32(1.0), np.float32(1.0)]",-3.0,99695.0,21
2025-08-14_08-18-36,4664,"[np.float32(0.0), np.float32(1.0), np.float32(1.0), np.float32(0.0), np.float32(0.0), np.float32(0.0), np.float32(1.0), np.float32(1.0), np.float32(1.0), np.float32(0.0), np.float32(1.0), np.float32(1.0), np.float32(0.0), np.float32(1.0), np.float32(0.0), np.float32(0.0)]",-2.0,99693.0,7
2025-08-14_08-18-36,4665,"[np.float32(0.0), np.float32(1.0), np.float32(1.0), np.float32(1.0), np.float32(1.0), np.float32(0.0), np.float32(1.0), np.float32(1.0), np.float32(1.0), np.float32(0.0), np.float32(0.0), np.float32(0.0), np.float32(1.0), np.float32(0.0), np.float32(0.0), np.float32(0.0)]",1.0,99694.0,6
2025-08-14_08-18-36,4666,"[np.float32(1.0), np.float32(1.0), np.float32(0.0), np.float32(1.0), np.float32(1.0), np.float32(1.0), np.float32(0.0), np.float32(1.0), np.float32(0.0), np.float32(0.0), np.float32(0.0), np.float32(0.0), np.float32(1.0), np.float32(1.0), np.float32(0.0), np.float32(1.0)]",-3.0,99691.0,11
2025-08-14_08-18-36,4667,"[np.float32(0.0), np.float32(0.0), np.float32(1.0), np.float32(0.0), np.float32(0.0), np.float32(1.0), np.float32(1.0), np.float32(1.0), np.float32(1.0), np.float32(0.0), np.float32(1.0), np.float32(1.0), np.float32(0.0), np.float32(0.0), np.float32(1.0), np.float32(0.0)]",-5.0,99686.0,1
2025-08-14_08-18-36,4668,"[np.float32(1.0), np.float32(1.0), np.float32(0.0), np.float32(1.0), np.float32(1.0), np.float32(1.0), np.float32(1.0), np.float32(0.0), np.float32(0.0), np.float32(1.0), np.float32(0.0), np.float32(1.0), np.float32(0.0), np.float32(0.0), np.float32(0.0), np.float32(1.0)]",-2.0,99684.0,22
2025-08-14_08-18-36,4669,"[np.float32(1.0), np.float32(0.0), np.float32(1.0), np.float32(1.0), np.float32(0.0), np.float32(1.0), np.float32(1.0), np.float32(1.0), np.float32(1.0), np.float32(0.0), np.float32(0.0), np.float32(1.0), np.float32(0.0), np.float32(1.0), np.float32(0.0), np.float32(1.0)]",1.0,99685.0,15
2025-08-14_08-18-36,4670,"[np.float32(1.0), np.float32(1.0), np.float32(0.0), np.float32(1.0), np.float32(1.0), np.float32(0.0), np.float32(1.0), np.float32(1.0), np.float32(1.0), np.float32(0.0), np.float32(1.0), np.float32(0.0), np.float32(0.0), np.float32(1.0), np.float32(1.0), np.float32(1.0)]",1.0,99686.0,1
2025-08-14_08-18-36,4671,"[np.float32(1.0), np.float32(0.0), np.float32(1.0), np.float32(0.0), np.float32(1.0), np.float32(1.0), np.float32(0.0), np.float32(0.0), np.float32(1.0), np.float32(0.0), np.float32(1.0), np.float32(1.0), np.float32(0.0), np.float32(1.0), np.float32(1.0), np.float32(0.0)]",-2.0,99684.0,20
2025-08-14_08-18-36,4672,"[np.float32(1.0), np.float32(1.0), np.float32(0.0), np.float32(1.0), np.float32(1.0), np.float32(0.0), np.float32(1.0), np.float32(1.0), np.float32(1.0), np.float32(1.0), np.float32(1.0), np.float32(0.0), np.float32(1.0), np.float32(1.0), np.float32(0.0), np.float32(0.0)]",-6.0,99678.0,0
2025-08-14_08-18-36,4673,"[np.float32(0.0), np.float32(0.0), np.float32(1.0), np.float32(0.0), np.float32(0.0), np.float32(1.0), np.float32(1.0), np.float32(1.0), np.float32(1.0), np.float32(0.0), np.float32(0.0), np.float32(0.0), np.float32(1.0), np.float32(1.0), np.float32(1.0), np.float32(1.0)]",1.0,99679.0,36
2025-08-14_08-18-36,4674,"[np.float32(1.0), np.float32(1.0), np.float32(1.0), np.float32(0.0), np.float32(0.0), np.float32(0.0), np.float32(0.0), np.float32(0.0), np.float32(1.0), np.float32(1.0), np.float32(0.0), np.float32(1.0), np.float32(1.0), np.float32(1.0), np.float32(0.0), np.float32(1.0)]",-1.0,99678.0,1
2025-08-14_08-18-36,4675,"[np.float32(0.0), np.float32(1.0), np.float32(1.0), np.float32(0.0), np.float32(0.0), np.float32(0.0), np.float32(0.0), np.float32(1.0), np.float32(0.0), np.float32(0.0), np.float32(1.0), np.float32(0.0), np.float32(0.0), np.float32(1.0), np.float32(0.0), np.float32(0.0)]",1.0,99679.0,19
2025-08-14_08-18-36,4676,"[np.float32(1.0), np.float32(1.0), np.float32(0.0), np.float32(1.0), np.float32(0.0), np.float32(1.0), np.float32(0.0), np.float32(0.0), np.float32(0.0), np.float32(1.0), np.float32(0.0), np.float32(0.0), np.float32(0.0), np.float32(0.0), np.float32(0.0), np.float32(0.0)]",1.0,99680.0,23
2025-08-14_08-18-36,4677,"[np.float32(0.0), np.float32(0.0), np.float32(0.0), np.float32(1.0), np.float32(1.0), np.float32(1.0), np.float32(1.0), np.float32(1.0), np.float32(0.0), np.float32(0.0), np.float32(1.0), np.float32(0.0), np.float32(1.0), np.float32(1.0), np.float32(0.0), np.float32(0.0)]",-1.0,99679.0,25
2025-08-14_08-18-36,4678,"[np.float32(1.0), np.float32(0.0), np.float32(1.0), np.float32(0.0), np.float32(0.0), np.float32(1.0), np.float32(0.0), np.float32(1.0), np.float32(0.0), np.float32(1.0), np.float32(1.0), np.float32(0.0), np.float32(0.0), np.float32(0.0), np.float32(1.0), np.float32(1.0)]",5.0,99684.0,16
2025-08-14_08-18-36,4679,"[np.float32(1.0), np.float32(0.0), np.float32(1.0), np.float32(0.0), np.float32(0.0), np.float32(1.0), np.float32(1.0), np.float32(1.0), np.float32(1.0), np.float32(0.0), np.float32(1.0), np.float32(1.0), np.float32(0.0), np.float32(1.0), np.float32(0.0), np.float32(0.0)]",-1.0,99683.0,4
2025-08-14_08-18-36,4680,"[np.float32(0.0), np.float32(0.0), np.float32(1.0), np.float32(1.0), np.float32(1.0), np.float32(1.0), np.float32(0.0), np.float32(1.0), np.float32(1.0), np.float32(0.0), np.float32(0.0), np.float32(1.0), np.float32(0.0), np.float32(1.0), np.float32(1.0), np.float32(1.0)]",-3.0,99680.0,5
2025-08-14_08-18-36,4681,"[np.float32(1.0), np.float32(0.0), np.float32(0.0), np.float32(0.0), np.float32(0.0), np.float32(0.0), np.float32(1.0), np.float32(1.0), np.float32(0.0), np.float32(1.0), np.float32(1.0), np.float32(1.0), np.float32(1.0), np.float32(0.0), np.float32(1.0), np.float32(0.0)]",0.0,99680.0,14
2025-08-14_08-18-36,4682,"[np.float32(1.0), np.float32(0.0), np.float32(0.0), np.float32(1.0), np.float32(1.0), np.float32(0.0), np.float32(1.0), np.float32(0.0), np.float32(1.0), np.float32(1.0), np.float32(0.0), np.float32(1.0), np.float32(0.0), np.float32(0.0), np.float32(1.0), np.float32(1.0)]",2.0,99682.0,30
2025-08-14_08-18-36,4683,"[np.float32(0.0), np.float32(1.0), np.float32(1.0), np.float32(0.0), np.float32(1.0), np.float32(1.0), np.float32(0.0), np.float32(0.0), np.float32(0.0), np.float32(1.0), np.float32(1.0), np.float32(0.0), np.float32(1.0), np.float32(1.0), np.float32(1.0), np.float32(0.0)]",-4.0,99678.0,3
2025-08-14_08-18-36,4684,"[np.float32(0.0), np.float32(1.0), np.float32(0.0), np.float32(1.0), np.float32(1.0), np.float32(0.0), np.float32(0.0), np.float32(1.0), np.float32(1.0), np.float32(1.0), np.float32(0.0), np.float32(1.0), np.float32(0.0), np.float32(1.0), np.float32(0.0), np.float32(0.0)]",-1.0,99677.0,9
2025-08-14_08-18-36,4685,"[np.float32(0.0), np.float32(1.0), np.float32(0.0), np.float32(1.0), np.float32(0.0), np.float32(0.0), np.float32(0.0), np.float32(0.0), np.float32(1.0), np.float32(0.0), np.float32(1.0), np.float32(1.0), np.float32(0.0), np.float32(1.0), np.float32(0.0), np.float32(1.0)]",3.0,99680.0,17
2025-08-14_08-18-36,4686,"[np.float32(0.0), np.float32(1.0), np.float32(1.0), np.float32(1.0), np.float32(0.0), np.float32(0.0), np.float32(1.0), np.float32(1.0), np.float32(1.0), np.float32(0.0), np.float32(1.0), np.float32(1.0), np.float32(0.0), np.float32(0.0), np.float32(0.0), np.float32(0.0)]",-1.0,99679.0,4
2025-08-14_08-18-36,4687,"[np.float32(1.0), np.float32(1.0), np.float32(1.0), np.float32(1.0), np.float32(1.0), np.float32(1.0), np.float32(1.0), np.float32(0.0), np.float32(1.0), np.float32(1.0), np.float32(1.0), np.float32(0.0), np.float32(0.0), np.float32(0.0), np.float32(1.0), np.float32(0.0)]",-5.0,99674.0,0
2025-08-14_08-18-36,4688,"[np.float32(1.0), np.float32(1.0), np.float32(1.0), np.float32(0.0), np.float32(0.0), np.float32(1.0), np.float32(0.0), np.float32(1.0), np.float32(0.0), np.float32(1.0), np.float32(0.0), np.float32(1.0), np.float32(1.0), np.float32(1.0), np.float32(0.0), np.float32(1.0)]",-8.0,99666.0,5
2025-08-14_08-18-36,4689,"[np.float32(1.0), np.float32(1.0), np.float32(1.0), np.float32(1.0), np.float32(1.0), np.float32(0.0), np.float32(0.0), np.float32(0.0), np.float32(0.0), np.float32(0.0), np.float32(0.0), np.float32(1.0), np.float32(0.0), np.float32(1.0), np.float32(0.0), np.float32(0.0)]",5.0,99671.0,3
2025-08-14_08-18-36,4690,"[np.float32(1.0), np.float32(0.0), np.float32(0.0), np.float32(1.0), np.float32(1.0), np.float32(0.0), np.float32(0.0), np.float32(1.0), np.float32(1.0), np.float32(0.0), np.float32(1.0), np.float32(0.0), np.float32(1.0), np.float32(1.0), np.float32(0.0), np.float32(0.0)]",-5.0,99666.0,0
2025-08-14_08-18-36,4691,"[np.float32(1.0), np.float32(0.0), np.float32(1.0), np.float32(1.0), np.float32(0.0), np.float32(1.0), np.float32(0.0), np.float32(0.0), np.float32(1.0), np.float32(0.0), np.float32(1.0), np.float32(1.0), np.float32(1.0), np.float32(0.0), np.float32(1.0), np.float32(1.0)]",2.0,99668.0,23
2025-08-14_08-18-36,4692,"[np.float32(1.0), np.float32(1.0), np.float32(0.0), np.float32(1.0), np.float32(1.0), np.float32(0.0), np.float32(0.0), np.float32(1.0), np.float32(0.0), np.float32(0.0), np.float32(0.0), np.float32(1.0), np.float32(0.0), np.float32(1.0), np.float32(0.0), np.float32(1.0)]",-4.0,99664.0,8
2025-08-14_08-18-36,4693,"[np.float32(0.0), np.float32(0.0), np.float32(0.0), np.float32(0.0), np.float32(0.0), np.float32(1.0), np.float32(0.0), np.float32(1.0), np.float32(1.0), np.float32(0.0), np.float32(0.0), np.float32(1.0), np.float32(0.0), np.float32(0.0), np.float32(0.0), np.float32(0.0)]",1.0,99665.0,26
2025-08-14_08-18-36,4694,"[np.float32(0.0), np.float32(1.0), np.float32(0.0), np.float32(1.0), np.float32(0.0), np.float32(0.0), np.float32(0.0), np.float32(0.0), np.float32(0.0), np.float32(1.0), np.float32(0.0), np.float32(0.0), np.float32(1.0), np.float32(1.0), np.float32(1.0), np.float32(0.0)]",-1.0,99664.0,21
2025-08-14_08-18-36,4695,"[np.float32(0.0), np.float32(1.0), np.float32(1.0), np.float32(0.0), np.float32(0.0), np.float32(1.0), np.float32(0.0), np.float32(1.0), np.float32(0.0), np.float32(0.0), np.float32(0.0), np.float32(0.0), np.float32(1.0), np.float32(1.0), np.float32(0.0), np.float32(1.0)]",-5.0,99659.0,11
2025-08-14_08-18-36,4696,"[np.float32(1.0), np.float32(1.0), np.float32(0.0), np.float32(0.0), np.float32(1.0), np.float32(0.0), np.float32(1.0), np.float32(1.0), np.float32(0.0), np.float32(1.0), np.float32(1.0), np.float32(0.0), np.float32(1.0), np.float32(0.0), np.float32(1.0), np.float32(0.0)]",1.0,99660.0,1
2025-08-14_08-18-36,4697,"[np.float32(1.0), np.float32(1.0), np.float32(1.0), np.float32(0.0), np.float32(0.0), np.float32(0.0), np.float32(1.0), np.float32(0.0), np.float32(1.0), np.float32(0.0), np.float32(0.0), np.float32(1.0), np.float32(0.0), np.float32(1.0), np.float32(1.0), np.float32(0.0)]",0.0,99660.0,29
2025-08-14_08-18-36,4698,"[np.float32(0.0), np.float32(1.0), np.float32(0.0), np.float32(1.0), np.float32(1.0), np.float32(1.0), np.float32(1.0), np.float32(0.0), np.float32(0.0), np.float32(1.0), np.float32(1.0), np.float32(0.0), np.float32(1.0), np.float32(0.0), np.float32(0.0), np.float32(1.0)]",-1.0,99659.0,14
2025-08-14_08-18-36,4699,"[np.float32(0.0), np.float32(0.0), np.float32(1.0), np.float32(0.0), np.float32(1.0), np.float32(1.0), np.float32(0.0), np.float32(1.0), np.float32(0.0), np.float32(0.0), np.float32(1.0), np.float32(0.0), np.float32(1.0), np.float32(1.0), np.float32(1.0), np.float32(1.0)]",-2.0,99657.0,4
2025-08-14_08-18-36,4700,"[np.float32(1.0), np.float32(0.0), np.float32(1.0), np.float32(0.0), np.float32(0.0), np.float32(0.0), np.float32(1.0), np.float32(1.0), np.float32(0.0), np.float32(1.0), np.float32(0.0), np.float32(1.0), np.float32(0.0), np.float32(0.0), np.float32(1.0), np.float32(0.0)]",-2.0,99655.0,28
2025-08-14_08-18-36,4701,"[np.float32(0.0), np.float32(1.0), np.float32(0.0), np.float32(0.0), np.float32(0.0), np.float32(0.0), np.float32(1.0), np.float32(1.0), np.float32(1.0), np.float32(1.0), np.float32(1.0), np.float32(0.0), np.float32(0.0), np.float32(0.0), np.float32(1.0), np.float32(1.0)]",-5.0,99650.0,18
2025-08-14_08-18-36,4702,"[np.float32(1.0), np.float32(0.0), np.float32(1.0), np.float32(0.0), np.float32(1.0), np.float32(0.0), np.float32(0.0), np.float32(1.0), np.float32(0.0), np.float32(1.0), np.float32(1.0), np.float32(1.0), np.float32(0.0), np.float32(0.0), np.float32(1.0), np.float32(1.0)]",2.0,99652.0,23
2025-08-14_08-18-36,4703,"[np.float32(0.0), np.float32(1.0), np.float32(1.0), np.float32(0.0), np.float32(0.0), np.float32(0.0), np.float32(0.0), np.float32(1.0), np.float32(0.0), np.float32(0.0), np.float32(1.0), np.float32(1.0), np.float32(1.0), np.float32(1.0), np.float32(1.0), np.float32(0.0)]",3.0,99655.0,18
2025-08-14_08-18-36,4704,"[np.float32(0.0), np.float32(1.0), np.float32(1.0), np.float32(0.0), np.float32(0.0), np.float32(0.0), np.float32(1.0), np.float32(1.0), np.float32(1.0), np.float32(1.0), np.float32(0.0), np.float32(0.0), np.float32(0.0), np.float32(1.0), np.float32(0.0), np.float32(1.0)]",0.0,99655.0,12
2025-08-14_08-18-36,4705,"[np.float32(1.0), np.float32(0.0), np.float32(1.0), np.float32(0.0), np.float32(0.0), np.float32(1.0), np.float32(1.0), np.float32(0.0), np.float32(1.0), np.float32(1.0), np.float32(0.0), np.float32(1.0), np.float32(1.0), np.float32(0.0), np.float32(0.0), np.float32(0.0)]",-1.0,99654.0,21
2025-08-14_08-18-36,4706,"[np.float32(1.0), np.float32(0.0), np.float32(1.0), np.float32(0.0), np.float32(1.0), np.float32(1.0), np.float32(0.0), np.float32(1.0), np.float32(1.0), np.float32(1.0), np.float32(1.0), np.float32(0.0), np.float32(0.0), np.float32(1.0), np.float32(1.0), np.float32(0.0)]",2.0,99656.0,34
2025-08-14_08-18-36,4707,"[np.float32(0.0), np.float32(0.0), np.float32(1.0), np.float32(1.0), np.float32(0.0), np.float32(0.0), np.float32(0.0), np.float32(1.0), np.float32(0.0), np.float32(1.0), np.float32(1.0), np.float32(0.0), np.float32(0.0), np.float32(0.0), np.float32(1.0), np.float32(1.0)]",-2.0,99654.0,30
2025-08-14_08-18-36,4708,"[np.float32(0.0), np.float32(1.0), np.float32(1.0), np.float32(1.0), np.float32(1.0), np.float32(0.0), np.float32(1.0), np.float32(1.0), np.float32(1.0), np.float32(1.0), np.float32(0.0), np.float32(0.0), np.float32(0.0), np.float32(1.0), np.float32(0.0), np.float32(0.0)]",1.0,99655.0,31
2025-08-14_08-18-36,4709,"[np.float32(0.0), np.float32(0.0), np.float32(0.0), np.float32(1.0), np.float32(1.0), np.float32(0.0), np.float32(0.0), np.float32(1.0), np.float32(0.0), np.float32(0.0), np.float32(0.0), np.float32(0.0), np.float32(0.0), np.float32(0.0), np.float32(0.0), np.float32(0.0)]",-3.0,99652.0,0
2025-08-14_08-18-36,4710,"[np.float32(1.0), np.float32(0.0), np.float32(1.0), np.float32(1.0), np.float32(0.0), np.float32(1.0), np.float32(0.0), np.float32(0.0), np.float32(0.0), np.float32(1.0), np.float32(0.0), np.float32(0.0), np.float32(0.0), np.float32(0.0), np.float32(0.0), np.float32(0.0)]",4.0,99656.0,34
2025-08-14_08-18-36,4711,"[np.float32(1.0), np.float32(0.0), np.float32(1.0), np.float32(1.0), np.float32(1.0), np.float32(1.0), np.float32(1.0), np.float32(1.0), np.float32(1.0), np.float32(1.0), np.float32(1.0), np.float32(0.0), np.float32(0.0), np.float32(0.0), np.float32(0.0), np.float32(0.0)]",0.0,99656.0,22
2025-08-14_08-18-36,4712,"[np.float32(1.0), np.float32(1.0), np.float32(0.0), np.float32(0.0), np.float32(1.0), np.float32(1.0), np.float32(1.0), np.float32(0.0), np.float32(0.0), np.float32(0.0), np.float32(1.0), np.float32(0.0), np.float32(1.0), np.float32(1.0), np.float32(1.0), np.float32(0.0)]",1.0,99657.0,35
2025-08-14_08-18-36,4713,"[np.float32(0.0), np.float32(0.0), np.float32(0.0), np.float32(1.0), np.float32(1.0), np.float32(0.0), np.float32(0.0), np.float32(0.0), np.float32(0.0), np.float32(0.0), np.float32(0.0), np.float32(0.0), np.float32(0.0), np.float32(1.0), np.float32(1.0), np.float32(1.0)]",-2.0,99655.0,22
2025-08-14_08-18-36,4714,"[np.float32(0.0), np.float32(1.0), np.float32(1.0), np.float32(0.0), np.float32(0.0), np.float32(1.0), np.float32(1.0), np.float32(1.0), np.float32(1.0), np.float32(0.0), np.float32(0.0), np.float32(0.0), np.float32(1.0), np.float32(0.0), np.float32(0.0), np.float32(1.0)]",-3.0,99652.0,16
2025-08-14_08-18-36,4715,"[np.float32(1.0), np.float32(0.0), np.float32(0.0), np.float32(0.0), np.float32(1.0), np.float32(0.0), np.float32(1.0), np.float32(0.0), np.float32(0.0), np.float32(0.0), np.float32(0.0), np.float32(1.0), np.float32(0.0), np.float32(0.0), np.float32(1.0), np.float32(0.0)]",2.0,99654.0,7
2025-08-14_08-18-36,4716,"[np.float32(0.0), np.float32(0.0), np.float32(0.0), np.float32(0.0), np.float32(0.0), np.float32(1.0), np.float32(0.0), np.float32(0.0), np.float32(1.0), np.float32(1.0), np.float32(1.0), np.float32(0.0), np.float32(1.0), np.float32(0.0), np.float32(1.0), np.float32(0.0)]",0.0,99654.0,5
2025-08-14_08-18-36,4717,"[np.float32(0.0), np.float32(0.0), np.float32(0.0), np.float32(1.0), np.float32(0.0), np.float32(1.0), np.float32(0.0), np.float32(0.0), np.float32(1.0), np.float32(0.0), np.float32(1.0), np.float32(0.0), np.float32(1.0), np.float32(1.0), np.float32(0.0), np.float32(0.0)]",1.0,99655.0,19
2025-08-14_08-18-36,4718,"[np.float32(0.0), np.float32(1.0), np.float32(0.0), np.float32(1.0), np.float32(1.0), np.float32(0.0), np.float32(0.0), np.float32(1.0), np.float32(0.0), np.float32(1.0), np.float32(0.0), np.float32(1.0), np.float32(1.0), np.float32(0.0), np.float32(0.0), np.float32(0.0)]",-5.0,99650.0,0
2025-08-14_08-18-36,4719,"[np.float32(1.0), np.float32(0.0), np.float32(0.0), np.float32(0.0), np.float32(0.0), np.float32(0.0), np.float32(1.0), np.float32(0.0), np.float32(0.0), np.float32(1.0), np.float32(0.0), np.float32(0.0), np.float32(1.0), np.float32(1.0), np.float32(1.0), np.float32(1.0)]",1.0,99651.0,25
2025-08-14_08-18-36,4720,"[np.float32(0.0), np.float32(1.0), np.float32(1.0), np.float32(0.0), np.float32(1.0), np.float32(0.0), np.float32(1.0), np.float32(1.0), np.float32(1.0), np.float32(0.0), np.float32(1.0), np.float32(1.0), np.float32(0.0), np.float32(0.0), np.float32(1.0), np.float32(0.0)]",1.0,99652.0,15
2025-08-14_08-18-36,4721,"[np.float32(0.0), np.float32(1.0), np.float32(0.0), np.float32(0.0), np.float32(0.0), np.float32(0.0), np.float32(1.0), np.float32(1.0), np.float32(1.0), np.float32(1.0), np.float32(0.0), np.float32(0.0), np.float32(0.0), np.float32(1.0), np.float32(1.0), np.float32(0.0)]",-1.0,99651.0,27
2025-08-14_08-18-36,4722,"[np.float32(0.0), np.float32(0.0), np.float32(0.0), np.float32(1.0), np.float32(1.0), np.float32(0.0), np.float32(1.0), np.float32(0.0), np.float32(0.0), np.float32(0.0), np.float32(0.0), np.float32(1.0), np.float32(0.0), np.float32(1.0), np.float32(1.0), np.float32(0.0)]",2.0,99653.0,6
2025-08-14_08-18-36,4723,"[np.float32(1.0), np.float32(0.0), np.float32(0.0), np.float32(1.0), np.float32(1.0), np.float32(0.0), np.float32(1.0), np.float32(1.0), np.float32(0.0), np.float32(0.0), np.float32(0.0), np.float32(0.0), np.float32(0.0), np.float32(0.0), np.float32(0.0), np.float32(1.0)]",3.0,99656.0,7
2025-08-14_08-18-36,4724,"[np.float32(0.0), np.float32(1.0), np.float32(1.0), np.float32(1.0), np.float32(1.0), np.float32(0.0), np.float32(1.0), np.float32(1.0), np.float32(0.0), np.float32(1.0), np.float32(1.0), np.float32(0.0), np.float32(0.0), np.float32(1.0), np.float32(1.0), np.float32(1.0)]",-3.0,99653.0,32
2025-08-14_08-18-36,4725,"[np.float32(1.0), np.float32(1.0), np.float32(0.0), np.float32(1.0), np.float32(0.0), np.float32(0.0), np.float32(0.0), np.float32(1.0), np.float32(1.0), np.float32(1.0), np.float32(1.0), np.float32(1.0), np.float32(1.0), np.float32(1.0), np.float32(1.0), np.float32(1.0)]",1.0,99654.0,25
2025-08-14_08-18-36,4726,"[np.float32(0.0), np.float32(1.0), np.float32(0.0), np.float32(0.0), np.float32(1.0), np.float32(1.0), np.float32(1.0), np.float32(0.0), np.float32(0.0), np.float32(1.0), np.float32(1.0), np.float32(1.0), np.float32(1.0), np.float32(0.0), np.float32(0.0), np.float32(1.0)]",-2.0,99652.0,35
2025-08-14_08-18-36,4727,"[np.float32(1.0), np.float32(1.0), np.float32(0.0), np.float32(0.0), np.float32(0.0), np.float32(1.0), np.float32(1.0), np.float32(1.0), np.float32(1.0), np.float32(0.0), np.float32(1.0), np.float32(1.0), np.float32(0.0), np.float32(1.0), np.float32(1.0), np.float32(0.0)]",-2.0,99650.0,9
2025-08-14_08-18-36,4728,"[np.float32(1.0), np.float32(0.0), np.float32(1.0), np.float32(0.0), np.float32(0.0), np.float32(0.0), np.float32(1.0), np.float32(0.0), np.float32(1.0), np.float32(1.0), np.float32(1.0), np.float32(1.0), np.float32(1.0), np.float32(1.0), np.float32(0.0), np.float32(1.0)]",-5.0,99645.0,23
2025-08-14_08-18-36,4729,"[np.float32(1.0), np.float32(0.0), np.float32(0.0), np.float32(1.0), np.float32(0.0), np.float32(0.0), np.float32(1.0), np.float32(0.0), np.float32(1.0), np.float32(0.0), np.float32(0.0), np.float32(1.0), np.float32(1.0), np.float32(0.0), np.float32(0.0), np.float32(0.0)]",-1.0,99644.0,11
2025-08-14_08-18-36,4730,"[np.float32(1.0), np.float32(0.0), np.float32(1.0), np.float32(1.0), np.float32(0.0), np.float32(1.0), np.float32(1.0), np.float32(0.0), np.float32(1.0), np.float32(1.0), np.float32(1.0), np.float32(0.0), np.float32(0.0), np.float32(0.0), np.float32(0.0), np.float32(1.0)]",0.0,99644.0,30
2025-08-14_08-18-36,4731,"[np.float32(1.0), np.float32(0.0), np.float32(0.0), np.float32(1.0), np.float32(0.0), np.float32(0.0), np.float32(0.0), np.float32(0.0), np.float32(0.0), np.float32(0.0), np.float32(1.0), np.float32(0.0), np.float32(1.0), np.float32(1.0), np.float32(0.0), np.float32(1.0)]",-4.0,99640.0,36
2025-08-14_08-18-36,4732,"[np.float32(0.0), np.float32(0.0), np.float32(1.0), np.float32(0.0), np.float32(0.0), np.float32(1.0), np.float32(1.0), np.float32(1.0), np.float32(1.0), np.float32(1.0), np.float32(0.0), np.float32(1.0), np.float32(1.0), np.float32(1.0), np.float32(0.0), np.float32(0.0)]",-6.0,99634.0,17
2025-08-14_08-18-36,4733,"[np.float32(0.0), np.float32(0.0), np.float32(0.0), np.float32(1.0), np.float32(0.0), np.float32(1.0), np.float32(1.0), np.float32(1.0), np.float32(0.0), np.float32(0.0), np.float32(1.0), np.float32(0.0), np.float32(1.0), np.float32(1.0), np.float32(0.0), np.float32(0.0)]",1.0,99635.0,17
2025-08-14_08-18-36,4734,"[np.float32(1.0), np.float32(1.0), np.float32(1.0), np.float32(1.0), np.float32(0.0), np.float32(0.0), np.float32(0.0), np.float32(1.0), np.float32(0.0), np.float32(0.0), np.float32(0.0), np.float32(0.0), np.float32(0.0), np.float32(1.0), np.float32(0.0), np.float32(0.0)]",4.0,99639.0,19
2025-08-14_08-18-36,4735,"[np.float32(0.0), np.float32(0.0), np.float32(0.0), np.float32(1.0), np.float32(1.0), np.float32(1.0), np.float32(1.0), np.float32(0.0), np.float32(0.0), np.float32(0.0), np.float32(0.0), np.float32(0.0), np.float32(1.0), np.float32(0.0), np.float32(0.0), np.float32(1.0)]",-2.0,99637.0,35
2025-08-14_08-18-36,4736,"[np.float32(0.0), np.float32(0.0), np.float32(0.0), np.float32(1.0), np.float32(1.0), np.float32(1.0), np.float32(1.0), np.float32(0.0), np.float32(1.0), np.float32(1.0), np.float32(1.0), np.float32(0.0), np.float32(0.0), np.float32(1.0), np.float32(0.0), np.float32(1.0)]",4.0,99641.0,1
2025-08-14_08-18-36,4737,"[np.float32(1.0), np.float32(0.0), np.float32(0.0), np.float32(1.0), np.float32(1.0), np.float32(0.0), np.float32(0.0), np.float32(0.0), np.float32(1.0), np.float32(0.0), np.float32(1.0), np.float32(0.0), np.float32(0.0), np.float32(1.0), np.float32(0.0), np.float32(1.0)]",4.0,99645.0,29
2025-08-14_08-18-36,4738,"[np.float32(0.0), np.float32(0.0), np.float32(0.0), np.float32(0.0), np.float32(1.0), np.float32(1.0), np.float32(1.0), np.float32(1.0), np.float32(1.0), np.float32(1.0), np.float32(1.0), np.float32(0.0), np.float32(1.0), np.float32(0.0), np.float32(0.0), np.float32(0.0)]",0.0,99645.0,2
2025-08-14_08-18-36,4739,"[np.float32(1.0), np.float32(1.0), np.float32(1.0), np.float32(0.0), np.float32(1.0), np.float32(1.0), np.float32(1.0), np.float32(1.0), np.float32(1.0), np.float32(0.0), np.float32(0.0), np.float32(0.0), np.float32(1.0), np.float32(1.0), np.float32(0.0), np.float32(0.0)]",-3.0,99642.0,23
2025-08-14_08-18-36,4740,"[np.float32(1.0), np.float32(0.0), np.float32(0.0), np.float32(0.0), np.float32(0.0), np.float32(0.0), np.float32(0.0), np.float32(1.0), np.float32(1.0), np.float32(1.0), np.float32(0.0), np.float32(1.0), np.float32(0.0), np.float32(0.0), np.float32(0.0), np.float32(0.0)]",-2.0,99640.0,26
2025-08-14_08-18-36,4741,"[np.float32(1.0), np.float32(1.0), np.float32(0.0), np.float32(1.0), np.float32(0.0), np.float32(1.0), np.float32(1.0), np.float32(1.0), np.float32(1.0), np.float32(0.0), np.float32(0.0), np.float32(1.0), np.float32(1.0), np.float32(1.0), np.float32(0.0), np.float32(1.0)]",-1.0,99639.0,17
2025-08-14_08-18-36,4742,"[np.float32(0.0), np.float32(0.0), np.float32(0.0), np.float32(0.0), np.float32(0.0), np.float32(0.0), np.float32(1.0), np.float32(0.0), np.float32(1.0), np.float32(0.0), np.float32(0.0), np.float32(1.0), np.float32(1.0), np.float32(1.0), np.float32(1.0), np.float32(0.0)]",-3.0,99636.0,0
2025-08-14_08-18-36,4743,"[np.float32(1.0), np.float32(0.0), np.float32(0.0), np.float32(0.0), np.float32(0.0), np.float32(1.0), np.float32(1.0), np.float32(1.0), np.float32(0.0), np.float32(0.0), np.float32(0.0), np.float32(0.0), np.float32(1.0), np.float32(0.0), np.float32(1.0), np.float32(0.0)]",1.0,99637.0,21
2025-08-14_08-18-36,4744,"[np.float32(1.0), np.float32(1.0), np.float32(0.0), np.float32(0.0), np.float32(1.0), np.float32(1.0), np.float32(0.0), np.float32(0.0), np.float32(1.0), np.float32(1.0), np.float32(1.0), np.float32(0.0), np.float32(0.0), np.float32(1.0), np.float32(0.0), np.float32(1.0)]",-2.0,99635.0,16
2025-08-14_08-18-36,4745,"[np.float32(0.0), np.float32(1.0), np.float32(1.0), np.float32(1.0), np.float32(1.0), np.float32(0.0), np.float32(1.0), np.float32(0.0), np.float32(1.0), np.float32(1.0), np.float32(0.0), np.float32(1.0), np.float32(0.0), np.float32(1.0), np.float32(1.0), np.float32(0.0)]",-2.0,99633.0,34
2025-08-14_08-18-36,4746,"[np.float32(1.0), np.float32(1.0), np.float32(0.0), np.float32(1.0), np.float32(0.0), np.float32(0.0), np.float32(0.0), np.float32(0.0), np.float32(0.0), np.float32(1.0), np.float32(1.0), np.float32(1.0), np.float32(1.0), np.float32(0.0), np.float32(1.0), np.float32(0.0)]",2.0,99635.0,27
2025-08-14_08-18-36,4747,"[np.float32(0.0), np.float32(0.0), np.float32(1.0), np.float32(1.0), np.float32(0.0), np.float32(1.0), np.float32(0.0), np.float32(1.0), np.float32(0.0), np.float32(0.0), np.float32(0.0), np.float32(1.0), np.float32(1.0), np.float32(1.0), np.float32(0.0), np.float32(0.0)]",0.0,99635.0,35
2025-08-14_08-18-36,4748,"[np.float32(1.0), np.float32(0.0), np.float32(1.0), np.float32(1.0), np.float32(1.0), np.float32(0.0), np.float32(0.0), np.float32(1.0), np.float32(0.0), np.float32(1.0), np.float32(0.0), np.float32(1.0), np.float32(1.0), np.float32(1.0), np.float32(1.0), np.float32(0.0)]",-3.0,99632.0,2
2025-08-14_08-18-36,4749,"[np.float32(0.0), np.float32(0.0), np.float32(0.0), np.float32(1.0), np.float32(0.0), np.float32(1.0), np.float32(0.0), np.float32(0.0), np.float32(1.0), np.float32(0.0), np.float32(1.0), np.float32(0.0), np.float32(0.0), np.float32(1.0), np.float32(0.0), np.float32(1.0)]",1.0,99633.0,33
2025-08-14_08-18-36,4750,"[np.float32(1.0), np.float32(1.0), np.float32(0.0), np.float32(0.0), np.float32(1.0), np.float32(1.0), np.float32(1.0), np.float32(1.0), np.float32(0.0), np.float32(0.0), np.float32(1.0), np.float32(0.0), np.float32(0.0), np.float32(0.0), np.float32(1.0), np.float32(1.0)]",-2.0,99631.0,12
2025-08-14_08-18-36,4751,"[np.float32(1.0), np.float32(1.0), np.float32(1.0), np.float32(1.0), np.float32(1.0), np.float32(0.0), np.float32(0.0), np.float32(0.0), np.float32(1.0), np.float32(0.0), np.float32(1.0), np.float32(1.0), np.float32(1.0), np.float32(0.0), np.float32(0.0), np.float32(0.0)]",0.0,99631.0,11
2025-08-14_08-18-36,4752,"[np.float32(0.0), np.float32(1.0), np.float32(0.0), np.float32(0.0), np.float32(1.0), np.float32(0.0), np.float32(1.0), np.float32(1.0), np.float32(1.0), np.float32(0.0), np.float32(0.0), np.float32(0.0), np.float32(1.0), np.float32(0.0), np.float32(0.0), np.float32(0.0)]",35.0,99666.0,7
2025-08-14_08-18-36,4753,"[np.float32(0.0), np.float32(1.0), np.float32(1.0), np.float32(0.0), np.float32(0.0), np.float32(1.0), np.float32(0.0), np.float32(1.0), np.float32(0.0), np.float32(0.0), np.float32(1.0), np.float32(1.0), np.float32(0.0), np.float32(0.0), np.float32(1.0), np.float32(1.0)]",-5.0,99661.0,1
2025-08-14_08-18-36,4754,"[np.float32(1.0), np.float32(1.0), np.float32(1.0), np.float32(1.0), np.float32(1.0), np.float32(0.0), np.float32(0.0), np.float32(0.0), np.float32(0.0), np.float32(1.0), np.float32(1.0), np.float32(0.0), np.float32(1.0), np.float32(0.0), np.float32(0.0), np.float32(0.0)]",-1.0,99660.0,31
2025-08-14_08-18-36,4755,"[np.float32(0.0), np.float32(0.0), np.float32(1.0), np.float32(0.0), np.float32(0.0), np.float32(1.0), np.float32(1.0), np.float32(0.0), np.float32(0.0), np.float32(1.0), np.float32(1.0), np.float32(0.0), np.float32(1.0), np.float32(0.0), np.float32(0.0), np.float32(0.0)]",-6.0,99654.0,15
2025-08-14_08-18-36,4756,"[np.float32(0.0), np.float32(1.0), np.float32(1.0), np.float32(0.0), np.float32(0.0), np.float32(1.0), np.float32(1.0), np.float32(1.0), np.float32(1.0), np.float32(0.0), np.float32(0.0), np.float32(0.0), np.float32(1.0), np.float32(1.0), np.float32(1.0), np.float32(0.0)]",-4.0,99650.0,17
2025-08-14_08-18-36,4757,"[np.float32(0.0), np.float32(1.0), np.float32(0.0), np.float32(0.0), np.float32(1.0), np.float32(0.0), np.float32(1.0), np.float32(1.0), np.float32(1.0), np.float32(1.0), np.float32(0.0), np.float32(0.0), np.float32(1.0), np.float32(1.0), np.float32(1.0), np.float32(1.0)]",1.0,99651.0,28
2025-08-14_08-18-36,4758,"[np.float32(1.0), np.float32(1.0), np.float32(0.0), np.float32(1.0), np.float32(0.0), np.float32(1.0), np.float32(0.0), np.float32(1.0), np.float32(1.0), np.float32(0.0), np.float32(0.0), np.float32(0.0), np.float32(0.0), np.float32(1.0), np.float32(0.0), np.float32(0.0)]",0.0,99651.0,3
2025-08-14_08-18-36,4759,"[np.float32(1.0), np.float32(1.0), np.float32(0.0), np.float32(1.0), np.float32(1.0), np.float32(1.0), np.float32(0.0), np.float32(0.0), np.float32(1.0), np.float32(1.0), np.float32(0.0), np.float32(1.0), np.float32(0.0), np.float32(0.0), np.float32(0.0), np.float32(1.0)]",-5.0,99646.0,8
2025-08-14_08-18-36,4760,"[np.float32(0.0), np.float32(1.0), np.float32(0.0), np.float32(1.0), np.float32(0.0), np.float32(1.0), np.float32(1.0), np.float32(1.0), np.float32(1.0), np.float32(1.0), np.float32(0.0), np.float32(0.0), np.float32(1.0), np.float32(0.0), np.float32(0.0), np.float32(1.0)]",1.0,99647.0,22
2025-08-14_08-18-36,4761,"[np.float32(0.0), np.float32(1.0), np.float32(1.0), np.float32(1.0), np.float32(0.0), np.float32(0.0), np.float32(0.0), np.float32(1.0), np.float32(1.0), np.float32(0.0), np.float32(0.0), np.float32(0.0), np.float32(0.0), np.float32(1.0), np.float32(0.0), np.float32(0.0)]",-4.0,99643.0,9
2025-08-14_08-18-36,4762,"[np.float32(0.0), np.float32(0.0), np.float32(1.0), np.float32(1.0), np.float32(1.0), np.float32(1.0), np.float32(0.0), np.float32(1.0), np.float32(0.0), np.float32(0.0), np.float32(1.0), np.float32(0.0), np.float32(0.0), np.float32(0.0), np.float32(0.0), np.float32(1.0)]",-3.0,99640.0,3
2025-08-14_08-18-36,4763,"[np.float32(0.0), np.float32(0.0), np.float32(0.0), np.float32(0.0), np.float32(0.0), np.float32(1.0), np.float32(0.0), np.float32(1.0), np.float32(0.0), np.float32(0.0), np.float32(0.0), np.float32(0.0), np.float32(1.0), np.float32(0.0), np.float32(1.0), np.float32(0.0)]",1.0,99641.0,20
2025-08-14_08-18-36,4764,"[np.float32(1.0), np.float32(1.0), np.float32(1.0), np.float32(1.0), np.float32(0.0), np.float32(0.0), np.float32(0.0), np.float32(1.0), np.float32(1.0), np.float32(0.0), np.float32(1.0), np.float32(0.0), np.float32(0.0), np.float32(0.0), np.float32(1.0), np.float32(0.0)]",2.0,99643.0,16
2025-08-14_08-18-36,4765,"[np.float32(0.0), np.float32(1.0), np.float32(0.0), np.float32(1.0), np.float32(1.0), np.float32(1.0), np.float32(1.0), np.float32(0.0), np.float32(1.0), np.float32(0.0), np.float32(1.0), np.float32(0.0), np.float32(0.0), np.float32(1.0), np.float32(0.0), np.float32(0.0)]",-1.0,99642.0,1
2025-08-14_08-18-36,4766,"[np.float32(1.0), np.float32(0.0), np.float32(0.0), np.float32(1.0), np.float32(0.0), np.float32(1.0), np.float32(1.0), np.float32(1.0), np.float32(1.0), np.float32(1.0), np.float32(0.0), np.float32(1.0), np.float32(0.0), np.float32(0.0), np.float32(1.0), np.float32(1.0)]",1.0,99643.0,16
2025-08-14_08-18-36,4767,"[np.float32(0.0), np.float32(0.0), np.float32(0.0), np.float32(1.0), np.float32(0.0), np.float32(0.0), np.float32(0.0), np.float32(1.0), np.float32(0.0), np.float32(1.0), np.float32(1.0), np.float32(0.0), np.float32(0.0), np.float32(1.0), np.float32(0.0), np.float32(0.0)]",1.0,99644.0,28
2025-08-14_08-18-36,4768,"[np.float32(1.0), np.float32(1.0), np.float32(0.0), np.float32(0.0), np.float32(0.0), np.float32(0.0), np.float32(0.0), np.float32(0.0), np.float32(1.0), np.float32(1.0), np.float32(0.0), np.float32(1.0), np.float32(1.0), np.float32(1.0), np.float32(0.0), np.float32(0.0)]",-5.0,99639.0,23
2025-08-14_08-18-36,4769,"[np.float32(0.0), np.float32(0.0), np.float32(0.0), np.float32(1.0), np.float32(1.0), np.float32(1.0), np.float32(1.0), np.float32(1.0), np.float32(0.0), np.float32(1.0), np.float32(1.0), np.float32(0.0), np.float32(0.0), np.float32(1.0), np.float32(0.0), np.float32(1.0)]",1.0,99640.0,29
2025-08-14_08-18-36,4770,"[np.float32(0.0), np.float32(0.0), np.float32(1.0), np.float32(1.0), np.float32(0.0), np.float32(0.0), np.float32(1.0), np.float32(1.0), np.float32(1.0), np.float32(0.0), np.float32(1.0), np.float32(1.0), np.float32(1.0), np.float32(1.0), np.float32(0.0), np.float32(0.0)]",-1.0,99639.0,36
2025-08-14_08-18-36,4771,"[np.float32(1.0), np.float32(1.0), np.float32(1.0), np.float32(1.0), np.float32(0.0), np.float32(0.0), np.float32(0.0), np.float32(1.0), np.float32(0.0), np.float32(0.0), np.float32(1.0), np.float32(0.0), np.float32(0.0), np.float32(0.0), np.float32(0.0), np.float32(1.0)]",6.0,99645.0,17
2025-08-14_08-18-36,4772,"[np.float32(0.0), np.float32(0.0), np.float32(1.0), np.float32(1.0), np.float32(0.0), np.float32(0.0), np.float32(1.0), np.float32(0.0), np.float32(1.0), np.float32(0.0), np.float32(0.0), np.float32(0.0), np.float32(1.0), np.float32(0.0), np.float32(0.0), np.float32(1.0)]",-1.0,99644.0,11
2025-08-14_08-18-36,4773,"[np.float32(1.0), np.float32(0.0), np.float32(0.0), np.float32(0.0), np.float32(0.0), np.float32(0.0), np.float32(0.0), np.float32(1.0), np.float32(1.0), np.float32(1.0), np.float32(0.0), np.float32(0.0), np.float32(1.0), np.float32(1.0), np.float32(0.0), np.float32(0.0)]",0.0,99644.0,31
2025-08-14_08-18-36,4774,"[np.float32(1.0), np.float32(0.0), np.float32(1.0), np.float32(1.0), np.float32(1.0), np.float32(0.0), np.float32(1.0), np.float32(1.0), np.float32(0.0), np.float32(0.0), np.float32(0.0), np.float32(0.0), np.float32(1.0), np.float32(1.0), np.float32(1.0), np.float32(0.0)]",0.0,99644.0,9
2025-08-14_08-18-36,4775,"[np.float32(1.0), np.float32(0.0), np.float32(1.0), np.float32(0.0), np.float32(0.0), np.float32(1.0), np.float32(0.0), np.float32(1.0), np.float32(1.0), np.float32(1.0), np.float32(1.0), np.float32(1.0), np.float32(0.0), np.float32(1.0), np.float32(0.0), np.float32(1.0)]",0.0,99644.0,23
2025-08-14_08-18-36,4776,"[np.float32(0.0), np.float32(0.0), np.float32(1.0), np.float32(0.0), np.float32(0.0), np.float32(0.0), np.float32(0.0), np.float32(1.0), np.float32(1.0), np.float32(0.0), np.float32(0.0), np.float32(1.0), np.float32(0.0), np.float32(1.0), np.float32(0.0), np.float32(1.0)]",-4.0,99640.0,10
2025-08-14_08-18-36,4777,"[np.float32(1.0), np.float32(0.0), np.float32(1.0), np.float32(1.0), np.float32(0.0), np.float32(1.0), np.float32(0.0), np.float32(1.0), np.float32(0.0), np.float32(1.0), np.float32(0.0), np.float32(0.0), np.float32(1.0), np.float32(1.0), np.float32(1.0), np.float32(1.0)]",1.0,99641.0,13
2025-08-14_08-18-36,4778,"[np.float32(1.0), np.float32(0.0), np.float32(1.0), np.float32(1.0), np.float32(1.0), np.float32(1.0), np.float32(0.0), np.float32(1.0), np.float32(1.0), np.float32(0.0), np.float32(1.0), np.float32(0.0), np.float32(0.0), np.float32(0.0), np.float32(0.0), np.float32(0.0)]",4.0,99645.0,23
2025-08-14_08-18-36,4779,"[np.float32(0.0), np.float32(1.0), np.float32(1.0), np.float32(1.0), np.float32(0.0), np.float32(0.0), np.float32(0.0), np.float32(1.0), np.float32(1.0), np.float32(1.0), np.float32(0.0), np.float32(0.0), np.float32(1.0), np.float32(0.0), np.float32(1.0), np.float32(1.0)]",-4.0,99641.0,9
2025-08-14_08-18-36,4780,"[np.float32(1.0), np.float32(1.0), np.float32(0.0), np.float32(0.0), np.float32(1.0), np.float32(1.0), np.float32(1.0), np.float32(1.0), np.float32(1.0), np.float32(0.0), np.float32(1.0), np.float32(0.0), np.float32(0.0), np.float32(0.0), np.float32(0.0), np.float32(0.0)]",-1.0,99640.0,36
2025-08-14_08-18-36,4781,"[np.float32(1.0), np.float32(0.0), np.float32(1.0), np.float32(0.0), np.float32(0.0), np.float32(0.0), np.float32(0.0), np.float32(1.0), np.float32(1.0), np.float32(1.0), np.float32(0.0), np.float32(1.0), np.float32(0.0), np.float32(1.0), np.float32(0.0), np.float32(0.0)]",-2.0,99638.0,0
2025-08-14_08-18-36,4782,"[np.float32(0.0), np.float32(0.0), np.float32(1.0), np.float32(1.0), np.float32(0.0), np.float32(1.0), np.float32(1.0), np.float32(1.0), np.float32(0.0), np.float32(0.0), np.float32(0.0), np.float32(0.0), np.float32(1.0), np.float32(0.0), np.float32(1.0), np.float32(0.0)]",-2.0,99636.0,15
2025-08-14_08-18-36,4783,"[np.float32(0.0), np.float32(1.0), np.float32(1.0), np.float32(0.0), np.float32(0.0), np.float32(0.0), np.float32(1.0), np.float32(1.0), np.float32(1.0), np.float32(1.0), np.float32(1.0), np.float32(1.0), np.float32(1.0), np.float32(1.0), np.float32(1.0), np.float32(0.0)]",-1.0,99635.0,20
2025-08-14_08-18-36,4784,"[np.float32(0.0), np.float32(0.0), np.float32(0.0), np.float32(1.0), np.float32(0.0), np.float32(1.0), np.float32(1.0), np.float32(0.0), np.float32(0.0), np.float32(0.0), np.float32(1.0), np.float32(1.0), np.float32(1.0), np.float32(0.0), np.float32(0.0), np.float32(1.0)]",-4.0,99631.0,18
2025-08-14_08-18-36,4785,"[np.float32(1.0), np.float32(1.0), np.float32(0.0), np.float32(1.0), np.float32(1.0), np.float32(1.0), np.float32(1.0), np.float32(1.0), np.float32(0.0), np.float32(1.0), np.float32(0.0), np.float32(0.0), np.float32(1.0), np.float32(0.0), np.float32(0.0), np.float32(0.0)]",1.0,99632.0,4
2025-08-14_08-18-36,4786,"[np.float32(1.0), np.float32(1.0), np.float32(1.0), np.float32(0.0), np.float32(0.0), np.float32(0.0), np.float32(0.0), np.float32(1.0), np.float32(0.0), np.float32(0.0), np.float32(0.0), np.float32(0.0), np.float32(0.0), np.float32(0.0), np.float32(0.0), np.float32(1.0)]",3.0,99635.0,17
2025-08-14_08-18-36,4787,"[np.float32(1.0), np.float32(0.0), np.float32(1.0), np.float32(1.0), np.float32(0.0), np.float32(0.0), np.float32(0.0), np.float32(1.0), np.float32(0.0), np.float32(0.0), np.float32(0.0), np.float32(0.0), np.float32(1.0), np.float32(0.0), np.float32(0.0), np.float32(1.0)]",-4.0,99631.0,11
2025-08-14_08-18-36,4788,"[np.float32(1.0), np.float32(1.0), np.float32(1.0), np.float32(1.0), np.float32(1.0), np.float32(1.0), np.float32(1.0), np.float32(0.0), np.float32(1.0), np.float32(0.0), np.float32(1.0), np.float32(0.0), np.float32(0.0), np.float32(1.0), np.float32(0.0), np.float32(1.0)]",-2.0,99629.0,30
2025-08-14_08-18-36,4789,"[np.float32(1.0), np.float32(0.0), np.float32(1.0), np.float32(0.0), np.float32(0.0), np.float32(0.0), np.float32(1.0), np.float32(1.0), np.float32(0.0), np.float32(1.0), np.float32(1.0), np.float32(1.0), np.float32(1.0), np.float32(1.0), np.float32(0.0), np.float32(0.0)]",-3.0,99626.0,13
2025-08-14_08-18-36,4790,"[np.float32(1.0), np.float32(1.0), np.float32(1.0), np.float32(0.0), np.float32(1.0), np.float32(1.0), np.float32(1.0), np.float32(0.0), np.float32(0.0), np.float32(0.0), np.float32(0.0), np.float32(0.0), np.float32(1.0), np.float32(0.0), np.float32(0.0), np.float32(0.0)]",0.0,99626.0,3
2025-08-14_08-18-36,4791,"[np.float32(1.0), np.float32(1.0), np.float32(1.0), np.float32(1.0), np.float32(1.0), np.float32(0.0), np.float32(0.0), np.float32(1.0), np.float32(0.0), np.float32(1.0), np.float32(0.0), np.float32(1.0), np.float32(0.0), np.float32(0.0), np.float32(0.0), np.float32(0.0)]",1.0,99627.0,7
2025-08-14_08-18-36,4792,"[np.float32(0.0), np.float32(1.0), np.float32(1.0), np.float32(1.0), np.float32(0.0), np.float32(0.0), np.float32(1.0), np.float32(1.0), np.float32(0.0), np.float32(1.0), np.float32(0.0), np.float32(1.0), np.float32(1.0), np.float32(1.0), np.float32(0.0), np.float32(1.0)]",-5.0,99622.0,27
2025-08-14_08-18-36,4793,"[np.float32(1.0), np.float32(0.0), np.float32(0.0), np.float32(0.0), np.float32(1.0), np.float32(0.0), np.float32(0.0), np.float32(0.0), np.float32(0.0), np.float32(0.0), np.float32(0.0), np.float32(1.0), np.float32(1.0), np.float32(1.0), np.float32(1.0), np.float32(1.0)]",-4.0,99618.0,28
2025-08-14_08-18-36,4794,"[np.float32(0.0), np.float32(0.0), np.float32(0.0), np.float32(1.0), np.float32(1.0), np.float32(0.0), np.float32(0.0), np.float32(1.0), np.float32(1.0), np.float32(1.0), np.float32(1.0), np.float32(0.0), np.float32(1.0), np.float32(1.0), np.float32(1.0), np.float32(0.0)]",2.0,99620.0,35
2025-08-14_08-18-36,4795,"[np.float32(1.0), np.float32(0.0), np.float32(1.0), np.float32(0.0), np.float32(0.0), np.float32(1.0), np.float32(0.0), np.float32(1.0), np.float32(0.0), np.float32(1.0), np.float32(0.0), np.float32(1.0), np.float32(0.0), np.float32(0.0), np.float32(0.0), np.float32(0.0)]",-3.0,99617.0,17
2025-08-14_08-18-36,4796,"[np.float32(0.0), np.float32(0.0), np.float32(1.0), np.float32(0.0), np.float32(0.0), np.float32(1.0), np.float32(0.0), np.float32(1.0), np.float32(1.0), np.float32(0.0), np.float32(0.0), np.float32(1.0), np.float32(1.0), np.float32(1.0), np.float32(0.0), np.float32(0.0)]",3.0,99620.0,36
2025-08-14_08-18-36,4797,"[np.float32(1.0), np.float32(1.0), np.float32(0.0), np.float32(0.0), np.float32(0.0), np.float32(1.0), np.float32(0.0), np.float32(1.0), np.float32(1.0), np.float32(0.0), np.float32(0.0), np.float32(0.0), np.float32(1.0), np.float32(1.0), np.float32(1.0), np.float32(1.0)]",1.0,99621.0,27
2025-08-14_08-18-36,4798,"[np.float32(0.0), np.float32(1.0), np.float32(1.0), np.float32(1.0), np.float32(0.0), np.float32(1.0), np.float32(1.0), np.float32(0.0), np.float32(0.0), np.float32(0.0), np.float32(0.0), np.float32(0.0), np.float32(0.0), np.float32(1.0), np.float32(1.0), np.float32(1.0)]",1.0,99622.0,24
2025-08-14_08-18-36,4799,"[np.float32(1.0), np.float32(0.0), np.float32(1.0), np.float32(1.0), np.float32(0.0), np.float32(0.0), np.float32(1.0), np.float32(1.0), np.float32(1.0), np.float32(0.0), np.float32(1.0), np.float32(0.0), np.float32(1.0), np.float32(0.0), np.float32(0.0), np.float32(1.0)]",-2.0,99620.0,30
2025-08-14_08-18-36,4800,"[np.float32(1.0), np.float32(1.0), np.float32(0.0), np.float32(0.0), np.float32(0.0), np.float32(1.0), np.float32(0.0), np.float32(0.0), np.float32(0.0), np.float32(1.0), np.float32(0.0), np.float32(1.0), np.float32(0.0), np.float32(0.0), np.float32(1.0), np.float32(0.0)]",-1.0,99619.0,5
2025-08-14_08-18-36,4801,"[np.float32(0.0), np.float32(0.0), np.float32(1.0), np.float32(1.0), np.float32(1.0), np.float32(1.0), np.float32(1.0), np.float32(1.0), np.float32(1.0), np.float32(0.0), np.float32(0.0), np.float32(1.0), np.float32(1.0), np.float32(0.0), np.float32(1.0), np.float32(0.0)]",0.0,99619.0,21
2025-08-14_08-18-36,4802,"[np.float32(1.0), np.float32(1.0), np.float32(1.0), np.float32(1.0), np.float32(1.0), np.float32(1.0), np.float32(0.0), np.float32(1.0), np.float32(0.0), np.float32(0.0), np.float32(1.0), np.float32(0.0), np.float32(1.0), np.float32(0.0), np.float32(0.0), np.float32(0.0)]",0.0,99619.0,24
2025-08-14_08-18-36,4803,"[np.float32(1.0), np.float32(1.0), np.float32(0.0), np.float32(1.0), np.float32(1.0), np.float32(1.0), np.float32(1.0), np.float32(1.0), np.float32(1.0), np.float32(1.0), np.float32(1.0), np.float32(0.0), np.float32(0.0), np.float32(1.0), np.float32(0.0), np.float32(0.0)]",-1.0,99618.0,10
2025-08-14_08-18-36,4804,"[np.float32(1.0), np.float32(1.0), np.float32(0.0), np.float32(1.0), np.float32(1.0), np.float32(0.0), np.float32(1.0), np.float32(1.0), np.float32(0.0), np.float32(0.0), np.float32(1.0), np.float32(0.0), np.float32(1.0), np.float32(1.0), np.float32(0.0), np.float32(0.0)]",1.0,99619.0,14
2025-08-14_08-18-36,4805,"[np.float32(0.0), np.float32(1.0), np.float32(0.0), np.float32(0.0), np.float32(0.0), np.float32(1.0), np.float32(0.0), np.float32(0.0), np.float32(1.0), np.float32(0.0), np.float32(0.0), np.float32(1.0), np.float32(1.0), np.float32(1.0), np.float32(1.0), np.float32(1.0)]",0.0,99619.0,6
2025-08-14_08-18-36,4806,"[np.float32(0.0), np.float32(1.0), np.float32(0.0), np.float32(0.0), np.float32(0.0), np.float32(1.0), np.float32(0.0), np.float32(0.0), np.float32(1.0), np.float32(0.0), np.float32(1.0), np.float32(0.0), np.float32(1.0), np.float32(0.0), np.float32(0.0), np.float32(0.0)]",0.0,99619.0,30
2025-08-14_08-18-36,4807,"[np.float32(0.0), np.float32(0.0), np.float32(0.0), np.float32(1.0), np.float32(1.0), np.float32(0.0), np.float32(0.0), np.float32(1.0), np.float32(0.0), np.float32(0.0), np.float32(1.0), np.float32(1.0), np.float32(0.0), np.float32(1.0), np.float32(0.0), np.float32(1.0)]",0.0,99619.0,5
2025-08-14_08-18-36,4808,"[np.float32(0.0), np.float32(0.0), np.float32(0.0), np.float32(0.0), np.float32(0.0), np.float32(0.0), np.float32(1.0), np.float32(1.0), np.float32(1.0), np.float32(1.0), np.float32(1.0), np.float32(1.0), np.float32(1.0), np.float32(1.0), np.float32(0.0), np.float32(0.0)]",-2.0,99617.0,13
2025-08-14_08-18-36,4809,"[np.float32(0.0), np.float32(0.0), np.float32(1.0), np.float32(1.0), np.float32(0.0), np.float32(1.0), np.float32(1.0), np.float32(0.0), np.float32(1.0), np.float32(0.0), np.float32(0.0), np.float32(1.0), np.float32(1.0), np.float32(1.0), np.float32(0.0), np.float32(1.0)]",1.0,99618.0,30
2025-08-14_08-18-36,4810,"[np.float32(0.0), np.float32(1.0), np.float32(0.0), np.float32(1.0), np.float32(1.0), np.float32(0.0), np.float32(0.0), np.float32(0.0), np.float32(1.0), np.float32(1.0), np.float32(0.0), np.float32(0.0), np.float32(1.0), np.float32(0.0), np.float32(1.0), np.float32(0.0)]",5.0,99623.0,13
2025-08-14_08-18-36,4811,"[np.float32(0.0), np.float32(1.0), np.float32(0.0), np.float32(1.0), np.float32(1.0), np.float32(0.0), np.float32(0.0), np.float32(1.0), np.float32(1.0), np.float32(1.0), np.float32(0.0), np.float32(1.0), np.float32(0.0), np.float32(0.0), np.float32(0.0), np.float32(0.0)]",1.0,99624.0,28
2025-08-14_08-18-36,4812,"[np.float32(1.0), np.float32(1.0), np.float32(1.0), np.float32(1.0), np.float32(1.0), np.float32(0.0), np.float32(0.0), np.float32(1.0), np.float32(1.0), np.float32(1.0), np.float32(0.0), np.float32(1.0), np.float32(0.0), np.float32(1.0), np.float32(0.0), np.float32(0.0)]",3.0,99627.0,21
2025-08-14_08-18-36,4813,"[np.float32(0.0), np.float32(0.0), np.float32(1.0), np.float32(1.0), np.float32(0.0), np.float32(1.0), np.float32(0.0), np.float32(1.0), np.float32(0.0), np.float32(0.0), np.float32(0.0), np.float32(0.0), np.float32(1.0), np.float32(0.0), np.float32(0.0), np.float32(1.0)]",-4.0,99623.0,8
2025-08-14_08-18-36,4814,"[np.float32(0.0), np.float32(1.0), np.float32(1.0), np.float32(0.0), np.float32(0.0), np.float32(1.0), np.float32(1.0), np.float32(1.0), np.float32(1.0), np.float32(0.0), np.float32(0.0), np.float32(0.0), np.float32(1.0), np.float32(0.0), np.float32(1.0), np.float32(1.0)]",-2.0,99621.0,4
2025-08-14_08-18-36,4815,"[np.float32(1.0), np.float32(1.0), np.float32(1.0), np.float32(1.0), np.float32(0.0), np.float32(1.0), np.float32(0.0), np.float32(0.0), np.float32(1.0), np.float32(1.0), np.float32(0.0), np.float32(1.0), np.float32(1.0), np.float32(0.0), np.float32(1.0), np.float32(1.0)]",-2.0,99619.0,20
2025-08-14_08-18-36,4816,"[np.float32(1.0), np.float32(0.0), np.float32(0.0), np.float32(1.0), np.float32(1.0), np.float32(1.0), np.float32(0.0), np.float32(0.0), np.float32(0.0), np.float32(0.0), np.float32(0.0), np.float32(0.0), np.float32(1.0), np.float32(1.0), np.float32(0.0), np.float32(0.0)]",-1.0,99618.0,0
2025-08-14_08-18-36,4817,"[np.float32(0.0), np.float32(1.0), np.float32(1.0), np.float32(1.0), np.float32(0.0), np.float32(1.0), np.float32(0.0), np.float32(1.0), np.float32(0.0), np.float32(0.0), np.float32(1.0), np.float32(1.0), np.float32(0.0), np.float32(0.0), np.float32(1.0), np.float32(1.0)]",3.0,99621.0,33
2025-08-14_08-18-36,4818,"[np.float32(0.0), np.float32(1.0), np.float32(1.0), np.float32(1.0), np.float32(0.0), np.float32(0.0), np.float32(0.0), np.float32(1.0), np.float32(0.0), np.float32(0.0), np.float32(0.0), np.float32(0.0), np.float32(0.0), np.float32(1.0), np.float32(0.0), np.float32(0.0)]",-3.0,99618.0,9
2025-08-14_08-18-36,4819,"[np.float32(1.0), np.float32(1.0), np.float32(1.0), np.float32(1.0), np.float32(0.0), np.float32(1.0), np.float32(1.0), np.float32(0.0), np.float32(1.0), np.float32(1.0), np.float32(1.0), np.float32(0.0), np.float32(1.0), np.float32(0.0), np.float32(1.0), np.float32(0.0)]",-2.0,99616.0,24
2025-08-14_08-18-36,4820,"[np.float32(0.0), np.float32(0.0), np.float32(0.0), np.float32(0.0), np.float32(0.0), np.float32(1.0), np.float32(1.0), np.float32(0.0), np.float32(0.0), np.float32(1.0), np.float32(1.0), np.float32(0.0), np.float32(1.0), np.float32(0.0), np.float32(1.0), np.float32(0.0)]",-3.0,99613.0,3
2025-08-14_08-18-36,4821,"[np.float32(0.0), np.float32(1.0), np.float32(0.0), np.float32(0.0), np.float32(0.0), np.float32(0.0), np.float32(0.0), np.float32(1.0), np.float32(1.0), np.float32(1.0), np.float32(0.0), np.float32(0.0), np.float32(0.0), np.float32(1.0), np.float32(1.0), np.float32(0.0)]",-1.0,99612.0,20
2025-08-14_08-18-36,4822,"[np.float32(1.0), np.float32(0.0), np.float32(1.0), np.float32(1.0), np.float32(1.0), np.float32(0.0), np.float32(1.0), np.float32(0.0), np.float32(1.0), np.float32(0.0), np.float32(1.0), np.float32(0.0), np.float32(1.0), np.float32(0.0), np.float32(0.0), np.float32(1.0)]",-3.0,99609.0,18
2025-08-14_08-18-36,4823,"[np.float32(1.0), np.float32(0.0), np.float32(0.0), np.float32(0.0), np.float32(0.0), np.float32(1.0), np.float32(0.0), np.float32(1.0), np.float32(0.0), np.float32(0.0), np.float32(0.0), np.float32(1.0), np.float32(0.0), np.float32(0.0), np.float32(0.0), np.float32(1.0)]",0.0,99609.0,1
2025-08-14_08-18-36,4824,"[np.float32(1.0), np.float32(0.0), np.float32(0.0), np.float32(1.0), np.float32(0.0), np.float32(0.0), np.float32(0.0), np.float32(1.0), np.float32(0.0), np.float32(0.0), np.float32(0.0), np.float32(0.0), np.float32(0.0), np.float32(1.0), np.float32(0.0), np.float32(0.0)]",-1.0,99608.0,0
2025-08-14_08-18-36,4825,"[np.float32(1.0), np.float32(0.0), np.float32(0.0), np.float32(0.0), np.float32(1.0), np.float32(0.0), np.float32(1.0), np.float32(1.0), np.float32(0.0), np.float32(0.0), np.float32(0.0), np.float32(0.0), np.float32(1.0), np.float32(1.0), np.float32(0.0), np.float32(1.0)]",1.0,99609.0,6
2025-08-14_08-18-36,4826,"[np.float32(1.0), np.float32(1.0), np.float32(0.0), np.float32(0.0), np.float32(0.0), np.float32(1.0), np.float32(1.0), np.float32(1.0), np.float32(1.0), np.float32(1.0), np.float32(0.0), np.float32(1.0), np.float32(0.0), np.float32(1.0), np.float32(0.0), np.float32(0.0)]",-2.0,99607.0,23
2025-08-14_08-18-36,4827,"[np.float32(1.0), np.float32(0.0), np.float32(1.0), np.float32(0.0), np.float32(0.0), np.float32(0.0), np.float32(0.0), np.float32(0.0), np.float32(1.0), np.float32(0.0), np.float32(0.0), np.float32(0.0), np.float32(1.0), np.float32(0.0), np.float32(1.0), np.float32(0.0)]",5.0,99612.0,36
2025-08-14_08-18-36,4828,"[np.float32(0.0), np.float32(0.0), np.float32(1.0), np.float32(1.0), np.float32(1.0), np.float32(0.0), np.float32(0.0), np.float32(0.0), np.float32(1.0), np.float32(0.0), np.float32(0.0), np.float32(0.0), np.float32(0.0), np.float32(1.0), np.float32(0.0), np.float32(0.0)]",0.0,99612.0,34
2025-08-14_08-18-36,4829,"[np.float32(1.0), np.float32(0.0), np.float32(0.0), np.float32(1.0), np.float32(0.0), np.float32(1.0), np.float32(1.0), np.float32(1.0), np.float32(0.0), np.float32(0.0), np.float32(0.0), np.float32(1.0), np.float32(1.0), np.float32(0.0), np.float32(0.0), np.float32(0.0)]",0.0,99612.0,30
2025-08-14_08-18-36,4830,"[np.float32(0.0), np.float32(0.0), np.float32(0.0), np.float32(0.0), np.float32(0.0), np.float32(0.0), np.float32(1.0), np.float32(1.0), np.float32(0.0), np.float32(0.0), np.float32(0.0), np.float32(0.0), np.float32(0.0), np.float32(1.0), np.float32(1.0), np.float32(1.0)]",1.0,99613.0,6
2025-08-14_08-18-36,4831,"[np.float32(0.0), np.float32(1.0), np.float32(0.0), np.float32(1.0), np.float32(0.0), np.float32(1.0), np.float32(0.0), np.float32(1.0), np.float32(1.0), np.float32(0.0), np.float32(1.0), np.float32(1.0), np.float32(0.0), np.float32(1.0), np.float32(0.0), np.float32(0.0)]",1.0,99614.0,31
2025-08-14_08-18-36,4832,"[np.float32(0.0), np.float32(0.0), np.float32(0.0), np.float32(1.0), np.float32(1.0), np.float32(0.0), np.float32(0.0), np.float32(1.0), np.float32(1.0), np.float32(0.0), np.float32(0.0), np.float32(0.0), np.float32(1.0), np.float32(0.0), np.float32(1.0), np.float32(0.0)]",-3.0,99611.0,20
2025-08-14_08-18-36,4833,"[np.float32(1.0), np.float32(0.0), np.float32(0.0), np.float32(0.0), np.float32(0.0), np.float32(1.0), np.float32(0.0), np.float32(0.0), np.float32(0.0), np.float32(0.0), np.float32(0.0), np.float32(0.0), np.float32(0.0), np.float32(1.0), np.float32(0.0), np.float32(0.0)]",-1.0,99610.0,24
2025-08-14_08-18-36,4834,"[np.float32(0.0), np.float32(1.0), np.float32(0.0), np.float32(1.0), np.float32(0.0), np.float32(1.0), np.float32(0.0), np.float32(0.0), np.float32(1.0), np.float32(0.0), np.float32(0.0), np.float32(1.0), np.float32(0.0), np.float32(0.0), np.float32(1.0), np.float32(1.0)]",0.0,99610.0,23
2025-08-14_08-18-36,4835,"[np.float32(1.0), np.float32(1.0), np.float32(0.0), np.float32(1.0), np.float32(1.0), np.float32(0.0), np.float32(0.0), np.float32(0.0), np.float32(1.0), np.float32(0.0), np.float32(0.0), np.float32(1.0), np.float32(0.0), np.float32(0.0), np.float32(0.0), np.float32(0.0)]",2.0,99612.0,30
2025-08-14_08-18-36,4836,"[np.float32(0.0), np.float32(0.0), np.float32(0.0), np.float32(0.0), np.float32(0.0), np.float32(0.0), np.float32(1.0), np.float32(1.0), np.float32(1.0), np.float32(1.0), np.float32(0.0), np.float32(0.0), np.float32(0.0), np.float32(1.0), np.float32(0.0), np.float32(1.0)]",0.0,99612.0,13
2025-08-14_08-18-36,4837,"[np.float32(0.0), np.float32(0.0), np.float32(0.0), np.float32(0.0), np.float32(1.0), np.float32(1.0), np.float32(0.0), np.float32(1.0), np.float32(1.0), np.float32(1.0), np.float32(1.0), np.float32(0.0), np.float32(1.0), np.float32(0.0), np.float32(1.0), np.float32(0.0)]",0.0,99612.0,36
2025-08-14_08-18-36,4838,"[np.float32(1.0), np.float32(1.0), np.float32(0.0), np.float32(1.0), np.float32(1.0), np.float32(0.0), np.float32(1.0), np.float32(1.0), np.float32(0.0), np.float32(0.0), np.float32(0.0), np.float32(0.0), np.float32(1.0), np.float32(0.0), np.float32(0.0), np.float32(1.0)]",4.0,99616.0,17
2025-08-14_08-18-36,4839,"[np.float32(1.0), np.float32(1.0), np.float32(1.0), np.float32(0.0), np.float32(1.0), np.float32(0.0), np.float32(0.0), np.float32(0.0), np.float32(0.0), np.float32(0.0), np.float32(0.0), np.float32(0.0), np.float32(0.0), np.float32(0.0), np.float32(1.0), np.float32(0.0)]",-1.0,99615.0,22
2025-08-14_08-18-36,4840,"[np.float32(0.0), np.float32(0.0), np.float32(1.0), np.float32(0.0), np.float32(1.0), np.float32(0.0), np.float32(1.0), np.float32(1.0), np.float32(0.0), np.float32(0.0), np.float32(1.0), np.float32(1.0), np.float32(1.0), np.float32(0.0), np.float32(0.0), np.float32(0.0)]",1.0,99616.0,3
2025-08-14_08-18-36,4841,"[np.float32(0.0), np.float32(0.0), np.float32(0.0), np.float32(1.0), np.float32(1.0), np.float32(1.0), np.float32(1.0), np.float32(1.0), np.float32(1.0), np.float32(0.0), np.float32(1.0), np.float32(1.0), np.float32(1.0), np.float32(1.0), np.float32(1.0), np.float32(1.0)]",1.0,99617.0,33
2025-08-14_08-18-36,4842,"[np.float32(0.0), np.float32(0.0), np.float32(0.0), np.float32(1.0), np.float32(1.0), np.float32(1.0), np.float32(0.0), np.float32(1.0), np.float32(1.0), np.float32(1.0), np.float32(0.0), np.float32(0.0), np.float32(1.0), np.float32(0.0), np.float32(0.0), np.float32(0.0)]",0.0,99617.0,21
2025-08-14_08-18-36,4843,"[np.float32(0.0), np.float32(1.0), np.float32(0.0), np.float32(1.0), np.float32(0.0), np.float32(0.0), np.float32(1.0), np.float32(1.0), np.float32(0.0), np.float32(0.0), np.float32(0.0), np.float32(0.0), np.float32(1.0), np.float32(1.0), np.float32(1.0), np.float32(0.0)]",0.0,99617.0,33
2025-08-14_08-18-36,4844,"[np.float32(1.0), np.float32(1.0), np.float32(1.0), np.float32(1.0), np.float32(1.0), np.float32(1.0), np.float32(1.0), np.float32(1.0), np.float32(1.0), np.float32(0.0), np.float32(0.0), np.float32(1.0), np.float32(0.0), np.float32(0.0), np.float32(0.0), np.float32(0.0)]",-1.0,99616.0,14
2025-08-14_08-18-36,4845,"[np.float32(0.0), np.float32(0.0), np.float32(0.0), np.float32(1.0), np.float32(0.0), np.float32(1.0), np.float32(1.0), np.float32(1.0), np.float32(0.0), np.float32(1.0), np.float32(1.0), np.float32(1.0), np.float32(1.0), np.float32(0.0), np.float32(0.0), np.float32(1.0)]",-3.0,99613.0,8
2025-08-14_08-18-36,4846,"[np.float32(0.0), np.float32(0.0), np.float32(0.0), np.float32(1.0), np.float32(1.0), np.float32(1.0), np.float32(0.0), np.float32(1.0), np.float32(0.0), np.float32(0.0), np.float32(1.0), np.float32(1.0), np.float32(0.0), np.float32(1.0), np.float32(0.0), np.float32(0.0)]",1.0,99614.0,20
2025-08-14_08-18-36,4847,"[np.float32(0.0), np.float32(0.0), np.float32(0.0), np.float32(1.0), np.float32(0.0), np.float32(0.0), np.float32(1.0), np.float32(0.0), np.float32(1.0), np.float32(1.0), np.float32(0.0), np.float32(1.0), np.float32(0.0), np.float32(1.0), np.float32(1.0), np.float32(1.0)]",0.0,99614.0,11
2025-08-14_08-18-36,4848,"[np.float32(1.0), np.float32(0.0), np.float32(1.0), np.float32(0.0), np.float32(0.0), np.float32(1.0), np.float32(0.0), np.float32(0.0), np.float32(1.0), np.float32(1.0), np.float32(1.0), np.float32(0.0), np.float32(1.0), np.float32(1.0), np.float32(1.0), np.float32(1.0)]",1.0,99615.0,35
2025-08-14_08-18-36,4849,"[np.float32(0.0), np.float32(1.0), np.float32(1.0), np.float32(1.0), np.float32(1.0), np.float32(0.0), np.float32(1.0), np.float32(0.0), np.float32(1.0), np.float32(1.0), np.float32(1.0), np.float32(0.0), np.float32(1.0), np.float32(0.0), np.float32(0.0), np.float32(1.0)]",-2.0,99613.0,32
2025-08-14_08-18-36,4850,"[np.float32(1.0), np.float32(0.0), np.float32(1.0), np.float32(0.0), np.float32(1.0), np.float32(1.0), np.float32(0.0), np.float32(0.0), np.float32(0.0), np.float32(0.0), np.float32(1.0), np.float32(1.0), np.float32(0.0), np.float32(1.0), np.float32(1.0), np.float32(1.0)]",1.0,99614.0,24
2025-08-14_08-18-36,4851,"[np.float32(0.0), np.float32(0.0), np.float32(0.0), np.float32(1.0), np.float32(0.0), np.float32(0.0), np.float32(0.0), np.float32(1.0), np.float32(0.0), np.float32(0.0), np.float32(0.0), np.float32(0.0), np.float32(0.0), np.float32(0.0), np.float32(0.0), np.float32(1.0)]",-1.0,99613.0,3
2025-08-14_08-18-36,4852,"[np.float32(1.0), np.float32(0.0), np.float32(0.0), np.float32(1.0), np.float32(0.0), np.float32(1.0), np.float32(0.0), np.float32(1.0), np.float32(0.0), np.float32(0.0), np.float32(0.0), np.float32(1.0), np.float32(0.0), np.float32(0.0), np.float32(0.0), np.float32(0.0)]",0.0,99613.0,22
2025-08-14_08-18-36,4853,"[np.float32(1.0), np.float32(0.0), np.float32(1.0), np.float32(0.0), np.float32(0.0), np.float32(1.0), np.float32(1.0), np.float32(0.0), np.float32(0.0), np.float32(1.0), np.float32(1.0), np.float32(0.0), np.float32(0.0), np.float32(1.0), np.float32(0.0), np.float32(0.0)]",2.0,99615.0,34
2025-08-14_08-18-36,4854,"[np.float32(0.0), np.float32(0.0), np.float32(0.0), np.float32(1.0), np.float32(1.0), np.float32(0.0), np.float32(0.0), np.float32(0.0), np.float32(1.0), np.float32(0.0), np.float32(0.0), np.float32(0.0), np.float32(1.0), np.float32(1.0), np.float32(0.0), np.float32(0.0)]",3.0,99618.0,25
2025-08-14_08-18-36,4855,"[np.float32(0.0), np.float32(1.0), np.float32(0.0), np.float32(1.0), np.float32(1.0), np.float32(1.0), np.float32(0.0), np.float32(1.0), np.float32(1.0), np.float32(1.0), np.float32(0.0), np.float32(0.0), np.float32(0.0), np.float32(0.0), np.float32(1.0), np.float32(1.0)]",1.0,99619.0,22
2025-08-14_08-18-36,4856,"[np.float32(0.0), np.float32(1.0), np.float32(0.0), np.float32(1.0), np.float32(1.0), np.float32(1.0), np.float32(1.0), np.float32(1.0), np.float32(0.0), np.float32(1.0), np.float32(1.0), np.float32(1.0), np.float32(1.0), np.float32(0.0), np.float32(1.0), np.float32(1.0)]",34.0,99653.0,7
2025-08-14_08-18-36,4857,"[np.float32(1.0), np.float32(0.0), np.float32(1.0), np.float32(1.0), np.float32(1.0), np.float32(1.0), np.float32(1.0), np.float32(1.0), np.float32(1.0), np.float32(0.0), np.float32(1.0), np.float32(0.0), np.float32(1.0), np.float32(1.0), np.float32(1.0), np.float32(0.0)]",0.0,99653.0,18
2025-08-14_08-18-36,4858,"[np.float32(0.0), np.float32(0.0), np.float32(1.0), np.float32(1.0), np.float32(0.0), np.float32(0.0), np.float32(0.0), np.float32(1.0), np.float32(0.0), np.float32(0.0), np.float32(1.0), np.float32(1.0), np.float32(0.0), np.float32(0.0), np.float32(0.0), np.float32(1.0)]",-4.0,99649.0,7
2025-08-14_08-18-36,4859,"[np.float32(1.0), np.float32(0.0), np.float32(0.0), np.float32(1.0), np.float32(1.0), np.float32(1.0), np.float32(0.0), np.float32(1.0), np.float32(0.0), np.float32(1.0), np.float32(1.0), np.float32(0.0), np.float32(1.0), np.float32(0.0), np.float32(1.0), np.float32(0.0)]",-2.0,99647.0,15
2025-08-14_08-18-36,4860,"[np.float32(0.0), np.float32(0.0), np.float32(1.0), np.float32(0.0), np.float32(1.0), np.float32(0.0), np.float32(0.0), np.float32(1.0), np.float32(0.0), np.float32(1.0), np.float32(1.0), np.float32(0.0), np.float32(0.0), np.float32(1.0), np.float32(1.0), np.float32(1.0)]",0.0,99647.0,15
2025-08-14_08-18-36,4861,"[np.float32(0.0), np.float32(0.0), np.float32(0.0), np.float32(1.0), np.float32(1.0), np.float32(0.0), np.float32(1.0), np.float32(1.0), np.float32(0.0), np.float32(1.0), np.float32(1.0), np.float32(0.0), np.float32(0.0), np.float32(0.0), np.float32(0.0), np.float32(1.0)]",1.0,99648.0,2
2025-08-14_08-18-36,4862,"[np.float32(1.0), np.float32(0.0), np.float32(1.0), np.float32(1.0), np.float32(1.0), np.float32(0.0), np.float32(0.0), np.float32(1.0), np.float32(1.0), np.float32(1.0), np.float32(0.0), np.float32(1.0), np.float32(0.0), np.float32(1.0), np.float32(1.0), np.float32(0.0)]",-1.0,99647.0,14
2025-08-14_08-18-36,4863,"[np.float32(1.0), np.float32(1.0), np.float32(1.0), np.float32(0.0), np.float32(0.0), np.float32(1.0), np.float32(0.0), np.float32(1.0), np.float32(1.0), np.float32(0.0), np.float32(1.0), np.float32(1.0), np.float32(0.0), np.float32(0.0), np.float32(0.0), np.float32(0.0)]",-3.0,99644.0,5
2025-08-14_08-18-36,4864,"[np.float32(0.0), np.float32(1.0), np.float32(1.0), np.float32(1.0), np.float32(0.0), np.float32(0.0), np.float32(0.0), np.float32(1.0), np.float32(0.0), np.float32(0.0), np.float32(1.0), np.float32(0.0), np.float32(0.0), np.float32(1.0), np.float32(0.0), np.float32(0.0)]",-2.0,99642.0,6
2025-08-14_08-18-36,4865,"[np.float32(1.0), np.float32(0.0), np.float32(0.0), np.float32(0.0), np.float32(0.0), np.float32(1.0), np.float32(1.0), np.float32(1.0), np.float32(1.0), np.float32(0.0), np.float32(0.0), np.float32(0.0), np.float32(0.0), np.float32(0.0), np.float32(1.0), np.float32(0.0)]",-1.0,99641.0,26
2025-08-14_08-18-36,4866,"[np.float32(1.0), np.float32(1.0), np.float32(0.0), np.float32(1.0), np.float32(0.0), np.float32(1.0), np.float32(0.0), np.float32(0.0), np.float32(1.0), np.float32(0.0), np.float32(1.0), np.float32(0.0), np.float32(0.0), np.float32(0.0), np.float32(0.0), np.float32(0.0)]",6.0,99647.0,29
2025-08-14_08-18-36,4867,"[np.float32(0.0), np.float32(0.0), np.float32(1.0), np.float32(0.0), np.float32(0.0), np.float32(1.0), np.float32(1.0), np.float32(1.0), np.float32(1.0), np.float32(0.0), np.float32(1.0), np.float32(1.0), np.float32(0.0), np.float32(1.0), np.float32(0.0), np.float32(1.0)]",1.0,99648.0,28
2025-08-14_08-18-36,4868,"[np.float32(1.0), np.float32(1.0), np.float32(0.0), np.float32(0.0), np.float32(0.0), np.float32(0.0), np.float32(1.0), np.float32(0.0), np.float32(0.0), np.float32(1.0), np.float32(1.0), np.float32(1.0), np.float32(0.0), np.float32(1.0), np.float32(0.0), np.float32(0.0)]",1.0,99649.0,8
2025-08-14_08-18-36,4869,"[np.float32(1.0), np.float32(0.0), np.float32(1.0), np.float32(1.0), np.float32(0.0), np.float32(0.0), np.float32(0.0), np.float32(1.0), np.float32(0.0), np.float32(0.0), np.float32(0.0), np.float32(1.0), np.float32(0.0), np.float32(0.0), np.float32(1.0), np.float32(0.0)]",-2.0,99647.0,32
2025-08-14_08-18-36,4870,"[np.float32(1.0), np.float32(0.0), np.float32(0.0), np.float32(1.0), np.float32(0.0), np.float32(0.0), np.float32(1.0), np.float32(1.0), np.float32(0.0), np.float32(1.0), np.float32(1.0), np.float32(1.0), np.float32(1.0), np.float32(1.0), np.float32(1.0), np.float32(0.0)]",-2.0,99645.0,14
2025-08-14_08-18-36,4871,"[np.float32(1.0), np.float32(0.0), np.float32(1.0), np.float32(1.0), np.float32(1.0), np.float32(1.0), np.float32(1.0), np.float32(1.0), np.float32(1.0), np.float32(1.0), np.float32(1.0), np.float32(1.0), np.float32(0.0), np.float32(0.0), np.float32(0.0), np.float32(1.0)]",-2.0,99643.0,33
2025-08-14_08-18-36,4872,"[np.float32(0.0), np.float32(1.0), np.float32(1.0), np.float32(0.0), np.float32(0.0), np.float32(0.0), np.float32(0.0), np.float32(0.0), np.float32(1.0), np.float32(1.0), np.float32(0.0), np.float32(0.0), np.float32(1.0), np.float32(1.0), np.float32(0.0), np.float32(1.0)]",-7.0,99636.0,23
2025-08-14_08-18-36,4873,"[np.float32(0.0), np.float32(1.0), np.float32(0.0), np.float32(1.0), np.float32(0.0), np.float32(1.0), np.float32(0.0), np.float32(1.0), np.float32(1.0), np.float32(0.0), np.float32(1.0), np.float32(0.0), np.float32(1.0), np.float32(0.0), np.float32(1.0), np.float32(1.0)]",-1.0,99635.0,32
2025-08-14_08-18-36,4874,"[np.float32(1.0), np.float32(0.0), np.float32(0.0), np.float32(1.0), np.float32(1.0), np.float32(1.0), np.float32(1.0), np.float32(1.0), np.float32(1.0), np.float32(1.0), np.float32(1.0), np.float32(1.0), np.float32(1.0), np.float32(0.0), np.float32(0.0), np.float32(1.0)]",3.0,99638.0,1
2025-08-14_08-18-36,4875,"[np.float32(1.0), np.float32(1.0), np.float32(1.0), np.float32(1.0), np.float32(0.0), np.float32(0.0), np.float32(1.0), np.float32(1.0), np.float32(0.0), np.float32(1.0), np.float32(0.0), np.float32(1.0), np.float32(1.0), np.float32(0.0), np.float32(0.0), np.float32(1.0)]",0.0,99638.0,13
2025-08-14_08-18-36,4876,"[np.float32(1.0), np.float32(1.0), np.float32(0.0), np.float32(1.0), np.float32(0.0), np.float32(0.0), np.float32(1.0), np.float32(0.0), np.float32(0.0), np.float32(1.0), np.float32(1.0), np.float32(1.0), np.float32(0.0), np.float32(1.0), np.float32(1.0), np.float32(1.0)]",-2.0,99636.0,14
2025-08-14_08-18-36,4877,"[np.float32(0.0), np.float32(0.0), np.float32(1.0), np.float32(1.0), np.float32(1.0), np.float32(1.0), np.float32(1.0), np.float32(1.0), np.float32(0.0), np.float32(0.0), np.float32(0.0), np.float32(0.0), np.float32(0.0), np.float32(0.0), np.float32(0.0), np.float32(0.0)]",-2.0,99634.0,28
2025-08-14_08-18-36,4878,"[np.float32(0.0), np.float32(1.0), np.float32(0.0), np.float32(1.0), np.float32(0.0), np.float32(0.0), np.float32(0.0), np.float32(0.0), np.float32(1.0), np.float32(0.0), np.float32(1.0), np.float32(0.0), np.float32(1.0), np.float32(0.0), np.float32(0.0), np.float32(0.0)]",-3.0,99631.0,1
2025-08-14_08-18-36,4879,"[np.float32(0.0), np.float32(0.0), np.float32(0.0), np.float32(0.0), np.float32(1.0), np.float32(1.0), np.float32(0.0), np.float32(1.0), np.float32(1.0), np.float32(0.0), np.float32(0.0), np.float32(0.0), np.float32(0.0), np.float32(0.0), np.float32(0.0), np.float32(0.0)]",-2.0,99629.0,3
2025-08-14_08-18-36,4880,"[np.float32(1.0), np.float32(0.0), np.float32(1.0), np.float32(0.0), np.float32(0.0), np.float32(0.0), np.float32(0.0), np.float32(1.0), np.float32(1.0), np.float32(0.0), np.float32(1.0), np.float32(0.0), np.float32(0.0), np.float32(0.0), np.float32(0.0), np.float32(0.0)]",-1.0,99628.0,12
2025-08-14_08-18-36,4881,"[np.float32(1.0), np.float32(1.0), np.float32(1.0), np.float32(1.0), np.float32(0.0), np.float32(1.0), np.float32(0.0), np.float32(0.0), np.float32(1.0), np.float32(0.0), np.float32(1.0), np.float32(1.0), np.float32(0.0), np.float32(1.0), np.float32(0.0), np.float32(0.0)]",-5.0,99623.0,13
2025-08-14_08-18-36,4882,"[np.float32(1.0), np.float32(1.0), np.float32(0.0), np.float32(0.0), np.float32(1.0), np.float32(1.0), np.float32(1.0), np.float32(1.0), np.float32(1.0), np.float32(0.0), np.float32(0.0), np.float32(1.0), np.float32(0.0), np.float32(1.0), np.float32(1.0), np.float32(0.0)]",0.0,99623.0,32
2025-08-14_08-18-36,4883,"[np.float32(0.0), np.float32(0.0), np.float32(1.0), np.float32(1.0), np.float32(1.0), np.float32(1.0), np.float32(1.0), np.float32(0.0), np.float32(0.0), np.float32(1.0), np.float32(0.0), np.float32(1.0), np.float32(0.0), np.float32(1.0), np.float32(0.0), np.float32(0.0)]",5.0,99628.0,7
2025-08-14_08-18-36,4884,"[np.float32(0.0), np.float32(1.0), np.float32(1.0), np.float32(1.0), np.float32(1.0), np.float32(0.0), np.float32(1.0), np.float32(0.0), np.float32(1.0), np.float32(1.0), np.float32(0.0), np.float32(0.0), np.float32(1.0), np.float32(1.0), np.float32(0.0), np.float32(0.0)]",1.0,99629.0,1
2025-08-14_08-18-36,4885,"[np.float32(0.0), np.float32(1.0), np.float32(0.0), np.float32(1.0), np.float32(0.0), np.float32(1.0), np.float32(1.0), np.float32(1.0), np.float32(1.0), np.float32(1.0), np.float32(0.0), np.float32(1.0), np.float32(1.0), np.float32(0.0), np.float32(1.0), np.float32(0.0)]",-5.0,99624.0,32
2025-08-14_08-18-36,4886,"[np.float32(0.0), np.float32(1.0), np.float32(0.0), np.float32(1.0), np.float32(1.0), np.float32(1.0), np.float32(0.0), np.float32(1.0), np.float32(1.0), np.float32(1.0), np.float32(0.0), np.float32(0.0), np.float32(0.0), np.float32(1.0), np.float32(1.0), np.float32(0.0)]",1.0,99625.0,7
2025-08-14_08-18-36,4887,"[np.float32(1.0), np.float32(0.0), np.float32(0.0), np.float32(0.0), np.float32(1.0), np.float32(0.0), np.float32(0.0), np.float32(1.0), np.float32(1.0), np.float32(1.0), np.float32(1.0), np.float32(1.0), np.float32(1.0), np.float32(0.0), np.float32(1.0), np.float32(1.0)]",1.0,99626.0,23
2025-08-14_08-18-36,4888,"[np.float32(1.0), np.float32(0.0), np.float32(0.0), np.float32(0.0), np.float32(0.0), np.float32(1.0), np.float32(0.0), np.float32(1.0), np.float32(1.0), np.float32(0.0), np.float32(1.0), np.float32(0.0), np.float32(0.0), np.float32(1.0), np.float32(0.0), np.float32(1.0)]",1.0,99627.0,18
2025-08-14_08-18-36,4889,"[np.float32(0.0), np.float32(0.0), np.float32(1.0), np.float32(1.0), np.float32(0.0), np.float32(0.0), np.float32(1.0), np.float32(1.0), np.float32(1.0), np.float32(0.0), np.float32(1.0), np.float32(0.0), np.float32(0.0), np.float32(1.0), np.float32(0.0), np.float32(0.0)]",1.0,99628.0,14
2025-08-14_08-18-36,4890,"[np.float32(0.0), np.float32(1.0), np.float32(1.0), np.float32(0.0), np.float32(0.0), np.float32(1.0), np.float32(0.0), np.float32(1.0), np.float32(1.0), np.float32(1.0), np.float32(1.0), np.float32(0.0), np.float32(0.0), np.float32(1.0), np.float32(0.0), np.float32(0.0)]",5.0,99633.0,35
2025-08-14_08-18-36,4891,"[np.float32(0.0), np.float32(0.0), np.float32(0.0), np.float32(0.0), np.float32(0.0), np.float32(0.0), np.float32(0.0), np.float32(0.0), np.float32(0.0), np.float32(1.0), np.float32(1.0), np.float32(1.0), np.float32(1.0), np.float32(0.0), np.float32(0.0), np.float32(0.0)]",-1.0,99632.0,10
2025-08-14_08-18-36,4892,"[np.float32(1.0), np.float32(1.0), np.float32(0.0), np.float32(0.0), np.float32(1.0), np.float32(0.0), np.float32(1.0), np.float32(1.0), np.float32(0.0), np.float32(1.0), np.float32(0.0), np.float32(0.0), np.float32(0.0), np.float32(0.0), np.float32(0.0), np.float32(0.0)]",1.0,99633.0,14
2025-08-14_08-18-36,4893,"[np.float32(1.0), np.float32(0.0), np.float32(1.0), np.float32(0.0), np.float32(0.0), np.float32(0.0), np.float32(0.0), np.float32(1.0), np.float32(0.0), np.float32(1.0), np.float32(1.0), np.float32(0.0), np.float32(0.0), np.float32(1.0), np.float32(0.0), np.float32(1.0)]",1.0,99634.0,26
2025-08-14_08-18-36,4894,"[np.float32(1.0), np.float32(0.0), np.float32(1.0), np.float32(1.0), np.float32(1.0), np.float32(1.0), np.float32(1.0), np.float32(1.0), np.float32(1.0), np.float32(0.0), np.float32(1.0), np.float32(0.0), np.float32(0.0), np.float32(1.0), np.float32(0.0), np.float32(1.0)]",-2.0,99632.0,27
2025-08-14_08-18-36,4895,"[np.float32(1.0), np.float32(0.0), np.float32(0.0), np.float32(1.0), np.float32(1.0), np.float32(1.0), np.float32(0.0), np.float32(1.0), np.float32(0.0), np.float32(0.0), np.float32(0.0), np.float32(0.0), np.float32(1.0), np.float32(0.0), np.float32(0.0), np.float32(0.0)]",-4.0,99628.0,28
2025-08-14_08-18-36,4896,"[np.float32(1.0), np.float32(0.0), np.float32(1.0), np.float32(1.0), np.float32(0.0), np.float32(1.0), np.float32(1.0), np.float32(1.0), np.float32(1.0), np.float32(1.0), np.float32(1.0), np.float32(0.0), np.float32(0.0), np.float32(1.0), np.float32(1.0), np.float32(0.0)]",-3.0,99625.0,15
2025-08-14_08-18-36,4897,"[np.float32(0.0), np.float32(1.0), np.float32(1.0), np.float32(0.0), np.float32(0.0), np.float32(0.0), np.float32(0.0), np.float32(0.0), np.float32(1.0), np.float32(0.0), np.float32(1.0), np.float32(0.0), np.float32(0.0), np.float32(1.0), np.float32(0.0), np.float32(0.0)]",0.0,99625.0,15
2025-08-14_08-18-36,4898,"[np.float32(1.0), np.float32(0.0), np.float32(0.0), np.float32(0.0), np.float32(1.0), np.float32(0.0), np.float32(1.0), np.float32(1.0), np.float32(0.0), np.float32(0.0), np.float32(1.0), np.float32(0.0), np.float32(1.0), np.float32(1.0), np.float32(1.0), np.float32(0.0)]",-6.0,99619.0,34
2025-08-14_08-18-36,4899,"[np.float32(0.0), np.float32(1.0), np.float32(0.0), np.float32(0.0), np.float32(1.0), np.float32(1.0), np.float32(0.0), np.float32(0.0), np.float32(1.0), np.float32(0.0), np.float32(0.0), np.float32(0.0), np.float32(0.0), np.float32(1.0), np.float32(1.0), np.float32(1.0)]",0.0,99619.0,2
2025-08-14_08-18-36,4900,"[np.float32(0.0), np.float32(1.0), np.float32(0.0), np.float32(1.0), np.float32(0.0), np.float32(0.0), np.float32(1.0), np.float32(1.0), np.float32(0.0), np.float32(0.0), np.float32(0.0), np.float32(0.0), np.float32(0.0), np.float32(1.0), np.float32(0.0), np.float32(1.0)]",4.0,99623.0,17
2025-08-14_08-18-36,4901,"[np.float32(1.0), np.float32(1.0), np.float32(0.0), np.float32(0.0), np.float32(0.0), np.float32(1.0), np.float32(1.0), np.float32(1.0), np.float32(1.0), np.float32(0.0), np.float32(1.0), np.float32(0.0), np.float32(0.0), np.float32(1.0), np.float32(0.0), np.float32(0.0)]",-3.0,99620.0,9
2025-08-14_08-18-36,4902,"[np.float32(0.0), np.float32(1.0), np.float32(0.0), np.float32(0.0), np.float32(0.0), np.float32(0.0), np.float32(0.0), np.float32(0.0), np.float32(0.0), np.float32(1.0), np.float32(1.0), np.float32(0.0), np.float32(0.0), np.float32(0.0), np.float32(0.0), np.float32(1.0)]",4.0,99624.0,17
2025-08-14_08-18-36,4903,"[np.float32(1.0), np.float32(0.0), np.float32(0.0), np.float32(1.0), np.float32(0.0), np.float32(1.0), np.float32(0.0), np.float32(0.0), np.float32(0.0), np.float32(1.0), np.float32(1.0), np.float32(1.0), np.float32(0.0), np.float32(1.0), np.float32(1.0), np.float32(1.0)]",1.0,99625.0,1
2025-08-14_08-18-36,4904,"[np.float32(0.0), np.float32(0.0), np.float32(1.0), np.float32(1.0), np.float32(0.0), np.float32(1.0), np.float32(0.0), np.float32(1.0), np.float32(0.0), np.float32(1.0), np.float32(1.0), np.float32(1.0), np.float32(1.0), np.float32(1.0), np.float32(0.0), np.float32(0.0)]",-1.0,99624.0,2
2025-08-14_08-18-36,4905,"[np.float32(0.0), np.float32(1.0), np.float32(1.0), np.float32(0.0), np.float32(0.0), np.float32(0.0), np.float32(0.0), np.float32(1.0), np.float32(0.0), np.float32(1.0), np.float32(0.0), np.float32(0.0), np.float32(1.0), np.float32(1.0), np.float32(0.0), np.float32(1.0)]",3.0,99627.0,4
2025-08-14_08-18-36,4906,"[np.float32(0.0), np.float32(1.0), np.float32(0.0), np.float32(0.0), np.float32(0.0), np.float32(0.0), np.float32(1.0), np.float32(0.0), np.float32(1.0), np.float32(0.0), np.float32(1.0), np.float32(1.0), np.float32(1.0), np.float32(0.0), np.float32(0.0), np.float32(0.0)]",-4.0,99623.0,22
2025-08-14_08-18-36,4907,"[np.float32(0.0), np.float32(0.0), np.float32(0.0), np.float32(1.0), np.float32(0.0), np.float32(1.0), np.float32(1.0), np.float32(0.0), np.float32(1.0), np.float32(1.0), np.float32(0.0), np.float32(1.0), np.float32(1.0), np.float32(1.0), np.float32(0.0), np.float32(1.0)]",-4.0,99619.0,17
2025-08-14_08-18-36,4908,"[np.float32(0.0), np.float32(1.0), np.float32(1.0), np.float32(0.0), np.float32(1.0), np.float32(1.0), np.float32(0.0), np.float32(1.0), np.float32(1.0), np.float32(0.0), np.float32(0.0), np.float32(1.0), np.float32(1.0), np.float32(1.0), np.float32(1.0), np.float32(1.0)]",30.0,99649.0,7
2025-08-14_08-18-36,4909,"[np.float32(0.0), np.float32(0.0), np.float32(0.0), np.float32(1.0), np.float32(0.0), np.float32(0.0), np.float32(0.0), np.float32(1.0), np.float32(1.0), np.float32(0.0), np.float32(0.0), np.float32(1.0), np.float32(0.0), np.float32(0.0), np.float32(0.0), np.float32(1.0)]",3.0,99652.0,27
2025-08-14_08-18-36,4910,"[np.float32(1.0), np.float32(1.0), np.float32(0.0), np.float32(0.0), np.float32(1.0), np.float32(1.0), np.float32(1.0), np.float32(1.0), np.float32(1.0), np.float32(0.0), np.float32(1.0), np.float32(0.0), np.float32(0.0), np.float32(1.0), np.float32(0.0), np.float32(0.0)]",1.0,99653.0,18
2025-08-14_08-18-36,4911,"[np.float32(1.0), np.float32(1.0), np.float32(1.0), np.float32(0.0), np.float32(0.0), np.float32(1.0), np.float32(1.0), np.float32(0.0), np.float32(0.0), np.float32(1.0), np.float32(1.0), np.float32(0.0), np.float32(0.0), np.float32(0.0), np.float32(1.0), np.float32(0.0)]",-6.0,99647.0,15
2025-08-14_08-18-36,4912,"[np.float32(0.0), np.float32(1.0), np.float32(0.0), np.float32(0.0), np.float32(0.0), np.float32(1.0), np.float32(0.0), np.float32(0.0), np.float32(0.0), np.float32(0.0), np.float32(1.0), np.float32(0.0), np.float32(0.0), np.float32(1.0), np.float32(0.0), np.float32(0.0)]",1.0,99648.0,15
2025-08-14_08-18-36,4913,"[np.float32(1.0), np.float32(0.0), np.float32(0.0), np.float32(0.0), np.float32(0.0), np.float32(1.0), np.float32(0.0), np.float32(1.0), np.float32(1.0), np.float32(1.0), np.float32(1.0), np.float32(1.0), np.float32(0.0), np.float32(0.0), np.float32(0.0), np.float32(0.0)]",-1.0,99647.0,17
2025-08-14_08-18-36,4914,"[np.float32(1.0), np.float32(0.0), np.float32(1.0), np.float32(0.0), np.float32(1.0), np.float32(1.0), np.float32(0.0), np.float32(1.0), np.float32(1.0), np.float32(0.0), np.float32(0.0), np.float32(1.0), np.float32(0.0), np.float32(0.0), np.float32(1.0), np.float32(1.0)]",-2.0,99645.0,25
2025-08-14_08-18-36,4915,"[np.float32(0.0), np.float32(0.0), np.float32(0.0), np.float32(0.0), np.float32(0.0), np.float32(1.0), np.float32(0.0), np.float32(1.0), np.float32(0.0), np.float32(0.0), np.float32(0.0), np.float32(0.0), np.float32(1.0), np.float32(0.0), np.float32(0.0), np.float32(1.0)]",-2.0,99643.0,26
2025-08-14_08-18-36,4916,"[np.float32(1.0), np.float32(0.0), np.float32(1.0), np.float32(0.0), np.float32(1.0), np.float32(1.0), np.float32(1.0), np.float32(0.0), np.float32(1.0), np.float32(1.0), np.float32(1.0), np.float32(1.0), np.float32(1.0), np.float32(1.0), np.float32(1.0), np.float32(0.0)]",3.0,99646.0,32
2025-08-14_08-18-36,4917,"[np.float32(0.0), np.float32(0.0), np.float32(1.0), np.float32(1.0), np.float32(1.0), np.float32(0.0), np.float32(1.0), np.float32(0.0), np.float32(0.0), np.float32(1.0), np.float32(0.0), np.float32(0.0), np.float32(1.0), np.float32(1.0), np.float32(1.0), np.float32(1.0)]",1.0,99647.0,3
2025-08-14_08-18-36,4918,"[np.float32(0.0), np.float32(0.0), np.float32(0.0), np.float32(1.0), np.float32(0.0), np.float32(1.0), np.float32(0.0), np.float32(1.0), np.float32(1.0), np.float32(0.0), np.float32(1.0), np.float32(0.0), np.float32(0.0), np.float32(0.0), np.float32(0.0), np.float32(0.0)]",0.0,99647.0,34
2025-08-14_08-18-36,4919,"[np.float32(1.0), np.float32(1.0), np.float32(0.0), np.float32(0.0), np.float32(0.0), np.float32(1.0), np.float32(1.0), np.float32(1.0), np.float32(1.0), np.float32(1.0), np.float32(0.0), np.float32(0.0), np.float32(0.0), np.float32(1.0), np.float32(0.0), np.float32(0.0)]",-1.0,99646.0,36
2025-08-14_08-18-36,4920,"[np.float32(1.0), np.float32(0.0), np.float32(0.0), np.float32(1.0), np.float32(1.0), np.float32(1.0), np.float32(1.0), np.float32(1.0), np.float32(0.0), np.float32(0.0), np.float32(1.0), np.float32(0.0), np.float32(0.0), np.float32(1.0), np.float32(0.0), np.float32(0.0)]",4.0,99650.0,3
2025-08-14_08-18-36,4921,"[np.float32(1.0), np.float32(0.0), np.float32(1.0), np.float32(1.0), np.float32(0.0), np.float32(0.0), np.float32(1.0), np.float32(0.0), np.float32(1.0), np.float32(1.0), np.float32(1.0), np.float32(1.0), np.float32(1.0), np.float32(1.0), np.float32(0.0), np.float32(1.0)]",0.0,99650.0,28
2025-08-14_08-18-36,4922,"[np.float32(0.0), np.float32(0.0), np.float32(1.0), np.float32(1.0), np.float32(1.0), np.float32(0.0), np.float32(0.0), np.float32(1.0), np.float32(0.0), np.float32(0.0), np.float32(0.0), np.float32(0.0), np.float32(1.0), np.float32(0.0), np.float32(1.0), np.float32(0.0)]",1.0,99651.0,14
2025-08-14_08-18-36,4923,"[np.float32(0.0), np.float32(0.0), np.float32(0.0), np.float32(0.0), np.float32(1.0), np.float32(1.0), np.float32(0.0), np.float32(0.0), np.float32(1.0), np.float32(0.0), np.float32(1.0), np.float32(1.0), np.float32(0.0), np.float32(1.0), np.float32(0.0), np.float32(1.0)]",-2.0,99649.0,4
2025-08-14_08-18-36,4924,"[np.float32(0.0), np.float32(0.0), np.float32(0.0), np.float32(1.0), np.float32(0.0), np.float32(0.0), np.float32(1.0), np.float32(0.0), np.float32(0.0), np.float32(0.0), np.float32(0.0), np.float32(1.0), np.float32(0.0), np.float32(0.0), np.float32(0.0), np.float32(0.0)]",-1.0,99648.0,25
2025-08-14_08-18-36,4925,"[np.float32(0.0), np.float32(1.0), np.float32(0.0), np.float32(0.0), np.float32(0.0), np.float32(1.0), np.float32(1.0), np.float32(1.0), np.float32(1.0), np.float32(1.0), np.float32(1.0), np.float32(1.0), np.float32(1.0), np.float32(1.0), np.float32(0.0), np.float32(1.0)]",2.0,99650.0,31
2025-08-14_08-18-36,4926,"[np.float32(1.0), np.float32(0.0), np.float32(1.0), np.float32(0.0), np.float32(0.0), np.float32(1.0), np.float32(0.0), np.float32(1.0), np.float32(1.0), np.float32(1.0), np.float32(0.0), np.float32(0.0), np.float32(1.0), np.float32(0.0), np.float32(0.0), np.float32(0.0)]",2.0,99652.0,36
2025-08-14_08-18-36,4927,"[np.float32(0.0), np.float32(0.0), np.float32(0.0), np.float32(1.0), np.float32(1.0), np.float32(1.0), np.float32(1.0), np.float32(1.0), np.float32(0.0), np.float32(1.0), np.float32(1.0), np.float32(1.0), np.float32(1.0), np.float32(0.0), np.float32(1.0), np.float32(0.0)]",-3.0,99649.0,31
2025-08-14_08-18-36,4928,"[np.float32(1.0), np.float32(1.0), np.float32(1.0), np.float32(0.0), np.float32(0.0), np.float32(1.0), np.float32(0.0), np.float32(0.0), np.float32(0.0), np.float32(0.0), np.float32(1.0), np.float32(0.0), np.float32(1.0), np.float32(1.0), np.float32(1.0), np.float32(1.0)]",-2.0,99647.0,19
2025-08-14_08-18-36,4929,"[np.float32(1.0), np.float32(0.0), np.float32(1.0), np.float32(1.0), np.float32(0.0), np.float32(1.0), np.float32(0.0), np.float32(1.0), np.float32(1.0), np.float32(0.0), np.float32(0.0), np.float32(0.0), np.float32(1.0), np.float32(0.0), np.float32(0.0), np.float32(1.0)]",1.0,99648.0,27
2025-08-14_08-18-36,4930,"[np.float32(1.0), np.float32(0.0), np.float32(1.0), np.float32(1.0), np.float32(1.0), np.float32(1.0), np.float32(1.0), np.float32(1.0), np.float32(1.0), np.float32(1.0), np.float32(0.0), np.float32(1.0), np.float32(1.0), np.float32(0.0), np.float32(0.0), np.float32(0.0)]",-4.0,99644.0,17
2025-08-14_08-18-36,4931,"[np.float32(0.0), np.float32(1.0), np.float32(0.0), np.float32(1.0), np.float32(1.0), np.float32(1.0), np.float32(0.0), np.float32(0.0), np.float32(1.0), np.float32(1.0), np.float32(1.0), np.float32(1.0), np.float32(0.0), np.float32(0.0), np.float32(0.0), np.float32(0.0)]",2.0,99646.0,28
2025-08-14_08-18-36,4932,"[np.float32(0.0), np.float32(0.0), np.float32(1.0), np.float32(1.0), np.float32(1.0), np.float32(0.0), np.float32(0.0), np.float32(0.0), np.float32(0.0), np.float32(1.0), np.float32(0.0), np.float32(0.0), np.float32(1.0), np.float32(0.0), np.float32(0.0), np.float32(1.0)]",1.0,99647.0,10
2025-08-14_08-18-36,4933,"[np.float32(1.0), np.float32(1.0), np.float32(0.0), np.float32(0.0), np.float32(0.0), np.float32(1.0), np.float32(0.0), np.float32(0.0), np.float32(0.0), np.float32(0.0), np.float32(1.0), np.float32(0.0), np.float32(0.0), np.float32(0.0), np.float32(0.0), np.float32(0.0)]",1.0,99648.0,17
2025-08-14_08-18-36,4934,"[np.float32(0.0), np.float32(1.0), np.float32(0.0), np.float32(0.0), np.float32(0.0), np.float32(1.0), np.float32(0.0), np.float32(0.0), np.float32(0.0), np.float32(0.0), np.float32(1.0), np.float32(1.0), np.float32(0.0), np.float32(0.0), np.float32(1.0), np.float32(0.0)]",0.0,99648.0,10
2025-08-14_08-18-36,4935,"[np.float32(1.0), np.float32(1.0), np.float32(1.0), np.float32(1.0), np.float32(0.0), np.float32(1.0), np.float32(1.0), np.float32(1.0), np.float32(1.0), np.float32(0.0), np.float32(1.0), np.float32(0.0), np.float32(1.0), np.float32(0.0), np.float32(1.0), np.float32(0.0)]",-4.0,99644.0,6
2025-08-14_08-18-36,4936,"[np.float32(1.0), np.float32(0.0), np.float32(0.0), np.float32(0.0), np.float32(0.0), np.float32(0.0), np.float32(1.0), np.float32(1.0), np.float32(1.0), np.float32(1.0), np.float32(0.0), np.float32(0.0), np.float32(1.0), np.float32(0.0), np.float32(1.0), np.float32(0.0)]",-4.0,99640.0,29
2025-08-14_08-18-36,4937,"[np.float32(0.0), np.float32(1.0), np.float32(0.0), np.float32(1.0), np.float32(1.0), np.float32(0.0), np.float32(0.0), np.float32(0.0), np.float32(1.0), np.float32(1.0), np.float32(1.0), np.float32(0.0), np.float32(1.0), np.float32(1.0), np.float32(0.0), np.float32(1.0)]",1.0,99641.0,1
2025-08-14_08-18-36,4938,"[np.float32(0.0), np.float32(1.0), np.float32(0.0), np.float32(1.0), np.float32(0.0), np.float32(0.0), np.float32(0.0), np.float32(1.0), np.float32(0.0), np.float32(1.0), np.float32(1.0), np.float32(1.0), np.float32(1.0), np.float32(1.0), np.float32(0.0), np.float32(1.0)]",-1.0,99640.0,26
2025-08-14_08-18-36,4939,"[np.float32(0.0), np.float32(0.0), np.float32(0.0), np.float32(0.0), np.float32(1.0), np.float32(0.0), np.float32(0.0), np.float32(1.0), np.float32(1.0), np.float32(0.0), np.float32(0.0), np.float32(0.0), np.float32(1.0), np.float32(1.0), np.float32(0.0), np.float32(0.0)]",1.0,99641.0,32
2025-08-14_08-18-36,4940,"[np.float32(1.0), np.float32(0.0), np.float32(0.0), np.float32(1.0), np.float32(0.0), np.float32(1.0), np.float32(1.0), np.float32(0.0), np.float32(0.0), np.float32(0.0), np.float32(0.0), np.float32(1.0), np.float32(1.0), np.float32(0.0), np.float32(0.0), np.float32(1.0)]",-1.0,99640.0,25
2025-08-14_08-18-36,4941,"[np.float32(1.0), np.float32(0.0), np.float32(1.0), np.float32(0.0), np.float32(1.0), np.float32(1.0), np.float32(1.0), np.float32(1.0), np.float32(1.0), np.float32(1.0), np.float32(1.0), np.float32(1.0), np.float32(0.0), np.float32(0.0), np.float32(0.0), np.float32(0.0)]",0.0,99640.0,23
2025-08-14_08-18-36,4942,"[np.float32(0.0), np.float32(0.0), np.float32(1.0), np.float32(1.0), np.float32(1.0), np.float32(0.0), np.float32(1.0), np.float32(1.0), np.float32(0.0), np.float32(1.0), np.float32(1.0), np.float32(0.0), np.float32(0.0), np.float32(0.0), np.float32(0.0), np.float32(0.0)]",-2.0,99638.0,31
2025-08-14_08-18-36,4943,"[np.float32(0.0), np.float32(0.0), np.float32(0.0), np.float32(0.0), np.float32(1.0), np.float32(0.0), np.float32(0.0), np.float32(1.0), np.float32(0.0), np.float32(1.0), np.float32(0.0), np.float32(1.0), np.float32(0.0), np.float32(1.0), np.float32(0.0), np.float32(1.0)]",0.0,99638.0,24
2025-08-14_08-18-36,4944,"[np.float32(0.0), np.float32(1.0), np.float32(1.0), np.float32(1.0), np.float32(0.0), np.float32(1.0), np.float32(0.0), np.float32(1.0), np.float32(0.0), np.float32(0.0), np.float32(1.0), np.float32(0.0), np.float32(0.0), np.float32(1.0), np.float32(0.0), np.float32(0.0)]",3.0,99641.0,21
2025-08-14_08-18-36,4945,"[np.float32(1.0), np.float32(1.0), np.float32(0.0), np.float32(0.0), np.float32(0.0), np.float32(0.0), np.float32(1.0), np.float32(1.0), np.float32(1.0), np.float32(0.0), np.float32(0.0), np.float32(0.0), np.float32(0.0), np.float32(0.0), np.float32(1.0), np.float32(0.0)]",2.0,99643.0,11
2025-08-14_08-18-36,4946,"[np.float32(0.0), np.float32(1.0), np.float32(0.0), np.float32(0.0), np.float32(0.0), np.float32(0.0), np.float32(0.0), np.float32(0.0), np.float32(0.0), np.float32(1.0), np.float32(1.0), np.float32(0.0), np.float32(0.0), np.float32(1.0), np.float32(0.0), np.float32(0.0)]",-2.0,99641.0,24
2025-08-14_08-18-36,4947,"[np.float32(1.0), np.float32(1.0), np.float32(0.0), np.float32(0.0), np.float32(0.0), np.float32(1.0), np.float32(1.0), np.float32(1.0), np.float32(0.0), np.float32(0.0), np.float32(1.0), np.float32(1.0), np.float32(0.0), np.float32(0.0), np.float32(1.0), np.float32(0.0)]",-4.0,99637.0,28
2025-08-14_08-18-36,4948,"[np.float32(1.0), np.float32(1.0), np.float32(1.0), np.float32(1.0), np.float32(0.0), np.float32(1.0), np.float32(1.0), np.float32(1.0), np.float32(0.0), np.float32(1.0), np.float32(1.0), np.float32(1.0), np.float32(0.0), np.float32(1.0), np.float32(0.0), np.float32(1.0)]",1.0,99638.0,15
2025-08-14_08-18-36,4949,"[np.float32(0.0), np.float32(1.0), np.float32(0.0), np.float32(1.0), np.float32(0.0), np.float32(1.0), np.float32(1.0), np.float32(1.0), np.float32(1.0), np.float32(1.0), np.float32(1.0), np.float32(0.0), np.float32(0.0), np.float32(0.0), np.float32(0.0), np.float32(0.0)]",2.0,99640.0,23
2025-08-14_08-18-36,4950,"[np.float32(0.0), np.float32(0.0), np.float32(0.0), np.float32(0.0), np.float32(1.0), np.float32(0.0), np.float32(0.0), np.float32(0.0), np.float32(1.0), np.float32(0.0), np.float32(0.0), np.float32(0.0), np.float32(0.0), np.float32(0.0), np.float32(1.0), np.float32(0.0)]",-3.0,99637.0,21
2025-08-14_08-18-36,4951,"[np.float32(0.0), np.float32(1.0), np.float32(0.0), np.float32(0.0), np.float32(0.0), np.float32(0.0), np.float32(1.0), np.float32(1.0), np.float32(0.0), np.float32(0.0), np.float32(1.0), np.float32(1.0), np.float32(1.0), np.float32(0.0), np.float32(1.0), np.float32(1.0)]",3.0,99640.0,8
2025-08-14_08-18-36,4952,"[np.float32(1.0), np.float32(0.0), np.float32(1.0), np.float32(1.0), np.float32(0.0), np.float32(1.0), np.float32(0.0), np.float32(1.0), np.float32(1.0), np.float32(0.0), np.float32(0.0), np.float32(0.0), np.float32(1.0), np.float32(1.0), np.float32(1.0), np.float32(1.0)]",0.0,99640.0,33
2025-08-14_08-18-36,4953,"[np.float32(0.0), np.float32(1.0), np.float32(1.0), np.float32(1.0), np.float32(0.0), np.float32(0.0), np.float32(0.0), np.float32(1.0), np.float32(1.0), np.float32(1.0), np.float32(1.0), np.float32(1.0), np.float32(0.0), np.float32(0.0), np.float32(0.0), np.float32(1.0)]",-1.0,99639.0,21
2025-08-14_08-18-36,4954,"[np.float32(1.0), np.float32(1.0), np.float32(1.0), np.float32(1.0), np.float32(1.0), np.float32(0.0), np.float32(0.0), np.float32(1.0), np.float32(0.0), np.float32(0.0), np.float32(0.0), np.float32(1.0), np.float32(0.0), np.float32(1.0), np.float32(0.0), np.float32(1.0)]",-3.0,99636.0,11
2025-08-14_08-18-36,4955,"[np.float32(1.0), np.float32(0.0), np.float32(1.0), np.float32(0.0), np.float32(1.0), np.float32(1.0), np.float32(0.0), np.float32(1.0), np.float32(1.0), np.float32(0.0), np.float32(0.0), np.float32(1.0), np.float32(0.0), np.float32(0.0), np.float32(0.0), np.float32(0.0)]",-3.0,99633.0,2
2025-08-14_08-18-36,4956,"[np.float32(1.0), np.float32(0.0), np.float32(0.0), np.float32(1.0), np.float32(1.0), np.float32(1.0), np.float32(1.0), np.float32(1.0), np.float32(1.0), np.float32(0.0), np.float32(1.0), np.float32(1.0), np.float32(1.0), np.float32(1.0), np.float32(1.0), np.float32(0.0)]",1.0,99634.0,33
2025-08-14_08-18-36,4957,"[np.float32(0.0), np.float32(0.0), np.float32(0.0), np.float32(0.0), np.float32(1.0), np.float32(0.0), np.float32(0.0), np.float32(1.0), np.float32(0.0), np.float32(1.0), np.float32(1.0), np.float32(0.0), np.float32(1.0), np.float32(0.0), np.float32(0.0), np.float32(0.0)]",-3.0,99631.0,9
2025-08-14_08-18-36,4958,"[np.float32(0.0), np.float32(1.0), np.float32(1.0), np.float32(1.0), np.float32(1.0), np.float32(1.0), np.float32(0.0), np.float32(0.0), np.float32(1.0), np.float32(1.0), np.float32(0.0), np.float32(0.0), np.float32(0.0), np.float32(0.0), np.float32(0.0), np.float32(0.0)]",-3.0,99628.0,18
2025-08-14_08-18-36,4959,"[np.float32(0.0), np.float32(1.0), np.float32(0.0), np.float32(1.0), np.float32(0.0), np.float32(0.0), np.float32(0.0), np.float32(0.0), np.float32(0.0), np.float32(1.0), np.float32(1.0), np.float32(1.0), np.float32(0.0), np.float32(1.0), np.float32(1.0), np.float32(0.0)]",0.0,99628.0,31
2025-08-14_08-18-36,4960,"[np.float32(0.0), np.float32(0.0), np.float32(0.0), np.float32(1.0), np.float32(0.0), np.float32(1.0), np.float32(1.0), np.float32(1.0), np.float32(1.0), np.float32(0.0), np.float32(0.0), np.float32(0.0), np.float32(0.0), np.float32(0.0), np.float32(0.0), np.float32(0.0)]",0.0,99628.0,7
2025-08-14_08-18-36,4961,"[np.float32(0.0), np.float32(0.0), np.float32(0.0), np.float32(0.0), np.float32(1.0), np.float32(1.0), np.float32(0.0), np.float32(1.0), np.float32(0.0), np.float32(0.0), np.float32(0.0), np.float32(0.0), np.float32(0.0), np.float32(1.0), np.float32(1.0), np.float32(0.0)]",0.0,99628.0,0
2025-08-14_08-18-36,4962,"[np.float32(0.0), np.float32(0.0), np.float32(1.0), np.float32(1.0), np.float32(0.0), np.float32(0.0), np.float32(1.0), np.float32(1.0), np.float32(1.0), np.float32(0.0), np.float32(0.0), np.float32(0.0), np.float32(0.0), np.float32(1.0), np.float32(0.0), np.float32(0.0)]",-1.0,99627.0,17
2025-08-14_08-18-36,4963,"[np.float32(0.0), np.float32(1.0), np.float32(1.0), np.float32(0.0), np.float32(1.0), np.float32(0.0), np.float32(0.0), np.float32(1.0), np.float32(1.0), np.float32(0.0), np.float32(0.0), np.float32(1.0), np.float32(1.0), np.float32(1.0), np.float32(1.0), np.float32(0.0)]",2.0,99629.0,33
2025-08-14_08-18-36,4964,"[np.float32(1.0), np.float32(0.0), np.float32(0.0), np.float32(1.0), np.float32(0.0), np.float32(0.0), np.float32(1.0), np.float32(1.0), np.float32(1.0), np.float32(0.0), np.float32(1.0), np.float32(0.0), np.float32(1.0), np.float32(0.0), np.float32(1.0), np.float32(0.0)]",-5.0,99624.0,22
2025-08-14_08-18-36,4965,"[np.float32(1.0), np.float32(0.0), np.float32(0.0), np.float32(0.0), np.float32(0.0), np.float32(0.0), np.float32(1.0), np.float32(1.0), np.float32(0.0), np.float32(1.0), np.float32(1.0), np.float32(1.0), np.float32(0.0), np.float32(1.0), np.float32(0.0), np.float32(0.0)]",-1.0,99623.0,24
2025-08-14_08-18-36,4966,"[np.float32(0.0), np.float32(0.0), np.float32(1.0), np.float32(1.0), np.float32(1.0), np.float32(0.0), np.float32(0.0), np.float32(0.0), np.float32(1.0), np.float32(1.0), np.float32(0.0), np.float32(1.0), np.float32(0.0), np.float32(0.0), np.float32(0.0), np.float32(0.0)]",-2.0,99621.0,17
2025-08-14_08-18-36,4967,"[np.float32(0.0), np.float32(0.0), np.float32(1.0), np.float32(1.0), np.float32(0.0), np.float32(1.0), np.float32(0.0), np.float32(0.0), np.float32(0.0), np.float32(0.0), np.float32(1.0), np.float32(0.0), np.float32(1.0), np.float32(1.0), np.float32(1.0), np.float32(1.0)]",-3.0,99618.0,3
2025-08-14_08-18-36,4968,"[np.float32(1.0), np.float32(0.0), np.float32(1.0), np.float32(0.0), np.float32(0.0), np.float32(1.0), np.float32(1.0), np.float32(1.0), np.float32(0.0), np.float32(0.0), np.float32(0.0), np.float32(1.0), np.float32(0.0), np.float32(0.0), np.float32(0.0), np.float32(1.0)]",-2.0,99616.0,33
2025-08-14_08-18-36,4969,"[np.float32(0.0), np.float32(0.0), np.float32(0.0), np.float32(1.0), np.float32(0.0), np.float32(0.0), np.float32(1.0), np.float32(1.0), np.float32(1.0), np.float32(0.0), np.float32(1.0), np.float32(0.0), np.float32(1.0), np.float32(0.0), np.float32(1.0), np.float32(1.0)]",-2.0,99614.0,34
2025-08-14_08-18-36,4970,"[np.float32(0.0), np.float32(0.0), np.float32(0.0), np.float32(0.0), np.float32(0.0), np.float32(0.0), np.float32(1.0), np.float32(1.0), np.float32(0.0), np.float32(0.0), np.float32(1.0), np.float32(0.0), np.float32(1.0), np.float32(1.0), np.float32(1.0), np.float32(0.0)]",-3.0,99611.0,1
2025-08-14_08-18-36,4971,"[np.float32(0.0), np.float32(0.0), np.float32(1.0), np.float32(0.0), np.float32(1.0), np.float32(1.0), np.float32(1.0), np.float32(1.0), np.float32(1.0), np.float32(0.0), np.float32(0.0), np.float32(0.0), np.float32(0.0), np.float32(1.0), np.float32(0.0), np.float32(0.0)]",3.0,99614.0,18
2025-08-14_08-18-36,4972,"[np.float32(1.0), np.float32(0.0), np.float32(1.0), np.float32(1.0), np.float32(0.0), np.float32(1.0), np.float32(1.0), np.float32(1.0), np.float32(0.0), np.float32(0.0), np.float32(0.0), np.float32(0.0), np.float32(1.0), np.float32(1.0), np.float32(1.0), np.float32(1.0)]",0.0,99614.0,22
2025-08-14_08-18-36,4973,"[np.float32(0.0), np.float32(1.0), np.float32(1.0), np.float32(0.0), np.float32(0.0), np.float32(1.0), np.float32(1.0), np.float32(0.0), np.float32(1.0), np.float32(1.0), np.float32(1.0), np.float32(1.0), np.float32(0.0), np.float32(1.0), np.float32(0.0), np.float32(1.0)]",-1.0,99613.0,3
2025-08-14_08-18-36,4974,"[np.float32(1.0), np.float32(0.0), np.float32(0.0), np.float32(0.0), np.float32(0.0), np.float32(0.0), np.float32(1.0), np.float32(1.0), np.float32(0.0), np.float32(1.0), np.float32(1.0), np.float32(0.0), np.float32(1.0), np.float32(1.0), np.float32(0.0), np.float32(1.0)]",-5.0,99608.0,0
2025-08-14_08-18-36,4975,"[np.float32(1.0), np.float32(0.0), np.float32(1.0), np.float32(1.0), np.float32(0.0), np.float32(0.0), np.float32(0.0), np.float32(1.0), np.float32(1.0), np.float32(0.0), np.float32(1.0), np.float32(0.0), np.float32(1.0), np.float32(0.0), np.float32(1.0), np.float32(0.0)]",0.0,99608.0,33
2025-08-14_08-18-36,4976,"[np.float32(0.0), np.float32(0.0), np.float32(0.0), np.float32(0.0), np.float32(0.0), np.float32(1.0), np.float32(0.0), np.float32(1.0), np.float32(1.0), np.float32(1.0), np.float32(1.0), np.float32(1.0), np.float32(0.0), np.float32(1.0), np.float32(0.0), np.float32(0.0)]",4.0,99612.0,22
2025-08-14_08-18-36,4977,"[np.float32(0.0), np.float32(1.0), np.float32(0.0), np.float32(0.0), np.float32(0.0), np.float32(1.0), np.float32(0.0), np.float32(1.0), np.float32(0.0), np.float32(0.0), np.float32(1.0), np.float32(1.0), np.float32(1.0), np.float32(0.0), np.float32(0.0), np.float32(1.0)]",-2.0,99610.0,34
2025-08-14_08-18-36,4978,"[np.float32(0.0), np.float32(0.0), np.float32(0.0), np.float32(1.0), np.float32(0.0), np.float32(0.0), np.float32(0.0), np.float32(0.0), np.float32(0.0), np.float32(1.0), np.float32(1.0), np.float32(0.0), np.float32(0.0), np.float32(0.0), np.float32(0.0), np.float32(0.0)]",2.0,99612.0,11
2025-08-14_08-18-36,4979,"[np.float32(0.0), np.float32(0.0), np.float32(1.0), np.float32(0.0), np.float32(0.0), np.float32(1.0), np.float32(0.0), np.float32(0.0), np.float32(1.0), np.float32(0.0), np.float32(1.0), np.float32(1.0), np.float32(1.0), np.float32(1.0), np.float32(0.0), np.float32(0.0)]",0.0,99612.0,34
2025-08-14_08-18-36,4980,"[np.float32(0.0), np.float32(0.0), np.float32(1.0), np.float32(1.0), np.float32(1.0), np.float32(1.0), np.float32(0.0), np.float32(1.0), np.float32(0.0), np.float32(1.0), np.float32(0.0), np.float32(0.0), np.float32(1.0), np.float32(1.0), np.float32(0.0), np.float32(1.0)]",-2.0,99610.0,6
2025-08-14_08-18-36,4981,"[np.float32(1.0), np.float32(1.0), np.float32(1.0), np.float32(1.0), np.float32(0.0), np.float32(1.0), np.float32(0.0), np.float32(1.0), np.float32(0.0), np.float32(1.0), np.float32(0.0), np.float32(1.0), np.float32(0.0), np.float32(0.0), np.float32(0.0), np.float32(0.0)]",4.0,99614.0,24
2025-08-14_08-18-36,4982,"[np.float32(0.0), np.float32(1.0), np.float32(1.0), np.float32(1.0), np.float32(0.0), np.float32(0.0), np.float32(1.0), np.float32(1.0), np.float32(1.0), np.float32(1.0), np.float32(0.0), np.float32(0.0), np.float32(1.0), np.float32(1.0), np.float32(1.0), np.float32(1.0)]",-1.0,99613.0,29
2025-08-14_08-18-36,4983,"[np.float32(0.0), np.float32(0.0), np.float32(1.0), np.float32(0.0), np.float32(0.0), np.float32(1.0), np.float32(1.0), np.float32(1.0), np.float32(0.0), np.float32(1.0), np.float32(0.0), np.float32(0.0), np.float32(0.0), np.float32(1.0), np.float32(0.0), np.float32(0.0)]",-2.0,99611.0,36
2025-08-14_08-18-36,4984,"[np.float32(1.0), np.float32(0.0), np.float32(1.0), np.float32(0.0), np.float32(1.0), np.float32(1.0), np.float32(1.0), np.float32(1.0), np.float32(0.0), np.float32(1.0), np.float32(1.0), np.float32(1.0), np.float32(0.0), np.float32(1.0), np.float32(1.0), np.float32(1.0)]",-2.0,99609.0,26
2025-08-14_08-18-36,4985,"[np.float32(1.0), np.float32(1.0), np.float32(0.0), np.float32(1.0), np.float32(0.0), np.float32(0.0), np.float32(1.0), np.float32(0.0), np.float32(1.0), np.float32(0.0), np.float32(0.0), np.float32(1.0), np.float32(1.0), np.float32(0.0), np.float32(1.0), np.float32(1.0)]",-2.0,99607.0,25
2025-08-14_08-18-36,4986,"[np.float32(1.0), np.float32(1.0), np.float32(0.0), np.float32(0.0), np.float32(0.0), np.float32(1.0), np.float32(0.0), np.float32(1.0), np.float32(0.0), np.float32(1.0), np.float32(1.0), np.float32(1.0), np.float32(1.0), np.float32(1.0), np.float32(0.0), np.float32(0.0)]",-4.0,99603.0,10
2025-08-14_08-18-36,4987,"[np.float32(1.0), np.float32(0.0), np.float32(1.0), np.float32(1.0), np.float32(1.0), np.float32(0.0), np.float32(0.0), np.float32(1.0), np.float32(1.0), np.float32(1.0), np.float32(0.0), np.float32(0.0), np.float32(1.0), np.float32(1.0), np.float32(0.0), np.float32(0.0)]",-1.0,99602.0,35
2025-08-14_08-18-36,4988,"[np.float32(0.0), np.float32(1.0), np.float32(1.0), np.float32(1.0), np.float32(1.0), np.float32(1.0), np.float32(1.0), np.float32(1.0), np.float32(0.0), np.float32(1.0), np.float32(1.0), np.float32(0.0), np.float32(1.0), np.float32(0.0), np.float32(0.0), np.float32(1.0)]",1.0,99603.0,31
2025-08-14_08-18-36,4989,"[np.float32(0.0), np.float32(1.0), np.float32(1.0), np.float32(1.0), np.float32(0.0), np.float32(1.0), np.float32(1.0), np.float32(1.0), np.float32(1.0), np.float32(0.0), np.float32(1.0), np.float32(0.0), np.float32(1.0), np.float32(1.0), np.float32(0.0), np.float32(1.0)]",1.0,99604.0,22
2025-08-14_08-18-36,4990,"[np.float32(0.0), np.float32(0.0), np.float32(0.0), np.float32(1.0), np.float32(0.0), np.float32(1.0), np.float32(0.0), np.float32(0.0), np.float32(1.0), np.float32(1.0), np.float32(0.0), np.float32(0.0), np.float32(0.0), np.float32(1.0), np.float32(0.0), np.float32(0.0)]",2.0,99606.0,33
2025-08-14_08-18-36,4991,"[np.float32(1.0), np.float32(0.0), np.float32(0.0), np.float32(0.0), np.float32(0.0), np.float32(0.0), np.float32(1.0), np.float32(0.0), np.float32(1.0), np.float32(1.0), np.float32(1.0), np.float32(0.0), np.float32(1.0), np.float32(0.0), np.float32(1.0), np.float32(0.0)]",-1.0,99605.0,28
2025-08-14_08-18-36,4992,"[np.float32(0.0), np.float32(1.0), np.float32(1.0), np.float32(0.0), np.float32(0.0), np.float32(0.0), np.float32(1.0), np.float32(0.0), np.float32(0.0), np.float32(1.0), np.float32(0.0), np.float32(0.0), np.float32(0.0), np.float32(0.0), np.float32(0.0), np.float32(0.0)]",0.0,99605.0,24
2025-08-14_08-18-36,4993,"[np.float32(1.0), np.float32(1.0), np.float32(1.0), np.float32(1.0), np.float32(1.0), np.float32(0.0), np.float32(0.0), np.float32(0.0), np.float32(1.0), np.float32(0.0), np.float32(1.0), np.float32(0.0), np.float32(1.0), np.float32(1.0), np.float32(0.0), np.float32(0.0)]",-3.0,99602.0,10
2025-08-14_08-18-36,4994,"[np.float32(0.0), np.float32(0.0), np.float32(1.0), np.float32(0.0), np.float32(0.0), np.float32(1.0), np.float32(1.0), np.float32(1.0), np.float32(1.0), np.float32(1.0), np.float32(0.0), np.float32(0.0), np.float32(1.0), np.float32(1.0), np.float32(1.0), np.float32(1.0)]",-4.0,99598.0,17
2025-08-14_08-18-36,4995,"[np.float32(0.0), np.float32(1.0), np.float32(1.0), np.float32(1.0), np.float32(1.0), np.float32(1.0), np.float32(0.0), np.float32(1.0), np.float32(1.0), np.float32(1.0), np.float32(0.0), np.float32(0.0), np.float32(0.0), np.float32(0.0), np.float32(0.0), np.float32(1.0)]",-3.0,99595.0,8
2025-08-14_08-18-36,4996,"[np.float32(1.0), np.float32(0.0), np.float32(1.0), np.float32(1.0), np.float32(1.0), np.float32(1.0), np.float32(0.0), np.float32(1.0), np.float32(1.0), np.float32(0.0), np.float32(1.0), np.float32(0.0), np.float32(1.0), np.float32(0.0), np.float32(0.0), np.float32(1.0)]",-4.0,99591.0,3
2025-08-14_08-18-36,4997,"[np.float32(0.0), np.float32(1.0), np.float32(1.0), np.float32(1.0), np.float32(0.0), np.float32(1.0), np.float32(0.0), np.float32(0.0), np.float32(1.0), np.float32(0.0), np.float32(1.0), np.float32(0.0), np.float32(0.0), np.float32(1.0), np.float32(0.0), np.float32(1.0)]",1.0,99592.0,33
2025-08-14_08-18-36,4998,"[np.float32(1.0), np.float32(1.0), np.float32(0.0), np.float32(1.0), np.float32(1.0), np.float32(0.0), np.float32(0.0), np.float32(1.0), np.float32(0.0), np.float32(0.0), np.float32(0.0), np.float32(1.0), np.float32(1.0), np.float32(1.0), np.float32(0.0), np.float32(1.0)]",-2.0,99590.0,23
2025-08-14_08-18-36,4999,"[np.float32(1.0), np.float32(1.0), np.float32(1.0), np.float32(1.0), np.float32(0.0), np.float32(1.0), np.float32(0.0), np.float32(1.0), np.float32(0.0), np.float32(0.0), np.float32(1.0), np.float32(1.0), np.float32(1.0), np.float32(1.0), np.float32(1.0), np.float32(0.0)]",1.0,99591.0,26
2025-08-14_08-18-36,5000,"[np.float32(1.0), np.float32(1.0), np.float32(0.0), np.float32(1.0), np.float32(1.0), np.float32(1.0), np.float32(1.0), np.float32(1.0), np.float32(1.0), np.float32(0.0), np.float32(1.0), np.float32(0.0), np.float32(1.0), np.float32(1.0), np.float32(0.0), np.float32(0.0)]",-1.0,99590.0,4
2025-08-14_08-18-36,5001,"[np.float32(1.0), np.float32(0.0), np.float32(1.0), np.float32(1.0), np.float32(1.0), np.float32(1.0), np.float32(0.0), np.float32(1.0), np.float32(1.0), np.float32(0.0), np.float32(1.0), np.float32(0.0), np.float32(1.0), np.float32(1.0), np.float32(0.0), np.float32(0.0)]",-3.0,99520.0,33
2025-08-14_08-18-36,5002,"[np.float32(1.0), np.float32(1.0), np.float32(0.0), np.float32(0.0), np.float32(0.0), np.float32(1.0), np.float32(1.0), np.float32(1.0), np.float32(1.0), np.float32(1.0), np.float32(1.0), np.float32(1.0), np.float32(0.0), np.float32(1.0), np.float32(1.0), np.float32(1.0)]",1.0,99521.0,27
2025-08-14_08-18-36,5003,"[np.float32(0.0), np.float32(0.0), np.float32(0.0), np.float32(1.0), np.float32(1.0), np.float32(0.0), np.float32(1.0), np.float32(0.0), np.float32(0.0), np.float32(1.0), np.float32(0.0), np.float32(0.0), np.float32(0.0), np.float32(1.0), np.float32(1.0), np.float32(1.0)]",1.0,99522.0,2
2025-08-14_08-18-36,5004,"[np.float32(1.0), np.float32(0.0), np.float32(0.0), np.float32(0.0), np.float32(0.0), np.float32(0.0), np.float32(0.0), np.float32(0.0), np.float32(0.0), np.float32(0.0), np.float32(0.0), np.float32(1.0), np.float32(1.0), np.float32(0.0), np.float32(0.0), np.float32(0.0)]",-1.0,99521.0,14
2025-08-14_08-18-36,5005,"[np.float32(0.0), np.float32(0.0), np.float32(1.0), np.float32(0.0), np.float32(1.0), np.float32(1.0), np.float32(0.0), np.float32(0.0), np.float32(1.0), np.float32(1.0), np.float32(1.0), np.float32(0.0), np.float32(1.0), np.float32(1.0), np.float32(1.0), np.float32(0.0)]",4.0,99525.0,28
2025-08-14_08-18-36,5006,"[np.float32(0.0), np.float32(0.0), np.float32(0.0), np.float32(1.0), np.float32(1.0), np.float32(1.0), np.float32(1.0), np.float32(1.0), np.float32(0.0), np.float32(0.0), np.float32(1.0), np.float32(0.0), np.float32(0.0), np.float32(1.0), np.float32(0.0), np.float32(1.0)]",2.0,99527.0,1
2025-08-14_08-18-36,5007,"[np.float32(1.0), np.float32(1.0), np.float32(0.0), np.float32(0.0), np.float32(0.0), np.float32(1.0), np.float32(0.0), np.float32(1.0), np.float32(1.0), np.float32(1.0), np.float32(1.0), np.float32(1.0), np.float32(0.0), np.float32(0.0), np.float32(1.0), np.float32(1.0)]",-2.0,99525.0,1
2025-08-14_08-18-36,5008,"[np.float32(1.0), np.float32(1.0), np.float32(0.0), np.float32(0.0), np.float32(0.0), np.float32(1.0), np.float32(1.0), np.float32(1.0), np.float32(0.0), np.float32(0.0), np.float32(0.0), np.float32(1.0), np.float32(1.0), np.float32(1.0), np.float32(1.0), np.float32(1.0)]",0.0,99525.0,22
2025-08-14_08-18-36,5009,"[np.float32(0.0), np.float32(1.0), np.float32(0.0), np.float32(1.0), np.float32(1.0), np.float32(1.0), np.float32(0.0), np.float32(0.0), np.float32(0.0), np.float32(1.0), np.float32(0.0), np.float32(0.0), np.float32(1.0), np.float32(0.0), np.float32(0.0), np.float32(1.0)]",-3.0,99522.0,5
2025-08-14_08-18-36,5010,"[np.float32(0.0), np.float32(0.0), np.float32(0.0), np.float32(1.0), np.float32(0.0), np.float32(1.0), np.float32(0.0), np.float32(0.0), np.float32(0.0), np.float32(0.0), np.float32(0.0), np.float32(1.0), np.float32(1.0), np.float32(1.0), np.float32(1.0), np.float32(0.0)]",4.0,99526.0,27
2025-08-14_08-18-36,5011,"[np.float32(0.0), np.float32(0.0), np.float32(1.0), np.float32(1.0), np.float32(1.0), np.float32(1.0), np.float32(1.0), np.float32(1.0), np.float32(1.0), np.float32(0.0), np.float32(0.0), np.float32(1.0), np.float32(0.0), np.float32(0.0), np.float32(0.0), np.float32(0.0)]",-1.0,99525.0,26
2025-08-14_08-18-36,5012,"[np.float32(0.0), np.float32(0.0), np.float32(1.0), np.float32(0.0), np.float32(1.0), np.float32(0.0), np.float32(0.0), np.float32(0.0), np.float32(1.0), np.float32(0.0), np.float32(0.0), np.float32(1.0), np.float32(0.0), np.float32(1.0), np.float32(1.0), np.float32(1.0)]",-4.0,99521.0,19
2025-08-14_08-18-36,5013,"[np.float32(1.0), np.float32(1.0), np.float32(1.0), np.float32(0.0), np.float32(0.0), np.float32(1.0), np.float32(1.0), np.float32(1.0), np.float32(0.0), np.float32(0.0), np.float32(0.0), np.float32(1.0), np.float32(0.0), np.float32(0.0), np.float32(0.0), np.float32(1.0)]",-1.0,99520.0,10
2025-08-14_08-18-36,5014,"[np.float32(0.0), np.float32(1.0), np.float32(0.0), np.float32(0.0), np.float32(1.0), np.float32(0.0), np.float32(1.0), np.float32(1.0), np.float32(0.0), np.float32(1.0), np.float32(1.0), np.float32(1.0), np.float32(1.0), np.float32(0.0), np.float32(1.0), np.float32(0.0)]",2.0,99522.0,24
2025-08-14_08-18-36,5015,"[np.float32(1.0), np.float32(1.0), np.float32(0.0), np.float32(1.0), np.float32(0.0), np.float32(0.0), np.float32(0.0), np.float32(1.0), np.float32(1.0), np.float32(0.0), np.float32(1.0), np.float32(0.0), np.float32(0.0), np.float32(1.0), np.float32(0.0), np.float32(0.0)]",4.0,99526.0,32
2025-08-14_08-18-36,5016,"[np.float32(0.0), np.float32(1.0), np.float32(0.0), np.float32(1.0), np.float32(1.0), np.float32(0.0), np.float32(1.0), np.float32(0.0), np.float32(1.0), np.float32(1.0), np.float32(0.0), np.float32(1.0), np.float32(1.0), np.float32(1.0), np.float32(0.0), np.float32(0.0)]",-1.0,99525.0,19
2025-08-14_08-18-36,5017,"[np.float32(0.0), np.float32(1.0), np.float32(1.0), np.float32(0.0), np.float32(1.0), np.float32(1.0), np.float32(0.0), np.float32(1.0), np.float32(0.0), np.float32(0.0), np.float32(1.0), np.float32(0.0), np.float32(0.0), np.float32(1.0), np.float32(1.0), np.float32(0.0)]",2.0,99527.0,35
2025-08-14_08-18-36,5018,"[np.float32(1.0), np.float32(1.0), np.float32(0.0), np.float32(0.0), np.float32(1.0), np.float32(1.0), np.float32(1.0), np.float32(1.0), np.float32(0.0), np.float32(1.0), np.float32(1.0), np.float32(1.0), np.float32(1.0), np.float32(0.0), np.float32(0.0), np.float32(0.0)]",0.0,99527.0,15
2025-08-14_08-18-36,5019,"[np.float32(1.0), np.float32(0.0), np.float32(0.0), np.float32(0.0), np.float32(1.0), np.float32(1.0), np.float32(1.0), np.float32(1.0), np.float32(0.0), np.float32(1.0), np.float32(0.0), np.float32(0.0), np.float32(0.0), np.float32(1.0), np.float32(0.0), np.float32(0.0)]",0.0,99527.0,23
2025-08-14_08-18-36,5020,"[np.float32(1.0), np.float32(0.0), np.float32(1.0), np.float32(0.0), np.float32(0.0), np.float32(0.0), np.float32(1.0), np.float32(1.0), np.float32(1.0), np.float32(1.0), np.float32(0.0), np.float32(0.0), np.float32(1.0), np.float32(1.0), np.float32(1.0), np.float32(1.0)]",-1.0,99526.0,31
2025-08-14_08-18-36,5021,"[np.float32(0.0), np.float32(1.0), np.float32(1.0), np.float32(1.0), np.float32(1.0), np.float32(0.0), np.float32(0.0), np.float32(1.0), np.float32(0.0), np.float32(0.0), np.float32(1.0), np.float32(0.0), np.float32(0.0), np.float32(0.0), np.float32(1.0), np.float32(1.0)]",-4.0,99522.0,28
2025-08-14_08-18-36,5022,"[np.float32(0.0), np.float32(0.0), np.float32(1.0), np.float32(1.0), np.float32(1.0), np.float32(0.0), np.float32(0.0), np.float32(1.0), np.float32(0.0), np.float32(0.0), np.float32(1.0), np.float32(1.0), np.float32(1.0), np.float32(1.0), np.float32(0.0), np.float32(0.0)]",-6.0,99516.0,34
2025-08-14_08-18-36,5023,"[np.float32(1.0), np.float32(0.0), np.float32(0.0), np.float32(1.0), np.float32(0.0), np.float32(1.0), np.float32(0.0), np.float32(1.0), np.float32(1.0), np.float32(1.0), np.float32(0.0), np.float32(1.0), np.float32(0.0), np.float32(0.0), np.float32(0.0), np.float32(0.0)]",-5.0,99511.0,11
2025-08-14_08-18-36,5024,"[np.float32(1.0), np.float32(1.0), np.float32(0.0), np.float32(1.0), np.float32(1.0), np.float32(0.0), np.float32(1.0), np.float32(0.0), np.float32(1.0), np.float32(1.0), np.float32(1.0), np.float32(1.0), np.float32(1.0), np.float32(1.0), np.float32(0.0), np.float32(0.0)]",-4.0,99507.0,16
2025-08-14_08-18-36,5025,"[np.float32(1.0), np.float32(0.0), np.float32(0.0), np.float32(1.0), np.float32(1.0), np.float32(0.0), np.float32(0.0), np.float32(1.0), np.float32(1.0), np.float32(0.0), np.float32(0.0), np.float32(0.0), np.float32(0.0), np.float32(1.0), np.float32(1.0), np.float32(0.0)]",3.0,99510.0,21
2025-08-14_08-18-36,5026,"[np.float32(1.0), np.float32(0.0), np.float32(0.0), np.float32(1.0), np.float32(0.0), np.float32(1.0), np.float32(1.0), np.float32(1.0), np.float32(0.0), np.float32(1.0), np.float32(0.0), np.float32(0.0), np.float32(0.0), np.float32(0.0), np.float32(0.0), np.float32(0.0)]",-3.0,99507.0,8
2025-08-14_08-18-36,5027,"[np.float32(0.0), np.float32(0.0), np.float32(0.0), np.float32(1.0), np.float32(1.0), np.float32(1.0), np.float32(1.0), np.float32(1.0), np.float32(0.0), np.float32(1.0), np.float32(0.0), np.float32(0.0), np.float32(0.0), np.float32(0.0), np.float32(1.0), np.float32(0.0)]",-5.0,99502.0,26
2025-08-14_08-18-36,5028,"[np.float32(1.0), np.float32(1.0), np.float32(0.0), np.float32(1.0), np.float32(0.0), np.float32(1.0), np.float32(0.0), np.float32(1.0), np.float32(0.0), np.float32(0.0), np.float32(1.0), np.float32(1.0), np.float32(0.0), np.float32(0.0), np.float32(0.0), np.float32(0.0)]",-3.0,99499.0,7
2025-08-14_08-18-36,5029,"[np.float32(1.0), np.float32(1.0), np.float32(1.0), np.float32(1.0), np.float32(0.0), np.float32(1.0), np.float32(0.0), np.float32(1.0), np.float32(0.0), np.float32(1.0), np.float32(1.0), np.float32(1.0), np.float32(1.0), np.float32(1.0), np.float32(0.0), np.float32(0.0)]",2.0,99501.0,15
2025-08-14_08-18-36,5030,"[np.float32(1.0), np.float32(1.0), np.float32(1.0), np.float32(0.0), np.float32(0.0), np.float32(0.0), np.float32(0.0), np.float32(0.0), np.float32(1.0), np.float32(0.0), np.float32(0.0), np.float32(0.0), np.float32(1.0), np.float32(0.0), np.float32(1.0), np.float32(0.0)]",1.0,99502.0,34
2025-08-14_08-18-36,5031,"[np.float32(0.0), np.float32(0.0), np.float32(1.0), np.float32(1.0), np.float32(1.0), np.float32(1.0), np.float32(1.0), np.float32(0.0), np.float32(0.0), np.float32(1.0), np.float32(1.0), np.float32(0.0), np.float32(1.0), np.float32(0.0), np.float32(0.0), np.float32(1.0)]",-2.0,99500.0,16
2025-08-14_08-18-36,5032,"[np.float32(0.0), np.float32(0.0), np.float32(0.0), np.float32(0.0), np.float32(0.0), np.float32(1.0), np.float32(0.0), np.float32(1.0), np.float32(1.0), np.float32(1.0), np.float32(0.0), np.float32(0.0), np.float32(0.0), np.float32(0.0), np.float32(1.0), np.float32(1.0)]",-3.0,99497.0,8
2025-08-14_08-18-36,5033,"[np.float32(1.0), np.float32(0.0), np.float32(0.0), np.float32(0.0), np.float32(0.0), np.float32(0.0), np.float32(1.0), np.float32(1.0), np.float32(0.0), np.float32(1.0), np.float32(0.0), np.float32(0.0), np.float32(0.0), np.float32(1.0), np.float32(0.0), np.float32(0.0)]",1.0,99498.0,28
2025-08-14_08-18-36,5034,"[np.float32(0.0), np.float32(1.0), np.float32(1.0), np.float32(1.0), np.float32(1.0), np.float32(1.0), np.float32(1.0), np.float32(1.0), np.float32(0.0), np.float32(0.0), np.float32(0.0), np.float32(1.0), np.float32(1.0), np.float32(1.0), np.float32(0.0), np.float32(1.0)]",-2.0,99496.0,35
2025-08-14_08-18-36,5035,"[np.float32(0.0), np.float32(0.0), np.float32(1.0), np.float32(0.0), np.float32(1.0), np.float32(1.0), np.float32(1.0), np.float32(0.0), np.float32(0.0), np.float32(1.0), np.float32(1.0), np.float32(0.0), np.float32(1.0), np.float32(1.0), np.float32(0.0), np.float32(0.0)]",-4.0,99492.0,36
2025-08-14_08-18-36,5036,"[np.float32(0.0), np.float32(0.0), np.float32(1.0), np.float32(0.0), np.float32(0.0), np.float32(1.0), np.float32(0.0), np.float32(1.0), np.float32(0.0), np.float32(0.0), np.float32(0.0), np.float32(1.0), np.float32(1.0), np.float32(0.0), np.float32(0.0), np.float32(0.0)]",-3.0,99489.0,10
2025-08-14_08-18-36,5037,"[np.float32(1.0), np.float32(1.0), np.float32(0.0), np.float32(0.0), np.float32(0.0), np.float32(1.0), np.float32(1.0), np.float32(1.0), np.float32(1.0), np.float32(1.0), np.float32(0.0), np.float32(0.0), np.float32(1.0), np.float32(0.0), np.float32(0.0), np.float32(1.0)]",-4.0,99485.0,11
2025-08-14_08-18-36,5038,"[np.float32(0.0), np.float32(0.0), np.float32(1.0), np.float32(0.0), np.float32(0.0), np.float32(1.0), np.float32(1.0), np.float32(1.0), np.float32(0.0), np.float32(0.0), np.float32(1.0), np.float32(0.0), np.float32(1.0), np.float32(1.0), np.float32(1.0), np.float32(1.0)]",-3.0,99482.0,3
2025-08-14_08-18-36,5039,"[np.float32(1.0), np.float32(0.0), np.float32(1.0), np.float32(1.0), np.float32(1.0), np.float32(0.0), np.float32(1.0), np.float32(1.0), np.float32(1.0), np.float32(0.0), np.float32(0.0), np.float32(1.0), np.float32(0.0), np.float32(0.0), np.float32(0.0), np.float32(1.0)]",-1.0,99481.0,33
2025-08-14_08-18-36,5040,"[np.float32(0.0), np.float32(1.0), np.float32(0.0), np.float32(0.0), np.float32(1.0), np.float32(1.0), np.float32(1.0), np.float32(0.0), np.float32(1.0), np.float32(0.0), np.float32(1.0), np.float32(1.0), np.float32(0.0), np.float32(0.0), np.float32(1.0), np.float32(1.0)]",-2.0,99479.0,4
2025-08-14_08-18-36,5041,"[np.float32(0.0), np.float32(0.0), np.float32(1.0), np.float32(0.0), np.float32(1.0), np.float32(1.0), np.float32(0.0), np.float32(0.0), np.float32(1.0), np.float32(1.0), np.float32(0.0), np.float32(0.0), np.float32(0.0), np.float32(0.0), np.float32(0.0), np.float32(1.0)]",1.0,99480.0,26
2025-08-14_08-18-36,5042,"[np.float32(1.0), np.float32(0.0), np.float32(1.0), np.float32(1.0), np.float32(1.0), np.float32(1.0), np.float32(1.0), np.float32(1.0), np.float32(0.0), np.float32(1.0), np.float32(0.0), np.float32(1.0), np.float32(0.0), np.float32(0.0), np.float32(0.0), np.float32(1.0)]",0.0,99480.0,20
2025-08-14_08-18-36,5043,"[np.float32(0.0), np.float32(1.0), np.float32(1.0), np.float32(0.0), np.float32(0.0), np.float32(0.0), np.float32(1.0), np.float32(1.0), np.float32(0.0), np.float32(0.0), np.float32(0.0), np.float32(0.0), np.float32(0.0), np.float32(0.0), np.float32(0.0), np.float32(0.0)]",3.0,99483.0,20
2025-08-14_08-18-36,5044,"[np.float32(1.0), np.float32(0.0), np.float32(0.0), np.float32(0.0), np.float32(0.0), np.float32(0.0), np.float32(0.0), np.float32(0.0), np.float32(1.0), np.float32(0.0), np.float32(0.0), np.float32(0.0), np.float32(1.0), np.float32(1.0), np.float32(0.0), np.float32(0.0)]",1.0,99484.0,12
2025-08-14_08-18-36,5045,"[np.float32(1.0), np.float32(0.0), np.float32(1.0), np.float32(0.0), np.float32(0.0), np.float32(1.0), np.float32(1.0), np.float32(1.0), np.float32(0.0), np.float32(1.0), np.float32(1.0), np.float32(0.0), np.float32(0.0), np.float32(0.0), np.float32(0.0), np.float32(0.0)]",1.0,99485.0,10
2025-08-14_08-18-36,5046,"[np.float32(1.0), np.float32(0.0), np.float32(0.0), np.float32(0.0), np.float32(0.0), np.float32(1.0), np.float32(0.0), np.float32(1.0), np.float32(0.0), np.float32(0.0), np.float32(1.0), np.float32(0.0), np.float32(0.0), np.float32(0.0), np.float32(1.0), np.float32(1.0)]",-3.0,99482.0,10
2025-08-14_08-18-36,5047,"[np.float32(0.0), np.float32(0.0), np.float32(0.0), np.float32(0.0), np.float32(0.0), np.float32(0.0), np.float32(0.0), np.float32(0.0), np.float32(1.0), np.float32(0.0), np.float32(1.0), np.float32(0.0), np.float32(1.0), np.float32(0.0), np.float32(0.0), np.float32(0.0)]",0.0,99482.0,5
2025-08-14_08-18-36,5048,"[np.float32(0.0), np.float32(1.0), np.float32(0.0), np.float32(1.0), np.float32(1.0), np.float32(0.0), np.float32(1.0), np.float32(1.0), np.float32(1.0), np.float32(1.0), np.float32(1.0), np.float32(0.0), np.float32(0.0), np.float32(1.0), np.float32(0.0), np.float32(0.0)]",-6.0,99476.0,36
2025-08-14_08-18-36,5049,"[np.float32(0.0), np.float32(1.0), np.float32(1.0), np.float32(0.0), np.float32(0.0), np.float32(1.0), np.float32(0.0), np.float32(0.0), np.float32(0.0), np.float32(0.0), np.float32(0.0), np.float32(1.0), np.float32(1.0), np.float32(0.0), np.float32(0.0), np.float32(1.0)]",-3.0,99473.0,3
2025-08-14_08-18-36,5050,"[np.float32(1.0), np.float32(0.0), np.float32(0.0), np.float32(1.0), np.float32(0.0), np.float32(1.0), np.float32(1.0), np.float32(1.0), np.float32(0.0), np.float32(0.0), np.float32(1.0), np.float32(0.0), np.float32(1.0), np.float32(1.0), np.float32(0.0), np.float32(0.0)]",2.0,99475.0,32
2025-08-14_08-18-36,5051,"[np.float32(1.0), np.float32(0.0), np.float32(1.0), np.float32(1.0), np.float32(0.0), np.float32(1.0), np.float32(0.0), np.float32(1.0), np.float32(0.0), np.float32(0.0), np.float32(0.0), np.float32(0.0), np.float32(0.0), np.float32(1.0), np.float32(1.0), np.float32(0.0)]",1.0,99476.0,13
2025-08-14_08-18-36,5052,"[np.float32(1.0), np.float32(1.0), np.float32(0.0), np.float32(1.0), np.float32(0.0), np.float32(1.0), np.float32(1.0), np.float32(1.0), np.float32(0.0), np.float32(0.0), np.float32(1.0), np.float32(1.0), np.float32(0.0), np.float32(1.0), np.float32(1.0), np.float32(0.0)]",5.0,99481.0,21
2025-08-14_08-18-36,5053,"[np.float32(0.0), np.float32(0.0), np.float32(0.0), np.float32(0.0), np.float32(1.0), np.float32(1.0), np.float32(1.0), np.float32(1.0), np.float32(1.0), np.float32(1.0), np.float32(0.0), np.float32(1.0), np.float32(1.0), np.float32(1.0), np.float32(0.0), np.float32(0.0)]",-1.0,99480.0,33
2025-08-14_08-18-36,5054,"[np.float32(1.0), np.float32(0.0), np.float32(0.0), np.float32(1.0), np.float32(0.0), np.float32(1.0), np.float32(0.0), np.float32(1.0), np.float32(1.0), np.float32(0.0), np.float32(1.0), np.float32(0.0), np.float32(0.0), np.float32(0.0), np.float32(0.0), np.float32(0.0)]",1.0,99481.0,33
2025-08-14_08-18-36,5055,"[np.float32(0.0), np.float32(1.0), np.float32(0.0), np.float32(1.0), np.float32(1.0), np.float32(1.0), np.float32(0.0), np.float32(1.0), np.float32(1.0), np.float32(1.0), np.float32(0.0), np.float32(0.0), np.float32(1.0), np.float32(0.0), np.float32(1.0), np.float32(1.0)]",-3.0,99478.0,8
2025-08-14_08-18-36,5056,"[np.float32(0.0), np.float32(0.0), np.float32(1.0), np.float32(0.0), np.float32(0.0), np.float32(1.0), np.float32(1.0), np.float32(0.0), np.float32(0.0), np.float32(1.0), np.float32(0.0), np.float32(1.0), np.float32(1.0), np.float32(0.0), np.float32(1.0), np.float32(1.0)]",-1.0,99477.0,22
2025-08-14_08-18-36,5057,"[np.float32(0.0), np.float32(0.0), np.float32(0.0), np.float32(0.0), np.float32(0.0), np.float32(0.0), np.float32(0.0), np.float32(0.0), np.float32(0.0), np.float32(0.0), np.float32(1.0), np.float32(0.0), np.float32(1.0), np.float32(1.0), np.float32(0.0), np.float32(0.0)]",-3.0,99474.0,27
2025-08-14_08-18-36,5058,"[np.float32(0.0), np.float32(1.0), np.float32(0.0), np.float32(1.0), np.float32(1.0), np.float32(0.0), np.float32(1.0), np.float32(1.0), np.float32(1.0), np.float32(0.0), np.float32(0.0), np.float32(0.0), np.float32(0.0), np.float32(1.0), np.float32(1.0), np.float32(1.0)]",3.0,99477.0,15
2025-08-14_08-18-36,5059,"[np.float32(1.0), np.float32(1.0), np.float32(0.0), np.float32(0.0), np.float32(0.0), np.float32(0.0), np.float32(1.0), np.float32(1.0), np.float32(0.0), np.float32(0.0), np.float32(0.0), np.float32(1.0), np.float32(0.0), np.float32(0.0), np.float32(0.0), np.float32(0.0)]",0.0,99477.0,1
2025-08-14_08-18-36,5060,"[np.float32(0.0), np.float32(1.0), np.float32(1.0), np.float32(1.0), np.float32(0.0), np.float32(0.0), np.float32(1.0), np.float32(1.0), np.float32(1.0), np.float32(0.0), np.float32(0.0), np.float32(1.0), np.float32(1.0), np.float32(1.0), np.float32(0.0), np.float32(1.0)]",1.0,99478.0,3
2025-08-14_08-18-36,5061,"[np.float32(1.0), np.float32(0.0), np.float32(1.0), np.float32(0.0), np.float32(1.0), np.float32(1.0), np.float32(0.0), np.float32(1.0), np.float32(1.0), np.float32(1.0), np.float32(1.0), np.float32(0.0), np.float32(1.0), np.float32(1.0), np.float32(0.0), np.float32(1.0)]",2.0,99480.0,28
2025-08-14_08-18-36,5062,"[np.float32(0.0), np.float32(1.0), np.float32(0.0), np.float32(1.0), np.float32(0.0), np.float32(0.0), np.float32(0.0), np.float32(0.0), np.float32(0.0), np.float32(1.0), np.float32(1.0), np.float32(1.0), np.float32(1.0), np.float32(0.0), np.float32(1.0), np.float32(1.0)]",2.0,99482.0,13
2025-08-14_08-18-36,5063,"[np.float32(0.0), np.float32(0.0), np.float32(1.0), np.float32(1.0), np.float32(0.0), np.float32(0.0), np.float32(0.0), np.float32(0.0), np.float32(1.0), np.float32(0.0), np.float32(1.0), np.float32(0.0), np.float32(1.0), np.float32(0.0), np.float32(0.0), np.float32(0.0)]",-3.0,99479.0,18
2025-08-14_08-18-36,5064,"[np.float32(1.0), np.float32(1.0), np.float32(1.0), np.float32(1.0), np.float32(0.0), np.float32(1.0), np.float32(1.0), np.float32(0.0), np.float32(1.0), np.float32(0.0), np.float32(1.0), np.float32(1.0), np.float32(0.0), np.float32(0.0), np.float32(1.0), np.float32(1.0)]",-4.0,99475.0,4
2025-08-14_08-18-36,5065,"[np.float32(1.0), np.float32(1.0), np.float32(1.0), np.float32(1.0), np.float32(0.0), np.float32(0.0), np.float32(0.0), np.float32(0.0), np.float32(0.0), np.float32(0.0), np.float32(0.0), np.float32(1.0), np.float32(1.0), np.float32(1.0), np.float32(0.0), np.float32(0.0)]",-3.0,99472.0,11
2025-08-14_08-18-36,5066,"[np.float32(1.0), np.float32(1.0), np.float32(1.0), np.float32(1.0), np.float32(1.0), np.float32(1.0), np.float32(0.0), np.float32(0.0), np.float32(0.0), np.float32(1.0), np.float32(0.0), np.float32(1.0), np.float32(1.0), np.float32(1.0), np.float32(0.0), np.float32(1.0)]",-2.0,99470.0,33
2025-08-14_08-18-36,5067,"[np.float32(0.0), np.float32(1.0), np.float32(0.0), np.float32(0.0), np.float32(1.0), np.float32(1.0), np.float32(0.0), np.float32(1.0), np.float32(0.0), np.float32(0.0), np.float32(1.0), np.float32(0.0), np.float32(1.0), np.float32(0.0), np.float32(1.0), np.float32(0.0)]",-3.0,99467.0,4
2025-08-14_08-18-36,5068,"[np.float32(1.0), np.float32(1.0), np.float32(1.0), np.float32(1.0), np.float32(0.0), np.float32(0.0), np.float32(0.0), np.float32(1.0), np.float32(0.0), np.float32(1.0), np.float32(0.0), np.float32(0.0), np.float32(0.0), np.float32(0.0), np.float32(0.0), np.float32(1.0)]",-3.0,99464.0,29
2025-08-14_08-18-36,5069,"[np.float32(1.0), np.float32(0.0), np.float32(1.0), np.float32(0.0), np.float32(1.0), np.float32(0.0), np.float32(1.0), np.float32(1.0), np.float32(0.0), np.float32(0.0), np.float32(1.0), np.float32(0.0), np.float32(0.0), np.float32(0.0), np.float32(0.0), np.float32(1.0)]",-3.0,99461.0,36
2025-08-14_08-18-36,5070,"[np.float32(1.0), np.float32(0.0), np.float32(0.0), np.float32(0.0), np.float32(1.0), np.float32(1.0), np.float32(1.0), np.float32(1.0), np.float32(1.0), np.float32(0.0), np.float32(0.0), np.float32(0.0), np.float32(0.0), np.float32(0.0), np.float32(1.0), np.float32(0.0)]",0.0,99461.0,14
2025-08-14_08-18-36,5071,"[np.float32(0.0), np.float32(0.0), np.float32(0.0), np.float32(1.0), np.float32(1.0), np.float32(1.0), np.float32(1.0), np.float32(0.0), np.float32(1.0), np.float32(1.0), np.float32(0.0), np.float32(1.0), np.float32(1.0), np.float32(1.0), np.float32(0.0), np.float32(0.0)]",-4.0,99457.0,24
2025-08-14_08-18-36,5072,"[np.float32(1.0), np.float32(0.0), np.float32(0.0), np.float32(1.0), np.float32(0.0), np.float32(1.0), np.float32(0.0), np.float32(1.0), np.float32(1.0), np.float32(1.0), np.float32(1.0), np.float32(1.0), np.float32(0.0), np.float32(1.0), np.float32(0.0), np.float32(1.0)]",1.0,99458.0,14
2025-08-14_08-18-36,5073,"[np.float32(0.0), np.float32(0.0), np.float32(0.0), np.float32(0.0), np.float32(0.0), np.float32(1.0), np.float32(1.0), np.float32(0.0), np.float32(1.0), np.float32(1.0), np.float32(0.0), np.float32(0.0), np.float32(1.0), np.float32(0.0), np.float32(0.0), np.float32(0.0)]",-2.0,99456.0,2
2025-08-14_08-18-36,5074,"[np.float32(0.0), np.float32(0.0), np.float32(0.0), np.float32(0.0), np.float32(0.0), np.float32(0.0), np.float32(1.0), np.float32(1.0), np.float32(0.0), np.float32(0.0), np.float32(1.0), np.float32(0.0), np.float32(1.0), np.float32(0.0), np.float32(0.0), np.float32(0.0)]",-4.0,99452.0,30
2025-08-14_08-18-36,5075,"[np.float32(0.0), np.float32(1.0), np.float32(0.0), np.float32(1.0), np.float32(0.0), np.float32(0.0), np.float32(0.0), np.float32(1.0), np.float32(1.0), np.float32(0.0), np.float32(1.0), np.float32(0.0), np.float32(1.0), np.float32(0.0), np.float32(0.0), np.float32(0.0)]",-1.0,99451.0,25
2025-08-14_08-18-36,5076,"[np.float32(0.0), np.float32(1.0), np.float32(0.0), np.float32(1.0), np.float32(0.0), np.float32(0.0), np.float32(1.0), np.float32(1.0), np.float32(1.0), np.float32(1.0), np.float32(1.0), np.float32(0.0), np.float32(0.0), np.float32(1.0), np.float32(1.0), np.float32(0.0)]",-3.0,99448.0,30
2025-08-14_08-18-36,5077,"[np.float32(0.0), np.float32(0.0), np.float32(1.0), np.float32(0.0), np.float32(0.0), np.float32(1.0), np.float32(1.0), np.float32(1.0), np.float32(1.0), np.float32(0.0), np.float32(0.0), np.float32(0.0), np.float32(0.0), np.float32(1.0), np.float32(0.0), np.float32(1.0)]",-4.0,99444.0,13
2025-08-14_08-18-36,5078,"[np.float32(0.0), np.float32(0.0), np.float32(1.0), np.float32(1.0), np.float32(0.0), np.float32(0.0), np.float32(0.0), np.float32(0.0), np.float32(1.0), np.float32(0.0), np.float32(0.0), np.float32(0.0), np.float32(1.0), np.float32(1.0), np.float32(1.0), np.float32(1.0)]",-2.0,99442.0,21
2025-08-14_08-18-36,5079,"[np.float32(0.0), np.float32(1.0), np.float32(0.0), np.float32(1.0), np.float32(0.0), np.float32(1.0), np.float32(1.0), np.float32(0.0), np.float32(0.0), np.float32(0.0), np.float32(1.0), np.float32(0.0), np.float32(1.0), np.float32(1.0), np.float32(0.0), np.float32(1.0)]",2.0,99444.0,17
2025-08-14_08-18-36,5080,"[np.float32(0.0), np.float32(1.0), np.float32(0.0), np.float32(1.0), np.float32(1.0), np.float32(0.0), np.float32(1.0), np.float32(0.0), np.float32(1.0), np.float32(0.0), np.float32(0.0), np.float32(1.0), np.float32(1.0), np.float32(0.0), np.float32(1.0), np.float32(0.0)]",-6.0,99438.0,22
2025-08-14_08-18-36,5081,"[np.float32(0.0), np.float32(1.0), np.float32(0.0), np.float32(0.0), np.float32(1.0), np.float32(0.0), np.float32(1.0), np.float32(0.0), np.float32(0.0), np.float32(1.0), np.float32(0.0), np.float32(0.0), np.float32(0.0), np.float32(1.0), np.float32(1.0), np.float32(0.0)]",-3.0,99435.0,34
2025-08-14_08-18-36,5082,"[np.float32(0.0), np.float32(0.0), np.float32(1.0), np.float32(0.0), np.float32(0.0), np.float32(0.0), np.float32(0.0), np.float32(1.0), np.float32(1.0), np.float32(0.0), np.float32(0.0), np.float32(1.0), np.float32(0.0), np.float32(1.0), np.float32(0.0), np.float32(0.0)]",0.0,99435.0,2
2025-08-14_08-18-36,5083,"[np.float32(0.0), np.float32(0.0), np.float32(1.0), np.float32(1.0), np.float32(1.0), np.float32(0.0), np.float32(1.0), np.float32(1.0), np.float32(1.0), np.float32(1.0), np.float32(0.0), np.float32(0.0), np.float32(1.0), np.float32(1.0), np.float32(0.0), np.float32(1.0)]",-3.0,99432.0,11
2025-08-14_08-18-36,5084,"[np.float32(1.0), np.float32(0.0), np.float32(0.0), np.float32(0.0), np.float32(1.0), np.float32(1.0), np.float32(0.0), np.float32(1.0), np.float32(0.0), np.float32(1.0), np.float32(0.0), np.float32(1.0), np.float32(1.0), np.float32(1.0), np.float32(1.0), np.float32(0.0)]",-1.0,99431.0,10
2025-08-14_08-18-36,5085,"[np.float32(1.0), np.float32(0.0), np.float32(0.0), np.float32(0.0), np.float32(0.0), np.float32(1.0), np.float32(0.0), np.float32(1.0), np.float32(0.0), np.float32(1.0), np.float32(0.0), np.float32(1.0), np.float32(1.0), np.float32(1.0), np.float32(1.0), np.float32(1.0)]",-3.0,99428.0,4
2025-08-14_08-18-36,5086,"[np.float32(0.0), np.float32(0.0), np.float32(1.0), np.float32(1.0), np.float32(0.0), np.float32(1.0), np.float32(1.0), np.float32(1.0), np.float32(1.0), np.float32(1.0), np.float32(0.0), np.float32(0.0), np.float32(1.0), np.float32(1.0), np.float32(1.0), np.float32(1.0)]",-1.0,99427.0,35
2025-08-14_08-18-36,5087,"[np.float32(0.0), np.float32(1.0), np.float32(1.0), np.float32(1.0), np.float32(0.0), np.float32(1.0), np.float32(1.0), np.float32(1.0), np.float32(1.0), np.float32(1.0), np.float32(1.0), np.float32(0.0), np.float32(1.0), np.float32(0.0), np.float32(0.0), np.float32(1.0)]",-2.0,99425.0,33
2025-08-14_08-18-36,5088,"[np.float32(1.0), np.float32(0.0), np.float32(0.0), np.float32(0.0), np.float32(0.0), np.float32(1.0), np.float32(0.0), np.float32(1.0), np.float32(0.0), np.float32(0.0), np.float32(1.0), np.float32(0.0), np.float32(0.0), np.float32(1.0), np.float32(0.0), np.float32(0.0)]",-2.0,99423.0,8
2025-08-14_08-18-36,5089,"[np.float32(1.0), np.float32(1.0), np.float32(0.0), np.float32(0.0), np.float32(0.0), np.float32(0.0), np.float32(1.0), np.float32(1.0), np.float32(1.0), np.float32(0.0), np.float32(1.0), np.float32(1.0), np.float32(0.0), np.float32(0.0), np.float32(0.0), np.float32(0.0)]",-2.0,99421.0,1
2025-08-14_08-18-36,5090,"[np.float32(1.0), np.float32(1.0), np.float32(1.0), np.float32(1.0), np.float32(1.0), np.float32(1.0), np.float32(1.0), np.float32(1.0), np.float32(0.0), np.float32(0.0), np.float32(0.0), np.float32(1.0), np.float32(0.0), np.float32(0.0), np.float32(0.0), np.float32(1.0)]",2.0,99423.0,15
2025-08-14_08-18-36,5091,"[np.float32(1.0), np.float32(0.0), np.float32(0.0), np.float32(0.0), np.float32(0.0), np.float32(1.0), np.float32(1.0), np.float32(1.0), np.float32(0.0), np.float32(0.0), np.float32(0.0), np.float32(1.0), np.float32(0.0), np.float32(1.0), np.float32(1.0), np.float32(0.0)]",0.0,99423.0,25
2025-08-14_08-18-36,5092,"[np.float32(1.0), np.float32(0.0), np.float32(1.0), np.float32(0.0), np.float32(0.0), np.float32(0.0), np.float32(1.0), np.float32(0.0), np.float32(0.0), np.float32(1.0), np.float32(0.0), np.float32(1.0), np.float32(1.0), np.float32(1.0), np.float32(0.0), np.float32(0.0)]",4.0,99427.0,4
2025-08-14_08-18-36,5093,"[np.float32(0.0), np.float32(0.0), np.float32(0.0), np.float32(1.0), np.float32(0.0), np.float32(1.0), np.float32(0.0), np.float32(1.0), np.float32(1.0), np.float32(1.0), np.float32(0.0), np.float32(1.0), np.float32(0.0), np.float32(0.0), np.float32(0.0), np.float32(0.0)]",-1.0,99426.0,20
2025-08-14_08-18-36,5094,"[np.float32(1.0), np.float32(1.0), np.float32(0.0), np.float32(1.0), np.float32(0.0), np.float32(0.0), np.float32(1.0), np.float32(1.0), np.float32(0.0), np.float32(0.0), np.float32(0.0), np.float32(0.0), np.float32(1.0), np.float32(1.0), np.float32(0.0), np.float32(0.0)]",0.0,99426.0,1
2025-08-14_08-18-36,5095,"[np.float32(0.0), np.float32(1.0), np.float32(0.0), np.float32(1.0), np.float32(0.0), np.float32(0.0), np.float32(1.0), np.float32(1.0), np.float32(0.0), np.float32(1.0), np.float32(1.0), np.float32(1.0), np.float32(1.0), np.float32(1.0), np.float32(1.0), np.float32(0.0)]",-2.0,99424.0,28
2025-08-14_08-18-36,5096,"[np.float32(0.0), np.float32(1.0), np.float32(0.0), np.float32(1.0), np.float32(1.0), np.float32(1.0), np.float32(1.0), np.float32(0.0), np.float32(1.0), np.float32(1.0), np.float32(0.0), np.float32(0.0), np.float32(0.0), np.float32(1.0), np.float32(1.0), np.float32(1.0)]",1.0,99425.0,34
2025-08-14_08-18-36,5097,"[np.float32(1.0), np.float32(0.0), np.float32(0.0), np.float32(1.0), np.float32(1.0), np.float32(1.0), np.float32(0.0), np.float32(1.0), np.float32(0.0), np.float32(0.0), np.float32(0.0), np.float32(0.0), np.float32(0.0), np.float32(1.0), np.float32(1.0), np.float32(1.0)]",2.0,99427.0,17
2025-08-14_08-18-36,5098,"[np.float32(1.0), np.float32(0.0), np.float32(1.0), np.float32(1.0), np.float32(0.0), np.float32(1.0), np.float32(0.0), np.float32(1.0), np.float32(1.0), np.float32(1.0), np.float32(0.0), np.float32(0.0), np.float32(0.0), np.float32(1.0), np.float32(1.0), np.float32(0.0)]",-1.0,99426.0,4
2025-08-14_08-18-36,5099,"[np.float32(1.0), np.float32(0.0), np.float32(0.0), np.float32(1.0), np.float32(1.0), np.float32(0.0), np.float32(1.0), np.float32(1.0), np.float32(0.0), np.float32(1.0), np.float32(1.0), np.float32(1.0), np.float32(0.0), np.float32(1.0), np.float32(0.0), np.float32(1.0)]",0.0,99426.0,16
2025-08-14_08-18-36,5100,"[np.float32(0.0), np.float32(1.0), np.float32(1.0), np.float32(0.0), np.float32(1.0), np.float32(0.0), np.float32(1.0), np.float32(0.0), np.float32(0.0), np.float32(0.0), np.float32(0.0), np.float32(1.0), np.float32(0.0), np.float32(1.0), np.float32(0.0), np.float32(0.0)]",-1.0,99425.0,36
2025-08-14_08-18-36,5101,"[np.float32(1.0), np.float32(1.0), np.float32(0.0), np.float32(0.0), np.float32(0.0), np.float32(1.0), np.float32(1.0), np.float32(0.0), np.float32(0.0), np.float32(1.0), np.float32(1.0), np.float32(0.0), np.float32(1.0), np.float32(0.0), np.float32(1.0), np.float32(1.0)]",-1.0,99424.0,13
2025-08-14_08-18-36,5102,"[np.float32(1.0), np.float32(0.0), np.float32(1.0), np.float32(0.0), np.float32(1.0), np.float32(1.0), np.float32(1.0), np.float32(0.0), np.float32(1.0), np.float32(1.0), np.float32(0.0), np.float32(1.0), np.float32(1.0), np.float32(1.0), np.float32(1.0), np.float32(0.0)]",2.0,99426.0,27
2025-08-14_08-18-36,5103,"[np.float32(0.0), np.float32(0.0), np.float32(1.0), np.float32(1.0), np.float32(1.0), np.float32(0.0), np.float32(1.0), np.float32(0.0), np.float32(1.0), np.float32(1.0), np.float32(1.0), np.float32(0.0), np.float32(0.0), np.float32(0.0), np.float32(1.0), np.float32(0.0)]",-4.0,99422.0,15
2025-08-14_08-18-36,5104,"[np.float32(0.0), np.float32(1.0), np.float32(1.0), np.float32(1.0), np.float32(0.0), np.float32(0.0), np.float32(0.0), np.float32(0.0), np.float32(1.0), np.float32(0.0), np.float32(1.0), np.float32(0.0), np.float32(0.0), np.float32(1.0), np.float32(1.0), np.float32(1.0)]",2.0,99424.0,28
2025-08-14_08-18-36,5105,"[np.float32(1.0), np.float32(1.0), np.float32(1.0), np.float32(0.0), np.float32(1.0), np.float32(1.0), np.float32(1.0), np.float32(1.0), np.float32(1.0), np.float32(0.0), np.float32(0.0), np.float32(1.0), np.float32(1.0), np.float32(1.0), np.float32(1.0), np.float32(0.0)]",-2.0,99422.0,11
2025-08-14_08-18-36,5106,"[np.float32(0.0), np.float32(0.0), np.float32(1.0), np.float32(1.0), np.float32(0.0), np.float32(1.0), np.float32(1.0), np.float32(1.0), np.float32(0.0), np.float32(1.0), np.float32(1.0), np.float32(0.0), np.float32(1.0), np.float32(0.0), np.float32(1.0), np.float32(0.0)]",-2.0,99420.0,33
2025-08-14_08-18-36,5107,"[np.float32(0.0), np.float32(0.0), np.float32(1.0), np.float32(0.0), np.float32(1.0), np.float32(0.0), np.float32(0.0), np.float32(1.0), np.float32(1.0), np.float32(1.0), np.float32(1.0), np.float32(0.0), np.float32(1.0), np.float32(1.0), np.float32(0.0), np.float32(1.0)]",2.0,99422.0,32
2025-08-14_08-18-36,5108,"[np.float32(1.0), np.float32(1.0), np.float32(1.0), np.float32(1.0), np.float32(0.0), np.float32(0.0), np.float32(0.0), np.float32(0.0), np.float32(0.0), np.float32(1.0), np.float32(0.0), np.float32(1.0), np.float32(0.0), np.float32(0.0), np.float32(0.0), np.float32(1.0)]",3.0,99425.0,6
2025-08-14_08-18-36,5109,"[np.float32(0.0), np.float32(1.0), np.float32(1.0), np.float32(0.0), np.float32(1.0), np.float32(1.0), np.float32(1.0), np.float32(1.0), np.float32(1.0), np.float32(1.0), np.float32(0.0), np.float32(1.0), np.float32(0.0), np.float32(0.0), np.float32(0.0), np.float32(1.0)]",-3.0,99422.0,11
2025-08-14_08-18-36,5110,"[np.float32(0.0), np.float32(1.0), np.float32(0.0), np.float32(1.0), np.float32(1.0), np.float32(0.0), np.float32(0.0), np.float32(1.0), np.float32(1.0), np.float32(1.0), np.float32(1.0), np.float32(1.0), np.float32(0.0), np.float32(1.0), np.float32(0.0), np.float32(0.0)]",-1.0,99421.0,20
2025-08-14_08-18-36,5111,"[np.float32(1.0), np.float32(1.0), np.float32(0.0), np.float32(0.0), np.float32(0.0), np.float32(1.0), np.float32(1.0), np.float32(0.0), np.float32(0.0), np.float32(0.0), np.float32(0.0), np.float32(0.0), np.float32(1.0), np.float32(1.0), np.float32(0.0), np.float32(0.0)]",1.0,99422.0,35
2025-08-14_08-18-36,5112,"[np.float32(1.0), np.float32(1.0), np.float32(1.0), np.float32(0.0), np.float32(1.0), np.float32(1.0), np.float32(0.0), np.float32(1.0), np.float32(1.0), np.float32(1.0), np.float32(0.0), np.float32(0.0), np.float32(1.0), np.float32(1.0), np.float32(0.0), np.float32(0.0)]",5.0,99427.0,22
2025-08-14_08-18-36,5113,"[np.float32(1.0), np.float32(1.0), np.float32(0.0), np.float32(0.0), np.float32(1.0), np.float32(1.0), np.float32(0.0), np.float32(1.0), np.float32(1.0), np.float32(1.0), np.float32(1.0), np.float32(0.0), np.float32(1.0), np.float32(1.0), np.float32(0.0), np.float32(0.0)]",-3.0,99424.0,5
2025-08-14_08-18-36,5114,"[np.float32(0.0), np.float32(1.0), np.float32(0.0), np.float32(0.0), np.float32(1.0), np.float32(1.0), np.float32(0.0), np.float32(1.0), np.float32(1.0), np.float32(1.0), np.float32(1.0), np.float32(0.0), np.float32(0.0), np.float32(0.0), np.float32(0.0), np.float32(0.0)]",-5.0,99419.0,12
2025-08-14_08-18-36,5115,"[np.float32(1.0), np.float32(0.0), np.float32(1.0), np.float32(0.0), np.float32(1.0), np.float32(1.0), np.float32(0.0), np.float32(0.0), np.float32(0.0), np.float32(0.0), np.float32(0.0), np.float32(1.0), np.float32(0.0), np.float32(1.0), np.float32(1.0), np.float32(0.0)]",-3.0,99416.0,1
2025-08-14_08-18-36,5116,"[np.float32(0.0), np.float32(0.0), np.float32(1.0), np.float32(1.0), np.float32(0.0), np.float32(1.0), np.float32(1.0), np.float32(0.0), np.float32(0.0), np.float32(1.0), np.float32(1.0), np.float32(0.0), np.float32(1.0), np.float32(1.0), np.float32(0.0), np.float32(0.0)]",-4.0,99412.0,33
2025-08-14_08-18-36,5117,"[np.float32(0.0), np.float32(1.0), np.float32(0.0), np.float32(1.0), np.float32(0.0), np.float32(1.0), np.float32(1.0), np.float32(1.0), np.float32(0.0), np.float32(0.0), np.float32(0.0), np.float32(1.0), np.float32(1.0), np.float32(1.0), np.float32(0.0), np.float32(0.0)]",-3.0,99409.0,32
2025-08-14_08-18-36,5118,"[np.float32(1.0), np.float32(1.0), np.float32(0.0), np.float32(1.0), np.float32(0.0), np.float32(0.0), np.float32(1.0), np.float32(1.0), np.float32(1.0), np.float32(1.0), np.float32(1.0), np.float32(1.0), np.float32(1.0), np.float32(1.0), np.float32(0.0), np.float32(1.0)]",1.0,99410.0,1
2025-08-14_08-18-36,5119,"[np.float32(1.0), np.float32(0.0), np.float32(0.0), np.float32(0.0), np.float32(0.0), np.float32(0.0), np.float32(0.0), np.float32(1.0), np.float32(0.0), np.float32(1.0), np.float32(1.0), np.float32(0.0), np.float32(0.0), np.float32(0.0), np.float32(1.0), np.float32(0.0)]",1.0,99411.0,22
2025-08-14_08-18-36,5120,"[np.float32(0.0), np.float32(1.0), np.float32(1.0), np.float32(0.0), np.float32(1.0), np.float32(1.0), np.float32(1.0), np.float32(1.0), np.float32(1.0), np.float32(0.0), np.float32(0.0), np.float32(0.0), np.float32(0.0), np.float32(1.0), np.float32(1.0), np.float32(1.0)]",2.0,99413.0,20
2025-08-14_08-18-36,5121,"[np.float32(1.0), np.float32(0.0), np.float32(1.0), np.float32(0.0), np.float32(0.0), np.float32(0.0), np.float32(0.0), np.float32(1.0), np.float32(0.0), np.float32(0.0), np.float32(0.0), np.float32(0.0), np.float32(0.0), np.float32(1.0), np.float32(1.0), np.float32(1.0)]",2.0,99415.0,22
2025-08-14_08-18-36,5122,"[np.float32(1.0), np.float32(1.0), np.float32(1.0), np.float32(1.0), np.float32(1.0), np.float32(0.0), np.float32(0.0), np.float32(1.0), np.float32(1.0), np.float32(0.0), np.float32(1.0), np.float32(1.0), np.float32(0.0), np.float32(1.0), np.float32(1.0), np.float32(0.0)]",2.0,99417.0,30
2025-08-14_08-18-36,5123,"[np.float32(0.0), np.float32(0.0), np.float32(0.0), np.float32(0.0), np.float32(0.0), np.float32(1.0), np.float32(0.0), np.float32(0.0), np.float32(1.0), np.float32(0.0), np.float32(0.0), np.float32(0.0), np.float32(0.0), np.float32(1.0), np.float32(1.0), np.float32(1.0)]",-2.0,99415.0,4
2025-08-14_08-18-36,5124,"[np.float32(1.0), np.float32(0.0), np.float32(0.0), np.float32(0.0), np.float32(0.0), np.float32(1.0), np.float32(0.0), np.float32(0.0), np.float32(1.0), np.float32(0.0), np.float32(0.0), np.float32(0.0), np.float32(0.0), np.float32(1.0), np.float32(0.0), np.float32(0.0)]",-4.0,99411.0,17
2025-08-14_08-18-36,5125,"[np.float32(0.0), np.float32(1.0), np.float32(0.0), np.float32(0.0), np.float32(0.0), np.float32(0.0), np.float32(1.0), np.float32(1.0), np.float32(1.0), np.float32(0.0), np.float32(0.0), np.float32(0.0), np.float32(1.0), np.float32(1.0), np.float32(0.0), np.float32(1.0)]",1.0,99412.0,2
2025-08-14_08-18-36,5126,"[np.float32(1.0), np.float32(0.0), np.float32(0.0), np.float32(1.0), np.float32(0.0), np.float32(1.0), np.float32(0.0), np.float32(1.0), np.float32(0.0), np.float32(1.0), np.float32(0.0), np.float32(1.0), np.float32(1.0), np.float32(0.0), np.float32(0.0), np.float32(0.0)]",-5.0,99407.0,0
2025-08-14_08-18-36,5127,"[np.float32(0.0), np.float32(1.0), np.float32(0.0), np.float32(1.0), np.float32(1.0), np.float32(0.0), np.float32(1.0), np.float32(0.0), np.float32(1.0), np.float32(0.0), np.float32(1.0), np.float32(0.0), np.float32(0.0), np.float32(1.0), np.float32(0.0), np.float32(0.0)]",3.0,99410.0,5
2025-08-14_08-18-36,5128,"[np.float32(1.0), np.float32(1.0), np.float32(0.0), np.float32(1.0), np.float32(1.0), np.float32(0.0), np.float32(1.0), np.float32(1.0), np.float32(1.0), np.float32(0.0), np.float32(1.0), np.float32(0.0), np.float32(0.0), np.float32(1.0), np.float32(0.0), np.float32(0.0)]",3.0,99413.0,17
2025-08-14_08-18-36,5129,"[np.float32(0.0), np.float32(1.0), np.float32(1.0), np.float32(1.0), np.float32(0.0), np.float32(0.0), np.float32(1.0), np.float32(0.0), np.float32(1.0), np.float32(0.0), np.float32(1.0), np.float32(0.0), np.float32(0.0), np.float32(1.0), np.float32(1.0), np.float32(1.0)]",-1.0,99412.0,1
2025-08-14_08-18-36,5130,"[np.float32(1.0), np.float32(1.0), np.float32(0.0), np.float32(1.0), np.float32(1.0), np.float32(1.0), np.float32(1.0), np.float32(0.0), np.float32(0.0), np.float32(0.0), np.float32(1.0), np.float32(0.0), np.float32(1.0), np.float32(0.0), np.float32(1.0), np.float32(0.0)]",1.0,99413.0,2
2025-08-14_08-18-36,5131,"[np.float32(1.0), np.float32(0.0), np.float32(0.0), np.float32(1.0), np.float32(1.0), np.float32(0.0), np.float32(1.0), np.float32(0.0), np.float32(0.0), np.float32(1.0), np.float32(0.0), np.float32(1.0), np.float32(1.0), np.float32(1.0), np.float32(0.0), np.float32(0.0)]",-3.0,99410.0,30
2025-08-14_08-18-36,5132,"[np.float32(0.0), np.float32(1.0), np.float32(0.0), np.float32(0.0), np.float32(1.0), np.float32(1.0), np.float32(0.0), np.float32(1.0), np.float32(1.0), np.float32(0.0), np.float32(1.0), np.float32(0.0), np.float32(0.0), np.float32(0.0), np.float32(0.0), np.float32(0.0)]",2.0,99412.0,23
2025-08-14_08-18-36,5133,"[np.float32(0.0), np.float32(1.0), np.float32(1.0), np.float32(1.0), np.float32(1.0), np.float32(1.0), np.float32(0.0), np.float32(1.0), np.float32(0.0), np.float32(0.0), np.float32(0.0), np.float32(1.0), np.float32(0.0), np.float32(1.0), np.float32(1.0), np.float32(1.0)]",-1.0,99411.0,4
2025-08-14_08-18-36,5134,"[np.float32(1.0), np.float32(0.0), np.float32(1.0), np.float32(1.0), np.float32(0.0), np.float32(1.0), np.float32(0.0), np.float32(1.0), np.float32(1.0), np.float32(1.0), np.float32(1.0), np.float32(1.0), np.float32(1.0), np.float32(1.0), np.float32(1.0), np.float32(0.0)]",1.0,99412.0,35
2025-08-14_08-18-36,5135,"[np.float32(1.0), np.float32(0.0), np.float32(0.0), np.float32(0.0), np.float32(1.0), np.float32(0.0), np.float32(0.0), np.float32(1.0), np.float32(1.0), np.float32(1.0), np.float32(1.0), np.float32(0.0), np.float32(1.0), np.float32(0.0), np.float32(0.0), np.float32(0.0)]",-3.0,99409.0,12
2025-08-14_08-18-36,5136,"[np.float32(0.0), np.float32(0.0), np.float32(1.0), np.float32(0.0), np.float32(0.0), np.float32(1.0), np.float32(1.0), np.float32(0.0), np.float32(1.0), np.float32(0.0), np.float32(0.0), np.float32(1.0), np.float32(1.0), np.float32(0.0), np.float32(0.0), np.float32(1.0)]",-2.0,99407.0,14
2025-08-14_08-18-36,5137,"[np.float32(0.0), np.float32(0.0), np.float32(1.0), np.float32(1.0), np.float32(0.0), np.float32(0.0), np.float32(1.0), np.float32(1.0), np.float32(0.0), np.float32(1.0), np.float32(0.0), np.float32(0.0), np.float32(0.0), np.float32(0.0), np.float32(0.0), np.float32(0.0)]",3.0,99410.0,19
2025-08-14_08-18-36,5138,"[np.float32(0.0), np.float32(0.0), np.float32(0.0), np.float32(0.0), np.float32(1.0), np.float32(1.0), np.float32(1.0), np.float32(0.0), np.float32(1.0), np.float32(1.0), np.float32(0.0), np.float32(0.0), np.float32(1.0), np.float32(0.0), np.float32(0.0), np.float32(0.0)]",-1.0,99409.0,3
2025-08-14_08-18-36,5139,"[np.float32(1.0), np.float32(1.0), np.float32(0.0), np.float32(1.0), np.float32(0.0), np.float32(0.0), np.float32(1.0), np.float32(0.0), np.float32(0.0), np.float32(1.0), np.float32(1.0), np.float32(1.0), np.float32(0.0), np.float32(1.0), np.float32(0.0), np.float32(0.0)]",2.0,99411.0,11
2025-08-14_08-18-36,5140,"[np.float32(0.0), np.float32(1.0), np.float32(0.0), np.float32(0.0), np.float32(1.0), np.float32(0.0), np.float32(1.0), np.float32(1.0), np.float32(1.0), np.float32(1.0), np.float32(0.0), np.float32(0.0), np.float32(1.0), np.float32(1.0), np.float32(0.0), np.float32(1.0)]",38.0,99449.0,7
2025-08-14_08-18-36,5141,"[np.float32(1.0), np.float32(1.0), np.float32(0.0), np.float32(0.0), np.float32(0.0), np.float32(1.0), np.float32(1.0), np.float32(0.0), np.float32(0.0), np.float32(1.0), np.float32(0.0), np.float32(1.0), np.float32(1.0), np.float32(1.0), np.float32(0.0), np.float32(0.0)]",0.0,99449.0,18
2025-08-14_08-18-36,5142,"[np.float32(0.0), np.float32(1.0), np.float32(0.0), np.float32(1.0), np.float32(1.0), np.float32(1.0), np.float32(1.0), np.float32(1.0), np.float32(0.0), np.float32(1.0), np.float32(0.0), np.float32(1.0), np.float32(1.0), np.float32(1.0), np.float32(0.0), np.float32(1.0)]",-1.0,99448.0,24
2025-08-14_08-18-36,5143,"[np.float32(1.0), np.float32(0.0), np.float32(1.0), np.float32(1.0), np.float32(1.0), np.float32(1.0), np.float32(0.0), np.float32(0.0), np.float32(0.0), np.float32(1.0), np.float32(1.0), np.float32(1.0), np.float32(1.0), np.float32(1.0), np.float32(0.0), np.float32(0.0)]",-1.0,99447.0,30
2025-08-14_08-18-36,5144,"[np.float32(0.0), np.float32(0.0), np.float32(1.0), np.float32(1.0), np.float32(1.0), np.float32(1.0), np.float32(1.0), np.float32(1.0), np.float32(1.0), np.float32(1.0), np.float32(1.0), np.float32(0.0), np.float32(1.0), np.float32(0.0), np.float32(0.0), np.float32(0.0)]",-6.0,99441.0,0
2025-08-14_08-18-36,5145,"[np.float32(0.0), np.float32(1.0), np.float32(0.0), np.float32(0.0), np.float32(0.0), np.float32(0.0), np.float32(0.0), np.float32(0.0), np.float32(0.0), np.float32(0.0), np.float32(1.0), np.float32(0.0), np.float32(1.0), np.float32(1.0), np.float32(1.0), np.float32(0.0)]",-5.0,99436.0,34
2025-08-14_08-18-36,5146,"[np.float32(0.0), np.float32(0.0), np.float32(1.0), np.float32(0.0), np.float32(0.0), np.float32(1.0), np.float32(1.0), np.float32(1.0), np.float32(1.0), np.float32(0.0), np.float32(1.0), np.float32(0.0), np.float32(1.0), np.float32(1.0), np.float32(0.0), np.float32(0.0)]",2.0,99438.0,20
2025-08-14_08-18-36,5147,"[np.float32(0.0), np.float32(0.0), np.float32(0.0), np.float32(0.0), np.float32(0.0), np.float32(1.0), np.float32(1.0), np.float32(0.0), np.float32(0.0), np.float32(1.0), np.float32(1.0), np.float32(1.0), np.float32(1.0), np.float32(0.0), np.float32(0.0), np.float32(0.0)]",0.0,99438.0,12
2025-08-14_08-18-36,5148,"[np.float32(0.0), np.float32(0.0), np.float32(1.0), np.float32(0.0), np.float32(1.0), np.float32(1.0), np.float32(1.0), np.float32(0.0), np.float32(0.0), np.float32(0.0), np.float32(0.0), np.float32(0.0), np.float32(0.0), np.float32(0.0), np.float32(0.0), np.float32(1.0)]",2.0,99440.0,14
2025-08-14_08-18-36,5149,"[np.float32(1.0), np.float32(1.0), np.float32(0.0), np.float32(1.0), np.float32(1.0), np.float32(0.0), np.float32(0.0), np.float32(1.0), np.float32(0.0), np.float32(0.0), np.float32(1.0), np.float32(0.0), np.float32(0.0), np.float32(1.0), np.float32(1.0), np.float32(0.0)]",-1.0,99439.0,27
2025-08-14_08-18-36,5150,"[np.float32(0.0), np.float32(1.0), np.float32(1.0), np.float32(1.0), np.float32(1.0), np.float32(1.0), np.float32(0.0), np.float32(1.0), np.float32(1.0), np.float32(1.0), np.float32(1.0), np.float32(0.0), np.float32(1.0), np.float32(1.0), np.float32(0.0), np.float32(0.0)]",-4.0,99435.0,30
2025-08-14_08-18-36,5151,"[np.float32(1.0), np.float32(0.0), np.float32(0.0), np.float32(0.0), np.float32(1.0), np.float32(1.0), np.float32(1.0), np.float32(0.0), np.float32(0.0), np.float32(0.0), np.float32(0.0), np.float32(0.0), np.float32(1.0), np.float32(0.0), np.float32(1.0), np.float32(0.0)]",-1.0,99434.0,6
2025-08-14_08-18-36,5152,"[np.float32(0.0), np.float32(0.0), np.float32(0.0), np.float32(0.0), np.float32(1.0), np.float32(0.0), np.float32(0.0), np.float32(0.0), np.float32(1.0), np.float32(1.0), np.float32(0.0), np.float32(0.0), np.float32(1.0), np.float32(0.0), np.float32(0.0), np.float32(0.0)]",-2.0,99432.0,8
2025-08-14_08-18-36,5153,"[np.float32(0.0), np.float32(0.0), np.float32(1.0), np.float32(0.0), np.float32(1.0), np.float32(1.0), np.float32(1.0), np.float32(1.0), np.float32(1.0), np.float32(1.0), np.float32(0.0), np.float32(0.0), np.float32(0.0), np.float32(1.0), np.float32(0.0), np.float32(0.0)]",2.0,99434.0,26
2025-08-14_08-18-36,5154,"[np.float32(1.0), np.float32(1.0), np.float32(0.0), np.float32(0.0), np.float32(0.0), np.float32(1.0), np.float32(0.0), np.float32(1.0), np.float32(1.0), np.float32(0.0), np.float32(1.0), np.float32(0.0), np.float32(1.0), np.float32(0.0), np.float32(1.0), np.float32(0.0)]",2.0,99436.0,24
2025-08-14_08-18-36,5155,"[np.float32(1.0), np.float32(1.0), np.float32(0.0), np.float32(0.0), np.float32(1.0), np.float32(1.0), np.float32(1.0), np.float32(0.0), np.float32(1.0), np.float32(1.0), np.float32(0.0), np.float32(0.0), np.float32(1.0), np.float32(1.0), np.float32(0.0), np.float32(0.0)]",-2.0,99434.0,11
2025-08-14_08-18-36,5156,"[np.float32(0.0), np.float32(0.0), np.float32(0.0), np.float32(1.0), np.float32(1.0), np.float32(1.0), np.float32(1.0), np.float32(1.0), np.float32(1.0), np.float32(0.0), np.float32(0.0), np.float32(1.0), np.float32(1.0), np.float32(1.0), np.float32(1.0), np.float32(1.0)]",-3.0,99431.0,14
2025-08-14_08-18-36,5157,"[np.float32(1.0), np.float32(1.0), np.float32(1.0), np.float32(1.0), np.float32(0.0), np.float32(0.0), np.float32(1.0), np.float32(1.0), np.float32(0.0), np.float32(0.0), np.float32(0.0), np.float32(0.0), np.float32(1.0), np.float32(0.0), np.float32(0.0), np.float32(1.0)]",-1.0,99430.0,23
2025-08-14_08-18-36,5158,"[np.float32(0.0), np.float32(1.0), np.float32(1.0), np.float32(1.0), np.float32(0.0), np.float32(1.0), np.float32(1.0), np.float32(1.0), np.float32(1.0), np.float32(0.0), np.float32(0.0), np.float32(1.0), np.float32(0.0), np.float32(1.0), np.float32(1.0), np.float32(0.0)]",0.0,99430.0,10
2025-08-14_08-18-36,5159,"[np.float32(0.0), np.float32(0.0), np.float32(0.0), np.float32(1.0), np.float32(0.0), np.float32(1.0), np.float32(1.0), np.float32(1.0), np.float32(0.0), np.float32(1.0), np.float32(0.0), np.float32(0.0), np.float32(1.0), np.float32(0.0), np.float32(1.0), np.float32(0.0)]",3.0,99433.0,19
2025-08-14_08-18-36,5160,"[np.float32(1.0), np.float32(0.0), np.float32(1.0), np.float32(0.0), np.float32(0.0), np.float32(0.0), np.float32(1.0), np.float32(1.0), np.float32(0.0), np.float32(0.0), np.float32(0.0), np.float32(0.0), np.float32(1.0), np.float32(1.0), np.float32(0.0), np.float32(0.0)]",1.0,99434.0,14
2025-08-14_08-18-36,5161,"[np.float32(1.0), np.float32(1.0), np.float32(0.0), np.float32(1.0), np.float32(0.0), np.float32(0.0), np.float32(0.0), np.float32(1.0), np.float32(1.0), np.float32(0.0), np.float32(1.0), np.float32(1.0), np.float32(0.0), np.float32(1.0), np.float32(0.0), np.float32(0.0)]",-3.0,99431.0,16
2025-08-14_08-18-36,5162,"[np.float32(1.0), np.float32(0.0), np.float32(0.0), np.float32(1.0), np.float32(0.0), np.float32(0.0), np.float32(1.0), np.float32(1.0), np.float32(0.0), np.float32(0.0), np.float32(0.0), np.float32(0.0), np.float32(1.0), np.float32(0.0), np.float32(0.0), np.float32(0.0)]",-3.0,99428.0,36
2025-08-14_08-18-36,5163,"[np.float32(0.0), np.float32(0.0), np.float32(0.0), np.float32(0.0), np.float32(1.0), np.float32(0.0), np.float32(1.0), np.float32(1.0), np.float32(1.0), np.float32(0.0), np.float32(1.0), np.float32(0.0), np.float32(0.0), np.float32(1.0), np.float32(0.0), np.float32(1.0)]",2.0,99430.0,35
2025-08-14_08-18-36,5164,"[np.float32(0.0), np.float32(1.0), np.float32(0.0), np.float32(0.0), np.float32(1.0), np.float32(0.0), np.float32(0.0), np.float32(0.0), np.float32(0.0), np.float32(0.0), np.float32(1.0), np.float32(0.0), np.float32(0.0), np.float32(1.0), np.float32(1.0), np.float32(1.0)]",0.0,99430.0,32
2025-08-14_08-18-36,5165,"[np.float32(0.0), np.float32(1.0), np.float32(0.0), np.float32(0.0), np.float32(0.0), np.float32(1.0), np.float32(1.0), np.float32(1.0), np.float32(0.0), np.float32(1.0), np.float32(0.0), np.float32(0.0), np.float32(0.0), np.float32(0.0), np.float32(0.0), np.float32(1.0)]",0.0,99430.0,16
2025-08-14_08-18-36,5166,"[np.float32(1.0), np.float32(1.0), np.float32(0.0), np.float32(1.0), np.float32(0.0), np.float32(0.0), np.float32(0.0), np.float32(1.0), np.float32(0.0), np.float32(0.0), np.float32(0.0), np.float32(0.0), np.float32(0.0), np.float32(0.0), np.float32(0.0), np.float32(0.0)]",0.0,99430.0,27
2025-08-14_08-18-36,5167,"[np.float32(0.0), np.float32(1.0), np.float32(0.0), np.float32(0.0), np.float32(1.0), np.float32(0.0), np.float32(1.0), np.float32(1.0), np.float32(1.0), np.float32(0.0), np.float32(0.0), np.float32(0.0), np.float32(0.0), np.float32(1.0), np.float32(0.0), np.float32(0.0)]",4.0,99434.0,15
2025-08-14_08-18-36,5168,"[np.float32(0.0), np.float32(1.0), np.float32(0.0), np.float32(1.0), np.float32(1.0), np.float32(0.0), np.float32(0.0), np.float32(1.0), np.float32(0.0), np.float32(1.0), np.float32(0.0), np.float32(1.0), np.float32(1.0), np.float32(0.0), np.float32(1.0), np.float32(0.0)]",3.0,99437.0,24
2025-08-14_08-18-36,5169,"[np.float32(0.0), np.float32(1.0), np.float32(1.0), np.float32(1.0), np.float32(0.0), np.float32(1.0), np.float32(0.0), np.float32(0.0), np.float32(1.0), np.float32(1.0), np.float32(0.0), np.float32(1.0), np.float32(1.0), np.float32(1.0), np.float32(0.0), np.float32(1.0)]",2.0,99439.0,29
2025-08-14_08-18-36,5170,"[np.float32(0.0), np.float32(1.0), np.float32(0.0), np.float32(0.0), np.float32(1.0), np.float32(1.0), np.float32(1.0), np.float32(0.0), np.float32(0.0), np.float32(1.0), np.float32(0.0), np.float32(1.0), np.float32(1.0), np.float32(1.0), np.float32(1.0), np.float32(1.0)]",0.0,99439.0,2
2025-08-14_08-18-36,5171,"[np.float32(0.0), np.float32(0.0), np.float32(0.0), np.float32(1.0), np.float32(0.0), np.float32(1.0), np.float32(0.0), np.float32(1.0), np.float32(0.0), np.float32(0.0), np.float32(1.0), np.float32(0.0), np.float32(0.0), np.float32(1.0), np.float32(1.0), np.float32(0.0)]",2.0,99441.0,26
2025-08-14_08-18-36,5172,"[np.float32(1.0), np.float32(1.0), np.float32(0.0), np.float32(0.0), np.float32(1.0), np.float32(0.0), np.float32(0.0), np.float32(0.0), np.float32(0.0), np.float32(0.0), np.float32(0.0), np.float32(0.0), np.float32(0.0), np.float32(0.0), np.float32(1.0), np.float32(1.0)]",-1.0,99440.0,2
2025-08-14_08-18-36,5173,"[np.float32(0.0), np.float32(1.0), np.float32(1.0), np.float32(0.0), np.float32(1.0), np.float32(1.0), np.float32(1.0), np.float32(1.0), np.float32(0.0), np.float32(1.0), np.float32(1.0), np.float32(1.0), np.float32(1.0), np.float32(1.0), np.float32(0.0), np.float32(0.0)]",1.0,99441.0,8
2025-08-14_08-18-36,5174,"[np.float32(0.0), np.float32(1.0), np.float32(1.0), np.float32(0.0), np.float32(1.0), np.float32(1.0), np.float32(0.0), np.float32(1.0), np.float32(0.0), np.float32(0.0), np.float32(1.0), np.float32(0.0), np.float32(1.0), np.float32(1.0), np.float32(0.0), np.float32(0.0)]",2.0,99443.0,18
2025-08-14_08-18-36,5175,"[np.float32(0.0), np.float32(0.0), np.float32(0.0), np.float32(0.0), np.float32(1.0), np.float32(1.0), np.float32(1.0), np.float32(1.0), np.float32(1.0), np.float32(0.0), np.float32(1.0), np.float32(1.0), np.float32(1.0), np.float32(1.0), np.float32(0.0), np.float32(0.0)]",-1.0,99442.0,8
2025-08-14_08-18-36,5176,"[np.float32(1.0), np.float32(0.0), np.float32(1.0), np.float32(1.0), np.float32(1.0), np.float32(1.0), np.float32(0.0), np.float32(0.0), np.float32(0.0), np.float32(0.0), np.float32(0.0), np.float32(1.0), np.float32(1.0), np.float32(0.0), np.float32(1.0), np.float32(0.0)]",34.0,99476.0,7
2025-08-14_08-18-36,5177,"[np.float32(0.0), np.float32(1.0), np.float32(0.0), np.float32(0.0), np.float32(1.0), np.float32(1.0), np.float32(1.0), np.float32(1.0), np.float32(1.0), np.float32(1.0), np.float32(1.0), np.float32(1.0), np.float32(1.0), np.float32(1.0), np.float32(0.0), np.float32(1.0)]",-1.0,99475.0,9
2025-08-14_08-18-36,5178,"[np.float32(0.0), np.float32(0.0), np.float32(1.0), np.float32(1.0), np.float32(0.0), np.float32(0.0), np.float32(0.0), np.float32(0.0), np.float32(1.0), np.float32(1.0), np.float32(1.0), np.float32(1.0), np.float32(1.0), np.float32(1.0), np.float32(0.0), np.float32(1.0)]",-1.0,99474.0,33
2025-08-14_08-18-36,5179,"[np.float32(0.0), np.float32(1.0), np.float32(1.0), np.float32(1.0), np.float32(1.0), np.float32(1.0), np.float32(0.0), np.float32(1.0), np.float32(0.0), np.float32(0.0), np.float32(1.0), np.float32(0.0), np.float32(1.0), np.float32(0.0), np.float32(1.0), np.float32(1.0)]",2.0,99476.0,11
2025-08-14_08-18-36,5180,"[np.float32(1.0), np.float32(1.0), np.float32(0.0), np.float32(1.0), np.float32(1.0), np.float32(0.0), np.float32(0.0), np.float32(0.0), np.float32(1.0), np.float32(0.0), np.float32(0.0), np.float32(0.0), np.float32(1.0), np.float32(0.0), np.float32(0.0), np.float32(1.0)]",-5.0,99471.0,24
2025-08-14_08-18-36,5181,"[np.float32(0.0), np.float32(1.0), np.float32(0.0), np.float32(1.0), np.float32(0.0), np.float32(1.0), np.float32(0.0), np.float32(0.0), np.float32(0.0), np.float32(0.0), np.float32(0.0), np.float32(1.0), np.float32(1.0), np.float32(1.0), np.float32(0.0), np.float32(0.0)]",-4.0,99467.0,8
2025-08-14_08-18-36,5182,"[np.float32(0.0), np.float32(0.0), np.float32(0.0), np.float32(0.0), np.float32(1.0), np.float32(0.0), np.float32(1.0), np.float32(0.0), np.float32(1.0), np.float32(0.0), np.float32(1.0), np.float32(1.0), np.float32(0.0), np.float32(1.0), np.float32(0.0), np.float32(1.0)]",-1.0,99466.0,34
2025-08-14_08-18-36,5183,"[np.float32(1.0), np.float32(0.0), np.float32(0.0), np.float32(1.0), np.float32(0.0), np.float32(1.0), np.float32(0.0), np.float32(1.0), np.float32(1.0), np.float32(1.0), np.float32(0.0), np.float32(0.0), np.float32(0.0), np.float32(1.0), np.float32(1.0), np.float32(1.0)]",4.0,99470.0,31
2025-08-14_08-18-36,5184,"[np.float32(1.0), np.float32(1.0), np.float32(1.0), np.float32(0.0), np.float32(0.0), np.float32(0.0), np.float32(1.0), np.float32(1.0), np.float32(1.0), np.float32(0.0), np.float32(1.0), np.float32(1.0), np.float32(0.0), np.float32(1.0), np.float32(0.0), np.float32(0.0)]",-1.0,99469.0,33
2025-08-14_08-18-36,5185,"[np.float32(1.0), np.float32(0.0), np.float32(1.0), np.float32(1.0), np.float32(0.0), np.float32(1.0), np.float32(0.0), np.float32(1.0), np.float32(0.0), np.float32(0.0), np.float32(1.0), np.float32(0.0), np.float32(0.0), np.float32(0.0), np.float32(1.0), np.float32(0.0)]",1.0,99470.0,8
2025-08-14_08-18-36,5186,"[np.float32(1.0), np.float32(0.0), np.float32(0.0), np.float32(0.0), np.float32(0.0), np.float32(1.0), np.float32(0.0), np.float32(0.0), np.float32(0.0), np.float32(0.0), np.float32(1.0), np.float32(1.0), np.float32(1.0), np.float32(1.0), np.float32(0.0), np.float32(1.0)]",0.0,99470.0,27
2025-08-14_08-18-36,5187,"[np.float32(0.0), np.float32(1.0), np.float32(1.0), np.float32(0.0), np.float32(1.0), np.float32(1.0), np.float32(0.0), np.float32(0.0), np.float32(0.0), np.float32(1.0), np.float32(0.0), np.float32(0.0), np.float32(1.0), np.float32(0.0), np.float32(1.0), np.float32(0.0)]",0.0,99470.0,30
2025-08-14_08-18-36,5188,"[np.float32(0.0), np.float32(0.0), np.float32(0.0), np.float32(0.0), np.float32(0.0), np.float32(0.0), np.float32(1.0), np.float32(1.0), np.float32(0.0), np.float32(1.0), np.float32(0.0), np.float32(1.0), np.float32(1.0), np.float32(0.0), np.float32(1.0), np.float32(0.0)]",-6.0,99464.0,26
2025-08-14_08-18-36,5189,"[np.float32(1.0), np.float32(1.0), np.float32(1.0), np.float32(0.0), np.float32(1.0), np.float32(1.0), np.float32(0.0), np.float32(1.0), np.float32(0.0), np.float32(1.0), np.float32(0.0), np.float32(1.0), np.float32(0.0), np.float32(0.0), np.float32(1.0), np.float32(1.0)]",-3.0,99461.0,7
2025-08-14_08-18-36,5190,"[np.float32(1.0), np.float32(0.0), np.float32(1.0), np.float32(1.0), np.float32(1.0), np.float32(1.0), np.float32(1.0), np.float32(1.0), np.float32(0.0), np.float32(0.0), np.float32(0.0), np.float32(0.0), np.float32(1.0), np.float32(1.0), np.float32(0.0), np.float32(0.0)]",1.0,99462.0,15
2025-08-14_08-18-36,5191,"[np.float32(1.0), np.float32(0.0), np.float32(1.0), np.float32(0.0), np.float32(1.0), np.float32(1.0), np.float32(0.0), np.float32(1.0), np.float32(1.0), np.float32(0.0), np.float32(0.0), np.float32(0.0), np.float32(0.0), np.float32(0.0), np.float32(1.0), np.float32(0.0)]",-2.0,99460.0,29
2025-08-14_08-18-36,5192,"[np.float32(0.0), np.float32(1.0), np.float32(0.0), np.float32(0.0), np.float32(1.0), np.float32(1.0), np.float32(1.0), np.float32(0.0), np.float32(0.0), np.float32(0.0), np.float32(0.0), np.float32(1.0), np.float32(1.0), np.float32(0.0), np.float32(0.0), np.float32(1.0)]",0.0,99460.0,8
2025-08-14_08-18-36,5193,"[np.float32(1.0), np.float32(1.0), np.float32(0.0), np.float32(1.0), np.float32(1.0), np.float32(0.0), np.float32(0.0), np.float32(0.0), np.float32(1.0), np.float32(0.0), np.float32(1.0), np.float32(1.0), np.float32(0.0), np.float32(0.0), np.float32(1.0), np.float32(1.0)]",0.0,99460.0,13
2025-08-14_08-18-36,5194,"[np.float32(1.0), np.float32(1.0), np.float32(0.0), np.float32(0.0), np.float32(0.0), np.float32(1.0), np.float32(1.0), np.float32(1.0), np.float32(1.0), np.float32(0.0), np.float32(1.0), np.float32(0.0), np.float32(1.0), np.float32(0.0), np.float32(0.0), np.float32(0.0)]",0.0,99460.0,8
2025-08-14_08-18-36,5195,"[np.float32(1.0), np.float32(1.0), np.float32(1.0), np.float32(1.0), np.float32(1.0), np.float32(0.0), np.float32(1.0), np.float32(1.0), np.float32(1.0), np.float32(0.0), np.float32(0.0), np.float32(0.0), np.float32(0.0), np.float32(1.0), np.float32(1.0), np.float32(0.0)]",0.0,99460.0,28
2025-08-14_08-18-36,5196,"[np.float32(0.0), np.float32(1.0), np.float32(0.0), np.float32(0.0), np.float32(0.0), np.float32(1.0), np.float32(1.0), np.float32(1.0), np.float32(1.0), np.float32(0.0), np.float32(0.0), np.float32(0.0), np.float32(0.0), np.float32(0.0), np.float32(0.0), np.float32(0.0)]",-1.0,99459.0,0
2025-08-14_08-18-36,5197,"[np.float32(1.0), np.float32(1.0), np.float32(1.0), np.float32(0.0), np.float32(0.0), np.float32(0.0), np.float32(1.0), np.float32(0.0), np.float32(1.0), np.float32(0.0), np.float32(0.0), np.float32(1.0), np.float32(0.0), np.float32(0.0), np.float32(0.0), np.float32(0.0)]",-1.0,99458.0,35
2025-08-14_08-18-36,5198,"[np.float32(0.0), np.float32(1.0), np.float32(0.0), np.float32(1.0), np.float32(0.0), np.float32(1.0), np.float32(0.0), np.float32(1.0), np.float32(1.0), np.float32(1.0), np.float32(1.0), np.float32(1.0), np.float32(0.0), np.float32(0.0), np.float32(1.0), np.float32(0.0)]",4.0,99462.0,24
2025-08-14_08-18-36,5199,"[np.float32(0.0), np.float32(1.0), np.float32(0.0), np.float32(0.0), np.float32(0.0), np.float32(1.0), np.float32(0.0), np.float32(0.0), np.float32(1.0), np.float32(1.0), np.float32(1.0), np.float32(1.0), np.float32(0.0), np.float32(1.0), np.float32(1.0), np.float32(0.0)]",-3.0,99459.0,6
2025-08-14_08-18-36,5200,"[np.float32(0.0), np.float32(1.0), np.float32(1.0), np.float32(0.0), np.float32(0.0), np.float32(1.0), np.float32(1.0), np.float32(1.0), np.float32(0.0), np.float32(1.0), np.float32(0.0), np.float32(0.0), np.float32(1.0), np.float32(0.0), np.float32(1.0), np.float32(1.0)]",0.0,99459.0,28
2025-08-14_08-18-36,5201,"[np.float32(0.0), np.float32(1.0), np.float32(0.0), np.float32(1.0), np.float32(0.0), np.float32(0.0), np.float32(1.0), np.float32(1.0), np.float32(0.0), np.float32(0.0), np.float32(0.0), np.float32(0.0), np.float32(0.0), np.float32(0.0), np.float32(0.0), np.float32(0.0)]",-2.0,99457.0,27
2025-08-14_08-18-36,5202,"[np.float32(0.0), np.float32(1.0), np.float32(1.0), np.float32(1.0), np.float32(0.0), np.float32(1.0), np.float32(0.0), np.float32(0.0), np.float32(0.0), np.float32(1.0), np.float32(0.0), np.float32(1.0), np.float32(0.0), np.float32(1.0), np.float32(1.0), np.float32(1.0)]",3.0,99460.0,33
2025-08-14_08-18-36,5203,"[np.float32(1.0), np.float32(0.0), np.float32(1.0), np.float32(1.0), np.float32(0.0), np.float32(1.0), np.float32(0.0), np.float32(1.0), np.float32(0.0), np.float32(0.0), np.float32(1.0), np.float32(1.0), np.float32(0.0), np.float32(0.0), np.float32(0.0), np.float32(0.0)]",-2.0,99458.0,11
2025-08-14_08-18-36,5204,"[np.float32(1.0), np.float32(0.0), np.float32(1.0), np.float32(0.0), np.float32(1.0), np.float32(1.0), np.float32(0.0), np.float32(1.0), np.float32(1.0), np.float32(0.0), np.float32(0.0), np.float32(1.0), np.float32(1.0), np.float32(0.0), np.float32(1.0), np.float32(0.0)]",3.0,99461.0,18
2025-08-14_08-18-36,5205,"[np.float32(0.0), np.float32(1.0), np.float32(0.0), np.float32(0.0), np.float32(0.0), np.float32(0.0), np.float32(0.0), np.float32(0.0), np.float32(1.0), np.float32(1.0), np.float32(1.0), np.float32(0.0), np.float32(1.0), np.float32(0.0), np.float32(0.0), np.float32(0.0)]",-2.0,99459.0,36
2025-08-14_08-18-36,5206,"[np.float32(1.0), np.float32(0.0), np.float32(0.0), np.float32(0.0), np.float32(0.0), np.float32(0.0), np.float32(1.0), np.float32(1.0), np.float32(1.0), np.float32(1.0), np.float32(1.0), np.float32(1.0), np.float32(1.0), np.float32(0.0), np.float32(1.0), np.float32(0.0)]",2.0,99461.0,27
2025-08-14_08-18-36,5207,"[np.float32(0.0), np.float32(1.0), np.float32(0.0), np.float32(0.0), np.float32(1.0), np.float32(1.0), np.float32(0.0), np.float32(0.0), np.float32(1.0), np.float32(0.0), np.float32(0.0), np.float32(0.0), np.float32(0.0), np.float32(0.0), np.float32(0.0), np.float32(0.0)]",1.0,99462.0,25
2025-08-14_08-18-36,5208,"[np.float32(1.0), np.float32(1.0), np.float32(1.0), np.float32(0.0), np.float32(0.0), np.float32(1.0), np.float32(1.0), np.float32(1.0), np.float32(0.0), np.float32(1.0), np.float32(1.0), np.float32(1.0), np.float32(0.0), np.float32(0.0), np.float32(1.0), np.float32(0.0)]",3.0,99465.0,8
2025-08-14_08-18-36,5209,"[np.float32(1.0), np.float32(1.0), np.float32(1.0), np.float32(0.0), np.float32(1.0), np.float32(1.0), np.float32(0.0), np.float32(1.0), np.float32(1.0), np.float32(0.0), np.float32(0.0), np.float32(1.0), np.float32(1.0), np.float32(0.0), np.float32(0.0), np.float32(1.0)]",-3.0,99462.0,35
2025-08-14_08-18-36,5210,"[np.float32(1.0), np.float32(1.0), np.float32(0.0), np.float32(0.0), np.float32(1.0), np.float32(1.0), np.float32(1.0), np.float32(0.0), np.float32(1.0), np.float32(1.0), np.float32(1.0), np.float32(0.0), np.float32(1.0), np.float32(0.0), np.float32(0.0), np.float32(0.0)]",1.0,99463.0,29
2025-08-14_08-18-36,5211,"[np.float32(1.0), np.float32(1.0), np.float32(0.0), np.float32(0.0), np.float32(0.0), np.float32(1.0), np.float32(1.0), np.float32(1.0), np.float32(0.0), np.float32(1.0), np.float32(0.0), np.float32(0.0), np.float32(1.0), np.float32(1.0), np.float32(1.0), np.float32(0.0)]",1.0,99464.0,24
2025-08-14_08-18-36,5212,"[np.float32(0.0), np.float32(0.0), np.float32(0.0), np.float32(1.0), np.float32(0.0), np.float32(0.0), np.float32(1.0), np.float32(1.0), np.float32(1.0), np.float32(1.0), np.float32(1.0), np.float32(0.0), np.float32(1.0), np.float32(1.0), np.float32(0.0), np.float32(0.0)]",3.0,99467.0,29
2025-08-14_08-18-36,5213,"[np.float32(1.0), np.float32(1.0), np.float32(0.0), np.float32(0.0), np.float32(1.0), np.float32(0.0), np.float32(1.0), np.float32(1.0), np.float32(1.0), np.float32(0.0), np.float32(0.0), np.float32(1.0), np.float32(0.0), np.float32(1.0), np.float32(0.0), np.float32(0.0)]",-1.0,99466.0,13
2025-08-14_08-18-36,5214,"[np.float32(1.0), np.float32(0.0), np.float32(0.0), np.float32(0.0), np.float32(0.0), np.float32(0.0), np.float32(1.0), np.float32(1.0), np.float32(0.0), np.float32(0.0), np.float32(0.0), np.float32(1.0), np.float32(0.0), np.float32(1.0), np.float32(0.0), np.float32(1.0)]",-3.0,99463.0,8
2025-08-14_08-18-36,5215,"[np.float32(0.0), np.float32(1.0), np.float32(1.0), np.float32(1.0), np.float32(1.0), np.float32(1.0), np.float32(0.0), np.float32(1.0), np.float32(0.0), np.float32(0.0), np.float32(0.0), np.float32(0.0), np.float32(0.0), np.float32(1.0), np.float32(1.0), np.float32(1.0)]",3.0,99466.0,20
2025-08-14_08-18-36,5216,"[np.float32(0.0), np.float32(1.0), np.float32(1.0), np.float32(0.0), np.float32(1.0), np.float32(0.0), np.float32(1.0), np.float32(0.0), np.float32(0.0), np.float32(0.0), np.float32(1.0), np.float32(1.0), np.float32(1.0), np.float32(1.0), np.float32(0.0), np.float32(1.0)]",1.0,99467.0,11
2025-08-14_08-18-36,5217,"[np.float32(0.0), np.float32(1.0), np.float32(0.0), np.float32(0.0), np.float32(0.0), np.float32(0.0), np.float32(1.0), np.float32(1.0), np.float32(1.0), np.float32(0.0), np.float32(1.0), np.float32(0.0), np.float32(1.0), np.float32(0.0), np.float32(0.0), np.float32(1.0)]",-2.0,99465.0,28
2025-08-14_08-18-36,5218,"[np.float32(0.0), np.float32(1.0), np.float32(1.0), np.float32(1.0), np.float32(1.0), np.float32(1.0), np.float32(1.0), np.float32(1.0), np.float32(1.0), np.float32(0.0), np.float32(1.0), np.float32(0.0), np.float32(1.0), np.float32(0.0), np.float32(0.0), np.float32(1.0)]",-4.0,99461.0,30
2025-08-14_08-18-36,5219,"[np.float32(1.0), np.float32(0.0), np.float32(0.0), np.float32(0.0), np.float32(0.0), np.float32(0.0), np.float32(1.0), np.float32(1.0), np.float32(0.0), np.float32(0.0), np.float32(0.0), np.float32(1.0), np.float32(0.0), np.float32(0.0), np.float32(0.0), np.float32(0.0)]",-4.0,99457.0,0
2025-08-14_08-18-36,5220,"[np.float32(0.0), np.float32(1.0), np.float32(0.0), np.float32(0.0), np.float32(0.0), np.float32(1.0), np.float32(1.0), np.float32(0.0), np.float32(1.0), np.float32(1.0), np.float32(1.0), np.float32(1.0), np.float32(0.0), np.float32(1.0), np.float32(1.0), np.float32(0.0)]",-1.0,99456.0,15
2025-08-14_08-18-36,5221,"[np.float32(0.0), np.float32(1.0), np.float32(1.0), np.float32(1.0), np.float32(1.0), np.float32(1.0), np.float32(1.0), np.float32(1.0), np.float32(1.0), np.float32(1.0), np.float32(0.0), np.float32(1.0), np.float32(1.0), np.float32(0.0), np.float32(0.0), np.float32(0.0)]",-2.0,99454.0,11
2025-08-14_08-18-36,5222,"[np.float32(1.0), np.float32(1.0), np.float32(0.0), np.float32(0.0), np.float32(0.0), np.float32(1.0), np.float32(0.0), np.float32(1.0), np.float32(1.0), np.float32(0.0), np.float32(1.0), np.float32(0.0), np.float32(1.0), np.float32(1.0), np.float32(1.0), np.float32(0.0)]",-1.0,99453.0,16
2025-08-14_08-18-36,5223,"[np.float32(0.0), np.float32(0.0), np.float32(0.0), np.float32(0.0), np.float32(1.0), np.float32(1.0), np.float32(0.0), np.float32(1.0), np.float32(1.0), np.float32(1.0), np.float32(0.0), np.float32(1.0), np.float32(1.0), np.float32(1.0), np.float32(0.0), np.float32(0.0)]",-3.0,99450.0,20
2025-08-14_08-18-36,5224,"[np.float32(1.0), np.float32(0.0), np.float32(1.0), np.float32(1.0), np.float32(1.0), np.float32(0.0), np.float32(1.0), np.float32(1.0), np.float32(1.0), np.float32(0.0), np.float32(1.0), np.float32(0.0), np.float32(1.0), np.float32(1.0), np.float32(1.0), np.float32(0.0)]",-1.0,99449.0,36
2025-08-14_08-18-36,5225,"[np.float32(1.0), np.float32(0.0), np.float32(1.0), np.float32(0.0), np.float32(1.0), np.float32(0.0), np.float32(0.0), np.float32(1.0), np.float32(0.0), np.float32(1.0), np.float32(1.0), np.float32(1.0), np.float32(0.0), np.float32(0.0), np.float32(0.0), np.float32(1.0)]",-1.0,99448.0,8
2025-08-14_08-18-36,5226,"[np.float32(0.0), np.float32(1.0), np.float32(0.0), np.float32(1.0), np.float32(0.0), np.float32(0.0), np.float32(1.0), np.float32(0.0), np.float32(1.0), np.float32(1.0), np.float32(1.0), np.float32(0.0), np.float32(1.0), np.float32(1.0), np.float32(0.0), np.float32(0.0)]",2.0,99450.0,11
2025-08-14_08-18-36,5227,"[np.float32(0.0), np.float32(1.0), np.float32(0.0), np.float32(1.0), np.float32(0.0), np.float32(1.0), np.float32(1.0), np.float32(0.0), np.float32(1.0), np.float32(0.0), np.float32(1.0), np.float32(1.0), np.float32(0.0), np.float32(0.0), np.float32(0.0), np.float32(0.0)]",-2.0,99448.0,4
2025-08-14_08-18-36,5228,"[np.float32(0.0), np.float32(0.0), np.float32(1.0), np.float32(0.0), np.float32(0.0), np.float32(1.0), np.float32(0.0), np.float32(1.0), np.float32(0.0), np.float32(1.0), np.float32(1.0), np.float32(1.0), np.float32(0.0), np.float32(1.0), np.float32(0.0), np.float32(1.0)]",-5.0,99443.0,11
2025-08-14_08-18-36,5229,"[np.float32(0.0), np.float32(0.0), np.float32(0.0), np.float32(1.0), np.float32(0.0), np.float32(0.0), np.float32(0.0), np.float32(0.0), np.float32(0.0), np.float32(0.0), np.float32(0.0), np.float32(1.0), np.float32(0.0), np.float32(0.0), np.float32(0.0), np.float32(1.0)]",-1.0,99442.0,25
2025-08-14_08-18-36,5230,"[np.float32(0.0), np.float32(0.0), np.float32(1.0), np.float32(0.0), np.float32(1.0), np.float32(1.0), np.float32(1.0), np.float32(0.0), np.float32(1.0), np.float32(0.0), np.float32(1.0), np.float32(1.0), np.float32(0.0), np.float32(1.0), np.float32(1.0), np.float32(0.0)]",-2.0,99440.0,34
2025-08-14_08-18-36,5231,"[np.float32(1.0), np.float32(0.0), np.float32(0.0), np.float32(1.0), np.float32(0.0), np.float32(1.0), np.float32(1.0), np.float32(0.0), np.float32(0.0), np.float32(0.0), np.float32(1.0), np.float32(0.0), np.float32(1.0), np.float32(0.0), np.float32(0.0), np.float32(1.0)]",-1.0,99439.0,8
2025-08-14_08-18-36,5232,"[np.float32(0.0), np.float32(1.0), np.float32(0.0), np.float32(1.0), np.float32(1.0), np.float32(1.0), np.float32(0.0), np.float32(1.0), np.float32(0.0), np.float32(1.0), np.float32(1.0), np.float32(0.0), np.float32(0.0), np.float32(0.0), np.float32(0.0), np.float32(1.0)]",1.0,99440.0,15
2025-08-14_08-18-36,5233,"[np.float32(0.0), np.float32(1.0), np.float32(0.0), np.float32(1.0), np.float32(0.0), np.float32(0.0), np.float32(1.0), np.float32(1.0), np.float32(1.0), np.float32(1.0), np.float32(1.0), np.float32(1.0), np.float32(0.0), np.float32(0.0), np.float32(0.0), np.float32(0.0)]",0.0,99440.0,24
2025-08-14_08-18-36,5234,"[np.float32(1.0), np.float32(0.0), np.float32(1.0), np.float32(1.0), np.float32(1.0), np.float32(1.0), np.float32(0.0), np.float32(0.0), np.float32(1.0), np.float32(1.0), np.float32(1.0), np.float32(1.0), np.float32(0.0), np.float32(0.0), np.float32(1.0), np.float32(0.0)]",2.0,99442.0,23
2025-08-14_08-18-36,5235,"[np.float32(1.0), np.float32(0.0), np.float32(0.0), np.float32(0.0), np.float32(0.0), np.float32(1.0), np.float32(0.0), np.float32(1.0), np.float32(0.0), np.float32(1.0), np.float32(0.0), np.float32(0.0), np.float32(0.0), np.float32(1.0), np.float32(1.0), np.float32(0.0)]",4.0,99446.0,25
2025-08-14_08-18-36,5236,"[np.float32(1.0), np.float32(1.0), np.float32(1.0), np.float32(0.0), np.float32(0.0), np.float32(0.0), np.float32(0.0), np.float32(1.0), np.float32(1.0), np.float32(1.0), np.float32(0.0), np.float32(1.0), np.float32(0.0), np.float32(1.0), np.float32(0.0), np.float32(1.0)]",-2.0,99444.0,0
2025-08-14_08-18-36,5237,"[np.float32(1.0), np.float32(0.0), np.float32(1.0), np.float32(1.0), np.float32(1.0), np.float32(0.0), np.float32(1.0), np.float32(1.0), np.float32(0.0), np.float32(0.0), np.float32(1.0), np.float32(0.0), np.float32(0.0), np.float32(0.0), np.float32(0.0), np.float32(0.0)]",-5.0,99439.0,31
2025-08-14_08-18-36,5238,"[np.float32(0.0), np.float32(0.0), np.float32(1.0), np.float32(1.0), np.float32(1.0), np.float32(1.0), np.float32(1.0), np.float32(1.0), np.float32(0.0), np.float32(1.0), np.float32(0.0), np.float32(1.0), np.float32(1.0), np.float32(0.0), np.float32(0.0), np.float32(0.0)]",-2.0,99437.0,30
2025-08-14_08-18-36,5239,"[np.float32(0.0), np.float32(1.0), np.float32(0.0), np.float32(0.0), np.float32(0.0), np.float32(1.0), np.float32(1.0), np.float32(1.0), np.float32(1.0), np.float32(1.0), np.float32(1.0), np.float32(0.0), np.float32(0.0), np.float32(1.0), np.float32(1.0), np.float32(0.0)]",1.0,99438.0,24
2025-08-14_08-18-36,5240,"[np.float32(1.0), np.float32(0.0), np.float32(0.0), np.float32(0.0), np.float32(1.0), np.float32(1.0), np.float32(1.0), np.float32(0.0), np.float32(0.0), np.float32(0.0), np.float32(0.0), np.float32(0.0), np.float32(1.0), np.float32(0.0), np.float32(0.0), np.float32(1.0)]",-4.0,99434.0,28
2025-08-14_08-18-36,5241,"[np.float32(0.0), np.float32(1.0), np.float32(1.0), np.float32(1.0), np.float32(1.0), np.float32(0.0), np.float32(1.0), np.float32(0.0), np.float32(1.0), np.float32(0.0), np.float32(1.0), np.float32(0.0), np.float32(0.0), np.float32(0.0), np.float32(1.0), np.float32(0.0)]",0.0,99434.0,30
2025-08-14_08-18-36,5242,"[np.float32(1.0), np.float32(1.0), np.float32(0.0), np.float32(1.0), np.float32(1.0), np.float32(0.0), np.float32(1.0), np.float32(1.0), np.float32(1.0), np.float32(0.0), np.float32(0.0), np.float32(1.0), np.float32(1.0), np.float32(0.0), np.float32(0.0), np.float32(0.0)]",-2.0,99432.0,8
2025-08-14_08-18-36,5243,"[np.float32(0.0), np.float32(0.0), np.float32(1.0), np.float32(1.0), np.float32(0.0), np.float32(0.0), np.float32(0.0), np.float32(1.0), np.float32(1.0), np.float32(0.0), np.float32(1.0), np.float32(0.0), np.float32(0.0), np.float32(1.0), np.float32(1.0), np.float32(0.0)]",1.0,99433.0,20
2025-08-14_08-18-36,5244,"[np.float32(1.0), np.float32(1.0), np.float32(0.0), np.float32(0.0), np.float32(0.0), np.float32(1.0), np.float32(0.0), np.float32(1.0), np.float32(0.0), np.float32(1.0), np.float32(1.0), np.float32(0.0), np.float32(1.0), np.float32(1.0), np.float32(0.0), np.float32(0.0)]",0.0,99433.0,4
2025-08-14_08-18-36,5245,"[np.float32(1.0), np.float32(1.0), np.float32(1.0), np.float32(0.0), np.float32(1.0), np.float32(1.0), np.float32(1.0), np.float32(1.0), np.float32(1.0), np.float32(0.0), np.float32(0.0), np.float32(1.0), np.float32(0.0), np.float32(1.0), np.float32(1.0), np.float32(0.0)]",1.0,99434.0,22
2025-08-14_08-18-36,5246,"[np.float32(0.0), np.float32(1.0), np.float32(1.0), np.float32(1.0), np.float32(1.0), np.float32(1.0), np.float32(1.0), np.float32(1.0), np.float32(0.0), np.float32(1.0), np.float32(1.0), np.float32(0.0), np.float32(0.0), np.float32(0.0), np.float32(1.0), np.float32(0.0)]",0.0,99434.0,7
2025-08-14_08-18-36,5247,"[np.float32(1.0), np.float32(0.0), np.float32(1.0), np.float32(0.0), np.float32(1.0), np.float32(0.0), np.float32(1.0), np.float32(0.0), np.float32(1.0), np.float32(0.0), np.float32(0.0), np.float32(0.0), np.float32(0.0), np.float32(0.0), np.float32(0.0), np.float32(1.0)]",-1.0,99433.0,27
2025-08-14_08-18-36,5248,"[np.float32(0.0), np.float32(1.0), np.float32(1.0), np.float32(1.0), np.float32(1.0), np.float32(0.0), np.float32(1.0), np.float32(1.0), np.float32(0.0), np.float32(0.0), np.float32(0.0), np.float32(1.0), np.float32(1.0), np.float32(1.0), np.float32(0.0), np.float32(1.0)]",1.0,99434.0,21
2025-08-14_08-18-36,5249,"[np.float32(0.0), np.float32(0.0), np.float32(1.0), np.float32(0.0), np.float32(0.0), np.float32(1.0), np.float32(0.0), np.float32(1.0), np.float32(0.0), np.float32(0.0), np.float32(0.0), np.float32(1.0), np.float32(1.0), np.float32(0.0), np.float32(1.0), np.float32(1.0)]",-4.0,99430.0,3
2025-08-14_08-18-36,5250,"[np.float32(0.0), np.float32(1.0), np.float32(0.0), np.float32(0.0), np.float32(0.0), np.float32(1.0), np.float32(1.0), np.float32(1.0), np.float32(0.0), np.float32(0.0), np.float32(1.0), np.float32(0.0), np.float32(0.0), np.float32(0.0), np.float32(0.0), np.float32(0.0)]",-2.0,99428.0,1
2025-08-14_08-18-36,5251,"[np.float32(1.0), np.float32(1.0), np.float32(0.0), np.float32(1.0), np.float32(0.0), np.float32(0.0), np.float32(1.0), np.float32(1.0), np.float32(1.0), np.float32(0.0), np.float32(0.0), np.float32(1.0), np.float32(0.0), np.float32(0.0), np.float32(1.0), np.float32(0.0)]",-3.0,99425.0,14
2025-08-14_08-18-36,5252,"[np.float32(0.0), np.float32(1.0), np.float32(1.0), np.float32(1.0), np.float32(0.0), np.float32(1.0), np.float32(1.0), np.float32(0.0), np.float32(1.0), np.float32(0.0), np.float32(1.0), np.float32(0.0), np.float32(0.0), np.float32(1.0), np.float32(1.0), np.float32(0.0)]",-1.0,99424.0,3
2025-08-14_08-18-36,5253,"[np.float32(1.0), np.float32(0.0), np.float32(0.0), np.float32(0.0), np.float32(1.0), np.float32(1.0), np.float32(0.0), np.float32(0.0), np.float32(0.0), np.float32(1.0), np.float32(1.0), np.float32(1.0), np.float32(0.0), np.float32(1.0), np.float32(0.0), np.float32(1.0)]",-3.0,99421.0,24
2025-08-14_08-18-36,5254,"[np.float32(0.0), np.float32(0.0), np.float32(1.0), np.float32(1.0), np.float32(1.0), np.float32(1.0), np.float32(1.0), np.float32(1.0), np.float32(0.0), np.float32(0.0), np.float32(1.0), np.float32(1.0), np.float32(0.0), np.float32(1.0), np.float32(1.0), np.float32(1.0)]",2.0,99423.0,5
2025-08-14_08-18-36,5255,"[np.float32(0.0), np.float32(0.0), np.float32(0.0), np.float32(1.0), np.float32(1.0), np.float32(1.0), np.float32(0.0), np.float32(1.0), np.float32(1.0), np.float32(0.0), np.float32(1.0), np.float32(1.0), np.float32(0.0), np.float32(0.0), np.float32(1.0), np.float32(0.0)]",0.0,99423.0,18
2025-08-14_08-18-36,5256,"[np.float32(0.0), np.float32(0.0), np.float32(0.0), np.float32(0.0), np.float32(0.0), np.float32(1.0), np.float32(1.0), np.float32(1.0), np.float32(1.0), np.float32(0.0), np.float32(1.0), np.float32(0.0), np.float32(0.0), np.float32(0.0), np.float32(0.0), np.float32(1.0)]",-1.0,99422.0,22
2025-08-14_08-18-36,5257,"[np.float32(0.0), np.float32(1.0), np.float32(1.0), np.float32(0.0), np.float32(0.0), np.float32(0.0), np.float32(1.0), np.float32(1.0), np.float32(1.0), np.float32(0.0), np.float32(1.0), np.float32(0.0), np.float32(0.0), np.float32(1.0), np.float32(1.0), np.float32(0.0)]",3.0,99425.0,35
2025-08-14_08-18-36,5258,"[np.float32(0.0), np.float32(1.0), np.float32(0.0), np.float32(1.0), np.float32(1.0), np.float32(0.0), np.float32(1.0), np.float32(0.0), np.float32(1.0), np.float32(1.0), np.float32(1.0), np.float32(0.0), np.float32(0.0), np.float32(1.0), np.float32(0.0), np.float32(0.0)]",5.0,99430.0,29
2025-08-14_08-18-36,5259,"[np.float32(0.0), np.float32(1.0), np.float32(1.0), np.float32(0.0), np.float32(1.0), np.float32(1.0), np.float32(0.0), np.float32(1.0), np.float32(1.0), np.float32(0.0), np.float32(1.0), np.float32(1.0), np.float32(1.0), np.float32(0.0), np.float32(0.0), np.float32(0.0)]",29.0,99459.0,7
2025-08-14_08-18-36,5260,"[np.float32(0.0), np.float32(0.0), np.float32(0.0), np.float32(1.0), np.float32(0.0), np.float32(0.0), np.float32(1.0), np.float32(1.0), np.float32(1.0), np.float32(0.0), np.float32(1.0), np.float32(0.0), np.float32(1.0), np.float32(0.0), np.float32(0.0), np.float32(1.0)]",-4.0,99455.0,30
2025-08-14_08-18-36,5261,"[np.float32(0.0), np.float32(1.0), np.float32(1.0), np.float32(1.0), np.float32(1.0), np.float32(1.0), np.float32(0.0), np.float32(1.0), np.float32(0.0), np.float32(1.0), np.float32(1.0), np.float32(0.0), np.float32(1.0), np.float32(0.0), np.float32(1.0), np.float32(0.0)]",2.0,99457.0,22
2025-08-14_08-18-36,5262,"[np.float32(1.0), np.float32(0.0), np.float32(1.0), np.float32(0.0), np.float32(1.0), np.float32(0.0), np.float32(0.0), np.float32(1.0), np.float32(0.0), np.float32(0.0), np.float32(0.0), np.float32(0.0), np.float32(0.0), np.float32(1.0), np.float32(0.0), np.float32(1.0)]",1.0,99458.0,3
2025-08-14_08-18-36,5263,"[np.float32(0.0), np.float32(0.0), np.float32(0.0), np.float32(1.0), np.float32(1.0), np.float32(0.0), np.float32(0.0), np.float32(1.0), np.float32(0.0), np.float32(0.0), np.float32(1.0), np.float32(0.0), np.float32(1.0), np.float32(1.0), np.float32(0.0), np.float32(0.0)]",-2.0,99456.0,1
2025-08-14_08-18-36,5264,"[np.float32(0.0), np.float32(0.0), np.float32(0.0), np.float32(1.0), np.float32(0.0), np.float32(1.0), np.float32(1.0), np.float32(1.0), np.float32(1.0), np.float32(1.0), np.float32(1.0), np.float32(1.0), np.float32(1.0), np.float32(1.0), np.float32(0.0), np.float32(0.0)]",37.0,99493.0,7
2025-08-14_08-18-36,5265,"[np.float32(1.0), np.float32(1.0), np.float32(0.0), np.float32(1.0), np.float32(1.0), np.float32(0.0), np.float32(0.0), np.float32(0.0), np.float32(1.0), np.float32(1.0), np.float32(1.0), np.float32(0.0), np.float32(0.0), np.float32(0.0), np.float32(0.0), np.float32(1.0)]",-1.0,99492.0,4
2025-08-14_08-18-36,5266,"[np.float32(0.0), np.float32(1.0), np.float32(0.0), np.float32(0.0), np.float32(0.0), np.float32(1.0), np.float32(1.0), np.float32(1.0), np.float32(1.0), np.float32(0.0), np.float32(1.0), np.float32(1.0), np.float32(0.0), np.float32(1.0), np.float32(1.0), np.float32(1.0)]",-1.0,99491.0,5
2025-08-14_08-18-36,5267,"[np.float32(1.0), np.float32(1.0), np.float32(1.0), np.float32(0.0), np.float32(0.0), np.float32(0.0), np.float32(1.0), np.float32(1.0), np.float32(0.0), np.float32(0.0), np.float32(1.0), np.float32(0.0), np.float32(0.0), np.float32(0.0), np.float32(0.0), np.float32(0.0)]",-1.0,99490.0,3
2025-08-14_08-18-36,5268,"[np.float32(0.0), np.float32(1.0), np.float32(0.0), np.float32(0.0), np.float32(1.0), np.float32(0.0), np.float32(0.0), np.float32(0.0), np.float32(1.0), np.float32(1.0), np.float32(1.0), np.float32(0.0), np.float32(1.0), np.float32(0.0), np.float32(0.0), np.float32(0.0)]",2.0,99492.0,31
2025-08-14_08-18-36,5269,"[np.float32(1.0), np.float32(1.0), np.float32(0.0), np.float32(1.0), np.float32(0.0), np.float32(0.0), np.float32(0.0), np.float32(0.0), np.float32(1.0), np.float32(0.0), np.float32(1.0), np.float32(0.0), np.float32(0.0), np.float32(1.0), np.float32(1.0), np.float32(1.0)]",5.0,99497.0,29
2025-08-14_08-18-36,5270,"[np.float32(1.0), np.float32(0.0), np.float32(0.0), np.float32(1.0), np.float32(0.0), np.float32(1.0), np.float32(1.0), np.float32(1.0), np.float32(0.0), np.float32(0.0), np.float32(0.0), np.float32(1.0), np.float32(0.0), np.float32(1.0), np.float32(0.0), np.float32(0.0)]",3.0,99500.0,7
2025-08-14_08-18-36,5271,"[np.float32(1.0), np.float32(1.0), np.float32(0.0), np.float32(1.0), np.float32(0.0), np.float32(0.0), np.float32(0.0), np.float32(1.0), np.float32(0.0), np.float32(1.0), np.float32(0.0), np.float32(1.0), np.float32(1.0), np.float32(1.0), np.float32(1.0), np.float32(0.0)]",1.0,99501.0,23
2025-08-14_08-18-36,5272,"[np.float32(0.0), np.float32(0.0), np.float32(1.0), np.float32(0.0), np.float32(0.0), np.float32(1.0), np.float32(0.0), np.float32(0.0), np.float32(1.0), np.float32(1.0), np.float32(0.0), np.float32(1.0), np.float32(1.0), np.float32(1.0), np.float32(0.0), np.float32(1.0)]",0.0,99501.0,27
2025-08-14_08-18-36,5273,"[np.float32(1.0), np.float32(1.0), np.float32(0.0), np.float32(0.0), np.float32(0.0), np.float32(0.0), np.float32(0.0), np.float32(0.0), np.float32(0.0), np.float32(1.0), np.float32(0.0), np.float32(1.0), np.float32(0.0), np.float32(1.0), np.float32(0.0), np.float32(1.0)]",-1.0,99500.0,2
2025-08-14_08-18-36,5274,"[np.float32(0.0), np.float32(1.0), np.float32(0.0), np.float32(0.0), np.float32(0.0), np.float32(1.0), np.float32(0.0), np.float32(0.0), np.float32(0.0), np.float32(0.0), np.float32(1.0), np.float32(1.0), np.float32(0.0), np.float32(0.0), np.float32(1.0), np.float32(0.0)]",-3.0,99497.0,19
2025-08-14_08-18-36,5275,"[np.float32(1.0), np.float32(0.0), np.float32(1.0), np.float32(0.0), np.float32(0.0), np.float32(1.0), np.float32(1.0), np.float32(0.0), np.float32(0.0), np.float32(1.0), np.float32(1.0), np.float32(1.0), np.float32(1.0), np.float32(1.0), np.float32(0.0), np.float32(1.0)]",0.0,99497.0,18
2025-08-14_08-18-36,5276,"[np.float32(0.0), np.float32(0.0), np.float32(1.0), np.float32(1.0), np.float32(0.0), np.float32(1.0), np.float32(1.0), np.float32(1.0), np.float32(0.0), np.float32(1.0), np.float32(0.0), np.float32(0.0), np.float32(1.0), np.float32(1.0), np.float32(1.0), np.float32(0.0)]",1.0,99498.0,25
2025-08-14_08-18-36,5277,"[np.float32(0.0), np.float32(1.0), np.float32(1.0), np.float32(0.0), np.float32(1.0), np.float32(1.0), np.float32(1.0), np.float32(0.0), np.float32(1.0), np.float32(1.0), np.float32(0.0), np.float32(1.0), np.float32(1.0), np.float32(0.0), np.float32(1.0), np.float32(1.0)]",-4.0,99494.0,17
2025-08-14_08-18-36,5278,"[np.float32(0.0), np.float32(0.0), np.float32(1.0), np.float32(0.0), np.float32(0.0), np.float32(1.0), np.float32(0.0), np.float32(0.0), np.float32(1.0), np.float32(0.0), np.float32(0.0), np.float32(1.0), np.float32(0.0), np.float32(1.0), np.float32(1.0), np.float32(1.0)]",-4.0,99490.0,17
2025-08-14_08-18-36,5279,"[np.float32(1.0), np.float32(1.0), np.float32(1.0), np.float32(1.0), np.float32(1.0), np.float32(1.0), np.float32(1.0), np.float32(1.0), np.float32(1.0), np.float32(1.0), np.float32(0.0), np.float32(0.0), np.float32(1.0), np.float32(0.0), np.float32(1.0), np.float32(0.0)]",-3.0,99487.0,9
2025-08-14_08-18-36,5280,"[np.float32(1.0), np.float32(0.0), np.float32(1.0), np.float32(0.0), np.float32(1.0), np.float32(0.0), np.float32(1.0), np.float32(1.0), np.float32(0.0), np.float32(1.0), np.float32(1.0), np.float32(1.0), np.float32(0.0), np.float32(0.0), np.float32(0.0), np.float32(1.0)]",-4.0,99483.0,28
2025-08-14_08-18-36,5281,"[np.float32(0.0), np.float32(1.0), np.float32(0.0), np.float32(1.0), np.float32(0.0), np.float32(1.0), np.float32(0.0), np.float32(0.0), np.float32(1.0), np.float32(0.0), np.float32(0.0), np.float32(1.0), np.float32(0.0), np.float32(0.0), np.float32(0.0), np.float32(1.0)]",-4.0,99479.0,10
2025-08-14_08-18-36,5282,"[np.float32(0.0), np.float32(0.0), np.float32(0.0), np.float32(1.0), np.float32(1.0), np.float32(0.0), np.float32(1.0), np.float32(0.0), np.float32(0.0), np.float32(0.0), np.float32(0.0), np.float32(1.0), np.float32(0.0), np.float32(0.0), np.float32(0.0), np.float32(1.0)]",-5.0,99474.0,32
2025-08-14_08-18-36,5283,"[np.float32(0.0), np.float32(0.0), np.float32(0.0), np.float32(1.0), np.float32(0.0), np.float32(1.0), np.float32(0.0), np.float32(0.0), np.float32(0.0), np.float32(0.0), np.float32(1.0), np.float32(1.0), np.float32(1.0), np.float32(1.0), np.float32(0.0), np.float32(0.0)]",-1.0,99473.0,0
2025-08-14_08-18-36,5284,"[np.float32(0.0), np.float32(1.0), np.float32(1.0), np.float32(0.0), np.float32(0.0), np.float32(0.0), np.float32(1.0), np.float32(0.0), np.float32(0.0), np.float32(0.0), np.float32(1.0), np.float32(0.0), np.float32(0.0), np.float32(0.0), np.float32(1.0), np.float32(0.0)]",0.0,99473.0,32
2025-08-14_08-18-36,5285,"[np.float32(1.0), np.float32(1.0), np.float32(1.0), np.float32(1.0), np.float32(0.0), np.float32(1.0), np.float32(0.0), np.float32(1.0), np.float32(0.0), np.float32(0.0), np.float32(1.0), np.float32(1.0), np.float32(1.0), np.float32(0.0), np.float32(0.0), np.float32(0.0)]",-5.0,99468.0,1
2025-08-14_08-18-36,5286,"[np.float32(0.0), np.float32(1.0), np.float32(0.0), np.float32(1.0), np.float32(0.0), np.float32(1.0), np.float32(0.0), np.float32(0.0), np.float32(1.0), np.float32(1.0), np.float32(1.0), np.float32(0.0), np.float32(0.0), np.float32(1.0), np.float32(0.0), np.float32(0.0)]",6.0,99474.0,25
2025-08-14_08-18-36,5287,"[np.float32(0.0), np.float32(0.0), np.float32(1.0), np.float32(0.0), np.float32(1.0), np.float32(0.0), np.float32(0.0), np.float32(0.0), np.float32(0.0), np.float32(0.0), np.float32(1.0), np.float32(1.0), np.float32(1.0), np.float32(1.0), np.float32(1.0), np.float32(0.0)]",0.0,99474.0,16
2025-08-14_08-18-36,5288,"[np.float32(0.0), np.float32(1.0), np.float32(1.0), np.float32(0.0), np.float32(1.0), np.float32(1.0), np.float32(0.0), np.float32(1.0), np.float32(0.0), np.float32(0.0), np.float32(0.0), np.float32(0.0), np.float32(1.0), np.float32(0.0), np.float32(1.0), np.float32(0.0)]",0.0,99474.0,17
2025-08-14_08-18-36,5289,"[np.float32(0.0), np.float32(1.0), np.float32(1.0), np.float32(0.0), np.float32(0.0), np.float32(1.0), np.float32(1.0), np.float32(0.0), np.float32(0.0), np.float32(0.0), np.float32(1.0), np.float32(0.0), np.float32(1.0), np.float32(1.0), np.float32(0.0), np.float32(0.0)]",-2.0,99472.0,18
2025-08-14_08-18-36,5290,"[np.float32(1.0), np.float32(1.0), np.float32(0.0), np.float32(1.0), np.float32(1.0), np.float32(1.0), np.float32(0.0), np.float32(1.0), np.float32(0.0), np.float32(1.0), np.float32(0.0), np.float32(0.0), np.float32(0.0), np.float32(1.0), np.float32(1.0), np.float32(0.0)]",1.0,99473.0,24
2025-08-14_08-18-36,5291,"[np.float32(0.0), np.float32(1.0), np.float32(1.0), np.float32(1.0), np.float32(1.0), np.float32(0.0), np.float32(1.0), np.float32(1.0), np.float32(0.0), np.float32(0.0), np.float32(1.0), np.float32(1.0), np.float32(0.0), np.float32(0.0), np.float32(0.0), np.float32(0.0)]",-6.0,99467.0,34
2025-08-14_08-18-36,5292,"[np.float32(1.0), np.float32(1.0), np.float32(0.0), np.float32(1.0), np.float32(0.0), np.float32(0.0), np.float32(1.0), np.float32(1.0), np.float32(1.0), np.float32(1.0), np.float32(0.0), np.float32(0.0), np.float32(0.0), np.float32(0.0), np.float32(0.0), np.float32(1.0)]",-3.0,99464.0,12
2025-08-14_08-18-36,5293,"[np.float32(0.0), np.float32(1.0), np.float32(1.0), np.float32(0.0), np.float32(1.0), np.float32(0.0), np.float32(1.0), np.float32(1.0), np.float32(1.0), np.float32(0.0), np.float32(1.0), np.float32(1.0), np.float32(0.0), np.float32(1.0), np.float32(0.0), np.float32(1.0)]",-2.0,99462.0,1
2025-08-14_08-18-36,5294,"[np.float32(1.0), np.float32(0.0), np.float32(1.0), np.float32(0.0), np.float32(0.0), np.float32(1.0), np.float32(1.0), np.float32(1.0), np.float32(0.0), np.float32(1.0), np.float32(1.0), np.float32(1.0), np.float32(1.0), np.float32(0.0), np.float32(0.0), np.float32(0.0)]",1.0,99463.0,14
2025-08-14_08-18-36,5295,"[np.float32(0.0), np.float32(0.0), np.float32(1.0), np.float32(1.0), np.float32(1.0), np.float32(0.0), np.float32(1.0), np.float32(1.0), np.float32(0.0), np.float32(1.0), np.float32(0.0), np.float32(1.0), np.float32(0.0), np.float32(1.0), np.float32(0.0), np.float32(1.0)]",1.0,99464.0,17
2025-08-14_08-18-36,5296,"[np.float32(0.0), np.float32(1.0), np.float32(1.0), np.float32(0.0), np.float32(0.0), np.float32(1.0), np.float32(0.0), np.float32(0.0), np.float32(1.0), np.float32(1.0), np.float32(0.0), np.float32(0.0), np.float32(0.0), np.float32(1.0), np.float32(1.0), np.float32(0.0)]",3.0,99467.0,4
2025-08-14_08-18-36,5297,"[np.float32(0.0), np.float32(1.0), np.float32(0.0), np.float32(0.0), np.float32(0.0), np.float32(0.0), np.float32(0.0), np.float32(0.0), np.float32(1.0), np.float32(1.0), np.float32(1.0), np.float32(1.0), np.float32(1.0), np.float32(0.0), np.float32(0.0), np.float32(1.0)]",-4.0,99463.0,19
2025-08-14_08-18-36,5298,"[np.float32(1.0), np.float32(0.0), np.float32(1.0), np.float32(1.0), np.float32(1.0), np.float32(1.0), np.float32(1.0), np.float32(0.0), np.float32(0.0), np.float32(0.0), np.float32(0.0), np.float32(1.0), np.float32(1.0), np.float32(1.0), np.float32(0.0), np.float32(1.0)]",3.0,99466.0,6
2025-08-14_08-18-36,5299,"[np.float32(1.0), np.float32(0.0), np.float32(1.0), np.float32(1.0), np.float32(0.0), np.float32(1.0), np.float32(1.0), np.float32(1.0), np.float32(1.0), np.float32(1.0), np.float32(1.0), np.float32(0.0), np.float32(1.0), np.float32(0.0), np.float32(0.0), np.float32(0.0)]",-2.0,99464.0,4
2025-08-14_08-18-36,5300,"[np.float32(1.0), np.float32(0.0), np.float32(0.0), np.float32(1.0), np.float32(0.0), np.float32(1.0), np.float32(1.0), np.float32(0.0), np.float32(0.0), np.float32(0.0), np.float32(0.0), np.float32(0.0), np.float32(0.0), np.float32(0.0), np.float32(0.0), np.float32(0.0)]",-2.0,99462.0,20
2025-08-14_08-18-36,5301,"[np.float32(1.0), np.float32(1.0), np.float32(1.0), np.float32(0.0), np.float32(0.0), np.float32(1.0), np.float32(1.0), np.float32(1.0), np.float32(1.0), np.float32(1.0), np.float32(0.0), np.float32(0.0), np.float32(0.0), np.float32(1.0), np.float32(0.0), np.float32(1.0)]",-5.0,99457.0,11
2025-08-14_08-18-36,5302,"[np.float32(0.0), np.float32(1.0), np.float32(0.0), np.float32(0.0), np.float32(1.0), np.float32(0.0), np.float32(0.0), np.float32(0.0), np.float32(1.0), np.float32(1.0), np.float32(1.0), np.float32(0.0), np.float32(0.0), np.float32(1.0), np.float32(0.0), np.float32(1.0)]",2.0,99459.0,25
2025-08-14_08-18-36,5303,"[np.float32(0.0), np.float32(1.0), np.float32(1.0), np.float32(1.0), np.float32(0.0), np.float32(0.0), np.float32(0.0), np.float32(1.0), np.float32(1.0), np.float32(0.0), np.float32(1.0), np.float32(0.0), np.float32(1.0), np.float32(0.0), np.float32(1.0), np.float32(0.0)]",-1.0,99458.0,10
2025-08-14_08-18-36,5304,"[np.float32(1.0), np.float32(1.0), np.float32(0.0), np.float32(0.0), np.float32(0.0), np.float32(1.0), np.float32(1.0), np.float32(0.0), np.float32(1.0), np.float32(0.0), np.float32(1.0), np.float32(1.0), np.float32(0.0), np.float32(0.0), np.float32(0.0), np.float32(0.0)]",3.0,99461.0,36
2025-08-14_08-18-36,5305,"[np.float32(1.0), np.float32(0.0), np.float32(0.0), np.float32(1.0), np.float32(1.0), np.float32(1.0), np.float32(0.0), np.float32(1.0), np.float32(1.0), np.float32(0.0), np.float32(1.0), np.float32(1.0), np.float32(0.0), np.float32(0.0), np.float32(1.0), np.float32(0.0)]",-7.0,99454.0,4
2025-08-14_08-18-36,5306,"[np.float32(0.0), np.float32(1.0), np.float32(1.0), np.float32(1.0), np.float32(1.0), np.float32(0.0), np.float32(0.0), np.float32(1.0), np.float32(0.0), np.float32(1.0), np.float32(0.0), np.float32(0.0), np.float32(1.0), np.float32(0.0), np.float32(1.0), np.float32(0.0)]",-3.0,99451.0,25
2025-08-14_08-18-36,5307,"[np.float32(0.0), np.float32(1.0), np.float32(0.0), np.float32(1.0), np.float32(1.0), np.float32(1.0), np.float32(0.0), np.float32(0.0), np.float32(1.0), np.float32(1.0), np.float32(0.0), np.float32(1.0), np.float32(1.0), np.float32(1.0), np.float32(0.0), np.float32(1.0)]",0.0,99451.0,4
2025-08-14_08-18-36,5308,"[np.float32(1.0), np.float32(0.0), np.float32(0.0), np.float32(1.0), np.float32(0.0), np.float32(1.0), np.float32(0.0), np.float32(0.0), np.float32(0.0), np.float32(1.0), np.float32(0.0), np.float32(0.0), np.float32(1.0), np.float32(0.0), np.float32(1.0), np.float32(0.0)]",-2.0,99449.0,35
2025-08-14_08-18-36,5309,"[np.float32(1.0), np.float32(1.0), np.float32(0.0), np.float32(1.0), np.float32(0.0), np.float32(1.0), np.float32(1.0), np.float32(0.0), np.float32(1.0), np.float32(1.0), np.float32(0.0), np.float32(1.0), np.float32(1.0), np.float32(0.0), np.float32(0.0), np.float32(0.0)]",-5.0,99444.0,17
2025-08-14_08-18-36,5310,"[np.float32(1.0), np.float32(0.0), np.float32(0.0), np.float32(1.0), np.float32(0.0), np.float32(1.0), np.float32(1.0), np.float32(1.0), np.float32(1.0), np.float32(0.0), np.float32(0.0), np.float32(1.0), np.float32(0.0), np.float32(1.0), np.float32(0.0), np.float32(0.0)]",-2.0,99442.0,2
2025-08-14_08-18-36,5311,"[np.float32(1.0), np.float32(0.0), np.float32(1.0), np.float32(0.0), np.float32(1.0), np.float32(1.0), np.float32(0.0), np.float32(1.0), np.float32(0.0), np.float32(1.0), np.float32(1.0), np.float32(1.0), np.float32(1.0), np.float32(0.0), np.float32(1.0), np.float32(1.0)]",-4.0,99438.0,26
2025-08-14_08-18-36,5312,"[np.float32(0.0), np.float32(1.0), np.float32(1.0), np.float32(0.0), np.float32(0.0), np.float32(0.0), np.float32(1.0), np.float32(1.0), np.float32(0.0), np.float32(0.0), np.float32(1.0), np.float32(0.0), np.float32(1.0), np.float32(1.0), np.float32(0.0), np.float32(0.0)]",3.0,99441.0,20
2025-08-14_08-18-36,5313,"[np.float32(1.0), np.float32(0.0), np.float32(1.0), np.float32(0.0), np.float32(1.0), np.float32(1.0), np.float32(0.0), np.float32(1.0), np.float32(0.0), np.float32(0.0), np.float32(0.0), np.float32(0.0), np.float32(0.0), np.float32(1.0), np.float32(0.0), np.float32(0.0)]",1.0,99442.0,2
2025-08-14_08-18-36,5314,"[np.float32(0.0), np.float32(1.0), np.float32(0.0), np.float32(1.0), np.float32(0.0), np.float32(1.0), np.float32(0.0), np.float32(1.0), np.float32(1.0), np.float32(0.0), np.float32(0.0), np.float32(0.0), np.float32(1.0), np.float32(0.0), np.float32(1.0), np.float32(0.0)]",-2.0,99440.0,5
2025-08-14_08-18-36,5315,"[np.float32(0.0), np.float32(0.0), np.float32(0.0), np.float32(0.0), np.float32(0.0), np.float32(0.0), np.float32(0.0), np.float32(1.0), np.float32(1.0), np.float32(1.0), np.float32(0.0), np.float32(0.0), np.float32(0.0), np.float32(0.0), np.float32(0.0), np.float32(1.0)]",-1.0,99439.0,18
2025-08-14_08-18-36,5316,"[np.float32(1.0), np.float32(0.0), np.float32(0.0), np.float32(0.0), np.float32(1.0), np.float32(1.0), np.float32(1.0), np.float32(1.0), np.float32(1.0), np.float32(1.0), np.float32(1.0), np.float32(1.0), np.float32(1.0), np.float32(0.0), np.float32(0.0), np.float32(0.0)]",-2.0,99437.0,35
2025-08-14_08-18-36,5317,"[np.float32(1.0), np.float32(0.0), np.float32(1.0), np.float32(0.0), np.float32(1.0), np.float32(0.0), np.float32(1.0), np.float32(1.0), np.float32(0.0), np.float32(1.0), np.float32(1.0), np.float32(0.0), np.float32(0.0), np.float32(1.0), np.float32(0.0), np.float32(1.0)]",-1.0,99436.0,28
2025-08-14_08-18-36,5318,"[np.float32(0.0), np.float32(1.0), np.float32(1.0), np.float32(0.0), np.float32(0.0), np.float32(1.0), np.float32(1.0), np.float32(0.0), np.float32(1.0), np.float32(0.0), np.float32(1.0), np.float32(1.0), np.float32(0.0), np.float32(1.0), np.float32(0.0), np.float32(0.0)]",4.0,99440.0,28
2025-08-14_08-18-36,5319,"[np.float32(0.0), np.float32(1.0), np.float32(0.0), np.float32(0.0), np.float32(0.0), np.float32(0.0), np.float32(0.0), np.float32(1.0), np.float32(1.0), np.float32(0.0), np.float32(1.0), np.float32(1.0), np.float32(0.0), np.float32(1.0), np.float32(1.0), np.float32(1.0)]",3.0,99443.0,29
2025-08-14_08-18-36,5320,"[np.float32(0.0), np.float32(0.0), np.float32(0.0), np.float32(1.0), np.float32(0.0), np.float32(1.0), np.float32(0.0), np.float32(0.0), np.float32(0.0), np.float32(0.0), np.float32(1.0), np.float32(0.0), np.float32(1.0), np.float32(1.0), np.float32(0.0), np.float32(1.0)]",-1.0,99442.0,28
2025-08-14_08-18-36,5321,"[np.float32(1.0), np.float32(1.0), np.float32(0.0), np.float32(0.0), np.float32(0.0), np.float32(0.0), np.float32(0.0), np.float32(1.0), np.float32(1.0), np.float32(0.0), np.float32(0.0), np.float32(0.0), np.float32(0.0), np.float32(0.0), np.float32(0.0), np.float32(0.0)]",1.0,99443.0,23
2025-08-14_08-18-36,5322,"[np.float32(0.0), np.float32(0.0), np.float32(0.0), np.float32(0.0), np.float32(0.0), np.float32(1.0), np.float32(1.0), np.float32(1.0), np.float32(0.0), np.float32(1.0), np.float32(0.0), np.float32(1.0), np.float32(0.0), np.float32(0.0), np.float32(0.0), np.float32(1.0)]",0.0,99443.0,16
2025-08-14_08-18-36,5323,"[np.float32(0.0), np.float32(0.0), np.float32(0.0), np.float32(1.0), np.float32(0.0), np.float32(1.0), np.float32(1.0), np.float32(1.0), np.float32(1.0), np.float32(0.0), np.float32(1.0), np.float32(1.0), np.float32(0.0), np.float32(0.0), np.float32(0.0), np.float32(1.0)]",-6.0,99437.0,0
2025-08-14_08-18-36,5324,"[np.float32(0.0), np.float32(1.0), np.float32(0.0), np.float32(0.0), np.float32(0.0), np.float32(0.0), np.float32(0.0), np.float32(0.0), np.float32(0.0), np.float32(0.0), np.float32(0.0), np.float32(1.0), np.float32(0.0), np.float32(0.0), np.float32(1.0), np.float32(0.0)]",2.0,99439.0,15
2025-08-14_08-18-36,5325,"[np.float32(1.0), np.float32(1.0), np.float32(1.0), np.float32(0.0), np.float32(0.0), np.float32(1.0), np.float32(1.0), np.float32(1.0), np.float32(1.0), np.float32(0.0), np.float32(1.0), np.float32(0.0), np.float32(1.0), np.float32(0.0), np.float32(0.0), np.float32(0.0)]",1.0,99440.0,29
2025-08-14_08-18-36,5326,"[np.float32(1.0), np.float32(0.0), np.float32(0.0), np.float32(1.0), np.float32(0.0), np.float32(1.0), np.float32(0.0), np.float32(1.0), np.float32(1.0), np.float32(1.0), np.float32(0.0), np.float32(0.0), np.float32(0.0), np.float32(0.0), np.float32(0.0), np.float32(0.0)]",-1.0,99439.0,18
2025-08-14_08-18-36,5327,"[np.float32(1.0), np.float32(0.0), np.float32(0.0), np.float32(1.0), np.float32(0.0), np.float32(1.0), np.float32(1.0), np.float32(1.0), np.float32(1.0), np.float32(1.0), np.float32(0.0), np.float32(1.0), np.float32(0.0), np.float32(1.0), np.float32(1.0), np.float32(1.0)]",-5.0,99434.0,2
2025-08-14_08-18-36,5328,"[np.float32(0.0), np.float32(1.0), np.float32(0.0), np.float32(0.0), np.float32(1.0), np.float32(0.0), np.float32(1.0), np.float32(1.0), np.float32(0.0), np.float32(1.0), np.float32(0.0), np.float32(1.0), np.float32(0.0), np.float32(1.0), np.float32(1.0), np.float32(0.0)]",5.0,99439.0,4
2025-08-14_08-18-36,5329,"[np.float32(1.0), np.float32(1.0), np.float32(0.0), np.float32(0.0), np.float32(1.0), np.float32(1.0), np.float32(1.0), np.float32(1.0), np.float32(1.0), np.float32(0.0), np.float32(1.0), np.float32(0.0), np.float32(0.0), np.float32(1.0), np.float32(1.0), np.float32(1.0)]",-1.0,99438.0,13
2025-08-14_08-18-36,5330,"[np.float32(1.0), np.float32(0.0), np.float32(1.0), np.float32(1.0), np.float32(0.0), np.float32(1.0), np.float32(0.0), np.float32(0.0), np.float32(1.0), np.float32(1.0), np.float32(1.0), np.float32(1.0), np.float32(1.0), np.float32(0.0), np.float32(0.0), np.float32(0.0)]",1.0,99439.0,33
2025-08-14_08-18-36,5331,"[np.float32(1.0), np.float32(0.0), np.float32(1.0), np.float32(0.0), np.float32(0.0), np.float32(0.0), np.float32(1.0), np.float32(1.0), np.float32(1.0), np.float32(0.0), np.float32(1.0), np.float32(1.0), np.float32(0.0), np.float32(1.0), np.float32(1.0), np.float32(0.0)]",0.0,99439.0,35
2025-08-14_08-18-36,5332,"[np.float32(0.0), np.float32(0.0), np.float32(0.0), np.float32(1.0), np.float32(0.0), np.float32(1.0), np.float32(1.0), np.float32(1.0), np.float32(0.0), np.float32(0.0), np.float32(0.0), np.float32(0.0), np.float32(1.0), np.float32(1.0), np.float32(1.0), np.float32(0.0)]",0.0,99439.0,35
2025-08-14_08-18-36,5333,"[np.float32(1.0), np.float32(0.0), np.float32(0.0), np.float32(1.0), np.float32(0.0), np.float32(0.0), np.float32(1.0), np.float32(1.0), np.float32(1.0), np.float32(0.0), np.float32(1.0), np.float32(0.0), np.float32(1.0), np.float32(0.0), np.float32(0.0), np.float32(1.0)]",-8.0,99431.0,0
2025-08-14_08-18-36,5334,"[np.float32(0.0), np.float32(1.0), np.float32(0.0), np.float32(1.0), np.float32(0.0), np.float32(0.0), np.float32(1.0), np.float32(1.0), np.float32(0.0), np.float32(1.0), np.float32(1.0), np.float32(0.0), np.float32(1.0), np.float32(1.0), np.float32(1.0), np.float32(0.0)]",-6.0,99425.0,34
2025-08-14_08-18-36,5335,"[np.float32(1.0), np.float32(0.0), np.float32(0.0), np.float32(1.0), np.float32(0.0), np.float32(0.0), np.float32(0.0), np.float32(1.0), np.float32(0.0), np.float32(0.0), np.float32(1.0), np.float32(0.0), np.float32(1.0), np.float32(1.0), np.float32(0.0), np.float32(0.0)]",-2.0,99423.0,27
2025-08-14_08-18-36,5336,"[np.float32(1.0), np.float32(0.0), np.float32(1.0), np.float32(1.0), np.float32(0.0), np.float32(0.0), np.float32(1.0), np.float32(0.0), np.float32(1.0), np.float32(1.0), np.float32(1.0), np.float32(1.0), np.float32(0.0), np.float32(1.0), np.float32(1.0), np.float32(1.0)]",0.0,99423.0,10
2025-08-14_08-18-36,5337,"[np.float32(1.0), np.float32(1.0), np.float32(0.0), np.float32(1.0), np.float32(1.0), np.float32(1.0), np.float32(1.0), np.float32(0.0), np.float32(1.0), np.float32(0.0), np.float32(0.0), np.float32(0.0), np.float32(0.0), np.float32(0.0), np.float32(1.0), np.float32(1.0)]",-2.0,99421.0,14
2025-08-14_08-18-36,5338,"[np.float32(1.0), np.float32(1.0), np.float32(1.0), np.float32(0.0), np.float32(0.0), np.float32(0.0), np.float32(0.0), np.float32(1.0), np.float32(1.0), np.float32(0.0), np.float32(0.0), np.float32(1.0), np.float32(0.0), np.float32(1.0), np.float32(1.0), np.float32(1.0)]",2.0,99423.0,33
2025-08-14_08-18-36,5339,"[np.float32(1.0), np.float32(1.0), np.float32(0.0), np.float32(0.0), np.float32(0.0), np.float32(0.0), np.float32(1.0), np.float32(0.0), np.float32(1.0), np.float32(0.0), np.float32(1.0), np.float32(0.0), np.float32(0.0), np.float32(1.0), np.float32(0.0), np.float32(0.0)]",-1.0,99422.0,15
2025-08-14_08-18-36,5340,"[np.float32(1.0), np.float32(0.0), np.float32(1.0), np.float32(0.0), np.float32(1.0), np.float32(0.0), np.float32(1.0), np.float32(1.0), np.float32(0.0), np.float32(1.0), np.float32(1.0), np.float32(1.0), np.float32(0.0), np.float32(0.0), np.float32(0.0), np.float32(1.0)]",1.0,99423.0,4
2025-08-14_08-18-36,5341,"[np.float32(1.0), np.float32(0.0), np.float32(1.0), np.float32(0.0), np.float32(0.0), np.float32(0.0), np.float32(1.0), np.float32(1.0), np.float32(0.0), np.float32(0.0), np.float32(1.0), np.float32(1.0), np.float32(0.0), np.float32(0.0), np.float32(1.0), np.float32(1.0)]",-2.0,99421.0,15
2025-08-14_08-18-36,5342,"[np.float32(1.0), np.float32(1.0), np.float32(1.0), np.float32(0.0), np.float32(0.0), np.float32(1.0), np.float32(0.0), np.float32(1.0), np.float32(0.0), np.float32(1.0), np.float32(0.0), np.float32(0.0), np.float32(0.0), np.float32(1.0), np.float32(1.0), np.float32(0.0)]",-3.0,99418.0,5
2025-08-14_08-18-36,5343,"[np.float32(0.0), np.float32(0.0), np.float32(1.0), np.float32(1.0), np.float32(0.0), np.float32(0.0), np.float32(1.0), np.float32(1.0), np.float32(1.0), np.float32(1.0), np.float32(1.0), np.float32(1.0), np.float32(1.0), np.float32(0.0), np.float32(1.0), np.float32(1.0)]",0.0,99418.0,20
2025-08-14_08-18-36,5344,"[np.float32(1.0), np.float32(0.0), np.float32(1.0), np.float32(1.0), np.float32(1.0), np.float32(0.0), np.float32(0.0), np.float32(0.0), np.float32(1.0), np.float32(0.0), np.float32(0.0), np.float32(0.0), np.float32(0.0), np.float32(1.0), np.float32(0.0), np.float32(0.0)]",1.0,99419.0,2
2025-08-14_08-18-36,5345,"[np.float32(0.0), np.float32(1.0), np.float32(0.0), np.float32(1.0), np.float32(1.0), np.float32(1.0), np.float32(1.0), np.float32(1.0), np.float32(0.0), np.float32(1.0), np.float32(0.0), np.float32(1.0), np.float32(0.0), np.float32(0.0), np.float32(0.0), np.float32(1.0)]",3.0,99422.0,17
2025-08-14_08-18-36,5346,"[np.float32(1.0), np.float32(0.0), np.float32(1.0), np.float32(1.0), np.float32(0.0), np.float32(0.0), np.float32(0.0), np.float32(0.0), np.float32(0.0), np.float32(1.0), np.float32(1.0), np.float32(1.0), np.float32(1.0), np.float32(1.0), np.float32(0.0), np.float32(1.0)]",-1.0,99421.0,29
2025-08-14_08-18-36,5347,"[np.float32(1.0), np.float32(0.0), np.float32(0.0), np.float32(0.0), np.float32(0.0), np.float32(0.0), np.float32(0.0), np.float32(0.0), np.float32(1.0), np.float32(0.0), np.float32(0.0), np.float32(0.0), np.float32(0.0), np.float32(0.0), np.float32(1.0), np.float32(0.0)]",2.0,99423.0,34
2025-08-14_08-18-36,5348,"[np.float32(1.0), np.float32(1.0), np.float32(1.0), np.float32(1.0), np.float32(0.0), np.float32(0.0), np.float32(1.0), np.float32(1.0), np.float32(1.0), np.float32(0.0), np.float32(0.0), np.float32(0.0), np.float32(1.0), np.float32(0.0), np.float32(1.0), np.float32(0.0)]",-2.0,99421.0,26
2025-08-14_08-18-36,5349,"[np.float32(1.0), np.float32(1.0), np.float32(0.0), np.float32(1.0), np.float32(0.0), np.float32(0.0), np.float32(0.0), np.float32(0.0), np.float32(1.0), np.float32(0.0), np.float32(0.0), np.float32(1.0), np.float32(1.0), np.float32(0.0), np.float32(0.0), np.float32(0.0)]",1.0,99422.0,9
2025-08-14_08-18-36,5350,"[np.float32(1.0), np.float32(1.0), np.float32(1.0), np.float32(0.0), np.float32(1.0), np.float32(1.0), np.float32(0.0), np.float32(1.0), np.float32(1.0), np.float32(0.0), np.float32(0.0), np.float32(1.0), np.float32(0.0), np.float32(0.0), np.float32(0.0), np.float32(1.0)]",1.0,99423.0,33
2025-08-14_08-18-36,5351,"[np.float32(1.0), np.float32(1.0), np.float32(1.0), np.float32(0.0), np.float32(0.0), np.float32(1.0), np.float32(0.0), np.float32(1.0), np.float32(0.0), np.float32(1.0), np.float32(0.0), np.float32(1.0), np.float32(0.0), np.float32(0.0), np.float32(1.0), np.float32(1.0)]",-4.0,99419.0,7
2025-08-14_08-18-36,5352,"[np.float32(0.0), np.float32(1.0), np.float32(0.0), np.float32(0.0), np.float32(1.0), np.float32(1.0), np.float32(1.0), np.float32(0.0), np.float32(1.0), np.float32(1.0), np.float32(1.0), np.float32(0.0), np.float32(1.0), np.float32(1.0), np.float32(1.0), np.float32(0.0)]",3.0,99422.0,26
2025-08-14_08-18-36,5353,"[np.float32(1.0), np.float32(1.0), np.float32(1.0), np.float32(0.0), np.float32(0.0), np.float32(1.0), np.float32(0.0), np.float32(0.0), np.float32(1.0), np.float32(1.0), np.float32(0.0), np.float32(1.0), np.float32(0.0), np.float32(0.0), np.float32(0.0), np.float32(1.0)]",-1.0,99421.0,21
2025-08-14_08-18-36,5354,"[np.float32(1.0), np.float32(0.0), np.float32(0.0), np.float32(0.0), np.float32(1.0), np.float32(1.0), np.float32(0.0), np.float32(0.0), np.float32(1.0), np.float32(0.0), np.float32(1.0), np.float32(0.0), np.float32(0.0), np.float32(0.0), np.float32(1.0), np.float32(1.0)]",1.0,99422.0,29
2025-08-14_08-18-36,5355,"[np.float32(0.0), np.float32(1.0), np.float32(0.0), np.float32(0.0), np.float32(1.0), np.float32(1.0), np.float32(1.0), np.float32(1.0), np.float32(1.0), np.float32(0.0), np.float32(0.0), np.float32(1.0), np.float32(0.0), np.float32(1.0), np.float32(1.0), np.float32(1.0)]",-3.0,99419.0,0
2025-08-14_08-18-36,5356,"[np.float32(1.0), np.float32(1.0), np.float32(0.0), np.float32(0.0), np.float32(0.0), np.float32(1.0), np.float32(1.0), np.float32(1.0), np.float32(1.0), np.float32(0.0), np.float32(0.0), np.float32(1.0), np.float32(1.0), np.float32(1.0), np.float32(0.0), np.float32(0.0)]",-1.0,99418.0,9
2025-08-14_08-18-36,5357,"[np.float32(0.0), np.float32(1.0), np.float32(1.0), np.float32(0.0), np.float32(0.0), np.float32(1.0), np.float32(1.0), np.float32(1.0), np.float32(1.0), np.float32(0.0), np.float32(0.0), np.float32(0.0), np.float32(0.0), np.float32(0.0), np.float32(1.0), np.float32(0.0)]",-2.0,99416.0,14
2025-08-14_08-18-36,5358,"[np.float32(1.0), np.float32(1.0), np.float32(1.0), np.float32(0.0), np.float32(0.0), np.float32(1.0), np.float32(0.0), np.float32(0.0), np.float32(1.0), np.float32(1.0), np.float32(0.0), np.float32(0.0), np.float32(0.0), np.float32(1.0), np.float32(0.0), np.float32(0.0)]",0.0,99416.0,2
2025-08-14_08-18-36,5359,"[np.float32(1.0), np.float32(1.0), np.float32(0.0), np.float32(0.0), np.float32(1.0), np.float32(0.0), np.float32(1.0), np.float32(1.0), np.float32(1.0), np.float32(0.0), np.float32(1.0), np.float32(1.0), np.float32(1.0), np.float32(0.0), np.float32(0.0), np.float32(1.0)]",3.0,99419.0,6
2025-08-14_08-18-36,5360,"[np.float32(0.0), np.float32(0.0), np.float32(0.0), np.float32(0.0), np.float32(0.0), np.float32(0.0), np.float32(0.0), np.float32(1.0), np.float32(1.0), np.float32(0.0), np.float32(0.0), np.float32(0.0), np.float32(1.0), np.float32(0.0), np.float32(0.0), np.float32(1.0)]",-1.0,99418.0,25
2025-08-14_08-18-36,5361,"[np.float32(0.0), np.float32(0.0), np.float32(0.0), np.float32(1.0), np.float32(0.0), np.float32(0.0), np.float32(0.0), np.float32(0.0), np.float32(1.0), np.float32(1.0), np.float32(0.0), np.float32(1.0), np.float32(0.0), np.float32(1.0), np.float32(0.0), np.float32(0.0)]",3.0,99421.0,7
2025-08-14_08-18-36,5362,"[np.float32(1.0), np.float32(0.0), np.float32(0.0), np.float32(0.0), np.float32(0.0), np.float32(0.0), np.float32(1.0), np.float32(0.0), np.float32(1.0), np.float32(1.0), np.float32(1.0), np.float32(0.0), np.float32(1.0), np.float32(0.0), np.float32(1.0), np.float32(1.0)]",-5.0,99416.0,24
2025-08-14_08-18-36,5363,"[np.float32(1.0), np.float32(1.0), np.float32(0.0), np.float32(0.0), np.float32(0.0), np.float32(0.0), np.float32(0.0), np.float32(1.0), np.float32(1.0), np.float32(0.0), np.float32(0.0), np.float32(0.0), np.float32(0.0), np.float32(1.0), np.float32(0.0), np.float32(0.0)]",3.0,99419.0,29
2025-08-14_08-18-36,5364,"[np.float32(0.0), np.float32(1.0), np.float32(1.0), np.float32(1.0), np.float32(1.0), np.float32(1.0), np.float32(0.0), np.float32(1.0), np.float32(0.0), np.float32(0.0), np.float32(1.0), np.float32(0.0), np.float32(0.0), np.float32(1.0), np.float32(1.0), np.float32(0.0)]",-5.0,99414.0,9
2025-08-14_08-18-36,5365,"[np.float32(0.0), np.float32(1.0), np.float32(1.0), np.float32(1.0), np.float32(0.0), np.float32(0.0), np.float32(1.0), np.float32(1.0), np.float32(1.0), np.float32(0.0), np.float32(0.0), np.float32(0.0), np.float32(1.0), np.float32(1.0), np.float32(1.0), np.float32(0.0)]",1.0,99415.0,11
2025-08-14_08-18-36,5366,"[np.float32(0.0), np.float32(1.0), np.float32(0.0), np.float32(1.0), np.float32(1.0), np.float32(1.0), np.float32(0.0), np.float32(1.0), np.float32(1.0), np.float32(0.0), np.float32(0.0), np.float32(0.0), np.float32(1.0), np.float32(1.0), np.float32(1.0), np.float32(0.0)]",1.0,99416.0,19
2025-08-14_08-18-36,5367,"[np.float32(1.0), np.float32(0.0), np.float32(1.0), np.float32(0.0), np.float32(1.0), np.float32(1.0), np.float32(0.0), np.float32(1.0), np.float32(0.0), np.float32(0.0), np.float32(1.0), np.float32(1.0), np.float32(1.0), np.float32(1.0), np.float32(1.0), np.float32(0.0)]",-2.0,99414.0,33
2025-08-14_08-18-36,5368,"[np.float32(1.0), np.float32(0.0), np.float32(0.0), np.float32(0.0), np.float32(0.0), np.float32(1.0), np.float32(0.0), np.float32(0.0), np.float32(0.0), np.float32(0.0), np.float32(0.0), np.float32(0.0), np.float32(0.0), np.float32(0.0), np.float32(1.0), np.float32(1.0)]",3.0,99417.0,23
2025-08-14_08-18-36,5369,"[np.float32(0.0), np.float32(1.0), np.float32(1.0), np.float32(0.0), np.float32(0.0), np.float32(0.0), np.float32(1.0), np.float32(1.0), np.float32(1.0), np.float32(1.0), np.float32(0.0), np.float32(0.0), np.float32(1.0), np.float32(0.0), np.float32(1.0), np.float32(0.0)]",2.0,99419.0,22
2025-08-14_08-18-36,5370,"[np.float32(0.0), np.float32(1.0), np.float32(1.0), np.float32(0.0), np.float32(0.0), np.float32(1.0), np.float32(0.0), np.float32(1.0), np.float32(0.0), np.float32(0.0), np.float32(1.0), np.float32(1.0), np.float32(0.0), np.float32(0.0), np.float32(0.0), np.float32(1.0)]",2.0,99421.0,22
2025-08-14_08-18-36,5371,"[np.float32(0.0), np.float32(0.0), np.float32(0.0), np.float32(1.0), np.float32(1.0), np.float32(1.0), np.float32(0.0), np.float32(1.0), np.float32(0.0), np.float32(0.0), np.float32(1.0), np.float32(1.0), np.float32(1.0), np.float32(1.0), np.float32(1.0), np.float32(1.0)]",-2.0,99419.0,32
2025-08-14_08-18-36,5372,"[np.float32(0.0), np.float32(1.0), np.float32(0.0), np.float32(0.0), np.float32(1.0), np.float32(1.0), np.float32(1.0), np.float32(0.0), np.float32(1.0), np.float32(1.0), np.float32(1.0), np.float32(0.0), np.float32(0.0), np.float32(1.0), np.float32(0.0), np.float32(0.0)]",0.0,99419.0,3
2025-08-14_08-18-36,5373,"[np.float32(0.0), np.float32(1.0), np.float32(1.0), np.float32(0.0), np.float32(1.0), np.float32(1.0), np.float32(1.0), np.float32(0.0), np.float32(0.0), np.float32(0.0), np.float32(1.0), np.float32(0.0), np.float32(0.0), np.float32(0.0), np.float32(1.0), np.float32(1.0)]",0.0,99419.0,23
2025-08-14_08-18-36,5374,"[np.float32(1.0), np.float32(0.0), np.float32(0.0), np.float32(1.0), np.float32(0.0), np.float32(1.0), np.float32(1.0), np.float32(0.0), np.float32(1.0), np.float32(1.0), np.float32(1.0), np.float32(0.0), np.float32(1.0), np.float32(1.0), np.float32(1.0), np.float32(1.0)]",-5.0,99414.0,6
2025-08-14_08-18-36,5375,"[np.float32(1.0), np.float32(1.0), np.float32(1.0), np.float32(0.0), np.float32(0.0), np.float32(1.0), np.float32(1.0), np.float32(0.0), np.float32(1.0), np.float32(0.0), np.float32(0.0), np.float32(0.0), np.float32(1.0), np.float32(0.0), np.float32(0.0), np.float32(1.0)]",-4.0,99410.0,23
2025-08-14_08-18-36,5376,"[np.float32(0.0), np.float32(1.0), np.float32(1.0), np.float32(1.0), np.float32(0.0), np.float32(1.0), np.float32(0.0), np.float32(0.0), np.float32(1.0), np.float32(0.0), np.float32(0.0), np.float32(0.0), np.float32(1.0), np.float32(1.0), np.float32(1.0), np.float32(0.0)]",-4.0,99406.0,6
2025-08-14_08-18-36,5377,"[np.float32(0.0), np.float32(1.0), np.float32(1.0), np.float32(1.0), np.float32(0.0), np.float32(1.0), np.float32(0.0), np.float32(0.0), np.float32(1.0), np.float32(0.0), np.float32(1.0), np.float32(1.0), np.float32(0.0), np.float32(0.0), np.float32(0.0), np.float32(1.0)]",0.0,99406.0,14
2025-08-14_08-18-36,5378,"[np.float32(1.0), np.float32(1.0), np.float32(1.0), np.float32(0.0), np.float32(1.0), np.float32(1.0), np.float32(0.0), np.float32(1.0), np.float32(1.0), np.float32(0.0), np.float32(0.0), np.float32(0.0), np.float32(0.0), np.float32(1.0), np.float32(0.0), np.float32(0.0)]",-4.0,99402.0,5
2025-08-14_08-18-36,5379,"[np.float32(1.0), np.float32(0.0), np.float32(1.0), np.float32(1.0), np.float32(0.0), np.float32(0.0), np.float32(1.0), np.float32(1.0), np.float32(1.0), np.float32(1.0), np.float32(0.0), np.float32(0.0), np.float32(1.0), np.float32(0.0), np.float32(0.0), np.float32(1.0)]",1.0,99403.0,19
2025-08-14_08-18-36,5380,"[np.float32(0.0), np.float32(0.0), np.float32(0.0), np.float32(1.0), np.float32(1.0), np.float32(1.0), np.float32(1.0), np.float32(1.0), np.float32(1.0), np.float32(0.0), np.float32(1.0), np.float32(0.0), np.float32(0.0), np.float32(1.0), np.float32(1.0), np.float32(0.0)]",-1.0,99402.0,22
2025-08-14_08-18-36,5381,"[np.float32(1.0), np.float32(0.0), np.float32(1.0), np.float32(0.0), np.float32(1.0), np.float32(1.0), np.float32(1.0), np.float32(0.0), np.float32(0.0), np.float32(1.0), np.float32(0.0), np.float32(0.0), np.float32(0.0), np.float32(0.0), np.float32(0.0), np.float32(1.0)]",2.0,99404.0,12
2025-08-14_08-18-36,5382,"[np.float32(1.0), np.float32(1.0), np.float32(0.0), np.float32(0.0), np.float32(1.0), np.float32(0.0), np.float32(1.0), np.float32(0.0), np.float32(0.0), np.float32(1.0), np.float32(1.0), np.float32(0.0), np.float32(1.0), np.float32(0.0), np.float32(0.0), np.float32(1.0)]",-6.0,99398.0,24
2025-08-14_08-18-36,5383,"[np.float32(0.0), np.float32(0.0), np.float32(0.0), np.float32(0.0), np.float32(1.0), np.float32(0.0), np.float32(1.0), np.float32(1.0), np.float32(0.0), np.float32(1.0), np.float32(0.0), np.float32(0.0), np.float32(0.0), np.float32(1.0), np.float32(0.0), np.float32(0.0)]",3.0,99401.0,10
2025-08-14_08-18-36,5384,"[np.float32(1.0), np.float32(1.0), np.float32(0.0), np.float32(1.0), np.float32(0.0), np.float32(1.0), np.float32(0.0), np.float32(1.0), np.float32(0.0), np.float32(1.0), np.float32(0.0), np.float32(1.0), np.float32(0.0), np.float32(1.0), np.float32(1.0), np.float32(0.0)]",0.0,99401.0,31
2025-08-14_08-18-36,5385,"[np.float32(1.0), np.float32(0.0), np.float32(0.0), np.float32(0.0), np.float32(0.0), np.float32(1.0), np.float32(1.0), np.float32(1.0), np.float32(1.0), np.float32(1.0), np.float32(0.0), np.float32(0.0), np.float32(0.0), np.float32(0.0), np.float32(0.0), np.float32(0.0)]",-1.0,99400.0,5
2025-08-14_08-18-36,5386,"[np.float32(0.0), np.float32(1.0), np.float32(0.0), np.float32(1.0), np.float32(0.0), np.float32(0.0), np.float32(1.0), np.float32(1.0), np.float32(0.0), np.float32(1.0), np.float32(0.0), np.float32(0.0), np.float32(1.0), np.float32(1.0), np.float32(1.0), np.float32(0.0)]",0.0,99400.0,2
2025-08-14_08-18-36,5387,"[np.float32(0.0), np.float32(0.0), np.float32(0.0), np.float32(0.0), np.float32(1.0), np.float32(0.0), np.float32(1.0), np.float32(0.0), np.float32(0.0), np.float32(0.0), np.float32(1.0), np.float32(0.0), np.float32(1.0), np.float32(0.0), np.float32(0.0), np.float32(1.0)]",-2.0,99398.0,34
2025-08-14_08-18-36,5388,"[np.float32(1.0), np.float32(1.0), np.float32(0.0), np.float32(0.0), np.float32(0.0), np.float32(1.0), np.float32(0.0), np.float32(0.0), np.float32(1.0), np.float32(0.0), np.float32(0.0), np.float32(1.0), np.float32(0.0), np.float32(1.0), np.float32(0.0), np.float32(0.0)]",4.0,99402.0,28
2025-08-14_08-18-36,5389,"[np.float32(0.0), np.float32(0.0), np.float32(1.0), np.float32(0.0), np.float32(1.0), np.float32(1.0), np.float32(0.0), np.float32(1.0), np.float32(0.0), np.float32(1.0), np.float32(0.0), np.float32(0.0), np.float32(0.0), np.float32(1.0), np.float32(0.0), np.float32(0.0)]",-4.0,99398.0,5
2025-08-14_08-18-36,5390,"[np.float32(0.0), np.float32(0.0), np.float32(1.0), np.float32(0.0), np.float32(1.0), np.float32(1.0), np.float32(0.0), np.float32(0.0), np.float32(0.0), np.float32(0.0), np.float32(0.0), np.float32(1.0), np.float32(0.0), np.float32(0.0), np.float32(0.0), np.float32(0.0)]",1.0,99399.0,15
2025-08-14_08-18-36,5391,"[np.float32(1.0), np.float32(0.0), np.float32(1.0), np.float32(1.0), np.float32(0.0), np.float32(1.0), np.float32(0.0), np.float32(1.0), np.float32(1.0), np.float32(1.0), np.float32(0.0), np.float32(0.0), np.float32(0.0), np.float32(1.0), np.float32(1.0), np.float32(0.0)]",-2.0,99397.0,12
2025-08-14_08-18-36,5392,"[np.float32(0.0), np.float32(1.0), np.float32(0.0), np.float32(1.0), np.float32(1.0), np.float32(0.0), np.float32(1.0), np.float32(0.0), np.float32(0.0), np.float32(0.0), np.float32(1.0), np.float32(1.0), np.float32(0.0), np.float32(0.0), np.float32(0.0), np.float32(0.0)]",1.0,99398.0,4
2025-08-14_08-18-36,5393,"[np.float32(0.0), np.float32(0.0), np.float32(0.0), np.float32(0.0), np.float32(1.0), np.float32(1.0), np.float32(1.0), np.float32(1.0), np.float32(1.0), np.float32(1.0), np.float32(1.0), np.float32(0.0), np.float32(1.0), np.float32(0.0), np.float32(0.0), np.float32(1.0)]",2.0,99400.0,14
2025-08-14_08-18-36,5394,"[np.float32(1.0), np.float32(0.0), np.float32(0.0), np.float32(1.0), np.float32(1.0), np.float32(1.0), np.float32(0.0), np.float32(0.0), np.float32(1.0), np.float32(1.0), np.float32(1.0), np.float32(0.0), np.float32(0.0), np.float32(1.0), np.float32(0.0), np.float32(1.0)]",-1.0,99399.0,22
2025-08-14_08-18-36,5395,"[np.float32(1.0), np.float32(1.0), np.float32(0.0), np.float32(0.0), np.float32(0.0), np.float32(1.0), np.float32(1.0), np.float32(0.0), np.float32(0.0), np.float32(1.0), np.float32(0.0), np.float32(0.0), np.float32(0.0), np.float32(0.0), np.float32(1.0), np.float32(0.0)]",2.0,99401.0,5
2025-08-14_08-18-36,5396,"[np.float32(0.0), np.float32(0.0), np.float32(1.0), np.float32(1.0), np.float32(1.0), np.float32(1.0), np.float32(1.0), np.float32(0.0), np.float32(1.0), np.float32(0.0), np.float32(0.0), np.float32(0.0), np.float32(1.0), np.float32(0.0), np.float32(1.0), np.float32(1.0)]",1.0,99402.0,33
2025-08-14_08-18-36,5397,"[np.float32(1.0), np.float32(1.0), np.float32(1.0), np.float32(1.0), np.float32(0.0), np.float32(1.0), np.float32(1.0), np.float32(1.0), np.float32(1.0), np.float32(1.0), np.float32(1.0), np.float32(1.0), np.float32(0.0), np.float32(1.0), np.float32(0.0), np.float32(1.0)]",-3.0,99399.0,13
2025-08-14_08-18-36,5398,"[np.float32(1.0), np.float32(0.0), np.float32(1.0), np.float32(1.0), np.float32(1.0), np.float32(0.0), np.float32(1.0), np.float32(0.0), np.float32(1.0), np.float32(1.0), np.float32(0.0), np.float32(1.0), np.float32(1.0), np.float32(0.0), np.float32(0.0), np.float32(0.0)]",1.0,99400.0,34
2025-08-14_08-18-36,5399,"[np.float32(0.0), np.float32(0.0), np.float32(1.0), np.float32(1.0), np.float32(1.0), np.float32(1.0), np.float32(0.0), np.float32(1.0), np.float32(0.0), np.float32(1.0), np.float32(1.0), np.float32(1.0), np.float32(0.0), np.float32(0.0), np.float32(0.0), np.float32(0.0)]",2.0,99402.0,22
2025-08-14_08-18-36,5400,"[np.float32(0.0), np.float32(1.0), np.float32(0.0), np.float32(0.0), np.float32(0.0), np.float32(1.0), np.float32(1.0), np.float32(1.0), np.float32(0.0), np.float32(1.0), np.float32(0.0), np.float32(0.0), np.float32(1.0), np.float32(0.0), np.float32(1.0), np.float32(0.0)]",-4.0,99398.0,9
2025-08-14_08-18-36,5401,"[np.float32(1.0), np.float32(0.0), np.float32(1.0), np.float32(0.0), np.float32(1.0), np.float32(0.0), np.float32(1.0), np.float32(1.0), np.float32(0.0), np.float32(0.0), np.float32(1.0), np.float32(0.0), np.float32(1.0), np.float32(0.0), np.float32(0.0), np.float32(0.0)]",-2.0,99396.0,22
2025-08-14_08-18-36,5402,"[np.float32(0.0), np.float32(0.0), np.float32(1.0), np.float32(0.0), np.float32(1.0), np.float32(0.0), np.float32(0.0), np.float32(0.0), np.float32(0.0), np.float32(1.0), np.float32(1.0), np.float32(0.0), np.float32(0.0), np.float32(0.0), np.float32(0.0), np.float32(0.0)]",-4.0,99392.0,27
2025-08-14_08-18-36,5403,"[np.float32(0.0), np.float32(1.0), np.float32(0.0), np.float32(1.0), np.float32(0.0), np.float32(1.0), np.float32(1.0), np.float32(1.0), np.float32(0.0), np.float32(1.0), np.float32(1.0), np.float32(0.0), np.float32(0.0), np.float32(1.0), np.float32(1.0), np.float32(1.0)]",-3.0,99389.0,0
2025-08-14_08-18-36,5404,"[np.float32(1.0), np.float32(0.0), np.float32(0.0), np.float32(0.0), np.float32(1.0), np.float32(1.0), np.float32(0.0), np.float32(1.0), np.float32(1.0), np.float32(1.0), np.float32(1.0), np.float32(0.0), np.float32(0.0), np.float32(1.0), np.float32(1.0), np.float32(0.0)]",-1.0,99388.0,10
2025-08-14_08-18-36,5405,"[np.float32(1.0), np.float32(0.0), np.float32(0.0), np.float32(1.0), np.float32(0.0), np.float32(1.0), np.float32(1.0), np.float32(1.0), np.float32(1.0), np.float32(0.0), np.float32(0.0), np.float32(0.0), np.float32(1.0), np.float32(1.0), np.float32(1.0), np.float32(1.0)]",-2.0,99386.0,16
2025-08-14_08-18-36,5406,"[np.float32(0.0), np.float32(1.0), np.float32(1.0), np.float32(0.0), np.float32(0.0), np.float32(0.0), np.float32(0.0), np.float32(1.0), np.float32(0.0), np.float32(1.0), np.float32(1.0), np.float32(1.0), np.float32(0.0), np.float32(1.0), np.float32(0.0), np.float32(1.0)]",2.0,99388.0,4
2025-08-14_08-18-36,5407,"[np.float32(0.0), np.float32(1.0), np.float32(1.0), np.float32(0.0), np.float32(1.0), np.float32(0.0), np.float32(0.0), np.float32(0.0), np.float32(1.0), np.float32(0.0), np.float32(0.0), np.float32(1.0), np.float32(1.0), np.float32(0.0), np.float32(1.0), np.float32(0.0)]",0.0,99388.0,18
2025-08-14_08-18-36,5408,"[np.float32(1.0), np.float32(0.0), np.float32(0.0), np.float32(0.0), np.float32(1.0), np.float32(1.0), np.float32(1.0), np.float32(0.0), np.float32(1.0), np.float32(0.0), np.float32(1.0), np.float32(1.0), np.float32(1.0), np.float32(1.0), np.float32(0.0), np.float32(1.0)]",-2.0,99386.0,28
2025-08-14_08-18-36,5409,"[np.float32(1.0), np.float32(1.0), np.float32(0.0), np.float32(1.0), np.float32(1.0), np.float32(0.0), np.float32(1.0), np.float32(0.0), np.float32(0.0), np.float32(0.0), np.float32(0.0), np.float32(0.0), np.float32(1.0), np.float32(1.0), np.float32(1.0), np.float32(0.0)]",-1.0,99385.0,35
2025-08-14_08-18-36,5410,"[np.float32(0.0), np.float32(0.0), np.float32(1.0), np.float32(0.0), np.float32(0.0), np.float32(0.0), np.float32(1.0), np.float32(1.0), np.float32(0.0), np.float32(1.0), np.float32(0.0), np.float32(1.0), np.float32(1.0), np.float32(1.0), np.float32(0.0), np.float32(1.0)]",0.0,99385.0,10
2025-08-14_08-18-36,5411,"[np.float32(1.0), np.float32(1.0), np.float32(0.0), np.float32(1.0), np.float32(1.0), np.float32(1.0), np.float32(1.0), np.float32(1.0), np.float32(1.0), np.float32(1.0), np.float32(0.0), np.float32(0.0), np.float32(0.0), np.float32(1.0), np.float32(1.0), np.float32(0.0)]",-2.0,99383.0,17
2025-08-14_08-18-36,5412,"[np.float32(1.0), np.float32(1.0), np.float32(0.0), np.float32(1.0), np.float32(1.0), np.float32(0.0), np.float32(0.0), np.float32(1.0), np.float32(1.0), np.float32(1.0), np.float32(1.0), np.float32(0.0), np.float32(1.0), np.float32(0.0), np.float32(0.0), np.float32(1.0)]",-5.0,99378.0,24
2025-08-14_08-18-36,5413,"[np.float32(1.0), np.float32(1.0), np.float32(1.0), np.float32(1.0), np.float32(0.0), np.float32(0.0), np.float32(0.0), np.float32(1.0), np.float32(0.0), np.float32(1.0), np.float32(1.0), np.float32(0.0), np.float32(0.0), np.float32(1.0), np.float32(0.0), np.float32(0.0)]",2.0,99380.0,21
2025-08-14_08-18-36,5414,"[np.float32(1.0), np.float32(1.0), np.float32(1.0), np.float32(1.0), np.float32(0.0), np.float32(1.0), np.float32(1.0), np.float32(1.0), np.float32(0.0), np.float32(1.0), np.float32(1.0), np.float32(0.0), np.float32(1.0), np.float32(0.0), np.float32(1.0), np.float32(0.0)]",-2.0,99378.0,27
2025-08-14_08-18-36,5415,"[np.float32(1.0), np.float32(0.0), np.float32(0.0), np.float32(1.0), np.float32(1.0), np.float32(1.0), np.float32(0.0), np.float32(1.0), np.float32(1.0), np.float32(0.0), np.float32(1.0), np.float32(0.0), np.float32(0.0), np.float32(0.0), np.float32(0.0), np.float32(1.0)]",3.0,99381.0,20
2025-08-14_08-18-36,5416,"[np.float32(1.0), np.float32(1.0), np.float32(0.0), np.float32(0.0), np.float32(1.0), np.float32(1.0), np.float32(1.0), np.float32(1.0), np.float32(1.0), np.float32(1.0), np.float32(1.0), np.float32(0.0), np.float32(0.0), np.float32(1.0), np.float32(0.0), np.float32(0.0)]",3.0,99384.0,22
2025-08-14_08-18-36,5417,"[np.float32(1.0), np.float32(0.0), np.float32(0.0), np.float32(1.0), np.float32(0.0), np.float32(1.0), np.float32(0.0), np.float32(1.0), np.float32(0.0), np.float32(0.0), np.float32(0.0), np.float32(1.0), np.float32(1.0), np.float32(0.0), np.float32(0.0), np.float32(1.0)]",3.0,99387.0,9
2025-08-14_08-18-36,5418,"[np.float32(0.0), np.float32(1.0), np.float32(0.0), np.float32(1.0), np.float32(0.0), np.float32(1.0), np.float32(0.0), np.float32(0.0), np.float32(0.0), np.float32(1.0), np.float32(1.0), np.float32(0.0), np.float32(0.0), np.float32(0.0), np.float32(0.0), np.float32(0.0)]",0.0,99387.0,1
2025-08-14_08-18-36,5419,"[np.float32(0.0), np.float32(1.0), np.float32(0.0), np.float32(1.0), np.float32(0.0), np.float32(0.0), np.float32(1.0), np.float32(0.0), np.float32(1.0), np.float32(0.0), np.float32(0.0), np.float32(1.0), np.float32(1.0), np.float32(0.0), np.float32(1.0), np.float32(1.0)]",-1.0,99386.0,29
2025-08-14_08-18-36,5420,"[np.float32(1.0), np.float32(1.0), np.float32(1.0), np.float32(0.0), np.float32(0.0), np.float32(1.0), np.float32(0.0), np.float32(1.0), np.float32(0.0), np.float32(0.0), np.float32(1.0), np.float32(0.0), np.float32(0.0), np.float32(1.0), np.float32(0.0), np.float32(0.0)]",1.0,99387.0,15
2025-08-14_08-18-36,5421,"[np.float32(0.0), np.float32(1.0), np.float32(0.0), np.float32(0.0), np.float32(1.0), np.float32(0.0), np.float32(0.0), np.float32(1.0), np.float32(1.0), np.float32(0.0), np.float32(1.0), np.float32(1.0), np.float32(0.0), np.float32(0.0), np.float32(0.0), np.float32(0.0)]",0.0,99387.0,27
2025-08-14_08-18-36,5422,"[np.float32(0.0), np.float32(0.0), np.float32(0.0), np.float32(0.0), np.float32(0.0), np.float32(0.0), np.float32(1.0), np.float32(0.0), np.float32(1.0), np.float32(0.0), np.float32(0.0), np.float32(0.0), np.float32(1.0), np.float32(1.0), np.float32(0.0), np.float32(0.0)]",-1.0,99386.0,1
2025-08-14_08-18-36,5423,"[np.float32(0.0), np.float32(0.0), np.float32(1.0), np.float32(1.0), np.float32(1.0), np.float32(1.0), np.float32(1.0), np.float32(0.0), np.float32(1.0), np.float32(0.0), np.float32(1.0), np.float32(1.0), np.float32(1.0), np.float32(0.0), np.float32(1.0), np.float32(0.0)]",-6.0,99380.0,22
2025-08-14_08-18-36,5424,"[np.float32(0.0), np.float32(0.0), np.float32(1.0), np.float32(0.0), np.float32(0.0), np.float32(0.0), np.float32(0.0), np.float32(1.0), np.float32(1.0), np.float32(0.0), np.float32(1.0), np.float32(1.0), np.float32(0.0), np.float32(0.0), np.float32(1.0), np.float32(1.0)]",4.0,99384.0,30
2025-08-14_08-18-36,5425,"[np.float32(0.0), np.float32(0.0), np.float32(1.0), np.float32(0.0), np.float32(1.0), np.float32(0.0), np.float32(1.0), np.float32(0.0), np.float32(1.0), np.float32(1.0), np.float32(1.0), np.float32(0.0), np.float32(1.0), np.float32(0.0), np.float32(0.0), np.float32(0.0)]",0.0,99384.0,6
2025-08-14_08-18-36,5426,"[np.float32(0.0), np.float32(1.0), np.float32(1.0), np.float32(0.0), np.float32(0.0), np.float32(0.0), np.float32(0.0), np.float32(0.0), np.float32(0.0), np.float32(1.0), np.float32(1.0), np.float32(1.0), np.float32(1.0), np.float32(1.0), np.float32(1.0), np.float32(0.0)]",2.0,99386.0,2
2025-08-14_08-18-36,5427,"[np.float32(0.0), np.float32(0.0), np.float32(1.0), np.float32(1.0), np.float32(0.0), np.float32(0.0), np.float32(0.0), np.float32(1.0), np.float32(1.0), np.float32(1.0), np.float32(1.0), np.float32(0.0), np.float32(0.0), np.float32(1.0), np.float32(1.0), np.float32(1.0)]",2.0,99388.0,16
2025-08-14_08-18-36,5428,"[np.float32(1.0), np.float32(1.0), np.float32(0.0), np.float32(0.0), np.float32(1.0), np.float32(0.0), np.float32(1.0), np.float32(0.0), np.float32(1.0), np.float32(0.0), np.float32(0.0), np.float32(1.0), np.float32(0.0), np.float32(0.0), np.float32(1.0), np.float32(0.0)]",3.0,99391.0,9
2025-08-14_08-18-36,5429,"[np.float32(0.0), np.float32(1.0), np.float32(0.0), np.float32(0.0), np.float32(1.0), np.float32(1.0), np.float32(1.0), np.float32(1.0), np.float32(0.0), np.float32(0.0), np.float32(1.0), np.float32(1.0), np.float32(1.0), np.float32(0.0), np.float32(0.0), np.float32(0.0)]",-3.0,99388.0,36
2025-08-14_08-18-36,5430,"[np.float32(1.0), np.float32(1.0), np.float32(1.0), np.float32(0.0), np.float32(0.0), np.float32(0.0), np.float32(1.0), np.float32(1.0), np.float32(1.0), np.float32(0.0), np.float32(0.0), np.float32(1.0), np.float32(0.0), np.float32(0.0), np.float32(0.0), np.float32(0.0)]",1.0,99389.0,3
2025-08-14_08-18-36,5431,"[np.float32(0.0), np.float32(0.0), np.float32(0.0), np.float32(0.0), np.float32(0.0), np.float32(1.0), np.float32(0.0), np.float32(1.0), np.float32(0.0), np.float32(0.0), np.float32(0.0), np.float32(0.0), np.float32(1.0), np.float32(0.0), np.float32(1.0), np.float32(0.0)]",1.0,99390.0,30
2025-08-14_08-18-36,5432,"[np.float32(0.0), np.float32(1.0), np.float32(1.0), np.float32(0.0), np.float32(0.0), np.float32(1.0), np.float32(1.0), np.float32(0.0), np.float32(0.0), np.float32(0.0), np.float32(1.0), np.float32(0.0), np.float32(1.0), np.float32(1.0), np.float32(1.0), np.float32(1.0)]",-1.0,99389.0,14
2025-08-14_08-18-36,5433,"[np.float32(0.0), np.float32(0.0), np.float32(0.0), np.float32(0.0), np.float32(1.0), np.float32(1.0), np.float32(0.0), np.float32(0.0), np.float32(0.0), np.float32(1.0), np.float32(1.0), np.float32(0.0), np.float32(1.0), np.float32(0.0), np.float32(0.0), np.float32(0.0)]",0.0,99389.0,4
2025-08-14_08-18-36,5434,"[np.float32(1.0), np.float32(0.0), np.float32(0.0), np.float32(0.0), np.float32(1.0), np.float32(0.0), np.float32(1.0), np.float32(0.0), np.float32(1.0), np.float32(0.0), np.float32(0.0), np.float32(0.0), np.float32(0.0), np.float32(0.0), np.float32(0.0), np.float32(0.0)]",1.0,99390.0,34
2025-08-14_08-18-36,5435,"[np.float32(1.0), np.float32(1.0), np.float32(1.0), np.float32(0.0), np.float32(0.0), np.float32(1.0), np.float32(1.0), np.float32(1.0), np.float32(1.0), np.float32(1.0), np.float32(0.0), np.float32(1.0), np.float32(1.0), np.float32(0.0), np.float32(1.0), np.float32(0.0)]",4.0,99394.0,30
2025-08-14_08-18-36,5436,"[np.float32(0.0), np.float32(0.0), np.float32(1.0), np.float32(0.0), np.float32(0.0), np.float32(1.0), np.float32(0.0), np.float32(0.0), np.float32(0.0), np.float32(1.0), np.float32(0.0), np.float32(0.0), np.float32(0.0), np.float32(0.0), np.float32(1.0), np.float32(1.0)]",0.0,99394.0,4
2025-08-14_08-18-36,5437,"[np.float32(1.0), np.float32(0.0), np.float32(0.0), np.float32(0.0), np.float32(1.0), np.float32(1.0), np.float32(1.0), np.float32(1.0), np.float32(0.0), np.float32(1.0), np.float32(1.0), np.float32(0.0), np.float32(0.0), np.float32(0.0), np.float32(0.0), np.float32(0.0)]",1.0,99395.0,4
2025-08-14_08-18-36,5438,"[np.float32(0.0), np.float32(0.0), np.float32(0.0), np.float32(0.0), np.float32(0.0), np.float32(1.0), np.float32(0.0), np.float32(0.0), np.float32(0.0), np.float32(0.0), np.float32(1.0), np.float32(1.0), np.float32(0.0), np.float32(0.0), np.float32(1.0), np.float32(0.0)]",1.0,99396.0,32
2025-08-14_08-18-36,5439,"[np.float32(0.0), np.float32(0.0), np.float32(1.0), np.float32(0.0), np.float32(0.0), np.float32(1.0), np.float32(0.0), np.float32(0.0), np.float32(1.0), np.float32(1.0), np.float32(0.0), np.float32(1.0), np.float32(0.0), np.float32(0.0), np.float32(0.0), np.float32(0.0)]",0.0,99396.0,19
2025-08-14_08-18-36,5440,"[np.float32(0.0), np.float32(1.0), np.float32(0.0), np.float32(1.0), np.float32(0.0), np.float32(1.0), np.float32(0.0), np.float32(0.0), np.float32(0.0), np.float32(1.0), np.float32(1.0), np.float32(1.0), np.float32(1.0), np.float32(0.0), np.float32(0.0), np.float32(0.0)]",0.0,99396.0,27
2025-08-14_08-18-36,5441,"[np.float32(0.0), np.float32(1.0), np.float32(0.0), np.float32(1.0), np.float32(0.0), np.float32(1.0), np.float32(1.0), np.float32(0.0), np.float32(0.0), np.float32(0.0), np.float32(0.0), np.float32(1.0), np.float32(1.0), np.float32(1.0), np.float32(1.0), np.float32(0.0)]",-1.0,99395.0,0
2025-08-14_08-18-36,5442,"[np.float32(0.0), np.float32(0.0), np.float32(0.0), np.float32(1.0), np.float32(1.0), np.float32(1.0), np.float32(0.0), np.float32(1.0), np.float32(1.0), np.float32(1.0), np.float32(0.0), np.float32(0.0), np.float32(0.0), np.float32(1.0), np.float32(0.0), np.float32(1.0)]",-3.0,99392.0,24
2025-08-14_08-18-36,5443,"[np.float32(1.0), np.float32(1.0), np.float32(1.0), np.float32(0.0), np.float32(1.0), np.float32(0.0), np.float32(1.0), np.float32(1.0), np.float32(0.0), np.float32(0.0), np.float32(0.0), np.float32(0.0), np.float32(0.0), np.float32(1.0), np.float32(1.0), np.float32(1.0)]",3.0,99395.0,18
2025-08-14_08-18-36,5444,"[np.float32(1.0), np.float32(0.0), np.float32(0.0), np.float32(1.0), np.float32(1.0), np.float32(0.0), np.float32(1.0), np.float32(1.0), np.float32(1.0), np.float32(1.0), np.float32(1.0), np.float32(1.0), np.float32(1.0), np.float32(0.0), np.float32(1.0), np.float32(0.0)]",-5.0,99390.0,28
2025-08-14_08-18-36,5445,"[np.float32(1.0), np.float32(1.0), np.float32(0.0), np.float32(0.0), np.float32(1.0), np.float32(0.0), np.float32(1.0), np.float32(1.0), np.float32(1.0), np.float32(1.0), np.float32(0.0), np.float32(1.0), np.float32(1.0), np.float32(0.0), np.float32(0.0), np.float32(0.0)]",1.0,99391.0,4
2025-08-14_08-18-36,5446,"[np.float32(0.0), np.float32(1.0), np.float32(1.0), np.float32(0.0), np.float32(1.0), np.float32(0.0), np.float32(1.0), np.float32(1.0), np.float32(0.0), np.float32(0.0), np.float32(1.0), np.float32(0.0), np.float32(0.0), np.float32(1.0), np.float32(1.0), np.float32(0.0)]",-5.0,99386.0,25
2025-08-14_08-18-36,5447,"[np.float32(1.0), np.float32(0.0), np.float32(1.0), np.float32(0.0), np.float32(0.0), np.float32(0.0), np.float32(1.0), np.float32(1.0), np.float32(0.0), np.float32(1.0), np.float32(0.0), np.float32(0.0), np.float32(0.0), np.float32(1.0), np.float32(1.0), np.float32(0.0)]",0.0,99386.0,32
2025-08-14_08-18-36,5448,"[np.float32(1.0), np.float32(0.0), np.float32(1.0), np.float32(1.0), np.float32(0.0), np.float32(1.0), np.float32(0.0), np.float32(0.0), np.float32(0.0), np.float32(0.0), np.float32(0.0), np.float32(0.0), np.float32(0.0), np.float32(0.0), np.float32(0.0), np.float32(1.0)]",-3.0,99383.0,4
2025-08-14_08-18-36,5449,"[np.float32(0.0), np.float32(0.0), np.float32(1.0), np.float32(0.0), np.float32(0.0), np.float32(1.0), np.float32(0.0), np.float32(1.0), np.float32(1.0), np.float32(1.0), np.float32(0.0), np.float32(1.0), np.float32(1.0), np.float32(0.0), np.float32(1.0), np.float32(0.0)]",0.0,99383.0,23
2025-08-14_08-18-36,5450,"[np.float32(0.0), np.float32(1.0), np.float32(0.0), np.float32(0.0), np.float32(0.0), np.float32(0.0), np.float32(1.0), np.float32(1.0), np.float32(0.0), np.float32(1.0), np.float32(0.0), np.float32(1.0), np.float32(1.0), np.float32(1.0), np.float32(0.0), np.float32(1.0)]",3.0,99386.0,4
2025-08-14_08-18-36,5451,"[np.float32(0.0), np.float32(0.0), np.float32(1.0), np.float32(1.0), np.float32(1.0), np.float32(1.0), np.float32(0.0), np.float32(1.0), np.float32(1.0), np.float32(0.0), np.float32(1.0), np.float32(0.0), np.float32(1.0), np.float32(0.0), np.float32(0.0), np.float32(0.0)]",32.0,99418.0,7
2025-08-14_08-18-36,5452,"[np.float32(1.0), np.float32(0.0), np.float32(1.0), np.float32(0.0), np.float32(0.0), np.float32(1.0), np.float32(0.0), np.float32(0.0), np.float32(0.0), np.float32(0.0), np.float32(0.0), np.float32(0.0), np.float32(1.0), np.float32(1.0), np.float32(1.0), np.float32(1.0)]",0.0,99418.0,19
2025-08-14_08-18-36,5453,"[np.float32(0.0), np.float32(0.0), np.float32(0.0), np.float32(0.0), np.float32(0.0), np.float32(0.0), np.float32(0.0), np.float32(1.0), np.float32(1.0), np.float32(0.0), np.float32(1.0), np.float32(0.0), np.float32(0.0), np.float32(1.0), np.float32(0.0), np.float32(1.0)]",-2.0,99416.0,5
2025-08-14_08-18-36,5454,"[np.float32(1.0), np.float32(0.0), np.float32(0.0), np.float32(1.0), np.float32(1.0), np.float32(1.0), np.float32(1.0), np.float32(1.0), np.float32(1.0), np.float32(0.0), np.float32(1.0), np.float32(0.0), np.float32(0.0), np.float32(0.0), np.float32(1.0), np.float32(0.0)]",1.0,99417.0,35
2025-08-14_08-18-36,5455,"[np.float32(0.0), np.float32(0.0), np.float32(0.0), np.float32(0.0), np.float32(0.0), np.float32(1.0), np.float32(0.0), np.float32(0.0), np.float32(1.0), np.float32(0.0), np.float32(1.0), np.float32(1.0), np.float32(1.0), np.float32(1.0), np.float32(1.0), np.float32(0.0)]",-4.0,99413.0,6
2025-08-14_08-18-36,5456,"[np.float32(1.0), np.float32(0.0), np.float32(1.0), np.float32(1.0), np.float32(0.0), np.float32(1.0), np.float32(0.0), np.float32(1.0), np.float32(1.0), np.float32(0.0), np.float32(1.0), np.float32(1.0), np.float32(0.0), np.float32(1.0), np.float32(1.0), np.float32(1.0)]",2.0,99415.0,26
2025-08-14_08-18-36,5457,"[np.float32(0.0), np.float32(0.0), np.float32(0.0), np.float32(1.0), np.float32(0.0), np.float32(0.0), np.float32(1.0), np.float32(0.0), np.float32(1.0), np.float32(0.0), np.float32(0.0), np.float32(0.0), np.float32(1.0), np.float32(0.0), np.float32(0.0), np.float32(0.0)]",-2.0,99413.0,15
2025-08-14_08-18-36,5458,"[np.float32(0.0), np.float32(1.0), np.float32(1.0), np.float32(0.0), np.float32(0.0), np.float32(0.0), np.float32(1.0), np.float32(1.0), np.float32(0.0), np.float32(0.0), np.float32(0.0), np.float32(1.0), np.float32(1.0), np.float32(1.0), np.float32(1.0), np.float32(0.0)]",3.0,99416.0,18
2025-08-14_08-18-36,5459,"[np.float32(0.0), np.float32(1.0), np.float32(1.0), np.float32(1.0), np.float32(1.0), np.float32(0.0), np.float32(1.0), np.float32(1.0), np.float32(1.0), np.float32(1.0), np.float32(0.0), np.float32(0.0), np.float32(1.0), np.float32(1.0), np.float32(0.0), np.float32(0.0)]",-3.0,99413.0,24
2025-08-14_08-18-36,5460,"[np.float32(1.0), np.float32(0.0), np.float32(0.0), np.float32(0.0), np.float32(0.0), np.float32(1.0), np.float32(0.0), np.float32(1.0), np.float32(0.0), np.float32(0.0), np.float32(0.0), np.float32(0.0), np.float32(0.0), np.float32(0.0), np.float32(1.0), np.float32(0.0)]",-2.0,99411.0,3
2025-08-14_08-18-36,5461,"[np.float32(0.0), np.float32(0.0), np.float32(0.0), np.float32(1.0), np.float32(0.0), np.float32(0.0), np.float32(0.0), np.float32(0.0), np.float32(1.0), np.float32(1.0), np.float32(0.0), np.float32(0.0), np.float32(0.0), np.float32(0.0), np.float32(0.0), np.float32(0.0)]",2.0,99413.0,27
2025-08-14_08-18-36,5462,"[np.float32(0.0), np.float32(0.0), np.float32(1.0), np.float32(1.0), np.float32(0.0), np.float32(1.0), np.float32(1.0), np.float32(0.0), np.float32(1.0), np.float32(1.0), np.float32(0.0), np.float32(1.0), np.float32(1.0), np.float32(0.0), np.float32(0.0), np.float32(1.0)]",-4.0,99409.0,18
2025-08-14_08-18-36,5463,"[np.float32(0.0), np.float32(1.0), np.float32(0.0), np.float32(0.0), np.float32(1.0), np.float32(0.0), np.float32(1.0), np.float32(1.0), np.float32(0.0), np.float32(1.0), np.float32(1.0), np.float32(1.0), np.float32(1.0), np.float32(0.0), np.float32(0.0), np.float32(0.0)]",-2.0,99407.0,21
2025-08-14_08-18-36,5464,"[np.float32(1.0), np.float32(1.0), np.float32(0.0), np.float32(0.0), np.float32(0.0), np.float32(0.0), np.float32(0.0), np.float32(0.0), np.float32(1.0), np.float32(0.0), np.float32(0.0), np.float32(0.0), np.float32(1.0), np.float32(1.0), np.float32(1.0), np.float32(0.0)]",-1.0,99406.0,23
2025-08-14_08-18-36,5465,"[np.float32(1.0), np.float32(1.0), np.float32(1.0), np.float32(0.0), np.float32(0.0), np.float32(0.0), np.float32(1.0), np.float32(0.0), np.float32(1.0), np.float32(0.0), np.float32(1.0), np.float32(0.0), np.float32(0.0), np.float32(0.0), np.float32(1.0), np.float32(1.0)]",2.0,99408.0,30
2025-08-14_08-18-36,5466,"[np.float32(0.0), np.float32(0.0), np.float32(1.0), np.float32(0.0), np.float32(1.0), np.float32(1.0), np.float32(0.0), np.float32(1.0), np.float32(0.0), np.float32(0.0), np.float32(0.0), np.float32(0.0), np.float32(0.0), np.float32(0.0), np.float32(1.0), np.float32(1.0)]",4.0,99412.0,24
2025-08-14_08-18-36,5467,"[np.float32(0.0), np.float32(1.0), np.float32(1.0), np.float32(1.0), np.float32(0.0), np.float32(0.0), np.float32(1.0), np.float32(1.0), np.float32(1.0), np.float32(1.0), np.float32(1.0), np.float32(0.0), np.float32(0.0), np.float32(0.0), np.float32(0.0), np.float32(0.0)]",-3.0,99409.0,36
2025-08-14_08-18-36,5468,"[np.float32(0.0), np.float32(0.0), np.float32(1.0), np.float32(0.0), np.float32(0.0), np.float32(1.0), np.float32(1.0), np.float32(1.0), np.float32(0.0), np.float32(0.0), np.float32(0.0), np.float32(0.0), np.float32(0.0), np.float32(1.0), np.float32(1.0), np.float32(0.0)]",4.0,99413.0,24
2025-08-14_08-18-36,5469,"[np.float32(1.0), np.float32(0.0), np.float32(0.0), np.float32(1.0), np.float32(0.0), np.float32(0.0), np.float32(0.0), np.float32(1.0), np.float32(1.0), np.float32(1.0), np.float32(0.0), np.float32(1.0), np.float32(1.0), np.float32(1.0), np.float32(1.0), np.float32(0.0)]",-4.0,99409.0,11
2025-08-14_08-18-36,5470,"[np.float32(0.0), np.float32(1.0), np.float32(1.0), np.float32(1.0), np.float32(0.0), np.float32(0.0), np.float32(1.0), np.float32(0.0), np.float32(1.0), np.float32(1.0), np.float32(0.0), np.float32(0.0), np.float32(0.0), np.float32(1.0), np.float32(1.0), np.float32(0.0)]",-3.0,99406.0,9
2025-08-14_08-18-36,5471,"[np.float32(0.0), np.float32(0.0), np.float32(1.0), np.float32(1.0), np.float32(1.0), np.float32(0.0), np.float32(0.0), np.float32(1.0), np.float32(0.0), np.float32(0.0), np.float32(0.0), np.float32(0.0), np.float32(1.0), np.float32(0.0), np.float32(0.0), np.float32(1.0)]",4.0,99410.0,17
2025-08-14_08-18-36,5472,"[np.float32(1.0), np.float32(0.0), np.float32(0.0), np.float32(1.0), np.float32(1.0), np.float32(1.0), np.float32(0.0), np.float32(0.0), np.float32(1.0), np.float32(1.0), np.float32(1.0), np.float32(0.0), np.float32(0.0), np.float32(0.0), np.float32(0.0), np.float32(0.0)]",0.0,99410.0,36
2025-08-14_08-18-36,5473,"[np.float32(0.0), np.float32(1.0), np.float32(0.0), np.float32(0.0), np.float32(0.0), np.float32(1.0), np.float32(1.0), np.float32(0.0), np.float32(1.0), np.float32(1.0), np.float32(1.0), np.float32(1.0), np.float32(1.0), np.float32(1.0), np.float32(1.0), np.float32(1.0)]",2.0,99412.0,29
2025-08-14_08-18-36,5474,"[np.float32(1.0), np.float32(1.0), np.float32(1.0), np.float32(0.0), np.float32(0.0), np.float32(1.0), np.float32(1.0), np.float32(1.0), np.float32(0.0), np.float32(0.0), np.float32(0.0), np.float32(1.0), np.float32(1.0), np.float32(1.0), np.float32(1.0), np.float32(1.0)]",-1.0,99411.0,19
2025-08-14_08-18-36,5475,"[np.float32(0.0), np.float32(0.0), np.float32(1.0), np.float32(0.0), np.float32(1.0), np.float32(1.0), np.float32(0.0), np.float32(1.0), np.float32(0.0), np.float32(0.0), np.float32(1.0), np.float32(0.0), np.float32(0.0), np.float32(0.0), np.float32(1.0), np.float32(0.0)]",-1.0,99410.0,33
2025-08-14_08-18-36,5476,"[np.float32(0.0), np.float32(1.0), np.float32(0.0), np.float32(0.0), np.float32(0.0), np.float32(1.0), np.float32(1.0), np.float32(1.0), np.float32(1.0), np.float32(0.0), np.float32(0.0), np.float32(1.0), np.float32(0.0), np.float32(0.0), np.float32(0.0), np.float32(0.0)]",1.0,99411.0,20
2025-08-14_08-18-36,5477,"[np.float32(1.0), np.float32(1.0), np.float32(1.0), np.float32(0.0), np.float32(1.0), np.float32(1.0), np.float32(0.0), np.float32(0.0), np.float32(1.0), np.float32(0.0), np.float32(1.0), np.float32(0.0), np.float32(1.0), np.float32(0.0), np.float32(0.0), np.float32(0.0)]",-2.0,99409.0,4
2025-08-14_08-18-36,5478,"[np.float32(1.0), np.float32(0.0), np.float32(1.0), np.float32(0.0), np.float32(1.0), np.float32(0.0), np.float32(0.0), np.float32(0.0), np.float32(1.0), np.float32(0.0), np.float32(1.0), np.float32(0.0), np.float32(1.0), np.float32(1.0), np.float32(0.0), np.float32(0.0)]",-2.0,99407.0,22
2025-08-14_08-18-36,5479,"[np.float32(0.0), np.float32(0.0), np.float32(0.0), np.float32(0.0), np.float32(1.0), np.float32(0.0), np.float32(0.0), np.float32(0.0), np.float32(0.0), np.float32(1.0), np.float32(1.0), np.float32(1.0), np.float32(0.0), np.float32(0.0), np.float32(1.0), np.float32(0.0)]",0.0,99407.0,1
2025-08-14_08-18-36,5480,"[np.float32(1.0), np.float32(0.0), np.float32(0.0), np.float32(1.0), np.float32(1.0), np.float32(1.0), np.float32(1.0), np.float32(1.0), np.float32(0.0), np.float32(1.0), np.float32(1.0), np.float32(0.0), np.float32(0.0), np.float32(1.0), np.float32(0.0), np.float32(1.0)]",5.0,99412.0,1
2025-08-14_08-18-36,5481,"[np.float32(0.0), np.float32(1.0), np.float32(1.0), np.float32(1.0), np.float32(0.0), np.float32(1.0), np.float32(1.0), np.float32(0.0), np.float32(1.0), np.float32(0.0), np.float32(0.0), np.float32(1.0), np.float32(0.0), np.float32(1.0), np.float32(1.0), np.float32(0.0)]",6.0,99418.0,33
2025-08-14_08-18-36,5482,"[np.float32(0.0), np.float32(1.0), np.float32(0.0), np.float32(1.0), np.float32(0.0), np.float32(1.0), np.float32(0.0), np.float32(1.0), np.float32(1.0), np.float32(0.0), np.float32(1.0), np.float32(1.0), np.float32(0.0), np.float32(1.0), np.float32(0.0), np.float32(1.0)]",-1.0,99417.0,34
2025-08-14_08-18-36,5483,"[np.float32(1.0), np.float32(0.0), np.float32(1.0), np.float32(0.0), np.float32(0.0), np.float32(1.0), np.float32(1.0), np.float32(1.0), np.float32(0.0), np.float32(1.0), np.float32(0.0), np.float32(1.0), np.float32(1.0), np.float32(1.0), np.float32(0.0), np.float32(0.0)]",4.0,99421.0,12
2025-08-14_08-18-36,5484,"[np.float32(1.0), np.float32(1.0), np.float32(0.0), np.float32(0.0), np.float32(0.0), np.float32(0.0), np.float32(1.0), np.float32(1.0), np.float32(1.0), np.float32(1.0), np.float32(0.0), np.float32(0.0), np.float32(0.0), np.float32(1.0), np.float32(0.0), np.float32(1.0)]",-3.0,99418.0,0
2025-08-14_08-18-36,5485,"[np.float32(1.0), np.float32(1.0), np.float32(0.0), np.float32(0.0), np.float32(1.0), np.float32(0.0), np.float32(0.0), np.float32(1.0), np.float32(1.0), np.float32(0.0), np.float32(0.0), np.float32(0.0), np.float32(0.0), np.float32(1.0), np.float32(0.0), np.float32(0.0)]",1.0,99419.0,16
2025-08-14_08-18-36,5486,"[np.float32(1.0), np.float32(1.0), np.float32(0.0), np.float32(0.0), np.float32(0.0), np.float32(0.0), np.float32(1.0), np.float32(1.0), np.float32(0.0), np.float32(0.0), np.float32(0.0), np.float32(0.0), np.float32(1.0), np.float32(0.0), np.float32(0.0), np.float32(1.0)]",-4.0,99415.0,33
2025-08-14_08-18-36,5487,"[np.float32(1.0), np.float32(0.0), np.float32(1.0), np.float32(0.0), np.float32(0.0), np.float32(0.0), np.float32(0.0), np.float32(0.0), np.float32(1.0), np.float32(1.0), np.float32(1.0), np.float32(0.0), np.float32(1.0), np.float32(1.0), np.float32(1.0), np.float32(1.0)]",2.0,99417.0,28
2025-08-14_08-18-36,5488,"[np.float32(1.0), np.float32(1.0), np.float32(0.0), np.float32(0.0), np.float32(0.0), np.float32(0.0), np.float32(1.0), np.float32(1.0), np.float32(0.0), np.float32(0.0), np.float32(0.0), np.float32(1.0), np.float32(1.0), np.float32(0.0), np.float32(0.0), np.float32(1.0)]",1.0,99418.0,15
2025-08-14_08-18-36,5489,"[np.float32(0.0), np.float32(1.0), np.float32(1.0), np.float32(1.0), np.float32(1.0), np.float32(0.0), np.float32(0.0), np.float32(1.0), np.float32(1.0), np.float32(1.0), np.float32(0.0), np.float32(0.0), np.float32(1.0), np.float32(1.0), np.float32(0.0), np.float32(1.0)]",-2.0,99416.0,32
2025-08-14_08-18-36,5490,"[np.float32(0.0), np.float32(1.0), np.float32(0.0), np.float32(1.0), np.float32(0.0), np.float32(0.0), np.float32(1.0), np.float32(1.0), np.float32(0.0), np.float32(1.0), np.float32(0.0), np.float32(0.0), np.float32(1.0), np.float32(1.0), np.float32(1.0), np.float32(0.0)]",-5.0,99411.0,34
2025-08-14_08-18-36,5491,"[np.float32(0.0), np.float32(1.0), np.float32(1.0), np.float32(1.0), np.float32(1.0), np.float32(1.0), np.float32(1.0), np.float32(0.0), np.float32(1.0), np.float32(0.0), np.float32(1.0), np.float32(0.0), np.float32(0.0), np.float32(0.0), np.float32(1.0), np.float32(0.0)]",3.0,99414.0,35
2025-08-14_08-18-36,5492,"[np.float32(0.0), np.float32(0.0), np.float32(0.0), np.float32(0.0), np.float32(0.0), np.float32(1.0), np.float32(0.0), np.float32(1.0), np.float32(0.0), np.float32(1.0), np.float32(1.0), np.float32(1.0), np.float32(0.0), np.float32(0.0), np.float32(0.0), np.float32(0.0)]",-2.0,99412.0,12
2025-08-14_08-18-36,5493,"[np.float32(0.0), np.float32(0.0), np.float32(0.0), np.float32(0.0), np.float32(1.0), np.float32(1.0), np.float32(1.0), np.float32(1.0), np.float32(1.0), np.float32(1.0), np.float32(1.0), np.float32(1.0), np.float32(0.0), np.float32(0.0), np.float32(0.0), np.float32(1.0)]",-1.0,99411.0,36
2025-08-14_08-18-36,5494,"[np.float32(1.0), np.float32(1.0), np.float32(1.0), np.float32(1.0), np.float32(0.0), np.float32(0.0), np.float32(1.0), np.float32(1.0), np.float32(0.0), np.float32(0.0), np.float32(1.0), np.float32(0.0), np.float32(1.0), np.float32(1.0), np.float32(1.0), np.float32(1.0)]",2.0,99413.0,20
2025-08-14_08-18-36,5495,"[np.float32(0.0), np.float32(0.0), np.float32(0.0), np.float32(0.0), np.float32(0.0), np.float32(0.0), np.float32(1.0), np.float32(0.0), np.float32(1.0), np.float32(1.0), np.float32(1.0), np.float32(0.0), np.float32(0.0), np.float32(1.0), np.float32(0.0), np.float32(0.0)]",-2.0,99411.0,0
2025-08-14_08-18-36,5496,"[np.float32(0.0), np.float32(0.0), np.float32(0.0), np.float32(0.0), np.float32(0.0), np.float32(1.0), np.float32(1.0), np.float32(1.0), np.float32(1.0), np.float32(0.0), np.float32(1.0), np.float32(1.0), np.float32(0.0), np.float32(0.0), np.float32(1.0), np.float32(0.0)]",-1.0,99410.0,3
2025-08-14_08-18-36,5497,"[np.float32(1.0), np.float32(0.0), np.float32(0.0), np.float32(0.0), np.float32(0.0), np.float32(0.0), np.float32(0.0), np.float32(0.0), np.float32(1.0), np.float32(0.0), np.float32(0.0), np.float32(1.0), np.float32(1.0), np.float32(0.0), np.float32(0.0), np.float32(0.0)]",-4.0,99406.0,8
2025-08-14_08-18-36,5498,"[np.float32(1.0), np.float32(0.0), np.float32(0.0), np.float32(1.0), np.float32(1.0), np.float32(0.0), np.float32(0.0), np.float32(1.0), np.float32(1.0), np.float32(0.0), np.float32(0.0), np.float32(0.0), np.float32(0.0), np.float32(1.0), np.float32(1.0), np.float32(0.0)]",0.0,99406.0,14
2025-08-14_08-18-36,5499,"[np.float32(1.0), np.float32(1.0), np.float32(1.0), np.float32(0.0), np.float32(0.0), np.float32(1.0), np.float32(0.0), np.float32(0.0), np.float32(0.0), np.float32(0.0), np.float32(0.0), np.float32(0.0), np.float32(1.0), np.float32(1.0), np.float32(1.0), np.float32(1.0)]",-1.0,99405.0,14
2025-08-14_08-18-36,5500,"[np.float32(0.0), np.float32(1.0), np.float32(1.0), np.float32(0.0), np.float32(0.0), np.float32(1.0), np.float32(1.0), np.float32(0.0), np.float32(1.0), np.float32(1.0), np.float32(0.0), np.float32(1.0), np.float32(1.0), np.float32(1.0), np.float32(1.0), np.float32(0.0)]",0.0,99405.0,8
2025-08-14_08-18-36,5501,"[np.float32(0.0), np.float32(0.0), np.float32(1.0), np.float32(0.0), np.float32(1.0), np.float32(1.0), np.float32(1.0), np.float32(0.0), np.float32(1.0), np.float32(1.0), np.float32(0.0), np.float32(1.0), np.float32(1.0), np.float32(1.0), np.float32(0.0), np.float32(1.0)]",-5.0,99400.0,17
2025-08-14_08-18-36,5502,"[np.float32(0.0), np.float32(0.0), np.float32(1.0), np.float32(0.0), np.float32(1.0), np.float32(0.0), np.float32(1.0), np.float32(1.0), np.float32(1.0), np.float32(1.0), np.float32(0.0), np.float32(1.0), np.float32(0.0), np.float32(1.0), np.float32(0.0), np.float32(0.0)]",0.0,99400.0,26
2025-08-14_08-18-36,5503,"[np.float32(1.0), np.float32(0.0), np.float32(0.0), np.float32(0.0), np.float32(1.0), np.float32(0.0), np.float32(1.0), np.float32(1.0), np.float32(0.0), np.float32(0.0), np.float32(0.0), np.float32(0.0), np.float32(1.0), np.float32(1.0), np.float32(0.0), np.float32(0.0)]",2.0,99402.0,21
2025-08-14_08-18-36,5504,"[np.float32(0.0), np.float32(0.0), np.float32(1.0), np.float32(0.0), np.float32(0.0), np.float32(1.0), np.float32(0.0), np.float32(1.0), np.float32(1.0), np.float32(0.0), np.float32(0.0), np.float32(0.0), np.float32(1.0), np.float32(0.0), np.float32(0.0), np.float32(0.0)]",0.0,99402.0,31
2025-08-14_08-18-36,5505,"[np.float32(1.0), np.float32(1.0), np.float32(1.0), np.float32(1.0), np.float32(1.0), np.float32(1.0), np.float32(1.0), np.float32(1.0), np.float32(0.0), np.float32(1.0), np.float32(0.0), np.float32(1.0), np.float32(1.0), np.float32(1.0), np.float32(1.0), np.float32(1.0)]",-2.0,99400.0,17
2025-08-14_08-18-36,5506,"[np.float32(1.0), np.float32(0.0), np.float32(1.0), np.float32(1.0), np.float32(0.0), np.float32(0.0), np.float32(1.0), np.float32(1.0), np.float32(0.0), np.float32(1.0), np.float32(0.0), np.float32(1.0), np.float32(0.0), np.float32(1.0), np.float32(1.0), np.float32(1.0)]",-3.0,99397.0,32
2025-08-14_08-18-36,5507,"[np.float32(0.0), np.float32(1.0), np.float32(0.0), np.float32(1.0), np.float32(0.0), np.float32(1.0), np.float32(1.0), np.float32(1.0), np.float32(0.0), np.float32(1.0), np.float32(0.0), np.float32(0.0), np.float32(0.0), np.float32(0.0), np.float32(0.0), np.float32(0.0)]",1.0,99398.0,11
2025-08-14_08-18-36,5508,"[np.float32(0.0), np.float32(0.0), np.float32(1.0), np.float32(0.0), np.float32(0.0), np.float32(0.0), np.float32(0.0), np.float32(1.0), np.float32(0.0), np.float32(1.0), np.float32(1.0), np.float32(1.0), np.float32(1.0), np.float32(1.0), np.float32(0.0), np.float32(1.0)]",-2.0,99396.0,29
2025-08-14_08-18-36,5509,"[np.float32(0.0), np.float32(1.0), np.float32(0.0), np.float32(0.0), np.float32(1.0), np.float32(1.0), np.float32(1.0), np.float32(0.0), np.float32(0.0), np.float32(1.0), np.float32(0.0), np.float32(1.0), np.float32(1.0), np.float32(0.0), np.float32(1.0), np.float32(0.0)]",2.0,99398.0,13
2025-08-14_08-18-36,5510,"[np.float32(0.0), np.float32(1.0), np.float32(0.0), np.float32(1.0), np.float32(0.0), np.float32(0.0), np.float32(0.0), np.float32(0.0), np.float32(0.0), np.float32(0.0), np.float32(1.0), np.float32(0.0), np.float32(1.0), np.float32(0.0), np.float32(0.0), np.float32(1.0)]",-3.0,99395.0,19
2025-08-14_08-18-36,5511,"[np.float32(0.0), np.float32(0.0), np.float32(0.0), np.float32(0.0), np.float32(0.0), np.float32(1.0), np.float32(0.0), np.float32(1.0), np.float32(1.0), np.float32(1.0), np.float32(1.0), np.float32(1.0), np.float32(0.0), np.float32(0.0), np.float32(1.0), np.float32(0.0)]",-1.0,99394.0,18
2025-08-14_08-18-36,5512,"[np.float32(0.0), np.float32(1.0), np.float32(0.0), np.float32(0.0), np.float32(1.0), np.float32(0.0), np.float32(0.0), np.float32(0.0), np.float32(0.0), np.float32(0.0), np.float32(0.0), np.float32(1.0), np.float32(0.0), np.float32(1.0), np.float32(0.0), np.float32(0.0)]",-1.0,99393.0,19
2025-08-14_08-18-36,5513,"[np.float32(1.0), np.float32(0.0), np.float32(0.0), np.float32(0.0), np.float32(0.0), np.float32(1.0), np.float32(1.0), np.float32(1.0), np.float32(1.0), np.float32(0.0), np.float32(0.0), np.float32(1.0), np.float32(0.0), np.float32(0.0), np.float32(0.0), np.float32(1.0)]",-2.0,99391.0,26
2025-08-14_08-18-36,5514,"[np.float32(1.0), np.float32(1.0), np.float32(1.0), np.float32(1.0), np.float32(0.0), np.float32(1.0), np.float32(1.0), np.float32(1.0), np.float32(1.0), np.float32(1.0), np.float32(0.0), np.float32(0.0), np.float32(1.0), np.float32(1.0), np.float32(1.0), np.float32(0.0)]",3.0,99394.0,25
2025-08-14_08-18-36,5515,"[np.float32(0.0), np.float32(0.0), np.float32(1.0), np.float32(1.0), np.float32(0.0), np.float32(1.0), np.float32(0.0), np.float32(1.0), np.float32(1.0), np.float32(0.0), np.float32(0.0), np.float32(1.0), np.float32(0.0), np.float32(0.0), np.float32(1.0), np.float32(0.0)]",0.0,99394.0,31
2025-08-14_08-18-36,5516,"[np.float32(1.0), np.float32(0.0), np.float32(0.0), np.float32(0.0), np.float32(0.0), np.float32(0.0), np.float32(1.0), np.float32(0.0), np.float32(0.0), np.float32(0.0), np.float32(1.0), np.float32(0.0), np.float32(1.0), np.float32(0.0), np.float32(1.0), np.float32(0.0)]",-5.0,99389.0,0
2025-08-14_08-18-36,5517,"[np.float32(1.0), np.float32(1.0), np.float32(0.0), np.float32(0.0), np.float32(1.0), np.float32(1.0), np.float32(0.0), np.float32(1.0), np.float32(1.0), np.float32(0.0), np.float32(0.0), np.float32(0.0), np.float32(1.0), np.float32(0.0), np.float32(1.0), np.float32(0.0)]",-1.0,99388.0,29
2025-08-14_08-18-36,5518,"[np.float32(0.0), np.float32(1.0), np.float32(1.0), np.float32(1.0), np.float32(0.0), np.float32(0.0), np.float32(1.0), np.float32(0.0), np.float32(1.0), np.float32(1.0), np.float32(0.0), np.float32(0.0), np.float32(0.0), np.float32(1.0), np.float32(1.0), np.float32(0.0)]",3.0,99391.0,25
2025-08-14_08-18-36,5519,"[np.float32(0.0), np.float32(1.0), np.float32(1.0), np.float32(0.0), np.float32(0.0), np.float32(1.0), np.float32(1.0), np.float32(1.0), np.float32(1.0), np.float32(0.0), np.float32(0.0), np.float32(1.0), np.float32(0.0), np.float32(1.0), np.float32(0.0), np.float32(1.0)]",2.0,99393.0,15
2025-08-14_08-18-36,5520,"[np.float32(0.0), np.float32(0.0), np.float32(1.0), np.float32(1.0), np.float32(1.0), np.float32(0.0), np.float32(0.0), np.float32(1.0), np.float32(1.0), np.float32(0.0), np.float32(0.0), np.float32(0.0), np.float32(1.0), np.float32(1.0), np.float32(0.0), np.float32(0.0)]",-2.0,99391.0,20
2025-08-14_08-18-36,5521,"[np.float32(1.0), np.float32(0.0), np.float32(1.0), np.float32(1.0), np.float32(0.0), np.float32(1.0), np.float32(1.0), np.float32(0.0), np.float32(1.0), np.float32(0.0), np.float32(0.0), np.float32(1.0), np.float32(0.0), np.float32(1.0), np.float32(0.0), np.float32(0.0)]",4.0,99395.0,36
2025-08-14_08-18-36,5522,"[np.float32(1.0), np.float32(0.0), np.float32(0.0), np.float32(0.0), np.float32(0.0), np.float32(1.0), np.float32(1.0), np.float32(0.0), np.float32(1.0), np.float32(1.0), np.float32(1.0), np.float32(1.0), np.float32(1.0), np.float32(0.0), np.float32(0.0), np.float32(0.0)]",2.0,99397.0,30
2025-08-14_08-18-36,5523,"[np.float32(0.0), np.float32(0.0), np.float32(0.0), np.float32(0.0), np.float32(1.0), np.float32(1.0), np.float32(1.0), np.float32(1.0), np.float32(1.0), np.float32(1.0), np.float32(1.0), np.float32(0.0), np.float32(1.0), np.float32(1.0), np.float32(1.0), np.float32(0.0)]",-2.0,99395.0,27
2025-08-14_08-18-36,5524,"[np.float32(1.0), np.float32(1.0), np.float32(0.0), np.float32(1.0), np.float32(0.0), np.float32(0.0), np.float32(0.0), np.float32(1.0), np.float32(1.0), np.float32(1.0), np.float32(1.0), np.float32(0.0), np.float32(0.0), np.float32(1.0), np.float32(0.0), np.float32(0.0)]",3.0,99398.0,32
2025-08-14_08-18-36,5525,"[np.float32(1.0), np.float32(0.0), np.float32(1.0), np.float32(0.0), np.float32(0.0), np.float32(1.0), np.float32(0.0), np.float32(1.0), np.float32(0.0), np.float32(1.0), np.float32(1.0), np.float32(0.0), np.float32(1.0), np.float32(1.0), np.float32(1.0), np.float32(1.0)]",-3.0,99395.0,27
2025-08-14_08-18-36,5526,"[np.float32(1.0), np.float32(0.0), np.float32(0.0), np.float32(0.0), np.float32(1.0), np.float32(0.0), np.float32(0.0), np.float32(0.0), np.float32(0.0), np.float32(0.0), np.float32(0.0), np.float32(0.0), np.float32(0.0), np.float32(1.0), np.float32(1.0), np.float32(1.0)]",0.0,99395.0,13
2025-08-14_08-18-36,5527,"[np.float32(1.0), np.float32(1.0), np.float32(1.0), np.float32(0.0), np.float32(0.0), np.float32(0.0), np.float32(1.0), np.float32(1.0), np.float32(1.0), np.float32(0.0), np.float32(1.0), np.float32(0.0), np.float32(1.0), np.float32(0.0), np.float32(0.0), np.float32(1.0)]",1.0,99396.0,6
2025-08-14_08-18-36,5528,"[np.float32(1.0), np.float32(0.0), np.float32(0.0), np.float32(0.0), np.float32(0.0), np.float32(0.0), np.float32(0.0), np.float32(0.0), np.float32(0.0), np.float32(1.0), np.float32(1.0), np.float32(0.0), np.float32(1.0), np.float32(0.0), np.float32(1.0), np.float32(0.0)]",0.0,99396.0,27
2025-08-14_08-18-36,5529,"[np.float32(1.0), np.float32(0.0), np.float32(0.0), np.float32(0.0), np.float32(0.0), np.float32(1.0), np.float32(1.0), np.float32(0.0), np.float32(0.0), np.float32(1.0), np.float32(1.0), np.float32(0.0), np.float32(0.0), np.float32(1.0), np.float32(1.0), np.float32(1.0)]",0.0,99396.0,31
2025-08-14_08-18-36,5530,"[np.float32(1.0), np.float32(0.0), np.float32(0.0), np.float32(0.0), np.float32(1.0), np.float32(1.0), np.float32(1.0), np.float32(0.0), np.float32(0.0), np.float32(1.0), np.float32(1.0), np.float32(0.0), np.float32(0.0), np.float32(1.0), np.float32(1.0), np.float32(0.0)]",3.0,99399.0,8
2025-08-14_08-18-36,5531,"[np.float32(1.0), np.float32(0.0), np.float32(1.0), np.float32(1.0), np.float32(1.0), np.float32(0.0), np.float32(1.0), np.float32(1.0), np.float32(1.0), np.float32(1.0), np.float32(0.0), np.float32(0.0), np.float32(1.0), np.float32(0.0), np.float32(0.0), np.float32(1.0)]",-1.0,99398.0,18
2025-08-14_08-18-36,5532,"[np.float32(1.0), np.float32(0.0), np.float32(0.0), np.float32(0.0), np.float32(1.0), np.float32(0.0), np.float32(1.0), np.float32(1.0), np.float32(1.0), np.float32(1.0), np.float32(0.0), np.float32(0.0), np.float32(0.0), np.float32(1.0), np.float32(1.0), np.float32(0.0)]",-2.0,99396.0,35
2025-08-14_08-18-36,5533,"[np.float32(1.0), np.float32(1.0), np.float32(0.0), np.float32(0.0), np.float32(1.0), np.float32(1.0), np.float32(0.0), np.float32(1.0), np.float32(0.0), np.float32(1.0), np.float32(1.0), np.float32(1.0), np.float32(0.0), np.float32(0.0), np.float32(0.0), np.float32(0.0)]",-1.0,99395.0,29
2025-08-14_08-18-36,5534,"[np.float32(0.0), np.float32(1.0), np.float32(1.0), np.float32(1.0), np.float32(0.0), np.float32(1.0), np.float32(1.0), np.float32(1.0), np.float32(0.0), np.float32(0.0), np.float32(0.0), np.float32(1.0), np.float32(0.0), np.float32(1.0), np.float32(1.0), np.float32(0.0)]",-1.0,99394.0,7
2025-08-14_08-18-36,5535,"[np.float32(1.0), np.float32(0.0), np.float32(0.0), np.float32(0.0), np.float32(1.0), np.float32(0.0), np.float32(0.0), np.float32(1.0), np.float32(1.0), np.float32(1.0), np.float32(0.0), np.float32(1.0), np.float32(1.0), np.float32(1.0), np.float32(1.0), np.float32(1.0)]",-1.0,99393.0,28
2025-08-14_08-18-36,5536,"[np.float32(1.0), np.float32(0.0), np.float32(0.0), np.float32(0.0), np.float32(1.0), np.float32(0.0), np.float32(1.0), np.float32(1.0), np.float32(1.0), np.float32(0.0), np.float32(1.0), np.float32(1.0), np.float32(0.0), np.float32(0.0), np.float32(0.0), np.float32(1.0)]",0.0,99393.0,23
2025-08-14_08-18-36,5537,"[np.float32(1.0), np.float32(0.0), np.float32(1.0), np.float32(0.0), np.float32(0.0), np.float32(1.0), np.float32(1.0), np.float32(1.0), np.float32(1.0), np.float32(1.0), np.float32(1.0), np.float32(1.0), np.float32(1.0), np.float32(0.0), np.float32(1.0), np.float32(1.0)]",1.0,99394.0,16
2025-08-14_08-18-36,5538,"[np.float32(0.0), np.float32(1.0), np.float32(0.0), np.float32(1.0), np.float32(0.0), np.float32(0.0), np.float32(0.0), np.float32(1.0), np.float32(1.0), np.float32(0.0), np.float32(0.0), np.float32(0.0), np.float32(1.0), np.float32(0.0), np.float32(1.0), np.float32(0.0)]",1.0,99395.0,31
2025-08-14_08-18-36,5539,"[np.float32(1.0), np.float32(1.0), np.float32(0.0), np.float32(0.0), np.float32(0.0), np.float32(0.0), np.float32(1.0), np.float32(0.0), np.float32(0.0), np.float32(0.0), np.float32(0.0), np.float32(0.0), np.float32(0.0), np.float32(0.0), np.float32(0.0), np.float32(1.0)]",1.0,99396.0,31
2025-08-14_08-18-36,5540,"[np.float32(1.0), np.float32(0.0), np.float32(1.0), np.float32(1.0), np.float32(1.0), np.float32(1.0), np.float32(1.0), np.float32(0.0), np.float32(0.0), np.float32(0.0), np.float32(0.0), np.float32(0.0), np.float32(1.0), np.float32(1.0), np.float32(1.0), np.float32(1.0)]",-3.0,99393.0,24
2025-08-14_08-18-36,5541,"[np.float32(1.0), np.float32(0.0), np.float32(1.0), np.float32(0.0), np.float32(1.0), np.float32(1.0), np.float32(1.0), np.float32(0.0), np.float32(0.0), np.float32(0.0), np.float32(0.0), np.float32(0.0), np.float32(1.0), np.float32(1.0), np.float32(1.0), np.float32(0.0)]",-3.0,99390.0,35
2025-08-14_08-18-36,5542,"[np.float32(1.0), np.float32(0.0), np.float32(1.0), np.float32(0.0), np.float32(0.0), np.float32(0.0), np.float32(1.0), np.float32(1.0), np.float32(1.0), np.float32(0.0), np.float32(1.0), np.float32(0.0), np.float32(1.0), np.float32(1.0), np.float32(0.0), np.float32(0.0)]",0.0,99390.0,23
2025-08-14_08-18-36,5543,"[np.float32(1.0), np.float32(1.0), np.float32(1.0), np.float32(0.0), np.float32(0.0), np.float32(1.0), np.float32(1.0), np.float32(0.0), np.float32(1.0), np.float32(0.0), np.float32(0.0), np.float32(1.0), np.float32(0.0), np.float32(0.0), np.float32(0.0), np.float32(0.0)]",-1.0,99389.0,0
2025-08-14_08-18-36,5544,"[np.float32(0.0), np.float32(1.0), np.float32(1.0), np.float32(0.0), np.float32(0.0), np.float32(0.0), np.float32(0.0), np.float32(0.0), np.float32(0.0), np.float32(1.0), np.float32(1.0), np.float32(1.0), np.float32(0.0), np.float32(0.0), np.float32(1.0), np.float32(0.0)]",0.0,99389.0,5
2025-08-14_08-18-36,5545,"[np.float32(0.0), np.float32(0.0), np.float32(0.0), np.float32(0.0), np.float32(0.0), np.float32(0.0), np.float32(1.0), np.float32(1.0), np.float32(1.0), np.float32(1.0), np.float32(1.0), np.float32(1.0), np.float32(1.0), np.float32(0.0), np.float32(1.0), np.float32(1.0)]",0.0,99389.0,8
2025-08-14_08-18-36,5546,"[np.float32(0.0), np.float32(0.0), np.float32(0.0), np.float32(0.0), np.float32(0.0), np.float32(0.0), np.float32(1.0), np.float32(0.0), np.float32(1.0), np.float32(1.0), np.float32(0.0), np.float32(0.0), np.float32(1.0), np.float32(0.0), np.float32(1.0), np.float32(1.0)]",-3.0,99386.0,20
2025-08-14_08-18-36,5547,"[np.float32(1.0), np.float32(0.0), np.float32(0.0), np.float32(0.0), np.float32(0.0), np.float32(1.0), np.float32(1.0), np.float32(1.0), np.float32(1.0), np.float32(1.0), np.float32(0.0), np.float32(1.0), np.float32(0.0), np.float32(1.0), np.float32(0.0), np.float32(0.0)]",2.0,99388.0,27
2025-08-14_08-18-36,5548,"[np.float32(1.0), np.float32(0.0), np.float32(1.0), np.float32(1.0), np.float32(0.0), np.float32(1.0), np.float32(1.0), np.float32(1.0), np.float32(1.0), np.float32(0.0), np.float32(1.0), np.float32(0.0), np.float32(0.0), np.float32(0.0), np.float32(1.0), np.float32(0.0)]",-2.0,99386.0,12
2025-08-14_08-18-36,5549,"[np.float32(0.0), np.float32(0.0), np.float32(0.0), np.float32(0.0), np.float32(0.0), np.float32(1.0), np.float32(0.0), np.float32(0.0), np.float32(1.0), np.float32(0.0), np.float32(0.0), np.float32(1.0), np.float32(1.0), np.float32(0.0), np.float32(1.0), np.float32(0.0)]",6.0,99392.0,27
2025-08-14_08-18-36,5550,"[np.float32(1.0), np.float32(0.0), np.float32(0.0), np.float32(0.0), np.float32(0.0), np.float32(1.0), np.float32(1.0), np.float32(1.0), np.float32(1.0), np.float32(0.0), np.float32(1.0), np.float32(0.0), np.float32(1.0), np.float32(1.0), np.float32(0.0), np.float32(1.0)]",-6.0,99386.0,10
2025-08-14_08-18-36,5551,"[np.float32(0.0), np.float32(0.0), np.float32(1.0), np.float32(1.0), np.float32(0.0), np.float32(1.0), np.float32(0.0), np.float32(0.0), np.float32(0.0), np.float32(0.0), np.float32(0.0), np.float32(0.0), np.float32(0.0), np.float32(0.0), np.float32(1.0), np.float32(1.0)]",0.0,99386.0,10
2025-08-14_08-18-36,5552,"[np.float32(1.0), np.float32(0.0), np.float32(0.0), np.float32(0.0), np.float32(1.0), np.float32(0.0), np.float32(1.0), np.float32(1.0), np.float32(0.0), np.float32(0.0), np.float32(0.0), np.float32(1.0), np.float32(0.0), np.float32(0.0), np.float32(0.0), np.float32(0.0)]",-2.0,99384.0,22
2025-08-14_08-18-36,5553,"[np.float32(1.0), np.float32(1.0), np.float32(1.0), np.float32(1.0), np.float32(1.0), np.float32(0.0), np.float32(0.0), np.float32(0.0), np.float32(0.0), np.float32(0.0), np.float32(0.0), np.float32(1.0), np.float32(1.0), np.float32(1.0), np.float32(1.0), np.float32(1.0)]",2.0,99386.0,3
2025-08-14_08-18-36,5554,"[np.float32(1.0), np.float32(0.0), np.float32(0.0), np.float32(0.0), np.float32(1.0), np.float32(1.0), np.float32(1.0), np.float32(1.0), np.float32(1.0), np.float32(1.0), np.float32(1.0), np.float32(0.0), np.float32(1.0), np.float32(0.0), np.float32(1.0), np.float32(1.0)]",-3.0,99383.0,26
2025-08-14_08-18-36,5555,"[np.float32(0.0), np.float32(1.0), np.float32(1.0), np.float32(1.0), np.float32(0.0), np.float32(1.0), np.float32(1.0), np.float32(0.0), np.float32(0.0), np.float32(0.0), np.float32(1.0), np.float32(0.0), np.float32(0.0), np.float32(1.0), np.float32(0.0), np.float32(0.0)]",-2.0,99381.0,18
2025-08-14_08-18-36,5556,"[np.float32(0.0), np.float32(0.0), np.float32(0.0), np.float32(0.0), np.float32(1.0), np.float32(0.0), np.float32(0.0), np.float32(0.0), np.float32(1.0), np.float32(1.0), np.float32(1.0), np.float32(0.0), np.float32(0.0), np.float32(0.0), np.float32(1.0), np.float32(0.0)]",3.0,99384.0,13
2025-08-14_08-18-36,5557,"[np.float32(1.0), np.float32(1.0), np.float32(0.0), np.float32(0.0), np.float32(0.0), np.float32(1.0), np.float32(0.0), np.float32(0.0), np.float32(0.0), np.float32(0.0), np.float32(1.0), np.float32(0.0), np.float32(0.0), np.float32(0.0), np.float32(0.0), np.float32(1.0)]",0.0,99384.0,1
2025-08-14_08-18-36,5558,"[np.float32(1.0), np.float32(1.0), np.float32(1.0), np.float32(1.0), np.float32(1.0), np.float32(1.0), np.float32(1.0), np.float32(1.0), np.float32(1.0), np.float32(0.0), np.float32(0.0), np.float32(1.0), np.float32(0.0), np.float32(1.0), np.float32(0.0), np.float32(1.0)]",0.0,99384.0,22
2025-08-14_08-18-36,5559,"[np.float32(1.0), np.float32(1.0), np.float32(0.0), np.float32(0.0), np.float32(0.0), np.float32(1.0), np.float32(1.0), np.float32(0.0), np.float32(0.0), np.float32(1.0), np.float32(1.0), np.float32(1.0), np.float32(0.0), np.float32(1.0), np.float32(1.0), np.float32(0.0)]",2.0,99386.0,5
2025-08-14_08-18-36,5560,"[np.float32(0.0), np.float32(1.0), np.float32(0.0), np.float32(0.0), np.float32(0.0), np.float32(1.0), np.float32(0.0), np.float32(1.0), np.float32(0.0), np.float32(1.0), np.float32(1.0), np.float32(1.0), np.float32(0.0), np.float32(0.0), np.float32(1.0), np.float32(0.0)]",-2.0,99384.0,6
2025-08-14_08-18-36,5561,"[np.float32(1.0), np.float32(0.0), np.float32(1.0), np.float32(0.0), np.float32(1.0), np.float32(1.0), np.float32(0.0), np.float32(1.0), np.float32(0.0), np.float32(1.0), np.float32(0.0), np.float32(0.0), np.float32(0.0), np.float32(0.0), np.float32(1.0), np.float32(0.0)]",8.0,99392.0,16
2025-08-14_08-18-36,5562,"[np.float32(0.0), np.float32(0.0), np.float32(0.0), np.float32(0.0), np.float32(0.0), np.float32(0.0), np.float32(0.0), np.float32(1.0), np.float32(1.0), np.float32(1.0), np.float32(1.0), np.float32(0.0), np.float32(0.0), np.float32(1.0), np.float32(1.0), np.float32(0.0)]",0.0,99392.0,7
2025-08-14_08-18-36,5563,"[np.float32(0.0), np.float32(1.0), np.float32(1.0), np.float32(0.0), np.float32(0.0), np.float32(1.0), np.float32(0.0), np.float32(1.0), np.float32(1.0), np.float32(0.0), np.float32(1.0), np.float32(1.0), np.float32(0.0), np.float32(0.0), np.float32(1.0), np.float32(0.0)]",-8.0,99384.0,7
2025-08-14_08-18-36,5564,"[np.float32(0.0), np.float32(1.0), np.float32(1.0), np.float32(1.0), np.float32(0.0), np.float32(0.0), np.float32(0.0), np.float32(1.0), np.float32(1.0), np.float32(1.0), np.float32(1.0), np.float32(1.0), np.float32(1.0), np.float32(1.0), np.float32(0.0), np.float32(1.0)]",0.0,99384.0,19
2025-08-14_08-18-36,5565,"[np.float32(0.0), np.float32(0.0), np.float32(0.0), np.float32(0.0), np.float32(1.0), np.float32(1.0), np.float32(1.0), np.float32(1.0), np.float32(0.0), np.float32(0.0), np.float32(0.0), np.float32(0.0), np.float32(0.0), np.float32(0.0), np.float32(1.0), np.float32(1.0)]",-4.0,99380.0,28
2025-08-14_08-18-36,5566,"[np.float32(0.0), np.float32(0.0), np.float32(1.0), np.float32(1.0), np.float32(0.0), np.float32(1.0), np.float32(0.0), np.float32(0.0), np.float32(1.0), np.float32(1.0), np.float32(0.0), np.float32(1.0), np.float32(1.0), np.float32(1.0), np.float32(1.0), np.float32(0.0)]",-4.0,99376.0,1
2025-08-14_08-18-36,5567,"[np.float32(1.0), np.float32(1.0), np.float32(1.0), np.float32(0.0), np.float32(1.0), np.float32(1.0), np.float32(0.0), np.float32(0.0), np.float32(1.0), np.float32(0.0), np.float32(1.0), np.float32(0.0), np.float32(1.0), np.float32(0.0), np.float32(0.0), np.float32(0.0)]",-2.0,99374.0,12
2025-08-14_08-18-36,5568,"[np.float32(1.0), np.float32(0.0), np.float32(0.0), np.float32(1.0), np.float32(1.0), np.float32(1.0), np.float32(1.0), np.float32(0.0), np.float32(1.0), np.float32(1.0), np.float32(0.0), np.float32(0.0), np.float32(0.0), np.float32(1.0), np.float32(0.0), np.float32(1.0)]",-1.0,99373.0,10
2025-08-14_08-18-36,5569,"[np.float32(0.0), np.float32(0.0), np.float32(0.0), np.float32(0.0), np.float32(0.0), np.float32(0.0), np.float32(0.0), np.float32(0.0), np.float32(1.0), np.float32(1.0), np.float32(1.0), np.float32(0.0), np.float32(1.0), np.float32(0.0), np.float32(0.0), np.float32(0.0)]",-1.0,99372.0,11
2025-08-14_08-18-36,5570,"[np.float32(1.0), np.float32(1.0), np.float32(0.0), np.float32(1.0), np.float32(0.0), np.float32(0.0), np.float32(0.0), np.float32(1.0), np.float32(1.0), np.float32(0.0), np.float32(1.0), np.float32(1.0), np.float32(1.0), np.float32(1.0), np.float32(0.0), np.float32(0.0)]",-1.0,99371.0,2
2025-08-14_08-18-36,5571,"[np.float32(0.0), np.float32(0.0), np.float32(1.0), np.float32(1.0), np.float32(0.0), np.float32(0.0), np.float32(1.0), np.float32(1.0), np.float32(1.0), np.float32(1.0), np.float32(0.0), np.float32(0.0), np.float32(1.0), np.float32(1.0), np.float32(1.0), np.float32(0.0)]",2.0,99373.0,13
2025-08-14_08-18-36,5572,"[np.float32(0.0), np.float32(0.0), np.float32(0.0), np.float32(1.0), np.float32(1.0), np.float32(0.0), np.float32(0.0), np.float32(1.0), np.float32(0.0), np.float32(0.0), np.float32(1.0), np.float32(0.0), np.float32(0.0), np.float32(0.0), np.float32(0.0), np.float32(0.0)]",3.0,99376.0,5
2025-08-14_08-18-36,5573,"[np.float32(1.0), np.float32(0.0), np.float32(0.0), np.float32(1.0), np.float32(1.0), np.float32(0.0), np.float32(0.0), np.float32(1.0), np.float32(1.0), np.float32(1.0), np.float32(0.0), np.float32(0.0), np.float32(1.0), np.float32(0.0), np.float32(1.0), np.float32(0.0)]",-1.0,99375.0,17
2025-08-14_08-18-36,5574,"[np.float32(1.0), np.float32(1.0), np.float32(0.0), np.float32(0.0), np.float32(0.0), np.float32(1.0), np.float32(0.0), np.float32(0.0), np.float32(1.0), np.float32(1.0), np.float32(1.0), np.float32(1.0), np.float32(1.0), np.float32(1.0), np.float32(0.0), np.float32(1.0)]",-3.0,99372.0,0
2025-08-14_08-18-36,5575,"[np.float32(0.0), np.float32(1.0), np.float32(1.0), np.float32(0.0), np.float32(1.0), np.float32(1.0), np.float32(0.0), np.float32(0.0), np.float32(1.0), np.float32(0.0), np.float32(0.0), np.float32(1.0), np.float32(0.0), np.float32(0.0), np.float32(0.0), np.float32(0.0)]",-4.0,99368.0,1
2025-08-14_08-18-36,5576,"[np.float32(1.0), np.float32(1.0), np.float32(1.0), np.float32(1.0), np.float32(0.0), np.float32(1.0), np.float32(0.0), np.float32(1.0), np.float32(1.0), np.float32(0.0), np.float32(1.0), np.float32(0.0), np.float32(0.0), np.float32(1.0), np.float32(0.0), np.float32(1.0)]",-3.0,99365.0,7
2025-08-14_08-18-36,5577,"[np.float32(1.0), np.float32(1.0), np.float32(0.0), np.float32(1.0), np.float32(0.0), np.float32(0.0), np.float32(0.0), np.float32(1.0), np.float32(1.0), np.float32(0.0), np.float32(0.0), np.float32(1.0), np.float32(1.0), np.float32(0.0), np.float32(1.0), np.float32(0.0)]",0.0,99365.0,18
2025-08-14_08-18-36,5578,"[np.float32(1.0), np.float32(0.0), np.float32(1.0), np.float32(1.0), np.float32(0.0), np.float32(1.0), np.float32(0.0), np.float32(0.0), np.float32(1.0), np.float32(0.0), np.float32(0.0), np.float32(1.0), np.float32(1.0), np.float32(0.0), np.float32(1.0), np.float32(0.0)]",7.0,99372.0,30
2025-08-14_08-18-36,5579,"[np.float32(1.0), np.float32(0.0), np.float32(0.0), np.float32(1.0), np.float32(0.0), np.float32(1.0), np.float32(0.0), np.float32(1.0), np.float32(0.0), np.float32(1.0), np.float32(0.0), np.float32(0.0), np.float32(0.0), np.float32(1.0), np.float32(0.0), np.float32(1.0)]",-4.0,99368.0,6
2025-08-14_08-18-36,5580,"[np.float32(0.0), np.float32(0.0), np.float32(0.0), np.float32(0.0), np.float32(1.0), np.float32(0.0), np.float32(1.0), np.float32(1.0), np.float32(1.0), np.float32(1.0), np.float32(0.0), np.float32(1.0), np.float32(0.0), np.float32(1.0), np.float32(0.0), np.float32(1.0)]",-2.0,99366.0,26
2025-08-14_08-18-36,5581,"[np.float32(1.0), np.float32(1.0), np.float32(1.0), np.float32(0.0), np.float32(0.0), np.float32(1.0), np.float32(1.0), np.float32(0.0), np.float32(1.0), np.float32(0.0), np.float32(1.0), np.float32(0.0), np.float32(1.0), np.float32(1.0), np.float32(1.0), np.float32(0.0)]",2.0,99368.0,36
2025-08-14_08-18-36,5582,"[np.float32(0.0), np.float32(0.0), np.float32(1.0), np.float32(1.0), np.float32(1.0), np.float32(1.0), np.float32(1.0), np.float32(0.0), np.float32(0.0), np.float32(1.0), np.float32(1.0), np.float32(0.0), np.float32(0.0), np.float32(1.0), np.float32(1.0), np.float32(0.0)]",-2.0,99366.0,18
2025-08-14_08-18-36,5583,"[np.float32(0.0), np.float32(0.0), np.float32(0.0), np.float32(0.0), np.float32(0.0), np.float32(1.0), np.float32(1.0), np.float32(1.0), np.float32(0.0), np.float32(0.0), np.float32(0.0), np.float32(0.0), np.float32(0.0), np.float32(1.0), np.float32(1.0), np.float32(0.0)]",3.0,99369.0,22
2025-08-14_08-18-36,5584,"[np.float32(0.0), np.float32(0.0), np.float32(0.0), np.float32(1.0), np.float32(1.0), np.float32(0.0), np.float32(1.0), np.float32(0.0), np.float32(1.0), np.float32(1.0), np.float32(0.0), np.float32(1.0), np.float32(1.0), np.float32(0.0), np.float32(1.0), np.float32(0.0)]",-5.0,99364.0,32
2025-08-14_08-18-36,5585,"[np.float32(1.0), np.float32(1.0), np.float32(0.0), np.float32(0.0), np.float32(1.0), np.float32(0.0), np.float32(0.0), np.float32(1.0), np.float32(1.0), np.float32(0.0), np.float32(1.0), np.float32(1.0), np.float32(1.0), np.float32(0.0), np.float32(1.0), np.float32(0.0)]",-4.0,99360.0,31
2025-08-14_08-18-36,5586,"[np.float32(0.0), np.float32(0.0), np.float32(0.0), np.float32(1.0), np.float32(0.0), np.float32(1.0), np.float32(1.0), np.float32(1.0), np.float32(0.0), np.float32(0.0), np.float32(1.0), np.float32(0.0), np.float32(0.0), np.float32(0.0), np.float32(1.0), np.float32(1.0)]",0.0,99360.0,33
2025-08-14_08-18-36,5587,"[np.float32(1.0), np.float32(0.0), np.float32(0.0), np.float32(0.0), np.float32(0.0), np.float32(1.0), np.float32(0.0), np.float32(0.0), np.float32(1.0), np.float32(1.0), np.float32(1.0), np.float32(0.0), np.float32(1.0), np.float32(1.0), np.float32(0.0), np.float32(0.0)]",-4.0,99356.0,13
2025-08-14_08-18-36,5588,"[np.float32(1.0), np.float32(1.0), np.float32(1.0), np.float32(0.0), np.float32(1.0), np.float32(1.0), np.float32(1.0), np.float32(1.0), np.float32(0.0), np.float32(1.0), np.float32(1.0), np.float32(1.0), np.float32(0.0), np.float32(0.0), np.float32(0.0), np.float32(1.0)]",1.0,99357.0,10
2025-08-14_08-18-36,5589,"[np.float32(0.0), np.float32(1.0), np.float32(0.0), np.float32(1.0), np.float32(0.0), np.float32(1.0), np.float32(0.0), np.float32(1.0), np.float32(0.0), np.float32(0.0), np.float32(1.0), np.float32(0.0), np.float32(0.0), np.float32(0.0), np.float32(1.0), np.float32(0.0)]",-1.0,99356.0,2
2025-08-14_08-18-36,5590,"[np.float32(1.0), np.float32(1.0), np.float32(1.0), np.float32(0.0), np.float32(0.0), np.float32(0.0), np.float32(1.0), np.float32(1.0), np.float32(1.0), np.float32(0.0), np.float32(1.0), np.float32(0.0), np.float32(1.0), np.float32(0.0), np.float32(1.0), np.float32(0.0)]",1.0,99357.0,30
2025-08-14_08-18-36,5591,"[np.float32(0.0), np.float32(0.0), np.float32(1.0), np.float32(0.0), np.float32(1.0), np.float32(0.0), np.float32(1.0), np.float32(1.0), np.float32(1.0), np.float32(0.0), np.float32(0.0), np.float32(1.0), np.float32(0.0), np.float32(1.0), np.float32(0.0), np.float32(0.0)]",-2.0,99355.0,0
2025-08-14_08-18-36,5592,"[np.float32(0.0), np.float32(1.0), np.float32(1.0), np.float32(0.0), np.float32(1.0), np.float32(1.0), np.float32(0.0), np.float32(0.0), np.float32(0.0), np.float32(1.0), np.float32(0.0), np.float32(1.0), np.float32(0.0), np.float32(1.0), np.float32(1.0), np.float32(0.0)]",-4.0,99351.0,17
2025-08-14_08-18-36,5593,"[np.float32(0.0), np.float32(1.0), np.float32(0.0), np.float32(1.0), np.float32(0.0), np.float32(1.0), np.float32(1.0), np.float32(1.0), np.float32(1.0), np.float32(0.0), np.float32(1.0), np.float32(0.0), np.float32(0.0), np.float32(1.0), np.float32(0.0), np.float32(0.0)]",-1.0,99350.0,13
2025-08-14_08-18-36,5594,"[np.float32(1.0), np.float32(1.0), np.float32(0.0), np.float32(0.0), np.float32(0.0), np.float32(1.0), np.float32(1.0), np.float32(1.0), np.float32(0.0), np.float32(0.0), np.float32(0.0), np.float32(1.0), np.float32(0.0), np.float32(1.0), np.float32(0.0), np.float32(1.0)]",-3.0,99347.0,16
2025-08-14_08-18-36,5595,"[np.float32(0.0), np.float32(1.0), np.float32(1.0), np.float32(0.0), np.float32(0.0), np.float32(0.0), np.float32(1.0), np.float32(1.0), np.float32(0.0), np.float32(1.0), np.float32(0.0), np.float32(0.0), np.float32(1.0), np.float32(1.0), np.float32(1.0), np.float32(0.0)]",-3.0,99344.0,14
2025-08-14_08-18-36,5596,"[np.float32(1.0), np.float32(0.0), np.float32(1.0), np.float32(1.0), np.float32(1.0), np.float32(1.0), np.float32(0.0), np.float32(1.0), np.float32(1.0), np.float32(1.0), np.float32(1.0), np.float32(1.0), np.float32(0.0), np.float32(1.0), np.float32(1.0), np.float32(0.0)]",1.0,99345.0,33
2025-08-14_08-18-36,5597,"[np.float32(1.0), np.float32(0.0), np.float32(1.0), np.float32(0.0), np.float32(0.0), np.float32(0.0), np.float32(1.0), np.float32(0.0), np.float32(0.0), np.float32(0.0), np.float32(0.0), np.float32(0.0), np.float32(1.0), np.float32(0.0), np.float32(1.0), np.float32(1.0)]",2.0,99347.0,10
2025-08-14_08-18-36,5598,"[np.float32(0.0), np.float32(1.0), np.float32(1.0), np.float32(1.0), np.float32(1.0), np.float32(0.0), np.float32(1.0), np.float32(1.0), np.float32(0.0), np.float32(1.0), np.float32(0.0), np.float32(1.0), np.float32(0.0), np.float32(0.0), np.float32(0.0), np.float32(0.0)]",1.0,99348.0,17
2025-08-14_08-18-36,5599,"[np.float32(1.0), np.float32(0.0), np.float32(1.0), np.float32(1.0), np.float32(1.0), np.float32(0.0), np.float32(0.0), np.float32(1.0), np.float32(1.0), np.float32(0.0), np.float32(0.0), np.float32(0.0), np.float32(1.0), np.float32(0.0), np.float32(1.0), np.float32(0.0)]",-1.0,99347.0,32
2025-08-14_08-18-36,5600,"[np.float32(0.0), np.float32(1.0), np.float32(1.0), np.float32(1.0), np.float32(1.0), np.float32(1.0), np.float32(1.0), np.float32(1.0), np.float32(1.0), np.float32(1.0), np.float32(1.0), np.float32(1.0), np.float32(1.0), np.float32(0.0), np.float32(1.0), np.float32(1.0)]",1.0,99348.0,17
2025-08-14_08-18-36,5601,"[np.float32(0.0), np.float32(1.0), np.float32(0.0), np.float32(0.0), np.float32(1.0), np.float32(0.0), np.float32(0.0), np.float32(1.0), np.float32(1.0), np.float32(1.0), np.float32(0.0), np.float32(1.0), np.float32(1.0), np.float32(0.0), np.float32(0.0), np.float32(1.0)]",-2.0,99346.0,25
2025-08-14_08-18-36,5602,"[np.float32(0.0), np.float32(1.0), np.float32(0.0), np.float32(1.0), np.float32(0.0), np.float32(0.0), np.float32(1.0), np.float32(1.0), np.float32(1.0), np.float32(1.0), np.float32(0.0), np.float32(0.0), np.float32(0.0), np.float32(0.0), np.float32(0.0), np.float32(0.0)]",2.0,99348.0,19
2025-08-14_08-18-36,5603,"[np.float32(1.0), np.float32(0.0), np.float32(1.0), np.float32(1.0), np.float32(0.0), np.float32(1.0), np.float32(0.0), np.float32(1.0), np.float32(0.0), np.float32(1.0), np.float32(1.0), np.float32(1.0), np.float32(1.0), np.float32(1.0), np.float32(1.0), np.float32(0.0)]",-4.0,99344.0,1
2025-08-14_08-18-36,5604,"[np.float32(0.0), np.float32(0.0), np.float32(0.0), np.float32(0.0), np.float32(0.0), np.float32(1.0), np.float32(1.0), np.float32(1.0), np.float32(0.0), np.float32(1.0), np.float32(1.0), np.float32(0.0), np.float32(1.0), np.float32(0.0), np.float32(0.0), np.float32(1.0)]",-2.0,99342.0,24
2025-08-14_08-18-36,5605,"[np.float32(0.0), np.float32(0.0), np.float32(1.0), np.float32(0.0), np.float32(0.0), np.float32(0.0), np.float32(1.0), np.float32(1.0), np.float32(1.0), np.float32(1.0), np.float32(1.0), np.float32(0.0), np.float32(1.0), np.float32(1.0), np.float32(0.0), np.float32(0.0)]",3.0,99345.0,26
2025-08-14_08-18-36,5606,"[np.float32(0.0), np.float32(0.0), np.float32(0.0), np.float32(1.0), np.float32(1.0), np.float32(0.0), np.float32(0.0), np.float32(1.0), np.float32(0.0), np.float32(0.0), np.float32(1.0), np.float32(1.0), np.float32(0.0), np.float32(0.0), np.float32(0.0), np.float32(1.0)]",1.0,99346.0,13
2025-08-14_08-18-36,5607,"[np.float32(0.0), np.float32(0.0), np.float32(0.0), np.float32(1.0), np.float32(1.0), np.float32(1.0), np.float32(0.0), np.float32(1.0), np.float32(1.0), np.float32(0.0), np.float32(0.0), np.float32(0.0), np.float32(1.0), np.float32(0.0), np.float32(0.0), np.float32(1.0)]",1.0,99347.0,20
2025-08-14_08-18-36,5608,"[np.float32(1.0), np.float32(0.0), np.float32(0.0), np.float32(1.0), np.float32(0.0), np.float32(0.0), np.float32(0.0), np.float32(1.0), np.float32(1.0), np.float32(0.0), np.float32(1.0), np.float32(0.0), np.float32(1.0), np.float32(0.0), np.float32(0.0), np.float32(0.0)]",34.0,99381.0,7
2025-08-14_08-18-36,5609,"[np.float32(0.0), np.float32(1.0), np.float32(0.0), np.float32(1.0), np.float32(0.0), np.float32(1.0), np.float32(0.0), np.float32(1.0), np.float32(0.0), np.float32(1.0), np.float32(1.0), np.float32(0.0), np.float32(0.0), np.float32(1.0), np.float32(0.0), np.float32(0.0)]",3.0,99384.0,23
2025-08-14_08-18-36,5610,"[np.float32(1.0), np.float32(1.0), np.float32(0.0), np.float32(0.0), np.float32(1.0), np.float32(1.0), np.float32(0.0), np.float32(1.0), np.float32(1.0), np.float32(1.0), np.float32(0.0), np.float32(0.0), np.float32(1.0), np.float32(1.0), np.float32(1.0), np.float32(0.0)]",3.0,99387.0,25
2025-08-14_08-18-36,5611,"[np.float32(0.0), np.float32(0.0), np.float32(0.0), np.float32(1.0), np.float32(0.0), np.float32(1.0), np.float32(1.0), np.float32(1.0), np.float32(1.0), np.float32(0.0), np.float32(0.0), np.float32(0.0), np.float32(1.0), np.float32(1.0), np.float32(1.0), np.float32(0.0)]",0.0,99387.0,22
2025-08-14_08-18-36,5612,"[np.float32(1.0), np.float32(0.0), np.float32(0.0), np.float32(0.0), np.float32(0.0), np.float32(1.0), np.float32(1.0), np.float32(0.0), np.float32(1.0), np.float32(1.0), np.float32(0.0), np.float32(1.0), np.float32(1.0), np.float32(1.0), np.float32(0.0), np.float32(1.0)]",2.0,99389.0,9
2025-08-14_08-18-36,5613,"[np.float32(1.0), np.float32(1.0), np.float32(1.0), np.float32(1.0), np.float32(1.0), np.float32(1.0), np.float32(1.0), np.float32(1.0), np.float32(0.0), np.float32(1.0), np.float32(1.0), np.float32(1.0), np.float32(1.0), np.float32(1.0), np.float32(0.0), np.float32(0.0)]",2.0,99391.0,18
2025-08-14_08-18-36,5614,"[np.float32(0.0), np.float32(0.0), np.float32(0.0), np.float32(0.0), np.float32(0.0), np.float32(1.0), np.float32(1.0), np.float32(0.0), np.float32(1.0), np.float32(0.0), np.float32(0.0), np.float32(1.0), np.float32(0.0), np.float32(0.0), np.float32(1.0), np.float32(0.0)]",-2.0,99389.0,2
2025-08-14_08-18-36,5615,"[np.float32(0.0), np.float32(1.0), np.float32(0.0), np.float32(0.0), np.float32(0.0), np.float32(1.0), np.float32(1.0), np.float32(1.0), np.float32(0.0), np.float32(1.0), np.float32(0.0), np.float32(1.0), np.float32(1.0), np.float32(0.0), np.float32(1.0), np.float32(0.0)]",0.0,99389.0,15
2025-08-14_08-18-36,5616,"[np.float32(1.0), np.float32(1.0), np.float32(1.0), np.float32(0.0), np.float32(1.0), np.float32(0.0), np.float32(0.0), np.float32(1.0), np.float32(0.0), np.float32(0.0), np.float32(1.0), np.float32(1.0), np.float32(1.0), np.float32(1.0), np.float32(0.0), np.float32(1.0)]",-3.0,99386.0,5
2025-08-14_08-18-36,5617,"[np.float32(0.0), np.float32(1.0), np.float32(1.0), np.float32(0.0), np.float32(0.0), np.float32(1.0), np.float32(1.0), np.float32(1.0), np.float32(1.0), np.float32(0.0), np.float32(1.0), np.float32(0.0), np.float32(0.0), np.float32(0.0), np.float32(0.0), np.float32(1.0)]",1.0,99387.0,28
2025-08-14_08-18-36,5618,"[np.float32(1.0), np.float32(1.0), np.float32(1.0), np.float32(0.0), np.float32(1.0), np.float32(0.0), np.float32(0.0), np.float32(0.0), np.float32(1.0), np.float32(0.0), np.float32(0.0), np.float32(1.0), np.float32(0.0), np.float32(1.0), np.float32(0.0), np.float32(0.0)]",1.0,99388.0,25
2025-08-14_08-18-36,5619,"[np.float32(0.0), np.float32(1.0), np.float32(1.0), np.float32(1.0), np.float32(0.0), np.float32(1.0), np.float32(0.0), np.float32(1.0), np.float32(0.0), np.float32(0.0), np.float32(1.0), np.float32(0.0), np.float32(1.0), np.float32(0.0), np.float32(1.0), np.float32(0.0)]",-4.0,99384.0,25
2025-08-14_08-18-36,5620,"[np.float32(0.0), np.float32(0.0), np.float32(0.0), np.float32(0.0), np.float32(1.0), np.float32(0.0), np.float32(1.0), np.float32(0.0), np.float32(0.0), np.float32(0.0), np.float32(0.0), np.float32(1.0), np.float32(1.0), np.float32(1.0), np.float32(1.0), np.float32(0.0)]",-6.0,99378.0,31
2025-08-14_08-18-36,5621,"[np.float32(1.0), np.float32(1.0), np.float32(1.0), np.float32(1.0), np.float32(0.0), np.float32(1.0), np.float32(1.0), np.float32(1.0), np.float32(1.0), np.float32(1.0), np.float32(1.0), np.float32(0.0), np.float32(0.0), np.float32(0.0), np.float32(0.0), np.float32(0.0)]",0.0,99378.0,17
2025-08-14_08-18-36,5622,"[np.float32(0.0), np.float32(1.0), np.float32(0.0), np.float32(1.0), np.float32(0.0), np.float32(1.0), np.float32(1.0), np.float32(1.0), np.float32(0.0), np.float32(1.0), np.float32(0.0), np.float32(0.0), np.float32(0.0), np.float32(1.0), np.float32(1.0), np.float32(1.0)]",0.0,99378.0,35
2025-08-14_08-18-36,5623,"[np.float32(0.0), np.float32(0.0), np.float32(0.0), np.float32(0.0), np.float32(0.0), np.float32(1.0), np.float32(0.0), np.float32(1.0), np.float32(0.0), np.float32(1.0), np.float32(1.0), np.float32(0.0), np.float32(0.0), np.float32(0.0), np.float32(1.0), np.float32(0.0)]",-2.0,99376.0,1
2025-08-14_08-18-36,5624,"[np.float32(1.0), np.float32(1.0), np.float32(1.0), np.float32(0.0), np.float32(0.0), np.float32(0.0), np.float32(0.0), np.float32(1.0), np.float32(0.0), np.float32(1.0), np.float32(1.0), np.float32(1.0), np.float32(0.0), np.float32(0.0), np.float32(0.0), np.float32(1.0)]",-3.0,99373.0,27
2025-08-14_08-18-36,5625,"[np.float32(1.0), np.float32(0.0), np.float32(1.0), np.float32(0.0), np.float32(1.0), np.float32(1.0), np.float32(1.0), np.float32(1.0), np.float32(0.0), np.float32(1.0), np.float32(0.0), np.float32(0.0), np.float32(1.0), np.float32(0.0), np.float32(0.0), np.float32(0.0)]",-3.0,99370.0,15
2025-08-14_08-18-36,5626,"[np.float32(0.0), np.float32(1.0), np.float32(1.0), np.float32(0.0), np.float32(1.0), np.float32(1.0), np.float32(0.0), np.float32(0.0), np.float32(1.0), np.float32(0.0), np.float32(1.0), np.float32(0.0), np.float32(1.0), np.float32(1.0), np.float32(1.0), np.float32(0.0)]",0.0,99370.0,22
2025-08-14_08-18-36,5627,"[np.float32(0.0), np.float32(1.0), np.float32(0.0), np.float32(1.0), np.float32(1.0), np.float32(1.0), np.float32(1.0), np.float32(1.0), np.float32(0.0), np.float32(0.0), np.float32(1.0), np.float32(1.0), np.float32(0.0), np.float32(1.0), np.float32(0.0), np.float32(1.0)]",-2.0,99368.0,32
2025-08-14_08-18-36,5628,"[np.float32(0.0), np.float32(0.0), np.float32(1.0), np.float32(1.0), np.float32(0.0), np.float32(0.0), np.float32(0.0), np.float32(1.0), np.float32(0.0), np.float32(0.0), np.float32(1.0), np.float32(1.0), np.float32(1.0), np.float32(1.0), np.float32(0.0), np.float32(0.0)]",-2.0,99366.0,4
2025-08-14_08-18-36,5629,"[np.float32(0.0), np.float32(0.0), np.float32(0.0), np.float32(1.0), np.float32(0.0), np.float32(1.0), np.float32(1.0), np.float32(0.0), np.float32(0.0), np.float32(0.0), np.float32(1.0), np.float32(1.0), np.float32(1.0), np.float32(1.0), np.float32(1.0), np.float32(1.0)]",1.0,99367.0,29
2025-08-14_08-18-36,5630,"[np.float32(1.0), np.float32(1.0), np.float32(0.0), np.float32(1.0), np.float32(1.0), np.float32(0.0), np.float32(1.0), np.float32(1.0), np.float32(0.0), np.float32(1.0), np.float32(1.0), np.float32(0.0), np.float32(1.0), np.float32(0.0), np.float32(0.0), np.float32(0.0)]",-2.0,99365.0,6
2025-08-14_08-18-36,5631,"[np.float32(1.0), np.float32(0.0), np.float32(0.0), np.float32(0.0), np.float32(0.0), np.float32(0.0), np.float32(1.0), np.float32(0.0), np.float32(1.0), np.float32(0.0), np.float32(0.0), np.float32(1.0), np.float32(1.0), np.float32(1.0), np.float32(1.0), np.float32(1.0)]",3.0,99368.0,30
2025-08-14_08-18-36,5632,"[np.float32(1.0), np.float32(0.0), np.float32(0.0), np.float32(1.0), np.float32(0.0), np.float32(1.0), np.float32(1.0), np.float32(0.0), np.float32(0.0), np.float32(1.0), np.float32(0.0), np.float32(1.0), np.float32(1.0), np.float32(0.0), np.float32(1.0), np.float32(1.0)]",37.0,99405.0,7
2025-08-14_08-18-36,5633,"[np.float32(1.0), np.float32(0.0), np.float32(0.0), np.float32(0.0), np.float32(1.0), np.float32(1.0), np.float32(1.0), np.float32(1.0), np.float32(1.0), np.float32(0.0), np.float32(1.0), np.float32(1.0), np.float32(0.0), np.float32(1.0), np.float32(0.0), np.float32(1.0)]",3.0,99408.0,9
2025-08-14_08-18-36,5634,"[np.float32(0.0), np.float32(0.0), np.float32(0.0), np.float32(0.0), np.float32(0.0), np.float32(1.0), np.float32(0.0), np.float32(1.0), np.float32(0.0), np.float32(1.0), np.float32(0.0), np.float32(1.0), np.float32(0.0), np.float32(1.0), np.float32(0.0), np.float32(1.0)]",5.0,99413.0,19
2025-08-14_08-18-36,5635,"[np.float32(1.0), np.float32(0.0), np.float32(0.0), np.float32(1.0), np.float32(0.0), np.float32(0.0), np.float32(0.0), np.float32(1.0), np.float32(1.0), np.float32(0.0), np.float32(1.0), np.float32(0.0), np.float32(0.0), np.float32(0.0), np.float32(1.0), np.float32(0.0)]",-1.0,99412.0,18
2025-08-14_08-18-36,5636,"[np.float32(0.0), np.float32(1.0), np.float32(0.0), np.float32(0.0), np.float32(0.0), np.float32(1.0), np.float32(1.0), np.float32(1.0), np.float32(1.0), np.float32(1.0), np.float32(1.0), np.float32(1.0), np.float32(0.0), np.float32(1.0), np.float32(1.0), np.float32(0.0)]",1.0,99413.0,21
2025-08-14_08-18-36,5637,"[np.float32(1.0), np.float32(1.0), np.float32(0.0), np.float32(0.0), np.float32(0.0), np.float32(1.0), np.float32(1.0), np.float32(1.0), np.float32(0.0), np.float32(1.0), np.float32(0.0), np.float32(0.0), np.float32(1.0), np.float32(1.0), np.float32(1.0), np.float32(0.0)]",-2.0,99411.0,27
2025-08-14_08-18-36,5638,"[np.float32(1.0), np.float32(1.0), np.float32(0.0), np.float32(0.0), np.float32(0.0), np.float32(0.0), np.float32(0.0), np.float32(1.0), np.float32(1.0), np.float32(0.0), np.float32(0.0), np.float32(0.0), np.float32(0.0), np.float32(1.0), np.float32(1.0), np.float32(0.0)]",2.0,99413.0,28
2025-08-14_08-18-36,5639,"[np.float32(1.0), np.float32(1.0), np.float32(0.0), np.float32(1.0), np.float32(0.0), np.float32(1.0), np.float32(0.0), np.float32(1.0), np.float32(0.0), np.float32(0.0), np.float32(0.0), np.float32(1.0), np.float32(0.0), np.float32(1.0), np.float32(0.0), np.float32(0.0)]",0.0,99413.0,7
2025-08-14_08-18-36,5640,"[np.float32(0.0), np.float32(0.0), np.float32(1.0), np.float32(0.0), np.float32(1.0), np.float32(0.0), np.float32(1.0), np.float32(0.0), np.float32(1.0), np.float32(0.0), np.float32(0.0), np.float32(0.0), np.float32(0.0), np.float32(0.0), np.float32(0.0), np.float32(0.0)]",-1.0,99412.0,31
2025-08-14_08-18-36,5641,"[np.float32(0.0), np.float32(0.0), np.float32(0.0), np.float32(0.0), np.float32(0.0), np.float32(1.0), np.float32(0.0), np.float32(1.0), np.float32(0.0), np.float32(0.0), np.float32(0.0), np.float32(0.0), np.float32(1.0), np.float32(0.0), np.float32(1.0), np.float32(0.0)]",1.0,99413.0,33
2025-08-14_08-18-36,5642,"[np.float32(1.0), np.float32(1.0), np.float32(0.0), np.float32(1.0), np.float32(0.0), np.float32(0.0), np.float32(1.0), np.float32(0.0), np.float32(1.0), np.float32(0.0), np.float32(0.0), np.float32(0.0), np.float32(0.0), np.float32(0.0), np.float32(1.0), np.float32(1.0)]",-2.0,99411.0,24
2025-08-14_08-18-36,5643,"[np.float32(0.0), np.float32(0.0), np.float32(1.0), np.float32(1.0), np.float32(1.0), np.float32(0.0), np.float32(0.0), np.float32(1.0), np.float32(0.0), np.float32(1.0), np.float32(1.0), np.float32(0.0), np.float32(0.0), np.float32(1.0), np.float32(0.0), np.float32(1.0)]",0.0,99411.0,32
2025-08-14_08-18-36,5644,"[np.float32(1.0), np.float32(1.0), np.float32(0.0), np.float32(1.0), np.float32(1.0), np.float32(0.0), np.float32(1.0), np.float32(1.0), np.float32(0.0), np.float32(1.0), np.float32(0.0), np.float32(0.0), np.float32(0.0), np.float32(1.0), np.float32(0.0), np.float32(0.0)]",2.0,99413.0,25
2025-08-14_08-18-36,5645,"[np.float32(1.0), np.float32(1.0), np.float32(1.0), np.float32(0.0), np.float32(0.0), np.float32(0.0), np.float32(0.0), np.float32(0.0), np.float32(0.0), np.float32(1.0), np.float32(1.0), np.float32(0.0), np.float32(1.0), np.float32(1.0), np.float32(0.0), np.float32(1.0)]",0.0,99413.0,29
2025-08-14_08-18-36,5646,"[np.float32(1.0), np.float32(1.0), np.float32(1.0), np.float32(0.0), np.float32(0.0), np.float32(1.0), np.float32(0.0), np.float32(0.0), np.float32(0.0), np.float32(0.0), np.float32(1.0), np.float32(1.0), np.float32(1.0), np.float32(0.0), np.float32(1.0), np.float32(1.0)]",-2.0,99411.0,2
2025-08-14_08-18-36,5647,"[np.float32(0.0), np.float32(1.0), np.float32(1.0), np.float32(0.0), np.float32(0.0), np.float32(0.0), np.float32(1.0), np.float32(0.0), np.float32(0.0), np.float32(0.0), np.float32(1.0), np.float32(0.0), np.float32(1.0), np.float32(1.0), np.float32(1.0), np.float32(0.0)]",0.0,99411.0,20
2025-08-14_08-18-36,5648,"[np.float32(1.0), np.float32(0.0), np.float32(0.0), np.float32(0.0), np.float32(0.0), np.float32(0.0), np.float32(1.0), np.float32(0.0), np.float32(0.0), np.float32(0.0), np.float32(0.0), np.float32(0.0), np.float32(1.0), np.float32(0.0), np.float32(0.0), np.float32(1.0)]",-4.0,99407.0,0
2025-08-14_08-18-36,5649,"[np.float32(0.0), np.float32(1.0), np.float32(1.0), np.float32(0.0), np.float32(1.0), np.float32(1.0), np.float32(1.0), np.float32(1.0), np.float32(0.0), np.float32(1.0), np.float32(0.0), np.float32(1.0), np.float32(0.0), np.float32(0.0), np.float32(0.0), np.float32(0.0)]",0.0,99407.0,21
2025-08-14_08-18-36,5650,"[np.float32(1.0), np.float32(1.0), np.float32(0.0), np.float32(0.0), np.float32(0.0), np.float32(1.0), np.float32(1.0), np.float32(0.0), np.float32(1.0), np.float32(0.0), np.float32(0.0), np.float32(1.0), np.float32(0.0), np.float32(0.0), np.float32(1.0), np.float32(0.0)]",-5.0,99402.0,14
2025-08-14_08-18-36,5651,"[np.float32(0.0), np.float32(0.0), np.float32(0.0), np.float32(1.0), np.float32(1.0), np.float32(0.0), np.float32(0.0), np.float32(0.0), np.float32(1.0), np.float32(0.0), np.float32(1.0), np.float32(1.0), np.float32(0.0), np.float32(0.0), np.float32(1.0), np.float32(1.0)]",-3.0,99399.0,7
2025-08-14_08-18-36,5652,"[np.float32(1.0), np.float32(1.0), np.float32(1.0), np.float32(1.0), np.float32(1.0), np.float32(1.0), np.float32(0.0), np.float32(1.0), np.float32(0.0), np.float32(0.0), np.float32(0.0), np.float32(0.0), np.float32(1.0), np.float32(1.0), np.float32(0.0), np.float32(0.0)]",-3.0,99396.0,33
2025-08-14_08-18-36,5653,"[np.float32(0.0), np.float32(1.0), np.float32(1.0), np.float32(1.0), np.float32(0.0), np.float32(1.0), np.float32(0.0), np.float32(1.0), np.float32(0.0), np.float32(0.0), np.float32(1.0), np.float32(0.0), np.float32(1.0), np.float32(0.0), np.float32(1.0), np.float32(0.0)]",0.0,99396.0,5
2025-08-14_08-18-36,5654,"[np.float32(1.0), np.float32(0.0), np.float32(0.0), np.float32(0.0), np.float32(1.0), np.float32(1.0), np.float32(0.0), np.float32(1.0), np.float32(1.0), np.float32(0.0), np.float32(1.0), np.float32(1.0), np.float32(0.0), np.float32(0.0), np.float32(1.0), np.float32(0.0)]",5.0,99401.0,30
2025-08-14_08-18-36,5655,"[np.float32(0.0), np.float32(1.0), np.float32(0.0), np.float32(0.0), np.float32(0.0), np.float32(0.0), np.float32(0.0), np.float32(1.0), np.float32(1.0), np.float32(0.0), np.float32(1.0), np.float32(0.0), np.float32(1.0), np.float32(1.0), np.float32(0.0), np.float32(0.0)]",5.0,99406.0,35
2025-08-14_08-18-36,5656,"[np.float32(1.0), np.float32(1.0), np.float32(1.0), np.float32(1.0), np.float32(1.0), np.float32(1.0), np.float32(0.0), np.float32(0.0), np.float32(1.0), np.float32(1.0), np.float32(0.0), np.float32(0.0), np.float32(1.0), np.float32(0.0), np.float32(0.0), np.float32(0.0)]",-3.0,99403.0,2
2025-08-14_08-18-36,5657,"[np.float32(1.0), np.float32(1.0), np.float32(0.0), np.float32(1.0), np.float32(0.0), np.float32(0.0), np.float32(0.0), np.float32(0.0), np.float32(1.0), np.float32(1.0), np.float32(1.0), np.float32(0.0), np.float32(1.0), np.float32(0.0), np.float32(0.0), np.float32(0.0)]",3.0,99406.0,31
2025-08-14_08-18-36,5658,"[np.float32(0.0), np.float32(1.0), np.float32(0.0), np.float32(0.0), np.float32(1.0), np.float32(0.0), np.float32(0.0), np.float32(1.0), np.float32(1.0), np.float32(0.0), np.float32(1.0), np.float32(0.0), np.float32(0.0), np.float32(0.0), np.float32(0.0), np.float32(1.0)]",0.0,99406.0,32
2025-08-14_08-18-36,5659,"[np.float32(1.0), np.float32(0.0), np.float32(0.0), np.float32(1.0), np.float32(0.0), np.float32(0.0), np.float32(0.0), np.float32(1.0), np.float32(1.0), np.float32(1.0), np.float32(1.0), np.float32(0.0), np.float32(1.0), np.float32(1.0), np.float32(1.0), np.float32(0.0)]",37.0,99443.0,7
2025-08-14_08-18-36,5660,"[np.float32(1.0), np.float32(0.0), np.float32(0.0), np.float32(1.0), np.float32(0.0), np.float32(0.0), np.float32(1.0), np.float32(1.0), np.float32(1.0), np.float32(1.0), np.float32(1.0), np.float32(0.0), np.float32(1.0), np.float32(0.0), np.float32(0.0), np.float32(0.0)]",-3.0,99440.0,12
2025-08-14_08-18-36,5661,"[np.float32(0.0), np.float32(0.0), np.float32(1.0), np.float32(0.0), np.float32(0.0), np.float32(1.0), np.float32(1.0), np.float32(1.0), np.float32(0.0), np.float32(0.0), np.float32(1.0), np.float32(0.0), np.float32(0.0), np.float32(1.0), np.float32(0.0), np.float32(0.0)]",2.0,99442.0,35
2025-08-14_08-18-36,5662,"[np.float32(1.0), np.float32(1.0), np.float32(1.0), np.float32(0.0), np.float32(0.0), np.float32(0.0), np.float32(0.0), np.float32(1.0), np.float32(0.0), np.float32(1.0), np.float32(0.0), np.float32(0.0), np.float32(1.0), np.float32(1.0), np.float32(1.0), np.float32(1.0)]",-4.0,99438.0,33
2025-08-14_08-18-36,5663,"[np.float32(0.0), np.float32(1.0), np.float32(0.0), np.float32(1.0), np.float32(0.0), np.float32(1.0), np.float32(0.0), np.float32(1.0), np.float32(1.0), np.float32(0.0), np.float32(0.0), np.float32(0.0), np.float32(0.0), np.float32(0.0), np.float32(1.0), np.float32(0.0)]",1.0,99439.0,22
2025-08-14_08-18-36,5664,"[np.float32(0.0), np.float32(0.0), np.float32(0.0), np.float32(1.0), np.float32(0.0), np.float32(1.0), np.float32(0.0), np.float32(1.0), np.float32(0.0), np.float32(1.0), np.float32(0.0), np.float32(0.0), np.float32(0.0), np.float32(1.0), np.float32(1.0), np.float32(0.0)]",-3.0,99436.0,12
2025-08-14_08-18-36,5665,"[np.float32(0.0), np.float32(0.0), np.float32(0.0), np.float32(0.0), np.float32(0.0), np.float32(1.0), np.float32(0.0), np.float32(0.0), np.float32(1.0), np.float32(0.0), np.float32(1.0), np.float32(1.0), np.float32(1.0), np.float32(0.0), np.float32(0.0), np.float32(0.0)]",-5.0,99431.0,4
2025-08-14_08-18-36,5666,"[np.float32(1.0), np.float32(0.0), np.float32(0.0), np.float32(1.0), np.float32(0.0), np.float32(0.0), np.float32(1.0), np.float32(1.0), np.float32(1.0), np.float32(1.0), np.float32(0.0), np.float32(0.0), np.float32(0.0), np.float32(0.0), np.float32(0.0), np.float32(0.0)]",2.0,99433.0,31
2025-08-14_08-18-36,5667,"[np.float32(0.0), np.float32(0.0), np.float32(1.0), np.float32(1.0), np.float32(0.0), np.float32(1.0), np.float32(0.0), np.float32(1.0), np.float32(1.0), np.float32(1.0), np.float32(1.0), np.float32(1.0), np.float32(0.0), np.float32(0.0), np.float32(0.0), np.float32(0.0)]",-3.0,99430.0,10
2025-08-14_08-18-36,5668,"[np.float32(1.0), np.float32(0.0), np.float32(1.0), np.float32(0.0), np.float32(0.0), np.float32(0.0), np.float32(1.0), np.float32(0.0), np.float32(1.0), np.float32(1.0), np.float32(1.0), np.float32(1.0), np.float32(0.0), np.float32(0.0), np.float32(1.0), np.float32(0.0)]",2.0,99432.0,12
2025-08-14_08-18-36,5669,"[np.float32(1.0), np.float32(0.0), np.float32(1.0), np.float32(0.0), np.float32(1.0), np.float32(1.0), np.float32(0.0), np.float32(1.0), np.float32(0.0), np.float32(1.0), np.float32(0.0), np.float32(0.0), np.float32(1.0), np.float32(0.0), np.float32(0.0), np.float32(1.0)]",-6.0,99426.0,29
2025-08-14_08-18-36,5670,"[np.float32(0.0), np.float32(0.0), np.float32(1.0), np.float32(0.0), np.float32(0.0), np.float32(0.0), np.float32(0.0), np.float32(1.0), np.float32(1.0), np.float32(1.0), np.float32(1.0), np.float32(1.0), np.float32(0.0), np.float32(0.0), np.float32(0.0), np.float32(1.0)]",2.0,99428.0,17
2025-08-14_08-18-36,5671,"[np.float32(1.0), np.float32(0.0), np.float32(0.0), np.float32(0.0), np.float32(1.0), np.float32(0.0), np.float32(1.0), np.float32(1.0), np.float32(1.0), np.float32(1.0), np.float32(1.0), np.float32(0.0), np.float32(1.0), np.float32(1.0), np.float32(0.0), np.float32(0.0)]",1.0,99429.0,18
2025-08-14_08-18-36,5672,"[np.float32(1.0), np.float32(1.0), np.float32(0.0), np.float32(1.0), np.float32(0.0), np.float32(0.0), np.float32(0.0), np.float32(1.0), np.float32(0.0), np.float32(1.0), np.float32(1.0), np.float32(1.0), np.float32(0.0), np.float32(0.0), np.float32(1.0), np.float32(0.0)]",3.0,99432.0,24
2025-08-14_08-18-36,5673,"[np.float32(1.0), np.float32(0.0), np.float32(0.0), np.float32(1.0), np.float32(1.0), np.float32(1.0), np.float32(1.0), np.float32(0.0), np.float32(0.0), np.float32(0.0), np.float32(0.0), np.float32(0.0), np.float32(0.0), np.float32(1.0), np.float32(1.0), np.float32(1.0)]",-1.0,99431.0,13
2025-08-14_08-18-36,5674,"[np.float32(1.0), np.float32(1.0), np.float32(0.0), np.float32(1.0), np.float32(0.0), np.float32(1.0), np.float32(0.0), np.float32(1.0), np.float32(1.0), np.float32(1.0), np.float32(1.0), np.float32(0.0), np.float32(1.0), np.float32(1.0), np.float32(1.0), np.float32(0.0)]",4.0,99435.0,35
2025-08-14_08-18-36,5675,"[np.float32(1.0), np.float32(1.0), np.float32(0.0), np.float32(0.0), np.float32(1.0), np.float32(1.0), np.float32(0.0), np.float32(1.0), np.float32(0.0), np.float32(0.0), np.float32(1.0), np.float32(0.0), np.float32(0.0), np.float32(0.0), np.float32(0.0), np.float32(1.0)]",-3.0,99432.0,25
2025-08-14_08-18-36,5676,"[np.float32(1.0), np.float32(1.0), np.float32(0.0), np.float32(1.0), np.float32(0.0), np.float32(0.0), np.float32(0.0), np.float32(1.0), np.float32(1.0), np.float32(0.0), np.float32(1.0), np.float32(1.0), np.float32(0.0), np.float32(0.0), np.float32(0.0), np.float32(0.0)]",-2.0,99430.0,12
2025-08-14_08-18-36,5677,"[np.float32(0.0), np.float32(1.0), np.float32(1.0), np.float32(1.0), np.float32(1.0), np.float32(0.0), np.float32(1.0), np.float32(1.0), np.float32(1.0), np.float32(0.0), np.float32(0.0), np.float32(1.0), np.float32(0.0), np.float32(1.0), np.float32(1.0), np.float32(1.0)]",-1.0,99429.0,14
2025-08-14_08-18-36,5678,"[np.float32(1.0), np.float32(0.0), np.float32(0.0), np.float32(0.0), np.float32(1.0), np.float32(0.0), np.float32(0.0), np.float32(1.0), np.float32(1.0), np.float32(0.0), np.float32(1.0), np.float32(1.0), np.float32(1.0), np.float32(1.0), np.float32(0.0), np.float32(0.0)]",5.0,99434.0,18
2025-08-14_08-18-36,5679,"[np.float32(1.0), np.float32(0.0), np.float32(1.0), np.float32(0.0), np.float32(0.0), np.float32(1.0), np.float32(1.0), np.float32(0.0), np.float32(0.0), np.float32(0.0), np.float32(1.0), np.float32(1.0), np.float32(0.0), np.float32(0.0), np.float32(0.0), np.float32(0.0)]",1.0,99435.0,26
2025-08-14_08-18-36,5680,"[np.float32(0.0), np.float32(0.0), np.float32(0.0), np.float32(0.0), np.float32(1.0), np.float32(1.0), np.float32(1.0), np.float32(0.0), np.float32(0.0), np.float32(1.0), np.float32(0.0), np.float32(0.0), np.float32(1.0), np.float32(0.0), np.float32(0.0), np.float32(0.0)]",-3.0,99432.0,33
2025-08-14_08-18-36,5681,"[np.float32(0.0), np.float32(0.0), np.float32(0.0), np.float32(1.0), np.float32(0.0), np.float32(0.0), np.float32(1.0), np.float32(1.0), np.float32(1.0), np.float32(1.0), np.float32(0.0), np.float32(1.0), np.float32(0.0), np.float32(1.0), np.float32(0.0), np.float32(1.0)]",-5.0,99427.0,0
2025-08-14_08-18-36,5682,"[np.float32(0.0), np.float32(0.0), np.float32(1.0), np.float32(1.0), np.float32(0.0), np.float32(1.0), np.float32(1.0), np.float32(1.0), np.float32(1.0), np.float32(0.0), np.float32(1.0), np.float32(0.0), np.float32(1.0), np.float32(1.0), np.float32(0.0), np.float32(0.0)]",2.0,99429.0,2
2025-08-14_08-18-36,5683,"[np.float32(1.0), np.float32(0.0), np.float32(0.0), np.float32(0.0), np.float32(1.0), np.float32(0.0), np.float32(1.0), np.float32(0.0), np.float32(1.0), np.float32(1.0), np.float32(0.0), np.float32(1.0), np.float32(0.0), np.float32(1.0), np.float32(0.0), np.float32(1.0)]",3.0,99432.0,34
2025-08-14_08-18-36,5684,"[np.float32(1.0), np.float32(0.0), np.float32(1.0), np.float32(0.0), np.float32(1.0), np.float32(0.0), np.float32(1.0), np.float32(0.0), np.float32(0.0), np.float32(0.0), np.float32(1.0), np.float32(0.0), np.float32(0.0), np.float32(0.0), np.float32(1.0), np.float32(0.0)]",-6.0,99426.0,31
2025-08-14_08-18-36,5685,"[np.float32(0.0), np.float32(0.0), np.float32(1.0), np.float32(1.0), np.float32(0.0), np.float32(1.0), np.float32(1.0), np.float32(1.0), np.float32(1.0), np.float32(0.0), np.float32(1.0), np.float32(0.0), np.float32(1.0), np.float32(1.0), np.float32(0.0), np.float32(0.0)]",-1.0,99425.0,14
2025-08-14_08-18-36,5686,"[np.float32(1.0), np.float32(1.0), np.float32(1.0), np.float32(1.0), np.float32(0.0), np.float32(0.0), np.float32(1.0), np.float32(1.0), np.float32(1.0), np.float32(0.0), np.float32(1.0), np.float32(0.0), np.float32(0.0), np.float32(1.0), np.float32(0.0), np.float32(1.0)]",-3.0,99422.0,36
2025-08-14_08-18-36,5687,"[np.float32(1.0), np.float32(0.0), np.float32(0.0), np.float32(0.0), np.float32(0.0), np.float32(1.0), np.float32(1.0), np.float32(0.0), np.float32(1.0), np.float32(0.0), np.float32(1.0), np.float32(0.0), np.float32(1.0), np.float32(1.0), np.float32(0.0), np.float32(0.0)]",37.0,99459.0,7
2025-08-14_08-18-36,5688,"[np.float32(0.0), np.float32(1.0), np.float32(1.0), np.float32(1.0), np.float32(0.0), np.float32(1.0), np.float32(0.0), np.float32(1.0), np.float32(0.0), np.float32(0.0), np.float32(0.0), np.float32(0.0), np.float32(0.0), np.float32(1.0), np.float32(0.0), np.float32(0.0)]",-2.0,99457.0,8
2025-08-14_08-18-36,5689,"[np.float32(1.0), np.float32(1.0), np.float32(0.0), np.float32(0.0), np.float32(0.0), np.float32(1.0), np.float32(0.0), np.float32(1.0), np.float32(1.0), np.float32(0.0), np.float32(0.0), np.float32(1.0), np.float32(1.0), np.float32(0.0), np.float32(1.0), np.float32(0.0)]",-1.0,99456.0,32
2025-08-14_08-18-36,5690,"[np.float32(0.0), np.float32(1.0), np.float32(1.0), np.float32(1.0), np.float32(0.0), np.float32(1.0), np.float32(1.0), np.float32(0.0), np.float32(1.0), np.float32(1.0), np.float32(1.0), np.float32(0.0), np.float32(0.0), np.float32(0.0), np.float32(1.0), np.float32(0.0)]",2.0,99458.0,5
2025-08-14_08-18-36,5691,"[np.float32(1.0), np.float32(1.0), np.float32(0.0), np.float32(0.0), np.float32(1.0), np.float32(0.0), np.float32(1.0), np.float32(1.0), np.float32(1.0), np.float32(0.0), np.float32(0.0), np.float32(0.0), np.float32(0.0), np.float32(0.0), np.float32(0.0), np.float32(0.0)]",1.0,99459.0,4
2025-08-14_08-18-36,5692,"[np.float32(1.0), np.float32(0.0), np.float32(1.0), np.float32(0.0), np.float32(1.0), np.float32(1.0), np.float32(0.0), np.float32(1.0), np.float32(0.0), np.float32(1.0), np.float32(0.0), np.float32(0.0), np.float32(1.0), np.float32(1.0), np.float32(1.0), np.float32(1.0)]",-1.0,99458.0,36
2025-08-14_08-18-36,5693,"[np.float32(0.0), np.float32(0.0), np.float32(0.0), np.float32(1.0), np.float32(1.0), np.float32(1.0), np.float32(1.0), np.float32(1.0), np.float32(1.0), np.float32(0.0), np.float32(0.0), np.float32(0.0), np.float32(0.0), np.float32(1.0), np.float32(1.0), np.float32(0.0)]",0.0,99458.0,24
2025-08-14_08-18-36,5694,"[np.float32(1.0), np.float32(0.0), np.float32(0.0), np.float32(0.0), np.float32(0.0), np.float32(0.0), np.float32(0.0), np.float32(0.0), np.float32(0.0), np.float32(1.0), np.float32(0.0), np.float32(1.0), np.float32(0.0), np.float32(1.0), np.float32(1.0), np.float32(0.0)]",1.0,99459.0,4
2025-08-14_08-18-36,5695,"[np.float32(1.0), np.float32(0.0), np.float32(0.0), np.float32(1.0), np.float32(1.0), np.float32(1.0), np.float32(1.0), np.float32(1.0), np.float32(1.0), np.float32(1.0), np.float32(0.0), np.float32(1.0), np.float32(1.0), np.float32(1.0), np.float32(0.0), np.float32(0.0)]",-2.0,99457.0,5
2025-08-14_08-18-36,5696,"[np.float32(1.0), np.float32(0.0), np.float32(0.0), np.float32(1.0), np.float32(0.0), np.float32(1.0), np.float32(1.0), np.float32(1.0), np.float32(0.0), np.float32(1.0), np.float32(1.0), np.float32(0.0), np.float32(0.0), np.float32(0.0), np.float32(0.0), np.float32(1.0)]",-1.0,99456.0,3
2025-08-14_08-18-36,5697,"[np.float32(1.0), np.float32(1.0), np.float32(0.0), np.float32(0.0), np.float32(0.0), np.float32(0.0), np.float32(0.0), np.float32(0.0), np.float32(1.0), np.float32(1.0), np.float32(0.0), np.float32(0.0), np.float32(1.0), np.float32(1.0), np.float32(0.0), np.float32(1.0)]",-2.0,99454.0,16
2025-08-14_08-18-36,5698,"[np.float32(0.0), np.float32(1.0), np.float32(1.0), np.float32(0.0), np.float32(0.0), np.float32(1.0), np.float32(1.0), np.float32(1.0), np.float32(1.0), np.float32(1.0), np.float32(1.0), np.float32(1.0), np.float32(0.0), np.float32(0.0), np.float32(1.0), np.float32(0.0)]",2.0,99456.0,22
2025-08-14_08-18-36,5699,"[np.float32(0.0), np.float32(0.0), np.float32(0.0), np.float32(1.0), np.float32(0.0), np.float32(1.0), np.float32(1.0), np.float32(1.0), np.float32(0.0), np.float32(1.0), np.float32(0.0), np.float32(1.0), np.float32(1.0), np.float32(1.0), np.float32(1.0), np.float32(0.0)]",2.0,99458.0,15
2025-08-14_08-18-36,5700,"[np.float32(0.0), np.float32(0.0), np.float32(1.0), np.float32(1.0), np.float32(1.0), np.float32(1.0), np.float32(0.0), np.float32(0.0), np.float32(0.0), np.float32(0.0), np.float32(1.0), np.float32(0.0), np.float32(1.0), np.float32(0.0), np.float32(0.0), np.float32(0.0)]",1.0,99459.0,35
2025-08-14_08-18-36,5701,"[np.float32(1.0), np.float32(1.0), np.float32(0.0), np.float32(0.0), np.float32(1.0), np.float32(1.0), np.float32(0.0), np.float32(0.0), np.float32(0.0), np.float32(1.0), np.float32(0.0), np.float32(0.0), np.float32(0.0), np.float32(0.0), np.float32(0.0), np.float32(0.0)]",-1.0,99458.0,30
2025-08-14_08-18-36,5702,"[np.float32(1.0), np.float32(1.0), np.float32(0.0), np.float32(1.0), np.float32(0.0), np.float32(0.0), np.float32(1.0), np.float32(0.0), np.float32(1.0), np.float32(0.0), np.float32(0.0), np.float32(0.0), np.float32(1.0), np.float32(1.0), np.float32(1.0), np.float32(0.0)]",-1.0,99457.0,1
2025-08-14_08-18-36,5703,"[np.float32(1.0), np.float32(1.0), np.float32(1.0), np.float32(1.0), np.float32(0.0), np.float32(1.0), np.float32(1.0), np.float32(1.0), np.float32(0.0), np.float32(1.0), np.float32(1.0), np.float32(0.0), np.float32(0.0), np.float32(0.0), np.float32(1.0), np.float32(1.0)]",2.0,99459.0,1
2025-08-14_08-18-36,5704,"[np.float32(0.0), np.float32(1.0), np.float32(0.0), np.float32(1.0), np.float32(0.0), np.float32(0.0), np.float32(1.0), np.float32(1.0), np.float32(0.0), np.float32(1.0), np.float32(1.0), np.float32(0.0), np.float32(0.0), np.float32(0.0), np.float32(0.0), np.float32(1.0)]",3.0,99462.0,13
2025-08-14_08-18-36,5705,"[np.float32(1.0), np.float32(1.0), np.float32(0.0), np.float32(1.0), np.float32(0.0), np.float32(0.0), np.float32(1.0), np.float32(1.0), np.float32(0.0), np.float32(1.0), np.float32(1.0), np.float32(0.0), np.float32(0.0), np.float32(1.0), np.float32(1.0), np.float32(1.0)]",-5.0,99457.0,36
2025-08-14_08-18-36,5706,"[np.float32(0.0), np.float32(1.0), np.float32(0.0), np.float32(1.0), np.float32(0.0), np.float32(1.0), np.float32(1.0), np.float32(0.0), np.float32(1.0), np.float32(0.0), np.float32(0.0), np.float32(0.0), np.float32(1.0), np.float32(0.0), np.float32(0.0), np.float32(1.0)]",-2.0,99455.0,3
2025-08-14_08-18-36,5707,"[np.float32(0.0), np.float32(1.0), np.float32(0.0), np.float32(0.0), np.float32(0.0), np.float32(1.0), np.float32(1.0), np.float32(1.0), np.float32(0.0), np.float32(1.0), np.float32(0.0), np.float32(1.0), np.float32(1.0), np.float32(1.0), np.float32(1.0), np.float32(0.0)]",4.0,99459.0,24
2025-08-14_08-18-36,5708,"[np.float32(0.0), np.float32(0.0), np.float32(1.0), np.float32(0.0), np.float32(1.0), np.float32(1.0), np.float32(0.0), np.float32(0.0), np.float32(0.0), np.float32(0.0), np.float32(0.0), np.float32(1.0), np.float32(1.0), np.float32(1.0), np.float32(1.0), np.float32(1.0)]",0.0,99459.0,21
2025-08-14_08-18-36,5709,"[np.float32(1.0), np.float32(1.0), np.float32(0.0), np.float32(1.0), np.float32(1.0), np.float32(1.0), np.float32(0.0), np.float32(1.0), np.float32(0.0), np.float32(0.0), np.float32(0.0), np.float32(1.0), np.float32(0.0), np.float32(1.0), np.float32(0.0), np.float32(1.0)]",-2.0,99457.0,0
2025-08-14_08-18-36,5710,"[np.float32(0.0), np.float32(1.0), np.float32(1.0), np.float32(1.0), np.float32(0.0), np.float32(1.0), np.float32(1.0), np.float32(1.0), np.float32(1.0), np.float32(1.0), np.float32(0.0), np.float32(0.0), np.float32(1.0), np.float32(1.0), np.float32(0.0), np.float32(1.0)]",-4.0,99453.0,11
2025-08-14_08-18-36,5711,"[np.float32(1.0), np.float32(0.0), np.float32(0.0), np.float32(0.0), np.float32(1.0), np.float32(0.0), np.float32(0.0), np.float32(1.0), np.float32(0.0), np.float32(1.0), np.float32(0.0), np.float32(1.0), np.float32(1.0), np.float32(0.0), np.float32(1.0), np.float32(1.0)]",-3.0,99450.0,11
2025-08-14_08-18-36,5712,"[np.float32(0.0), np.float32(1.0), np.float32(1.0), np.float32(1.0), np.float32(0.0), np.float32(0.0), np.float32(1.0), np.float32(1.0), np.float32(0.0), np.float32(0.0), np.float32(0.0), np.float32(1.0), np.float32(0.0), np.float32(0.0), np.float32(1.0), np.float32(1.0)]",2.0,99452.0,8
2025-08-14_08-18-36,5713,"[np.float32(0.0), np.float32(1.0), np.float32(1.0), np.float32(0.0), np.float32(1.0), np.float32(0.0), np.float32(1.0), np.float32(1.0), np.float32(0.0), np.float32(0.0), np.float32(1.0), np.float32(0.0), np.float32(0.0), np.float32(0.0), np.float32(0.0), np.float32(1.0)]",-3.0,99449.0,28
2025-08-14_08-18-36,5714,"[np.float32(1.0), np.float32(1.0), np.float32(1.0), np.float32(0.0), np.float32(1.0), np.float32(0.0), np.float32(1.0), np.float32(1.0), np.float32(1.0), np.float32(1.0), np.float32(1.0), np.float32(0.0), np.float32(0.0), np.float32(1.0), np.float32(0.0), np.float32(0.0)]",-5.0,99444.0,33
2025-08-14_08-18-36,5715,"[np.float32(0.0), np.float32(0.0), np.float32(0.0), np.float32(0.0), np.float32(0.0), np.float32(1.0), np.float32(0.0), np.float32(0.0), np.float32(1.0), np.float32(0.0), np.float32(1.0), np.float32(1.0), np.float32(1.0), np.float32(1.0), np.float32(0.0), np.float32(0.0)]",-3.0,99441.0,5
2025-08-14_08-18-36,5716,"[np.float32(0.0), np.float32(1.0), np.float32(0.0), np.float32(0.0), np.float32(0.0), np.float32(0.0), np.float32(1.0), np.float32(1.0), np.float32(0.0), np.float32(0.0), np.float32(0.0), np.float32(0.0), np.float32(0.0), np.float32(0.0), np.float32(1.0), np.float32(0.0)]",-2.0,99439.0,0
2025-08-14_08-18-36,5717,"[np.float32(1.0), np.float32(1.0), np.float32(0.0), np.float32(1.0), np.float32(0.0), np.float32(0.0), np.float32(0.0), np.float32(1.0), np.float32(0.0), np.float32(1.0), np.float32(0.0), np.float32(1.0), np.float32(1.0), np.float32(0.0), np.float32(0.0), np.float32(0.0)]",36.0,99475.0,7
2025-08-14_08-18-36,5718,"[np.float32(0.0), np.float32(0.0), np.float32(0.0), np.float32(0.0), np.float32(0.0), np.float32(1.0), np.float32(0.0), np.float32(0.0), np.float32(0.0), np.float32(1.0), np.float32(1.0), np.float32(1.0), np.float32(0.0), np.float32(0.0), np.float32(1.0), np.float32(0.0)]",1.0,99476.0,11
2025-08-14_08-18-36,5719,"[np.float32(0.0), np.float32(0.0), np.float32(0.0), np.float32(1.0), np.float32(0.0), np.float32(0.0), np.float32(0.0), np.float32(0.0), np.float32(0.0), np.float32(0.0), np.float32(0.0), np.float32(1.0), np.float32(1.0), np.float32(1.0), np.float32(0.0), np.float32(0.0)]",-1.0,99475.0,22
2025-08-14_08-18-36,5720,"[np.float32(1.0), np.float32(1.0), np.float32(1.0), np.float32(1.0), np.float32(1.0), np.float32(0.0), np.float32(1.0), np.float32(1.0), np.float32(0.0), np.float32(0.0), np.float32(0.0), np.float32(0.0), np.float32(1.0), np.float32(0.0), np.float32(0.0), np.float32(0.0)]",1.0,99476.0,12
2025-08-14_08-18-36,5721,"[np.float32(1.0), np.float32(0.0), np.float32(0.0), np.float32(1.0), np.float32(0.0), np.float32(1.0), np.float32(1.0), np.float32(1.0), np.float32(1.0), np.float32(1.0), np.float32(0.0), np.float32(1.0), np.float32(0.0), np.float32(1.0), np.float32(1.0), np.float32(0.0)]",3.0,99479.0,3
2025-08-14_08-18-36,5722,"[np.float32(1.0), np.float32(1.0), np.float32(1.0), np.float32(0.0), np.float32(1.0), np.float32(0.0), np.float32(1.0), np.float32(0.0), np.float32(1.0), np.float32(0.0), np.float32(0.0), np.float32(0.0), np.float32(0.0), np.float32(0.0), np.float32(1.0), np.float32(0.0)]",-3.0,99476.0,15
2025-08-14_08-18-36,5723,"[np.float32(1.0), np.float32(0.0), np.float32(1.0), np.float32(1.0), np.float32(1.0), np.float32(0.0), np.float32(0.0), np.float32(1.0), np.float32(0.0), np.float32(1.0), np.float32(1.0), np.float32(0.0), np.float32(0.0), np.float32(1.0), np.float32(1.0), np.float32(1.0)]",-3.0,99473.0,36
2025-08-14_08-18-36,5724,"[np.float32(0.0), np.float32(1.0), np.float32(0.0), np.float32(0.0), np.float32(1.0), np.float32(1.0), np.float32(1.0), np.float32(1.0), np.float32(1.0), np.float32(1.0), np.float32(0.0), np.float32(1.0), np.float32(1.0), np.float32(1.0), np.float32(0.0), np.float32(0.0)]",0.0,99473.0,13
2025-08-14_08-18-36,5725,"[np.float32(0.0), np.float32(0.0), np.float32(0.0), np.float32(1.0), np.float32(0.0), np.float32(0.0), np.float32(1.0), np.float32(1.0), np.float32(1.0), np.float32(0.0), np.float32(1.0), np.float32(1.0), np.float32(0.0), np.float32(0.0), np.float32(1.0), np.float32(0.0)]",-4.0,99469.0,4
2025-08-14_08-18-36,5726,"[np.float32(0.0), np.float32(0.0), np.float32(0.0), np.float32(0.0), np.float32(0.0), np.float32(1.0), np.float32(0.0), np.float32(1.0), np.float32(0.0), np.float32(1.0), np.float32(1.0), np.float32(0.0), np.float32(1.0), np.float32(0.0), np.float32(0.0), np.float32(1.0)]",0.0,99469.0,13
2025-08-14_08-18-36,5727,"[np.float32(1.0), np.float32(0.0), np.float32(0.0), np.float32(0.0), np.float32(0.0), np.float32(1.0), np.float32(0.0), np.float32(1.0), np.float32(1.0), np.float32(1.0), np.float32(0.0), np.float32(1.0), np.float32(1.0), np.float32(0.0), np.float32(0.0), np.float32(1.0)]",-1.0,99468.0,32
2025-08-14_08-18-36,5728,"[np.float32(1.0), np.float32(1.0), np.float32(0.0), np.float32(1.0), np.float32(1.0), np.float32(0.0), np.float32(1.0), np.float32(0.0), np.float32(1.0), np.float32(0.0), np.float32(1.0), np.float32(0.0), np.float32(0.0), np.float32(0.0), np.float32(0.0), np.float32(0.0)]",-1.0,99467.0,15
2025-08-14_08-18-36,5729,"[np.float32(1.0), np.float32(1.0), np.float32(0.0), np.float32(1.0), np.float32(1.0), np.float32(0.0), np.float32(0.0), np.float32(1.0), np.float32(1.0), np.float32(1.0), np.float32(0.0), np.float32(1.0), np.float32(0.0), np.float32(1.0), np.float32(1.0), np.float32(1.0)]",-1.0,99466.0,29
2025-08-14_08-18-36,5730,"[np.float32(1.0), np.float32(1.0), np.float32(0.0), np.float32(0.0), np.float32(0.0), np.float32(0.0), np.float32(0.0), np.float32(0.0), np.float32(0.0), np.float32(1.0), np.float32(0.0), np.float32(0.0), np.float32(0.0), np.float32(1.0), np.float32(0.0), np.float32(0.0)]",4.0,99470.0,22
2025-08-14_08-18-36,5731,"[np.float32(0.0), np.float32(1.0), np.float32(1.0), np.float32(0.0), np.float32(0.0), np.float32(0.0), np.float32(0.0), np.float32(0.0), np.float32(1.0), np.float32(0.0), np.float32(1.0), np.float32(0.0), np.float32(1.0), np.float32(1.0), np.float32(1.0), np.float32(0.0)]",-2.0,99468.0,13
2025-08-14_08-18-36,5732,"[np.float32(1.0), np.float32(0.0), np.float32(1.0), np.float32(0.0), np.float32(1.0), np.float32(1.0), np.float32(0.0), np.float32(1.0), np.float32(1.0), np.float32(1.0), np.float32(0.0), np.float32(1.0), np.float32(0.0), np.float32(1.0), np.float32(0.0), np.float32(0.0)]",-4.0,99464.0,17
2025-08-14_08-18-36,5733,"[np.float32(0.0), np.float32(1.0), np.float32(0.0), np.float32(1.0), np.float32(0.0), np.float32(0.0), np.float32(0.0), np.float32(1.0), np.float32(0.0), np.float32(1.0), np.float32(1.0), np.float32(0.0), np.float32(0.0), np.float32(1.0), np.float32(0.0), np.float32(1.0)]",-5.0,99459.0,27
2025-08-14_08-18-36,5734,"[np.float32(1.0), np.float32(0.0), np.float32(0.0), np.float32(1.0), np.float32(1.0), np.float32(1.0), np.float32(1.0), np.float32(1.0), np.float32(1.0), np.float32(1.0), np.float32(1.0), np.float32(0.0), np.float32(1.0), np.float32(1.0), np.float32(0.0), np.float32(0.0)]",-1.0,99458.0,13
2025-08-14_08-18-36,5735,"[np.float32(0.0), np.float32(0.0), np.float32(0.0), np.float32(0.0), np.float32(0.0), np.float32(0.0), np.float32(0.0), np.float32(1.0), np.float32(0.0), np.float32(1.0), np.float32(1.0), np.float32(0.0), np.float32(1.0), np.float32(1.0), np.float32(1.0), np.float32(0.0)]",-3.0,99455.0,1
2025-08-14_08-18-36,5736,"[np.float32(1.0), np.float32(0.0), np.float32(0.0), np.float32(0.0), np.float32(1.0), np.float32(1.0), np.float32(1.0), np.float32(1.0), np.float32(0.0), np.float32(1.0), np.float32(0.0), np.float32(0.0), np.float32(1.0), np.float32(1.0), np.float32(1.0), np.float32(0.0)]",2.0,99457.0,10
2025-08-14_08-18-36,5737,"[np.float32(0.0), np.float32(0.0), np.float32(1.0), np.float32(1.0), np.float32(0.0), np.float32(1.0), np.float32(1.0), np.float32(0.0), np.float32(0.0), np.float32(1.0), np.float32(1.0), np.float32(0.0), np.float32(1.0), np.float32(0.0), np.float32(1.0), np.float32(0.0)]",0.0,99457.0,16
2025-08-14_08-18-36,5738,"[np.float32(1.0), np.float32(0.0), np.float32(1.0), np.float32(0.0), np.float32(1.0), np.float32(0.0), np.float32(1.0), np.float32(0.0), np.float32(1.0), np.float32(1.0), np.float32(0.0), np.float32(0.0), np.float32(1.0), np.float32(0.0), np.float32(0.0), np.float32(0.0)]",3.0,99460.0,34
2025-08-14_08-18-36,5739,"[np.float32(0.0), np.float32(0.0), np.float32(0.0), np.float32(0.0), np.float32(0.0), np.float32(1.0), np.float32(1.0), np.float32(0.0), np.float32(1.0), np.float32(1.0), np.float32(0.0), np.float32(1.0), np.float32(0.0), np.float32(0.0), np.float32(0.0), np.float32(0.0)]",0.0,99460.0,24
2025-08-14_08-18-36,5740,"[np.float32(1.0), np.float32(0.0), np.float32(1.0), np.float32(1.0), np.float32(0.0), np.float32(1.0), np.float32(1.0), np.float32(1.0), np.float32(1.0), np.float32(0.0), np.float32(0.0), np.float32(0.0), np.float32(1.0), np.float32(0.0), np.float32(1.0), np.float32(1.0)]",0.0,99460.0,14
2025-08-14_08-18-36,5741,"[np.float32(0.0), np.float32(0.0), np.float32(1.0), np.float32(0.0), np.float32(0.0), np.float32(0.0), np.float32(1.0), np.float32(1.0), np.float32(0.0), np.float32(0.0), np.float32(0.0), np.float32(1.0), np.float32(1.0), np.float32(1.0), np.float32(0.0), np.float32(0.0)]",-3.0,99457.0,25
2025-08-14_08-18-36,5742,"[np.float32(0.0), np.float32(0.0), np.float32(0.0), np.float32(0.0), np.float32(1.0), np.float32(0.0), np.float32(0.0), np.float32(0.0), np.float32(1.0), np.float32(1.0), np.float32(0.0), np.float32(1.0), np.float32(1.0), np.float32(0.0), np.float32(0.0), np.float32(1.0)]",2.0,99459.0,1
2025-08-14_08-18-36,5743,"[np.float32(0.0), np.float32(0.0), np.float32(1.0), np.float32(1.0), np.float32(1.0), np.float32(0.0), np.float32(0.0), np.float32(1.0), np.float32(1.0), np.float32(0.0), np.float32(1.0), np.float32(0.0), np.float32(1.0), np.float32(1.0), np.float32(1.0), np.float32(0.0)]",1.0,99460.0,16
2025-08-14_08-18-36,5744,"[np.float32(1.0), np.float32(1.0), np.float32(0.0), np.float32(0.0), np.float32(0.0), np.float32(1.0), np.float32(0.0), np.float32(1.0), np.float32(1.0), np.float32(0.0), np.float32(1.0), np.float32(0.0), np.float32(0.0), np.float32(0.0), np.float32(1.0), np.float32(0.0)]",3.0,99463.0,36
2025-08-14_08-18-36,5745,"[np.float32(0.0), np.float32(1.0), np.float32(1.0), np.float32(0.0), np.float32(0.0), np.float32(0.0), np.float32(1.0), np.float32(1.0), np.float32(1.0), np.float32(1.0), np.float32(1.0), np.float32(0.0), np.float32(0.0), np.float32(0.0), np.float32(1.0), np.float32(1.0)]",-4.0,99459.0,12
2025-08-14_08-18-36,5746,"[np.float32(0.0), np.float32(0.0), np.float32(1.0), np.float32(1.0), np.float32(0.0), np.float32(1.0), np.float32(1.0), np.float32(1.0), np.float32(1.0), np.float32(0.0), np.float32(1.0), np.float32(0.0), np.float32(1.0), np.float32(1.0), np.float32(0.0), np.float32(0.0)]",1.0,99460.0,23
2025-08-14_08-18-36,5747,"[np.float32(0.0), np.float32(0.0), np.float32(1.0), np.float32(0.0), np.float32(1.0), np.float32(0.0), np.float32(0.0), np.float32(0.0), np.float32(0.0), np.float32(1.0), np.float32(0.0), np.float32(1.0), np.float32(0.0), np.float32(0.0), np.float32(0.0), np.float32(1.0)]",0.0,99460.0,22
2025-08-14_08-18-36,5748,"[np.float32(1.0), np.float32(1.0), np.float32(0.0), np.float32(0.0), np.float32(1.0), np.float32(0.0), np.float32(1.0), np.float32(1.0), np.float32(1.0), np.float32(0.0), np.float32(0.0), np.float32(1.0), np.float32(0.0), np.float32(0.0), np.float32(0.0), np.float32(0.0)]",0.0,99460.0,14
2025-08-14_08-18-36,5749,"[np.float32(0.0), np.float32(1.0), np.float32(0.0), np.float32(1.0), np.float32(0.0), np.float32(1.0), np.float32(1.0), np.float32(0.0), np.float32(1.0), np.float32(0.0), np.float32(0.0), np.float32(1.0), np.float32(0.0), np.float32(1.0), np.float32(0.0), np.float32(0.0)]",0.0,99460.0,0
2025-08-14_08-18-36,5750,"[np.float32(1.0), np.float32(1.0), np.float32(0.0), np.float32(1.0), np.float32(1.0), np.float32(0.0), np.float32(0.0), np.float32(1.0), np.float32(0.0), np.float32(1.0), np.float32(0.0), np.float32(0.0), np.float32(0.0), np.float32(0.0), np.float32(1.0), np.float32(0.0)]",3.0,99463.0,23
2025-08-14_08-18-36,5751,"[np.float32(0.0), np.float32(0.0), np.float32(0.0), np.float32(0.0), np.float32(0.0), np.float32(1.0), np.float32(0.0), np.float32(1.0), np.float32(1.0), np.float32(0.0), np.float32(0.0), np.float32(1.0), np.float32(0.0), np.float32(1.0), np.float32(0.0), np.float32(0.0)]",0.0,99463.0,20
2025-08-14_08-18-36,5752,"[np.float32(0.0), np.float32(1.0), np.float32(0.0), np.float32(0.0), np.float32(0.0), np.float32(0.0), np.float32(1.0), np.float32(1.0), np.float32(0.0), np.float32(1.0), np.float32(0.0), np.float32(0.0), np.float32(1.0), np.float32(1.0), np.float32(1.0), np.float32(0.0)]",1.0,99464.0,15
2025-08-14_08-18-36,5753,"[np.float32(0.0), np.float32(0.0), np.float32(0.0), np.float32(1.0), np.float32(1.0), np.float32(1.0), np.float32(1.0), np.float32(0.0), np.float32(1.0), np.float32(0.0), np.float32(0.0), np.float32(1.0), np.float32(1.0), np.float32(1.0), np.float32(0.0), np.float32(0.0)]",2.0,99466.0,35
2025-08-14_08-18-36,5754,"[np.float32(1.0), np.float32(1.0), np.float32(1.0), np.float32(1.0), np.float32(1.0), np.float32(1.0), np.float32(0.0), np.float32(1.0), np.float32(1.0), np.float32(1.0), np.float32(0.0), np.float32(0.0), np.float32(1.0), np.float32(1.0), np.float32(0.0), np.float32(1.0)]",0.0,99466.0,4
2025-08-14_08-18-36,5755,"[np.float32(1.0), np.float32(1.0), np.float32(0.0), np.float32(1.0), np.float32(1.0), np.float32(0.0), np.float32(0.0), np.float32(1.0), np.float32(0.0), np.float32(0.0), np.float32(0.0), np.float32(1.0), np.float32(1.0), np.float32(1.0), np.float32(0.0), np.float32(0.0)]",0.0,99466.0,22
2025-08-14_08-18-36,5756,"[np.float32(0.0), np.float32(0.0), np.float32(1.0), np.float32(0.0), np.float32(0.0), np.float32(0.0), np.float32(1.0), np.float32(1.0), np.float32(1.0), np.float32(0.0), np.float32(0.0), np.float32(1.0), np.float32(1.0), np.float32(1.0), np.float32(0.0), np.float32(0.0)]",-1.0,99465.0,29
2025-08-14_08-18-36,5757,"[np.float32(0.0), np.float32(0.0), np.float32(1.0), np.float32(1.0), np.float32(0.0), np.float32(0.0), np.float32(1.0), np.float32(1.0), np.float32(0.0), np.float32(1.0), np.float32(0.0), np.float32(0.0), np.float32(1.0), np.float32(1.0), np.float32(0.0), np.float32(0.0)]",1.0,99466.0,1
2025-08-14_08-18-36,5758,"[np.float32(1.0), np.float32(0.0), np.float32(1.0), np.float32(1.0), np.float32(1.0), np.float32(0.0), np.float32(0.0), np.float32(0.0), np.float32(1.0), np.float32(1.0), np.float32(0.0), np.float32(1.0), np.float32(1.0), np.float32(0.0), np.float32(1.0), np.float32(1.0)]",-3.0,99463.0,21
2025-08-14_08-18-36,5759,"[np.float32(1.0), np.float32(1.0), np.float32(1.0), np.float32(1.0), np.float32(1.0), np.float32(1.0), np.float32(0.0), np.float32(1.0), np.float32(1.0), np.float32(0.0), np.float32(0.0), np.float32(0.0), np.float32(1.0), np.float32(1.0), np.float32(0.0), np.float32(1.0)]",34.0,99497.0,7
2025-08-14_08-18-36,5760,"[np.float32(0.0), np.float32(1.0), np.float32(1.0), np.float32(0.0), np.float32(0.0), np.float32(0.0), np.float32(1.0), np.float32(1.0), np.float32(1.0), np.float32(1.0), np.float32(0.0), np.float32(0.0), np.float32(1.0), np.float32(1.0), np.float32(0.0), np.float32(0.0)]",0.0,99497.0,29
2025-08-14_08-18-36,5761,"[np.float32(1.0), np.float32(0.0), np.float32(0.0), np.float32(1.0), np.float32(1.0), np.float32(0.0), np.float32(1.0), np.float32(1.0), np.float32(1.0), np.float32(0.0), np.float32(1.0), np.float32(0.0), np.float32(1.0), np.float32(0.0), np.float32(1.0), np.float32(1.0)]",-3.0,99494.0,25
2025-08-14_08-18-36,5762,"[np.float32(1.0), np.float32(0.0), np.float32(1.0), np.float32(1.0), np.float32(0.0), np.float32(1.0), np.float32(1.0), np.float32(0.0), np.float32(0.0), np.float32(1.0), np.float32(0.0), np.float32(1.0), np.float32(1.0), np.float32(1.0), np.float32(1.0), np.float32(1.0)]",-4.0,99490.0,0
2025-08-14_08-18-36,5763,"[np.float32(0.0), np.float32(1.0), np.float32(0.0), np.float32(1.0), np.float32(1.0), np.float32(1.0), np.float32(0.0), np.float32(1.0), np.float32(1.0), np.float32(1.0), np.float32(0.0), np.float32(1.0), np.float32(1.0), np.float32(1.0), np.float32(0.0), np.float32(1.0)]",-1.0,99489.0,4
2025-08-14_08-18-36,5764,"[np.float32(0.0), np.float32(0.0), np.float32(1.0), np.float32(0.0), np.float32(1.0), np.float32(0.0), np.float32(0.0), np.float32(1.0), np.float32(0.0), np.float32(1.0), np.float32(0.0), np.float32(0.0), np.float32(0.0), np.float32(1.0), np.float32(0.0), np.float32(1.0)]",-1.0,99488.0,24
2025-08-14_08-18-36,5765,"[np.float32(1.0), np.float32(1.0), np.float32(0.0), np.float32(0.0), np.float32(1.0), np.float32(0.0), np.float32(0.0), np.float32(1.0), np.float32(0.0), np.float32(1.0), np.float32(1.0), np.float32(0.0), np.float32(0.0), np.float32(1.0), np.float32(1.0), np.float32(1.0)]",-1.0,99487.0,25
2025-08-14_08-18-36,5766,"[np.float32(1.0), np.float32(1.0), np.float32(0.0), np.float32(0.0), np.float32(0.0), np.float32(1.0), np.float32(0.0), np.float32(1.0), np.float32(1.0), np.float32(1.0), np.float32(1.0), np.float32(0.0), np.float32(1.0), np.float32(1.0), np.float32(0.0), np.float32(1.0)]",-3.0,99484.0,0
2025-08-14_08-18-36,5767,"[np.float32(0.0), np.float32(1.0), np.float32(1.0), np.float32(0.0), np.float32(0.0), np.float32(0.0), np.float32(1.0), np.float32(1.0), np.float32(1.0), np.float32(1.0), np.float32(0.0), np.float32(0.0), np.float32(1.0), np.float32(1.0), np.float32(1.0), np.float32(0.0)]",-3.0,99481.0,21
2025-08-14_08-18-36,5768,"[np.float32(1.0), np.float32(1.0), np.float32(0.0), np.float32(1.0), np.float32(1.0), np.float32(0.0), np.float32(1.0), np.float32(1.0), np.float32(1.0), np.float32(1.0), np.float32(0.0), np.float32(0.0), np.float32(1.0), np.float32(0.0), np.float32(0.0), np.float32(0.0)]",-4.0,99477.0,30
2025-08-14_08-18-36,5769,"[np.float32(0.0), np.float32(1.0), np.float32(0.0), np.float32(0.0), np.float32(0.0), np.float32(0.0), np.float32(0.0), np.float32(0.0), np.float32(1.0), np.float32(0.0), np.float32(0.0), np.float32(0.0), np.float32(0.0), np.float32(1.0), np.float32(0.0), np.float32(0.0)]",-1.0,99476.0,8
2025-08-14_08-18-36,5770,"[np.float32(1.0), np.float32(1.0), np.float32(1.0), np.float32(0.0), np.float32(1.0), np.float32(1.0), np.float32(0.0), np.float32(1.0), np.float32(0.0), np.float32(1.0), np.float32(0.0), np.float32(0.0), np.float32(1.0), np.float32(0.0), np.float32(0.0), np.float32(0.0)]",-2.0,99474.0,2
2025-08-14_08-18-36,5771,"[np.float32(0.0), np.float32(1.0), np.float32(0.0), np.float32(1.0), np.float32(1.0), np.float32(0.0), np.float32(0.0), np.float32(1.0), np.float32(1.0), np.float32(0.0), np.float32(0.0), np.float32(0.0), np.float32(1.0), np.float32(1.0), np.float32(0.0), np.float32(0.0)]",-2.0,99472.0,12
2025-08-14_08-18-36,5772,"[np.float32(0.0), np.float32(0.0), np.float32(0.0), np.float32(0.0), np.float32(1.0), np.float32(1.0), np.float32(0.0), np.float32(1.0), np.float32(1.0), np.float32(0.0), np.float32(0.0), np.float32(1.0), np.float32(1.0), np.float32(1.0), np.float32(1.0), np.float32(0.0)]",0.0,99472.0,22
2025-08-14_08-18-36,5773,"[np.float32(1.0), np.float32(1.0), np.float32(1.0), np.float32(0.0), np.float32(0.0), np.float32(1.0), np.float32(1.0), np.float32(1.0), np.float32(1.0), np.float32(0.0), np.float32(0.0), np.float32(0.0), np.float32(0.0), np.float32(1.0), np.float32(1.0), np.float32(1.0)]",0.0,99472.0,14
2025-08-14_08-18-36,5774,"[np.float32(1.0), np.float32(0.0), np.float32(0.0), np.float32(0.0), np.float32(1.0), np.float32(0.0), np.float32(0.0), np.float32(1.0), np.float32(0.0), np.float32(1.0), np.float32(1.0), np.float32(1.0), np.float32(1.0), np.float32(1.0), np.float32(0.0), np.float32(1.0)]",-3.0,99469.0,35
2025-08-14_08-18-36,5775,"[np.float32(1.0), np.float32(1.0), np.float32(0.0), np.float32(0.0), np.float32(1.0), np.float32(0.0), np.float32(1.0), np.float32(1.0), np.float32(0.0), np.float32(1.0), np.float32(1.0), np.float32(1.0), np.float32(0.0), np.float32(1.0), np.float32(0.0), np.float32(0.0)]",-1.0,99468.0,26
2025-08-14_08-18-36,5776,"[np.float32(1.0), np.float32(0.0), np.float32(1.0), np.float32(0.0), np.float32(0.0), np.float32(1.0), np.float32(1.0), np.float32(1.0), np.float32(1.0), np.float32(0.0), np.float32(1.0), np.float32(0.0), np.float32(0.0), np.float32(0.0), np.float32(0.0), np.float32(0.0)]",-2.0,99466.0,7
2025-08-14_08-18-36,5777,"[np.float32(0.0), np.float32(0.0), np.float32(1.0), np.float32(0.0), np.float32(0.0), np.float32(1.0), np.float32(0.0), np.float32(1.0), np.float32(0.0), np.float32(0.0), np.float32(0.0), np.float32(0.0), np.float32(0.0), np.float32(1.0), np.float32(1.0), np.float32(1.0)]",1.0,99467.0,26
2025-08-14_08-18-36,5778,"[np.float32(0.0), np.float32(1.0), np.float32(0.0), np.float32(1.0), np.float32(1.0), np.float32(0.0), np.float32(0.0), np.float32(1.0), np.float32(1.0), np.float32(1.0), np.float32(0.0), np.float32(0.0), np.float32(0.0), np.float32(0.0), np.float32(0.0), np.float32(1.0)]",-2.0,99465.0,27
2025-08-14_08-18-36,5779,"[np.float32(0.0), np.float32(0.0), np.float32(0.0), np.float32(1.0), np.float32(1.0), np.float32(1.0), np.float32(1.0), np.float32(1.0), np.float32(0.0), np.float32(0.0), np.float32(0.0), np.float32(0.0), np.float32(1.0), np.float32(0.0), np.float32(1.0), np.float32(1.0)]",0.0,99465.0,14
2025-08-14_08-18-36,5780,"[np.float32(0.0), np.float32(0.0), np.float32(1.0), np.float32(1.0), np.float32(1.0), np.float32(1.0), np.float32(0.0), np.float32(0.0), np.float32(1.0), np.float32(1.0), np.float32(1.0), np.float32(0.0), np.float32(0.0), np.float32(0.0), np.float32(1.0), np.float32(0.0)]",-4.0,99461.0,21
2025-08-14_08-18-36,5781,"[np.float32(1.0), np.float32(1.0), np.float32(0.0), np.float32(0.0), np.float32(1.0), np.float32(0.0), np.float32(0.0), np.float32(0.0), np.float32(0.0), np.float32(0.0), np.float32(1.0), np.float32(0.0), np.float32(0.0), np.float32(1.0), np.float32(0.0), np.float32(1.0)]",1.0,99462.0,4
2025-08-14_08-18-36,5782,"[np.float32(0.0), np.float32(0.0), np.float32(0.0), np.float32(0.0), np.float32(0.0), np.float32(0.0), np.float32(0.0), np.float32(1.0), np.float32(1.0), np.float32(0.0), np.float32(0.0), np.float32(0.0), np.float32(1.0), np.float32(0.0), np.float32(0.0), np.float32(1.0)]",-4.0,99458.0,4
2025-08-14_08-18-36,5783,"[np.float32(1.0), np.float32(1.0), np.float32(1.0), np.float32(0.0), np.float32(1.0), np.float32(0.0), np.float32(1.0), np.float32(0.0), np.float32(0.0), np.float32(1.0), np.float32(1.0), np.float32(0.0), np.float32(0.0), np.float32(0.0), np.float32(1.0), np.float32(1.0)]",-4.0,99454.0,33
2025-08-14_08-18-36,5784,"[np.float32(0.0), np.float32(0.0), np.float32(1.0), np.float32(1.0), np.float32(0.0), np.float32(0.0), np.float32(0.0), np.float32(0.0), np.float32(1.0), np.float32(0.0), np.float32(0.0), np.float32(1.0), np.float32(1.0), np.float32(0.0), np.float32(0.0), np.float32(1.0)]",-4.0,99450.0,0
2025-08-14_08-18-36,5785,"[np.float32(0.0), np.float32(1.0), np.float32(1.0), np.float32(1.0), np.float32(1.0), np.float32(0.0), np.float32(1.0), np.float32(1.0), np.float32(0.0), np.float32(1.0), np.float32(0.0), np.float32(0.0), np.float32(0.0), np.float32(1.0), np.float32(0.0), np.float32(1.0)]",-7.0,99443.0,30
2025-08-14_08-18-36,5786,"[np.float32(1.0), np.float32(1.0), np.float32(0.0), np.float32(1.0), np.float32(0.0), np.float32(1.0), np.float32(0.0), np.float32(1.0), np.float32(1.0), np.float32(1.0), np.float32(0.0), np.float32(0.0), np.float32(0.0), np.float32(0.0), np.float32(1.0), np.float32(1.0)]",-2.0,99441.0,5
2025-08-14_08-18-36,5787,"[np.float32(0.0), np.float32(1.0), np.float32(1.0), np.float32(0.0), np.float32(1.0), np.float32(0.0), np.float32(1.0), np.float32(1.0), np.float32(0.0), np.float32(1.0), np.float32(0.0), np.float32(0.0), np.float32(0.0), np.float32(0.0), np.float32(1.0), np.float32(0.0)]",5.0,99446.0,4
2025-08-14_08-18-36,5788,"[np.float32(1.0), np.float32(1.0), np.float32(1.0), np.float32(1.0), np.float32(1.0), np.float32(0.0), np.float32(0.0), np.float32(0.0), np.float32(0.0), np.float32(1.0), np.float32(0.0), np.float32(0.0), np.float32(1.0), np.float32(1.0), np.float32(1.0), np.float32(0.0)]",-2.0,99444.0,33
2025-08-14_08-18-36,5789,"[np.float32(1.0), np.float32(1.0), np.float32(1.0), np.float32(1.0), np.float32(0.0), np.float32(0.0), np.float32(1.0), np.float32(0.0), np.float32(1.0), np.float32(1.0), np.float32(1.0), np.float32(1.0), np.float32(0.0), np.float32(0.0), np.float32(0.0), np.float32(0.0)]",1.0,99445.0,32
2025-08-14_08-18-36,5790,"[np.float32(0.0), np.float32(0.0), np.float32(1.0), np.float32(0.0), np.float32(0.0), np.float32(1.0), np.float32(0.0), np.float32(1.0), np.float32(1.0), np.float32(0.0), np.float32(1.0), np.float32(1.0), np.float32(0.0), np.float32(0.0), np.float32(1.0), np.float32(0.0)]",1.0,99446.0,21
2025-08-14_08-18-36,5791,"[np.float32(0.0), np.float32(0.0), np.float32(1.0), np.float32(0.0), np.float32(0.0), np.float32(1.0), np.float32(0.0), np.float32(0.0), np.float32(1.0), np.float32(1.0), np.float32(0.0), np.float32(1.0), np.float32(0.0), np.float32(0.0), np.float32(0.0), np.float32(1.0)]",-3.0,99443.0,3
2025-08-14_08-18-36,5792,"[np.float32(1.0), np.float32(0.0), np.float32(0.0), np.float32(0.0), np.float32(1.0), np.float32(0.0), np.float32(1.0), np.float32(1.0), np.float32(1.0), np.float32(1.0), np.float32(1.0), np.float32(1.0), np.float32(1.0), np.float32(1.0), np.float32(0.0), np.float32(0.0)]",1.0,99444.0,2
2025-08-14_08-18-36,5793,"[np.float32(0.0), np.float32(0.0), np.float32(1.0), np.float32(0.0), np.float32(0.0), np.float32(1.0), np.float32(1.0), np.float32(1.0), np.float32(1.0), np.float32(0.0), np.float32(0.0), np.float32(1.0), np.float32(0.0), np.float32(1.0), np.float32(1.0), np.float32(0.0)]",0.0,99444.0,10
2025-08-14_08-18-36,5794,"[np.float32(1.0), np.float32(1.0), np.float32(0.0), np.float32(0.0), np.float32(0.0), np.float32(1.0), np.float32(0.0), np.float32(0.0), np.float32(0.0), np.float32(1.0), np.float32(1.0), np.float32(0.0), np.float32(1.0), np.float32(1.0), np.float32(0.0), np.float32(1.0)]",0.0,99444.0,17
2025-08-14_08-18-36,5795,"[np.float32(1.0), np.float32(1.0), np.float32(0.0), np.float32(1.0), np.float32(1.0), np.float32(0.0), np.float32(1.0), np.float32(1.0), np.float32(1.0), np.float32(0.0), np.float32(0.0), np.float32(1.0), np.float32(1.0), np.float32(0.0), np.float32(1.0), np.float32(1.0)]",-3.0,99441.0,34
2025-08-14_08-18-36,5796,"[np.float32(0.0), np.float32(1.0), np.float32(0.0), np.float32(1.0), np.float32(0.0), np.float32(0.0), np.float32(1.0), np.float32(1.0), np.float32(1.0), np.float32(0.0), np.float32(1.0), np.float32(0.0), np.float32(1.0), np.float32(1.0), np.float32(0.0), np.float32(1.0)]",-3.0,99438.0,18
2025-08-14_08-18-36,5797,"[np.float32(0.0), np.float32(0.0), np.float32(0.0), np.float32(1.0), np.float32(1.0), np.float32(1.0), np.float32(1.0), np.float32(1.0), np.float32(0.0), np.float32(1.0), np.float32(1.0), np.float32(1.0), np.float32(1.0), np.float32(1.0), np.float32(1.0), np.float32(1.0)]",-1.0,99437.0,2
2025-08-14_08-18-36,5798,"[np.float32(1.0), np.float32(0.0), np.float32(0.0), np.float32(0.0), np.float32(0.0), np.float32(1.0), np.float32(1.0), np.float32(0.0), np.float32(1.0), np.float32(1.0), np.float32(1.0), np.float32(0.0), np.float32(1.0), np.float32(0.0), np.float32(1.0), np.float32(1.0)]",-1.0,99436.0,14
2025-08-14_08-18-36,5799,"[np.float32(1.0), np.float32(0.0), np.float32(0.0), np.float32(0.0), np.float32(1.0), np.float32(1.0), np.float32(1.0), np.float32(1.0), np.float32(0.0), np.float32(0.0), np.float32(0.0), np.float32(1.0), np.float32(1.0), np.float32(0.0), np.float32(1.0), np.float32(0.0)]",0.0,99436.0,10
2025-08-14_08-18-36,5800,"[np.float32(1.0), np.float32(0.0), np.float32(0.0), np.float32(1.0), np.float32(1.0), np.float32(1.0), np.float32(0.0), np.float32(1.0), np.float32(0.0), np.float32(0.0), np.float32(0.0), np.float32(0.0), np.float32(1.0), np.float32(1.0), np.float32(1.0), np.float32(0.0)]",-4.0,99432.0,34
2025-08-14_08-18-36,5801,"[np.float32(1.0), np.float32(0.0), np.float32(0.0), np.float32(0.0), np.float32(1.0), np.float32(1.0), np.float32(0.0), np.float32(0.0), np.float32(1.0), np.float32(0.0), np.float32(1.0), np.float32(1.0), np.float32(1.0), np.float32(1.0), np.float32(1.0), np.float32(0.0)]",-1.0,99431.0,2
2025-08-14_08-18-36,5802,"[np.float32(1.0), np.float32(0.0), np.float32(1.0), np.float32(0.0), np.float32(1.0), np.float32(0.0), np.float32(0.0), np.float32(0.0), np.float32(0.0), np.float32(1.0), np.float32(0.0), np.float32(1.0), np.float32(0.0), np.float32(1.0), np.float32(0.0), np.float32(0.0)]",-4.0,99427.0,11
2025-08-14_08-18-36,5803,"[np.float32(0.0), np.float32(0.0), np.float32(0.0), np.float32(0.0), np.float32(0.0), np.float32(1.0), np.float32(0.0), np.float32(1.0), np.float32(0.0), np.float32(0.0), np.float32(0.0), np.float32(1.0), np.float32(1.0), np.float32(1.0), np.float32(0.0), np.float32(0.0)]",-2.0,99425.0,9
2025-08-14_08-18-36,5804,"[np.float32(1.0), np.float32(0.0), np.float32(1.0), np.float32(0.0), np.float32(1.0), np.float32(0.0), np.float32(0.0), np.float32(1.0), np.float32(1.0), np.float32(1.0), np.float32(0.0), np.float32(1.0), np.float32(1.0), np.float32(0.0), np.float32(0.0), np.float32(0.0)]",-2.0,99423.0,31
2025-08-14_08-18-36,5805,"[np.float32(1.0), np.float32(1.0), np.float32(1.0), np.float32(1.0), np.float32(1.0), np.float32(1.0), np.float32(1.0), np.float32(0.0), np.float32(0.0), np.float32(0.0), np.float32(1.0), np.float32(0.0), np.float32(1.0), np.float32(1.0), np.float32(1.0), np.float32(1.0)]",0.0,99423.0,32
2025-08-14_08-18-36,5806,"[np.float32(1.0), np.float32(1.0), np.float32(1.0), np.float32(0.0), np.float32(1.0), np.float32(0.0), np.float32(1.0), np.float32(1.0), np.float32(0.0), np.float32(0.0), np.float32(0.0), np.float32(0.0), np.float32(1.0), np.float32(1.0), np.float32(0.0), np.float32(1.0)]",3.0,99426.0,6
2025-08-14_08-18-36,5807,"[np.float32(0.0), np.float32(0.0), np.float32(0.0), np.float32(1.0), np.float32(1.0), np.float32(1.0), np.float32(1.0), np.float32(1.0), np.float32(0.0), np.float32(1.0), np.float32(1.0), np.float32(0.0), np.float32(0.0), np.float32(0.0), np.float32(0.0), np.float32(0.0)]",1.0,99427.0,2
2025-08-14_08-18-36,5808,"[np.float32(1.0), np.float32(1.0), np.float32(1.0), np.float32(0.0), np.float32(0.0), np.float32(1.0), np.float32(1.0), np.float32(1.0), np.float32(0.0), np.float32(1.0), np.float32(1.0), np.float32(0.0), np.float32(1.0), np.float32(0.0), np.float32(1.0), np.float32(1.0)]",-2.0,99425.0,26
2025-08-14_08-18-36,5809,"[np.float32(1.0), np.float32(1.0), np.float32(0.0), np.float32(0.0), np.float32(1.0), np.float32(1.0), np.float32(0.0), np.float32(1.0), np.float32(1.0), np.float32(0.0), np.float32(1.0), np.float32(0.0), np.float32(0.0), np.float32(1.0), np.float32(1.0), np.float32(1.0)]",3.0,99428.0,29
2025-08-14_08-18-36,5810,"[np.float32(1.0), np.float32(0.0), np.float32(0.0), np.float32(0.0), np.float32(1.0), np.float32(0.0), np.float32(1.0), np.float32(0.0), np.float32(1.0), np.float32(0.0), np.float32(1.0), np.float32(0.0), np.float32(0.0), np.float32(1.0), np.float32(0.0), np.float32(1.0)]",3.0,99431.0,1
2025-08-14_08-18-36,5811,"[np.float32(0.0), np.float32(0.0), np.float32(0.0), np.float32(1.0), np.float32(0.0), np.float32(0.0), np.float32(0.0), np.float32(1.0), np.float32(0.0), np.float32(0.0), np.float32(1.0), np.float32(0.0), np.float32(0.0), np.float32(0.0), np.float32(1.0), np.float32(1.0)]",6.0,99437.0,23
2025-08-14_08-18-36,5812,"[np.float32(0.0), np.float32(0.0), np.float32(1.0), np.float32(0.0), np.float32(1.0), np.float32(1.0), np.float32(0.0), np.float32(1.0), np.float32(1.0), np.float32(1.0), np.float32(1.0), np.float32(0.0), np.float32(0.0), np.float32(1.0), np.float32(0.0), np.float32(0.0)]",0.0,99437.0,23
2025-08-14_08-18-36,5813,"[np.float32(1.0), np.float32(1.0), np.float32(1.0), np.float32(1.0), np.float32(0.0), np.float32(0.0), np.float32(1.0), np.float32(0.0), np.float32(1.0), np.float32(1.0), np.float32(1.0), np.float32(1.0), np.float32(1.0), np.float32(0.0), np.float32(0.0), np.float32(1.0)]",-4.0,99433.0,13
2025-08-14_08-18-36,5814,"[np.float32(1.0), np.float32(0.0), np.float32(1.0), np.float32(0.0), np.float32(0.0), np.float32(0.0), np.float32(0.0), np.float32(0.0), np.float32(0.0), np.float32(1.0), np.float32(0.0), np.float32(0.0), np.float32(0.0), np.float32(1.0), np.float32(0.0), np.float32(1.0)]",-3.0,99430.0,5
2025-08-14_08-18-36,5815,"[np.float32(0.0), np.float32(0.0), np.float32(0.0), np.float32(0.0), np.float32(0.0), np.float32(1.0), np.float32(1.0), np.float32(1.0), np.float32(0.0), np.float32(0.0), np.float32(0.0), np.float32(0.0), np.float32(1.0), np.float32(0.0), np.float32(1.0), np.float32(1.0)]",-4.0,99426.0,0
2025-08-14_08-18-36,5816,"[np.float32(1.0), np.float32(1.0), np.float32(0.0), np.float32(1.0), np.float32(1.0), np.float32(1.0), np.float32(0.0), np.float32(1.0), np.float32(1.0), np.float32(0.0), np.float32(0.0), np.float32(0.0), np.float32(1.0), np.float32(1.0), np.float32(0.0), np.float32(0.0)]",1.0,99427.0,28
2025-08-14_08-18-36,5817,"[np.float32(0.0), np.float32(1.0), np.float32(0.0), np.float32(1.0), np.float32(1.0), np.float32(1.0), np.float32(1.0), np.float32(1.0), np.float32(1.0), np.float32(0.0), np.float32(1.0), np.float32(1.0), np.float32(0.0), np.float32(0.0), np.float32(1.0), np.float32(0.0)]",3.0,99430.0,27
2025-08-14_08-18-36,5818,"[np.float32(1.0), np.float32(0.0), np.float32(1.0), np.float32(1.0), np.float32(0.0), np.float32(0.0), np.float32(1.0), np.float32(0.0), np.float32(1.0), np.float32(0.0), np.float32(1.0), np.float32(0.0), np.float32(0.0), np.float32(0.0), np.float32(0.0), np.float32(0.0)]",2.0,99432.0,8
2025-08-14_08-18-36,5819,"[np.float32(0.0), np.float32(1.0), np.float32(0.0), np.float32(0.0), np.float32(1.0), np.float32(0.0), np.float32(1.0), np.float32(1.0), np.float32(1.0), np.float32(0.0), np.float32(1.0), np.float32(1.0), np.float32(1.0), np.float32(1.0), np.float32(0.0), np.float32(0.0)]",-6.0,99426.0,34
2025-08-14_08-18-36,5820,"[np.float32(1.0), np.float32(1.0), np.float32(0.0), np.float32(0.0), np.float32(1.0), np.float32(1.0), np.float32(0.0), np.float32(1.0), np.float32(0.0), np.float32(0.0), np.float32(1.0), np.float32(1.0), np.float32(1.0), np.float32(1.0), np.float32(1.0), np.float32(0.0)]",0.0,99426.0,33
2025-08-14_08-18-36,5821,"[np.float32(0.0), np.float32(0.0), np.float32(1.0), np.float32(1.0), np.float32(0.0), np.float32(1.0), np.float32(1.0), np.float32(0.0), np.float32(0.0), np.float32(0.0), np.float32(1.0), np.float32(0.0), np.float32(0.0), np.float32(1.0), np.float32(1.0), np.float32(1.0)]",-1.0,99425.0,24
2025-08-14_08-18-36,5822,"[np.float32(1.0), np.float32(1.0), np.float32(0.0), np.float32(1.0), np.float32(0.0), np.float32(1.0), np.float32(1.0), np.float32(0.0), np.float32(0.0), np.float32(0.0), np.float32(1.0), np.float32(1.0), np.float32(0.0), np.float32(1.0), np.float32(0.0), np.float32(1.0)]",-4.0,99421.0,10
2025-08-14_08-18-36,5823,"[np.float32(1.0), np.float32(1.0), np.float32(1.0), np.float32(0.0), np.float32(0.0), np.float32(0.0), np.float32(0.0), np.float32(0.0), np.float32(1.0), np.float32(1.0), np.float32(1.0), np.float32(1.0), np.float32(1.0), np.float32(1.0), np.float32(0.0), np.float32(1.0)]",0.0,99421.0,12
2025-08-14_08-18-36,5824,"[np.float32(0.0), np.float32(0.0), np.float32(0.0), np.float32(0.0), np.float32(1.0), np.float32(1.0), np.float32(0.0), np.float32(0.0), np.float32(1.0), np.float32(0.0), np.float32(1.0), np.float32(1.0), np.float32(1.0), np.float32(0.0), np.float32(1.0), np.float32(1.0)]",3.0,99424.0,36
2025-08-14_08-18-36,5825,"[np.float32(1.0), np.float32(1.0), np.float32(0.0), np.float32(1.0), np.float32(0.0), np.float32(1.0), np.float32(0.0), np.float32(1.0), np.float32(0.0), np.float32(1.0), np.float32(1.0), np.float32(0.0), np.float32(0.0), np.float32(0.0), np.float32(1.0), np.float32(0.0)]",1.0,99425.0,35
2025-08-14_08-18-36,5826,"[np.float32(1.0), np.float32(1.0), np.float32(1.0), np.float32(1.0), np.float32(0.0), np.float32(0.0), np.float32(1.0), np.float32(1.0), np.float32(1.0), np.float32(1.0), np.float32(0.0), np.float32(1.0), np.float32(0.0), np.float32(1.0), np.float32(0.0), np.float32(0.0)]",-3.0,99422.0,5
2025-08-14_08-18-36,5827,"[np.float32(1.0), np.float32(0.0), np.float32(1.0), np.float32(1.0), np.float32(1.0), np.float32(0.0), np.float32(0.0), np.float32(1.0), np.float32(0.0), np.float32(0.0), np.float32(0.0), np.float32(0.0), np.float32(1.0), np.float32(0.0), np.float32(0.0), np.float32(0.0)]",-2.0,99420.0,32
2025-08-14_08-18-36,5828,"[np.float32(1.0), np.float32(0.0), np.float32(0.0), np.float32(0.0), np.float32(1.0), np.float32(1.0), np.float32(1.0), np.float32(1.0), np.float32(1.0), np.float32(0.0), np.float32(0.0), np.float32(0.0), np.float32(1.0), np.float32(0.0), np.float32(0.0), np.float32(0.0)]",0.0,99420.0,12
2025-08-14_08-18-36,5829,"[np.float32(1.0), np.float32(1.0), np.float32(1.0), np.float32(0.0), np.float32(1.0), np.float32(1.0), np.float32(0.0), np.float32(0.0), np.float32(0.0), np.float32(0.0), np.float32(1.0), np.float32(0.0), np.float32(0.0), np.float32(0.0), np.float32(0.0), np.float32(0.0)]",1.0,99421.0,29
2025-08-14_08-18-36,5830,"[np.float32(0.0), np.float32(1.0), np.float32(1.0), np.float32(1.0), np.float32(1.0), np.float32(0.0), np.float32(1.0), np.float32(1.0), np.float32(1.0), np.float32(0.0), np.float32(0.0), np.float32(0.0), np.float32(0.0), np.float32(0.0), np.float32(1.0), np.float32(1.0)]",-1.0,99420.0,34
2025-08-14_08-18-36,5831,"[np.float32(0.0), np.float32(0.0), np.float32(0.0), np.float32(0.0), np.float32(1.0), np.float32(0.0), np.float32(1.0), np.float32(0.0), np.float32(0.0), np.float32(0.0), np.float32(0.0), np.float32(0.0), np.float32(0.0), np.float32(1.0), np.float32(0.0), np.float32(0.0)]",0.0,99420.0,28
2025-08-14_08-18-36,5832,"[np.float32(1.0), np.float32(1.0), np.float32(0.0), np.float32(0.0), np.float32(0.0), np.float32(0.0), np.float32(0.0), np.float32(1.0), np.float32(1.0), np.float32(1.0), np.float32(1.0), np.float32(1.0), np.float32(0.0), np.float32(1.0), np.float32(1.0), np.float32(1.0)]",-2.0,99418.0,7
2025-08-14_08-18-36,5833,"[np.float32(1.0), np.float32(1.0), np.float32(0.0), np.float32(1.0), np.float32(0.0), np.float32(1.0), np.float32(0.0), np.float32(0.0), np.float32(0.0), np.float32(1.0), np.float32(1.0), np.float32(1.0), np.float32(1.0), np.float32(0.0), np.float32(1.0), np.float32(0.0)]",3.0,99421.0,23
2025-08-14_08-18-36,5834,"[np.float32(0.0), np.float32(0.0), np.float32(0.0), np.float32(1.0), np.float32(0.0), np.float32(1.0), np.float32(0.0), np.float32(1.0), np.float32(1.0), np.float32(0.0), np.float32(1.0), np.float32(0.0), np.float32(0.0), np.float32(1.0), np.float32(1.0), np.float32(1.0)]",-3.0,99418.0,1
2025-08-14_08-18-36,5835,"[np.float32(1.0), np.float32(0.0), np.float32(1.0), np.float32(1.0), np.float32(0.0), np.float32(1.0), np.float32(0.0), np.float32(1.0), np.float32(0.0), np.float32(1.0), np.float32(1.0), np.float32(1.0), np.float32(0.0), np.float32(1.0), np.float32(0.0), np.float32(0.0)]",3.0,99421.0,32
2025-08-14_08-18-36,5836,"[np.float32(0.0), np.float32(1.0), np.float32(0.0), np.float32(0.0), np.float32(1.0), np.float32(1.0), np.float32(1.0), np.float32(1.0), np.float32(1.0), np.float32(0.0), np.float32(0.0), np.float32(0.0), np.float32(1.0), np.float32(0.0), np.float32(1.0), np.float32(0.0)]",-3.0,99418.0,32
2025-08-14_08-18-36,5837,"[np.float32(1.0), np.float32(0.0), np.float32(1.0), np.float32(0.0), np.float32(1.0), np.float32(0.0), np.float32(0.0), np.float32(1.0), np.float32(1.0), np.float32(0.0), np.float32(0.0), np.float32(0.0), np.float32(0.0), np.float32(1.0), np.float32(1.0), np.float32(1.0)]",-1.0,99417.0,4
2025-08-14_08-18-36,5838,"[np.float32(0.0), np.float32(1.0), np.float32(0.0), np.float32(0.0), np.float32(1.0), np.float32(0.0), np.float32(0.0), np.float32(0.0), np.float32(0.0), np.float32(0.0), np.float32(0.0), np.float32(0.0), np.float32(0.0), np.float32(1.0), np.float32(0.0), np.float32(0.0)]",4.0,99421.0,4
2025-08-14_08-18-36,5839,"[np.float32(1.0), np.float32(0.0), np.float32(1.0), np.float32(1.0), np.float32(0.0), np.float32(0.0), np.float32(1.0), np.float32(0.0), np.float32(1.0), np.float32(1.0), np.float32(0.0), np.float32(0.0), np.float32(0.0), np.float32(1.0), np.float32(0.0), np.float32(1.0)]",3.0,99424.0,31
2025-08-14_08-18-36,5840,"[np.float32(0.0), np.float32(0.0), np.float32(1.0), np.float32(1.0), np.float32(0.0), np.float32(1.0), np.float32(0.0), np.float32(1.0), np.float32(1.0), np.float32(1.0), np.float32(0.0), np.float32(0.0), np.float32(0.0), np.float32(1.0), np.float32(1.0), np.float32(1.0)]",4.0,99428.0,25
2025-08-14_08-18-36,5841,"[np.float32(1.0), np.float32(0.0), np.float32(0.0), np.float32(0.0), np.float32(0.0), np.float32(0.0), np.float32(1.0), np.float32(1.0), np.float32(1.0), np.float32(0.0), np.float32(0.0), np.float32(0.0), np.float32(1.0), np.float32(0.0), np.float32(0.0), np.float32(0.0)]",-2.0,99426.0,13
2025-08-14_08-18-36,5842,"[np.float32(0.0), np.float32(1.0), np.float32(0.0), np.float32(1.0), np.float32(0.0), np.float32(1.0), np.float32(0.0), np.float32(1.0), np.float32(1.0), np.float32(0.0), np.float32(1.0), np.float32(0.0), np.float32(1.0), np.float32(1.0), np.float32(1.0), np.float32(0.0)]",1.0,99427.0,21
2025-08-14_08-18-36,5843,"[np.float32(0.0), np.float32(0.0), np.float32(0.0), np.float32(0.0), np.float32(0.0), np.float32(1.0), np.float32(1.0), np.float32(1.0), np.float32(1.0), np.float32(0.0), np.float32(0.0), np.float32(0.0), np.float32(0.0), np.float32(1.0), np.float32(0.0), np.float32(0.0)]",1.0,99428.0,18
2025-08-14_08-18-36,5844,"[np.float32(0.0), np.float32(0.0), np.float32(1.0), np.float32(1.0), np.float32(1.0), np.float32(0.0), np.float32(0.0), np.float32(0.0), np.float32(0.0), np.float32(0.0), np.float32(1.0), np.float32(0.0), np.float32(1.0), np.float32(0.0), np.float32(1.0), np.float32(1.0)]",3.0,99431.0,17
2025-08-14_08-18-36,5845,"[np.float32(1.0), np.float32(1.0), np.float32(1.0), np.float32(1.0), np.float32(0.0), np.float32(0.0), np.float32(1.0), np.float32(0.0), np.float32(1.0), np.float32(0.0), np.float32(1.0), np.float32(1.0), np.float32(1.0), np.float32(0.0), np.float32(0.0), np.float32(0.0)]",-5.0,99426.0,19
2025-08-14_08-18-36,5846,"[np.float32(0.0), np.float32(1.0), np.float32(0.0), np.float32(1.0), np.float32(1.0), np.float32(0.0), np.float32(0.0), np.float32(1.0), np.float32(1.0), np.float32(1.0), np.float32(0.0), np.float32(1.0), np.float32(0.0), np.float32(0.0), np.float32(0.0), np.float32(1.0)]",-3.0,99423.0,12
2025-08-14_08-18-36,5847,"[np.float32(1.0), np.float32(0.0), np.float32(0.0), np.float32(1.0), np.float32(1.0), np.float32(0.0), np.float32(1.0), np.float32(1.0), np.float32(0.0), np.float32(0.0), np.float32(1.0), np.float32(1.0), np.float32(0.0), np.float32(1.0), np.float32(0.0), np.float32(1.0)]",-1.0,99422.0,29
2025-08-14_08-18-36,5848,"[np.float32(1.0), np.float32(1.0), np.float32(0.0), np.float32(1.0), np.float32(1.0), np.float32(0.0), np.float32(0.0), np.float32(1.0), np.float32(0.0), np.float32(0.0), np.float32(1.0), np.float32(1.0), np.float32(0.0), np.float32(1.0), np.float32(0.0), np.float32(1.0)]",-4.0,99418.0,28
2025-08-14_08-18-36,5849,"[np.float32(1.0), np.float32(1.0), np.float32(0.0), np.float32(1.0), np.float32(0.0), np.float32(0.0), np.float32(0.0), np.float32(1.0), np.float32(0.0), np.float32(0.0), np.float32(0.0), np.float32(1.0), np.float32(0.0), np.float32(1.0), np.float32(1.0), np.float32(0.0)]",0.0,99418.0,7
2025-08-14_08-18-36,5850,"[np.float32(1.0), np.float32(1.0), np.float32(0.0), np.float32(0.0), np.float32(1.0), np.float32(1.0), np.float32(1.0), np.float32(1.0), np.float32(0.0), np.float32(1.0), np.float32(1.0), np.float32(1.0), np.float32(1.0), np.float32(1.0), np.float32(0.0), np.float32(1.0)]",1.0,99419.0,17
2025-08-14_08-18-36,5851,"[np.float32(0.0), np.float32(0.0), np.float32(0.0), np.float32(0.0), np.float32(1.0), np.float32(0.0), np.float32(0.0), np.float32(1.0), np.float32(0.0), np.float32(1.0), np.float32(0.0), np.float32(0.0), np.float32(0.0), np.float32(0.0), np.float32(0.0), np.float32(1.0)]",-2.0,99417.0,5
2025-08-14_08-18-36,5852,"[np.float32(1.0), np.float32(0.0), np.float32(1.0), np.float32(1.0), np.float32(1.0), np.float32(0.0), np.float32(0.0), np.float32(0.0), np.float32(1.0), np.float32(1.0), np.float32(0.0), np.float32(1.0), np.float32(0.0), np.float32(1.0), np.float32(1.0), np.float32(1.0)]",-5.0,99412.0,20
2025-08-14_08-18-36,5853,"[np.float32(1.0), np.float32(0.0), np.float32(1.0), np.float32(0.0), np.float32(1.0), np.float32(0.0), np.float32(0.0), np.float32(0.0), np.float32(1.0), np.float32(0.0), np.float32(0.0), np.float32(0.0), np.float32(1.0), np.float32(0.0), np.float32(0.0), np.float32(0.0)]",-1.0,99411.0,6
2025-08-14_08-18-36,5854,"[np.float32(0.0), np.float32(1.0), np.float32(1.0), np.float32(1.0), np.float32(1.0), np.float32(1.0), np.float32(1.0), np.float32(0.0), np.float32(0.0), np.float32(1.0), np.float32(1.0), np.float32(1.0), np.float32(0.0), np.float32(1.0), np.float32(1.0), np.float32(0.0)]",1.0,99412.0,6
2025-08-14_08-18-36,5855,"[np.float32(0.0), np.float32(1.0), np.float32(0.0), np.float32(1.0), np.float32(0.0), np.float32(1.0), np.float32(0.0), np.float32(1.0), np.float32(0.0), np.float32(0.0), np.float32(1.0), np.float32(0.0), np.float32(0.0), np.float32(1.0), np.float32(1.0), np.float32(0.0)]",1.0,99413.0,32
2025-08-14_08-18-36,5856,"[np.float32(1.0), np.float32(0.0), np.float32(1.0), np.float32(0.0), np.float32(1.0), np.float32(1.0), np.float32(0.0), np.float32(0.0), np.float32(0.0), np.float32(1.0), np.float32(1.0), np.float32(0.0), np.float32(0.0), np.float32(1.0), np.float32(0.0), np.float32(1.0)]",0.0,99413.0,17
2025-08-14_08-18-36,5857,"[np.float32(1.0), np.float32(1.0), np.float32(1.0), np.float32(0.0), np.float32(0.0), np.float32(0.0), np.float32(0.0), np.float32(1.0), np.float32(0.0), np.float32(0.0), np.float32(0.0), np.float32(1.0), np.float32(1.0), np.float32(0.0), np.float32(0.0), np.float32(1.0)]",31.0,99444.0,7
2025-08-14_08-18-36,5858,"[np.float32(0.0), np.float32(1.0), np.float32(0.0), np.float32(1.0), np.float32(1.0), np.float32(1.0), np.float32(0.0), np.float32(1.0), np.float32(1.0), np.float32(0.0), np.float32(1.0), np.float32(1.0), np.float32(0.0), np.float32(0.0), np.float32(1.0), np.float32(0.0)]",-1.0,99443.0,32
2025-08-14_08-18-36,5859,"[np.float32(0.0), np.float32(0.0), np.float32(1.0), np.float32(1.0), np.float32(1.0), np.float32(0.0), np.float32(1.0), np.float32(1.0), np.float32(1.0), np.float32(1.0), np.float32(0.0), np.float32(0.0), np.float32(0.0), np.float32(1.0), np.float32(1.0), np.float32(0.0)]",4.0,99447.0,16
2025-08-14_08-18-36,5860,"[np.float32(1.0), np.float32(0.0), np.float32(0.0), np.float32(0.0), np.float32(1.0), np.float32(1.0), np.float32(0.0), np.float32(0.0), np.float32(0.0), np.float32(1.0), np.float32(0.0), np.float32(1.0), np.float32(0.0), np.float32(0.0), np.float32(0.0), np.float32(0.0)]",2.0,99449.0,21
2025-08-14_08-18-36,5861,"[np.float32(1.0), np.float32(0.0), np.float32(1.0), np.float32(0.0), np.float32(0.0), np.float32(1.0), np.float32(1.0), np.float32(1.0), np.float32(1.0), np.float32(0.0), np.float32(0.0), np.float32(0.0), np.float32(0.0), np.float32(1.0), np.float32(1.0), np.float32(0.0)]",2.0,99451.0,16
2025-08-14_08-18-36,5862,"[np.float32(0.0), np.float32(1.0), np.float32(1.0), np.float32(1.0), np.float32(1.0), np.float32(0.0), np.float32(1.0), np.float32(1.0), np.float32(0.0), np.float32(0.0), np.float32(0.0), np.float32(1.0), np.float32(0.0), np.float32(0.0), np.float32(0.0), np.float32(0.0)]",-2.0,99449.0,27
2025-08-14_08-18-36,5863,"[np.float32(0.0), np.float32(1.0), np.float32(1.0), np.float32(0.0), np.float32(0.0), np.float32(1.0), np.float32(1.0), np.float32(0.0), np.float32(1.0), np.float32(1.0), np.float32(0.0), np.float32(0.0), np.float32(1.0), np.float32(0.0), np.float32(0.0), np.float32(0.0)]",-2.0,99447.0,13
2025-08-14_08-18-36,5864,"[np.float32(0.0), np.float32(1.0), np.float32(1.0), np.float32(0.0), np.float32(0.0), np.float32(1.0), np.float32(1.0), np.float32(0.0), np.float32(1.0), np.float32(1.0), np.float32(0.0), np.float32(0.0), np.float32(0.0), np.float32(0.0), np.float32(0.0), np.float32(1.0)]",6.0,99453.0,31
2025-08-14_08-18-36,5865,"[np.float32(1.0), np.float32(0.0), np.float32(0.0), np.float32(0.0), np.float32(0.0), np.float32(1.0), np.float32(1.0), np.float32(0.0), np.float32(1.0), np.float32(1.0), np.float32(0.0), np.float32(0.0), np.float32(1.0), np.float32(1.0), np.float32(1.0), np.float32(0.0)]",-2.0,99451.0,8
2025-08-14_08-18-36,5866,"[np.float32(0.0), np.float32(1.0), np.float32(1.0), np.float32(0.0), np.float32(0.0), np.float32(1.0), np.float32(0.0), np.float32(0.0), np.float32(1.0), np.float32(0.0), np.float32(1.0), np.float32(0.0), np.float32(1.0), np.float32(1.0), np.float32(0.0), np.float32(1.0)]",-1.0,99450.0,33
2025-08-14_08-18-36,5867,"[np.float32(1.0), np.float32(1.0), np.float32(1.0), np.float32(1.0), np.float32(0.0), np.float32(0.0), np.float32(1.0), np.float32(1.0), np.float32(0.0), np.float32(1.0), np.float32(0.0), np.float32(1.0), np.float32(0.0), np.float32(1.0), np.float32(0.0), np.float32(1.0)]",0.0,99450.0,25
2025-08-14_08-18-36,5868,"[np.float32(0.0), np.float32(0.0), np.float32(0.0), np.float32(0.0), np.float32(0.0), np.float32(1.0), np.float32(0.0), np.float32(1.0), np.float32(0.0), np.float32(1.0), np.float32(0.0), np.float32(1.0), np.float32(0.0), np.float32(0.0), np.float32(0.0), np.float32(0.0)]",1.0,99451.0,31
2025-08-14_08-18-36,5869,"[np.float32(1.0), np.float32(1.0), np.float32(0.0), np.float32(1.0), np.float32(1.0), np.float32(1.0), np.float32(1.0), np.float32(1.0), np.float32(1.0), np.float32(1.0), np.float32(0.0), np.float32(1.0), np.float32(1.0), np.float32(0.0), np.float32(1.0), np.float32(0.0)]",-2.0,99449.0,28
2025-08-14_08-18-36,5870,"[np.float32(1.0), np.float32(1.0), np.float32(0.0), np.float32(1.0), np.float32(0.0), np.float32(1.0), np.float32(1.0), np.float32(0.0), np.float32(1.0), np.float32(1.0), np.float32(1.0), np.float32(0.0), np.float32(1.0), np.float32(0.0), np.float32(0.0), np.float32(1.0)]",-2.0,99447.0,6
2025-08-14_08-18-36,5871,"[np.float32(0.0), np.float32(0.0), np.float32(1.0), np.float32(0.0), np.float32(0.0), np.float32(1.0), np.float32(0.0), np.float32(0.0), np.float32(1.0), np.float32(0.0), np.float32(0.0), np.float32(0.0), np.float32(0.0), np.float32(1.0), np.float32(0.0), np.float32(0.0)]",1.0,99448.0,19
2025-08-14_08-18-36,5872,"[np.float32(1.0), np.float32(0.0), np.float32(1.0), np.float32(1.0), np.float32(1.0), np.float32(1.0), np.float32(1.0), np.float32(0.0), np.float32(1.0), np.float32(1.0), np.float32(0.0), np.float32(1.0), np.float32(1.0), np.float32(0.0), np.float32(1.0), np.float32(1.0)]",-2.0,99446.0,13
2025-08-14_08-18-36,5873,"[np.float32(1.0), np.float32(1.0), np.float32(0.0), np.float32(1.0), np.float32(0.0), np.float32(1.0), np.float32(1.0), np.float32(1.0), np.float32(1.0), np.float32(0.0), np.float32(0.0), np.float32(0.0), np.float32(0.0), np.float32(0.0), np.float32(1.0), np.float32(0.0)]",-3.0,99443.0,4
2025-08-14_08-18-36,5874,"[np.float32(1.0), np.float32(0.0), np.float32(0.0), np.float32(1.0), np.float32(1.0), np.float32(1.0), np.float32(0.0), np.float32(0.0), np.float32(1.0), np.float32(0.0), np.float32(0.0), np.float32(0.0), np.float32(0.0), np.float32(0.0), np.float32(1.0), np.float32(0.0)]",1.0,99444.0,32
2025-08-14_08-18-36,5875,"[np.float32(0.0), np.float32(1.0), np.float32(1.0), np.float32(1.0), np.float32(1.0), np.float32(1.0), np.float32(0.0), np.float32(0.0), np.float32(0.0), np.float32(0.0), np.float32(0.0), np.float32(1.0), np.float32(1.0), np.float32(1.0), np.float32(1.0), np.float32(1.0)]",-1.0,99443.0,0
2025-08-14_08-18-36,5876,"[np.float32(0.0), np.float32(1.0), np.float32(0.0), np.float32(0.0), np.float32(1.0), np.float32(1.0), np.float32(1.0), np.float32(1.0), np.float32(0.0), np.float32(1.0), np.float32(1.0), np.float32(1.0), np.float32(0.0), np.float32(1.0), np.float32(0.0), np.float32(0.0)]",2.0,99445.0,12
2025-08-14_08-18-36,5877,"[np.float32(0.0), np.float32(1.0), np.float32(1.0), np.float32(0.0), np.float32(0.0), np.float32(1.0), np.float32(0.0), np.float32(1.0), np.float32(1.0), np.float32(1.0), np.float32(0.0), np.float32(0.0), np.float32(0.0), np.float32(0.0), np.float32(0.0), np.float32(0.0)]",3.0,99448.0,24
2025-08-14_08-18-36,5878,"[np.float32(0.0), np.float32(0.0), np.float32(0.0), np.float32(0.0), np.float32(0.0), np.float32(0.0), np.float32(1.0), np.float32(0.0), np.float32(0.0), np.float32(1.0), np.float32(1.0), np.float32(0.0), np.float32(0.0), np.float32(0.0), np.float32(1.0), np.float32(0.0)]",5.0,99453.0,5
2025-08-14_08-18-36,5879,"[np.float32(0.0), np.float32(0.0), np.float32(0.0), np.float32(1.0), np.float32(0.0), np.float32(1.0), np.float32(1.0), np.float32(0.0), np.float32(1.0), np.float32(1.0), np.float32(0.0), np.float32(1.0), np.float32(0.0), np.float32(0.0), np.float32(1.0), np.float32(1.0)]",-3.0,99450.0,22
2025-08-14_08-18-36,5880,"[np.float32(1.0), np.float32(0.0), np.float32(0.0), np.float32(1.0), np.float32(0.0), np.float32(0.0), np.float32(0.0), np.float32(0.0), np.float32(1.0), np.float32(0.0), np.float32(0.0), np.float32(1.0), np.float32(1.0), np.float32(0.0), np.float32(0.0), np.float32(0.0)]",0.0,99450.0,34
2025-08-14_08-18-36,5881,"[np.float32(1.0), np.float32(0.0), np.float32(1.0), np.float32(1.0), np.float32(1.0), np.float32(0.0), np.float32(0.0), np.float32(0.0), np.float32(0.0), np.float32(0.0), np.float32(1.0), np.float32(0.0), np.float32(0.0), np.float32(0.0), np.float32(1.0), np.float32(1.0)]",0.0,99450.0,32
2025-08-14_08-18-36,5882,"[np.float32(1.0), np.float32(0.0), np.float32(1.0), np.float32(1.0), np.float32(0.0), np.float32(1.0), np.float32(0.0), np.float32(1.0), np.float32(0.0), np.float32(1.0), np.float32(1.0), np.float32(1.0), np.float32(1.0), np.float32(1.0), np.float32(1.0), np.float32(0.0)]",1.0,99451.0,36
2025-08-14_08-18-36,5883,"[np.float32(0.0), np.float32(0.0), np.float32(1.0), np.float32(0.0), np.float32(1.0), np.float32(1.0), np.float32(0.0), np.float32(1.0), np.float32(0.0), np.float32(1.0), np.float32(0.0), np.float32(1.0), np.float32(0.0), np.float32(0.0), np.float32(0.0), np.float32(1.0)]",0.0,99451.0,30
2025-08-14_08-18-36,5884,"[np.float32(1.0), np.float32(0.0), np.float32(1.0), np.float32(1.0), np.float32(1.0), np.float32(0.0), np.float32(1.0), np.float32(0.0), np.float32(1.0), np.float32(0.0), np.float32(1.0), np.float32(0.0), np.float32(1.0), np.float32(0.0), np.float32(1.0), np.float32(0.0)]",0.0,99451.0,1
2025-08-14_08-18-36,5885,"[np.float32(0.0), np.float32(0.0), np.float32(1.0), np.float32(0.0), np.float32(0.0), np.float32(0.0), np.float32(0.0), np.float32(0.0), np.float32(1.0), np.float32(1.0), np.float32(1.0), np.float32(1.0), np.float32(0.0), np.float32(1.0), np.float32(0.0), np.float32(1.0)]",1.0,99452.0,14
2025-08-14_08-18-36,5886,"[np.float32(0.0), np.float32(0.0), np.float32(0.0), np.float32(0.0), np.float32(0.0), np.float32(1.0), np.float32(1.0), np.float32(0.0), np.float32(1.0), np.float32(0.0), np.float32(0.0), np.float32(0.0), np.float32(0.0), np.float32(1.0), np.float32(1.0), np.float32(0.0)]",1.0,99453.0,3
2025-08-14_08-18-36,5887,"[np.float32(0.0), np.float32(0.0), np.float32(0.0), np.float32(1.0), np.float32(0.0), np.float32(0.0), np.float32(1.0), np.float32(1.0), np.float32(1.0), np.float32(0.0), np.float32(1.0), np.float32(1.0), np.float32(1.0), np.float32(1.0), np.float32(1.0), np.float32(1.0)]",-1.0,99452.0,6
2025-08-14_08-18-36,5888,"[np.float32(1.0), np.float32(0.0), np.float32(1.0), np.float32(1.0), np.float32(0.0), np.float32(1.0), np.float32(0.0), np.float32(1.0), np.float32(1.0), np.float32(1.0), np.float32(0.0), np.float32(1.0), np.float32(0.0), np.float32(0.0), np.float32(1.0), np.float32(0.0)]",-1.0,99451.0,10
2025-08-14_08-18-36,5889,"[np.float32(0.0), np.float32(1.0), np.float32(1.0), np.float32(1.0), np.float32(0.0), np.float32(1.0), np.float32(0.0), np.float32(1.0), np.float32(1.0), np.float32(0.0), np.float32(1.0), np.float32(0.0), np.float32(0.0), np.float32(1.0), np.float32(0.0), np.float32(0.0)]",2.0,99453.0,23
2025-08-14_08-18-36,5890,"[np.float32(1.0), np.float32(0.0), np.float32(1.0), np.float32(0.0), np.float32(1.0), np.float32(1.0), np.float32(0.0), np.float32(1.0), np.float32(0.0), np.float32(0.0), np.float32(0.0), np.float32(1.0), np.float32(0.0), np.float32(1.0), np.float32(1.0), np.float32(1.0)]",3.0,99456.0,36
2025-08-14_08-18-36,5891,"[np.float32(1.0), np.float32(1.0), np.float32(0.0), np.float32(1.0), np.float32(1.0), np.float32(0.0), np.float32(1.0), np.float32(1.0), np.float32(1.0), np.float32(1.0), np.float32(1.0), np.float32(1.0), np.float32(0.0), np.float32(0.0), np.float32(1.0), np.float32(1.0)]",-1.0,99455.0,20
2025-08-14_08-18-36,5892,"[np.float32(1.0), np.float32(0.0), np.float32(0.0), np.float32(0.0), np.float32(0.0), np.float32(1.0), np.float32(0.0), np.float32(1.0), np.float32(1.0), np.float32(1.0), np.float32(0.0), np.float32(0.0), np.float32(1.0), np.float32(1.0), np.float32(0.0), np.float32(1.0)]",-3.0,99452.0,24
2025-08-14_08-18-36,5893,"[np.float32(1.0), np.float32(0.0), np.float32(1.0), np.float32(1.0), np.float32(1.0), np.float32(0.0), np.float32(0.0), np.float32(1.0), np.float32(1.0), np.float32(0.0), np.float32(1.0), np.float32(0.0), np.float32(0.0), np.float32(0.0), np.float32(0.0), np.float32(0.0)]",0.0,99452.0,30
2025-08-14_08-18-36,5894,"[np.float32(1.0), np.float32(0.0), np.float32(1.0), np.float32(1.0), np.float32(0.0), np.float32(0.0), np.float32(1.0), np.float32(1.0), np.float32(0.0), np.float32(1.0), np.float32(0.0), np.float32(0.0), np.float32(0.0), np.float32(1.0), np.float32(0.0), np.float32(0.0)]",-5.0,99447.0,33
2025-08-14_08-18-36,5895,"[np.float32(1.0), np.float32(0.0), np.float32(1.0), np.float32(1.0), np.float32(1.0), np.float32(0.0), np.float32(1.0), np.float32(1.0), np.float32(1.0), np.float32(0.0), np.float32(0.0), np.float32(1.0), np.float32(0.0), np.float32(1.0), np.float32(0.0), np.float32(0.0)]",-2.0,99445.0,23
2025-08-14_08-18-36,5896,"[np.float32(0.0), np.float32(1.0), np.float32(1.0), np.float32(1.0), np.float32(1.0), np.float32(0.0), np.float32(1.0), np.float32(1.0), np.float32(1.0), np.float32(0.0), np.float32(1.0), np.float32(0.0), np.float32(1.0), np.float32(0.0), np.float32(0.0), np.float32(1.0)]",-1.0,99444.0,13
2025-08-14_08-18-36,5897,"[np.float32(1.0), np.float32(1.0), np.float32(1.0), np.float32(1.0), np.float32(1.0), np.float32(0.0), np.float32(0.0), np.float32(1.0), np.float32(1.0), np.float32(0.0), np.float32(1.0), np.float32(1.0), np.float32(1.0), np.float32(0.0), np.float32(1.0), np.float32(0.0)]",-4.0,99440.0,31
2025-08-14_08-18-36,5898,"[np.float32(0.0), np.float32(0.0), np.float32(0.0), np.float32(1.0), np.float32(0.0), np.float32(0.0), np.float32(1.0), np.float32(0.0), np.float32(1.0), np.float32(1.0), np.float32(0.0), np.float32(1.0), np.float32(0.0), np.float32(1.0), np.float32(1.0), np.float32(1.0)]",3.0,99443.0,27
2025-08-14_08-18-36,5899,"[np.float32(0.0), np.float32(0.0), np.float32(1.0), np.float32(0.0), np.float32(0.0), np.float32(1.0), np.float32(0.0), np.float32(1.0), np.float32(1.0), np.float32(1.0), np.float32(0.0), np.float32(0.0), np.float32(1.0), np.float32(1.0), np.float32(1.0), np.float32(0.0)]",2.0,99445.0,34
2025-08-14_08-18-36,5900,"[np.float32(0.0), np.float32(1.0), np.float32(0.0), np.float32(0.0), np.float32(0.0), np.float32(0.0), np.float32(1.0), np.float32(1.0), np.float32(1.0), np.float32(0.0), np.float32(0.0), np.float32(0.0), np.float32(0.0), np.float32(0.0), np.float32(0.0), np.float32(0.0)]",-1.0,99444.0,9
2025-08-14_08-18-36,5901,"[np.float32(0.0), np.float32(0.0), np.float32(1.0), np.float32(1.0), np.float32(0.0), np.float32(0.0), np.float32(0.0), np.float32(1.0), np.float32(0.0), np.float32(0.0), np.float32(1.0), np.float32(0.0), np.float32(1.0), np.float32(0.0), np.float32(1.0), np.float32(1.0)]",-2.0,99442.0,30
2025-08-14_08-18-36,5902,"[np.float32(0.0), np.float32(1.0), np.float32(0.0), np.float32(0.0), np.float32(0.0), np.float32(1.0), np.float32(1.0), np.float32(0.0), np.float32(1.0), np.float32(0.0), np.float32(0.0), np.float32(0.0), np.float32(0.0), np.float32(1.0), np.float32(0.0), np.float32(0.0)]",-2.0,99440.0,5
2025-08-14_08-18-36,5903,"[np.float32(1.0), np.float32(0.0), np.float32(0.0), np.float32(0.0), np.float32(1.0), np.float32(1.0), np.float32(1.0), np.float32(1.0), np.float32(0.0), np.float32(0.0), np.float32(1.0), np.float32(1.0), np.float32(1.0), np.float32(1.0), np.float32(1.0), np.float32(1.0)]",-3.0,99437.0,33
2025-08-14_08-18-36,5904,"[np.float32(1.0), np.float32(1.0), np.float32(0.0), np.float32(0.0), np.float32(1.0), np.float32(1.0), np.float32(1.0), np.float32(1.0), np.float32(1.0), np.float32(1.0), np.float32(1.0), np.float32(0.0), np.float32(0.0), np.float32(1.0), np.float32(1.0), np.float32(0.0)]",2.0,99439.0,10
2025-08-14_08-18-36,5905,"[np.float32(0.0), np.float32(0.0), np.float32(0.0), np.float32(0.0), np.float32(1.0), np.float32(1.0), np.float32(0.0), np.float32(1.0), np.float32(1.0), np.float32(1.0), np.float32(1.0), np.float32(1.0), np.float32(0.0), np.float32(0.0), np.float32(0.0), np.float32(1.0)]",0.0,99439.0,9
2025-08-14_08-18-36,5906,"[np.float32(0.0), np.float32(1.0), np.float32(0.0), np.float32(1.0), np.float32(0.0), np.float32(0.0), np.float32(1.0), np.float32(1.0), np.float32(0.0), np.float32(0.0), np.float32(0.0), np.float32(0.0), np.float32(0.0), np.float32(0.0), np.float32(1.0), np.float32(0.0)]",-3.0,99436.0,28
2025-08-14_08-18-36,5907,"[np.float32(1.0), np.float32(1.0), np.float32(0.0), np.float32(1.0), np.float32(0.0), np.float32(0.0), np.float32(1.0), np.float32(1.0), np.float32(0.0), np.float32(0.0), np.float32(1.0), np.float32(1.0), np.float32(0.0), np.float32(0.0), np.float32(0.0), np.float32(0.0)]",0.0,99436.0,33
2025-08-14_08-18-36,5908,"[np.float32(1.0), np.float32(0.0), np.float32(1.0), np.float32(1.0), np.float32(1.0), np.float32(1.0), np.float32(0.0), np.float32(1.0), np.float32(0.0), np.float32(0.0), np.float32(1.0), np.float32(0.0), np.float32(0.0), np.float32(0.0), np.float32(0.0), np.float32(0.0)]",-3.0,99433.0,10
2025-08-14_08-18-36,5909,"[np.float32(0.0), np.float32(0.0), np.float32(1.0), np.float32(0.0), np.float32(1.0), np.float32(0.0), np.float32(1.0), np.float32(0.0), np.float32(1.0), np.float32(0.0), np.float32(1.0), np.float32(1.0), np.float32(1.0), np.float32(1.0), np.float32(0.0), np.float32(0.0)]",-5.0,99428.0,31
2025-08-14_08-18-36,5910,"[np.float32(0.0), np.float32(0.0), np.float32(1.0), np.float32(1.0), np.float32(1.0), np.float32(0.0), np.float32(1.0), np.float32(1.0), np.float32(1.0), np.float32(1.0), np.float32(1.0), np.float32(1.0), np.float32(1.0), np.float32(0.0), np.float32(0.0), np.float32(0.0)]",-2.0,99426.0,31
2025-08-14_08-18-36,5911,"[np.float32(0.0), np.float32(0.0), np.float32(0.0), np.float32(0.0), np.float32(1.0), np.float32(0.0), np.float32(1.0), np.float32(1.0), np.float32(1.0), np.float32(1.0), np.float32(1.0), np.float32(0.0), np.float32(0.0), np.float32(0.0), np.float32(0.0), np.float32(1.0)]",-2.0,99424.0,3
2025-08-14_08-18-36,5912,"[np.float32(0.0), np.float32(0.0), np.float32(1.0), np.float32(1.0), np.float32(0.0), np.float32(0.0), np.float32(1.0), np.float32(1.0), np.float32(1.0), np.float32(1.0), np.float32(0.0), np.float32(0.0), np.float32(0.0), np.float32(0.0), np.float32(1.0), np.float32(0.0)]",-2.0,99422.0,6
2025-08-14_08-18-36,5913,"[np.float32(0.0), np.float32(0.0), np.float32(0.0), np.float32(1.0), np.float32(0.0), np.float32(0.0), np.float32(0.0), np.float32(1.0), np.float32(0.0), np.float32(1.0), np.float32(1.0), np.float32(1.0), np.float32(0.0), np.float32(1.0), np.float32(0.0), np.float32(0.0)]",5.0,99427.0,21
2025-08-14_08-18-36,5914,"[np.float32(0.0), np.float32(1.0), np.float32(0.0), np.float32(0.0), np.float32(0.0), np.float32(0.0), np.float32(1.0), np.float32(1.0), np.float32(1.0), np.float32(1.0), np.float32(0.0), np.float32(1.0), np.float32(1.0), np.float32(0.0), np.float32(0.0), np.float32(1.0)]",3.0,99430.0,31
2025-08-14_08-18-36,5915,"[np.float32(1.0), np.float32(0.0), np.float32(0.0), np.float32(0.0), np.float32(1.0), np.float32(0.0), np.float32(1.0), np.float32(1.0), np.float32(1.0), np.float32(1.0), np.float32(1.0), np.float32(0.0), np.float32(1.0), np.float32(1.0), np.float32(0.0), np.float32(0.0)]",0.0,99430.0,22
2025-08-14_08-18-36,5916,"[np.float32(1.0), np.float32(1.0), np.float32(1.0), np.float32(1.0), np.float32(0.0), np.float32(0.0), np.float32(1.0), np.float32(0.0), np.float32(1.0), np.float32(0.0), np.float32(1.0), np.float32(0.0), np.float32(1.0), np.float32(1.0), np.float32(1.0), np.float32(0.0)]",36.0,99466.0,7
2025-08-14_08-18-36,5917,"[np.float32(0.0), np.float32(1.0), np.float32(1.0), np.float32(0.0), np.float32(0.0), np.float32(1.0), np.float32(1.0), np.float32(1.0), np.float32(0.0), np.float32(1.0), np.float32(1.0), np.float32(0.0), np.float32(0.0), np.float32(1.0), np.float32(1.0), np.float32(1.0)]",-5.0,99461.0,27
2025-08-14_08-18-36,5918,"[np.float32(1.0), np.float32(1.0), np.float32(1.0), np.float32(1.0), np.float32(0.0), np.float32(0.0), np.float32(1.0), np.float32(1.0), np.float32(0.0), np.float32(0.0), np.float32(0.0), np.float32(0.0), np.float32(1.0), np.float32(0.0), np.float32(0.0), np.float32(1.0)]",-1.0,99460.0,16
2025-08-14_08-18-36,5919,"[np.float32(0.0), np.float32(1.0), np.float32(0.0), np.float32(0.0), np.float32(1.0), np.float32(1.0), np.float32(0.0), np.float32(0.0), np.float32(1.0), np.float32(0.0), np.float32(0.0), np.float32(1.0), np.float32(1.0), np.float32(0.0), np.float32(0.0), np.float32(0.0)]",-2.0,99458.0,4
2025-08-14_08-18-36,5920,"[np.float32(1.0), np.float32(1.0), np.float32(0.0), np.float32(1.0), np.float32(0.0), np.float32(0.0), np.float32(1.0), np.float32(1.0), np.float32(0.0), np.float32(0.0), np.float32(0.0), np.float32(1.0), np.float32(0.0), np.float32(1.0), np.float32(0.0), np.float32(0.0)]",-5.0,99453.0,34
2025-08-14_08-18-36,5921,"[np.float32(0.0), np.float32(1.0), np.float32(1.0), np.float32(0.0), np.float32(0.0), np.float32(0.0), np.float32(0.0), np.float32(1.0), np.float32(1.0), np.float32(1.0), np.float32(0.0), np.float32(0.0), np.float32(1.0), np.float32(1.0), np.float32(0.0), np.float32(0.0)]",-2.0,99451.0,14
2025-08-14_08-18-36,5922,"[np.float32(0.0), np.float32(0.0), np.float32(0.0), np.float32(1.0), np.float32(1.0), np.float32(0.0), np.float32(1.0), np.float32(1.0), np.float32(1.0), np.float32(1.0), np.float32(0.0), np.float32(0.0), np.float32(1.0), np.float32(0.0), np.float32(0.0), np.float32(1.0)]",-1.0,99450.0,3
2025-08-14_08-18-36,5923,"[np.float32(0.0), np.float32(1.0), np.float32(0.0), np.float32(1.0), np.float32(1.0), np.float32(0.0), np.float32(1.0), np.float32(0.0), np.float32(1.0), np.float32(1.0), np.float32(1.0), np.float32(1.0), np.float32(1.0), np.float32(0.0), np.float32(1.0), np.float32(0.0)]",36.0,99486.0,7
2025-08-14_08-18-36,5924,"[np.float32(1.0), np.float32(1.0), np.float32(1.0), np.float32(1.0), np.float32(1.0), np.float32(0.0), np.float32(1.0), np.float32(1.0), np.float32(0.0), np.float32(0.0), np.float32(0.0), np.float32(0.0), np.float32(0.0), np.float32(1.0), np.float32(0.0), np.float32(1.0)]",-5.0,99481.0,36
2025-08-14_08-18-36,5925,"[np.float32(0.0), np.float32(0.0), np.float32(0.0), np.float32(1.0), np.float32(1.0), np.float32(0.0), np.float32(1.0), np.float32(1.0), np.float32(1.0), np.float32(0.0), np.float32(1.0), np.float32(0.0), np.float32(1.0), np.float32(0.0), np.float32(0.0), np.float32(0.0)]",0.0,99481.0,3
2025-08-14_08-18-36,5926,"[np.float32(0.0), np.float32(0.0), np.float32(1.0), np.float32(0.0), np.float32(0.0), np.float32(1.0), np.float32(0.0), np.float32(1.0), np.float32(0.0), np.float32(1.0), np.float32(1.0), np.float32(0.0), np.float32(0.0), np.float32(0.0), np.float32(0.0), np.float32(0.0)]",5.0,99486.0,20
2025-08-14_08-18-36,5927,"[np.float32(1.0), np.float32(1.0), np.float32(1.0), np.float32(0.0), np.float32(1.0), np.float32(1.0), np.float32(1.0), np.float32(1.0), np.float32(1.0), np.float32(0.0), np.float32(0.0), np.float32(1.0), np.float32(0.0), np.float32(1.0), np.float32(1.0), np.float32(1.0)]",0.0,99486.0,2
2025-08-14_08-18-36,5928,"[np.float32(0.0), np.float32(0.0), np.float32(1.0), np.float32(0.0), np.float32(1.0), np.float32(1.0), np.float32(0.0), np.float32(1.0), np.float32(1.0), np.float32(1.0), np.float32(0.0), np.float32(0.0), np.float32(1.0), np.float32(0.0), np.float32(0.0), np.float32(1.0)]",2.0,99488.0,20
2025-08-14_08-18-36,5929,"[np.float32(1.0), np.float32(0.0), np.float32(0.0), np.float32(0.0), np.float32(1.0), np.float32(1.0), np.float32(1.0), np.float32(1.0), np.float32(0.0), np.float32(0.0), np.float32(0.0), np.float32(0.0), np.float32(1.0), np.float32(1.0), np.float32(0.0), np.float32(0.0)]",-2.0,99486.0,8
2025-08-14_08-18-36,5930,"[np.float32(1.0), np.float32(1.0), np.float32(1.0), np.float32(0.0), np.float32(0.0), np.float32(0.0), np.float32(0.0), np.float32(1.0), np.float32(1.0), np.float32(0.0), np.float32(1.0), np.float32(0.0), np.float32(0.0), np.float32(0.0), np.float32(0.0), np.float32(0.0)]",1.0,99487.0,24
2025-08-14_08-18-36,5931,"[np.float32(1.0), np.float32(1.0), np.float32(0.0), np.float32(0.0), np.float32(0.0), np.float32(0.0), np.float32(1.0), np.float32(1.0), np.float32(1.0), np.float32(1.0), np.float32(0.0), np.float32(0.0), np.float32(0.0), np.float32(1.0), np.float32(0.0), np.float32(1.0)]",-3.0,99484.0,24
2025-08-14_08-18-36,5932,"[np.float32(0.0), np.float32(0.0), np.float32(0.0), np.float32(0.0), np.float32(1.0), np.float32(1.0), np.float32(1.0), np.float32(0.0), np.float32(1.0), np.float32(1.0), np.float32(0.0), np.float32(1.0), np.float32(0.0), np.float32(1.0), np.float32(0.0), np.float32(1.0)]",-3.0,99481.0,24
2025-08-14_08-18-36,5933,"[np.float32(0.0), np.float32(0.0), np.float32(0.0), np.float32(1.0), np.float32(1.0), np.float32(0.0), np.float32(0.0), np.float32(0.0), np.float32(0.0), np.float32(1.0), np.float32(0.0), np.float32(1.0), np.float32(0.0), np.float32(1.0), np.float32(1.0), np.float32(0.0)]",2.0,99483.0,4
2025-08-14_08-18-36,5934,"[np.float32(1.0), np.float32(1.0), np.float32(1.0), np.float32(1.0), np.float32(1.0), np.float32(1.0), np.float32(1.0), np.float32(1.0), np.float32(0.0), np.float32(0.0), np.float32(1.0), np.float32(1.0), np.float32(0.0), np.float32(0.0), np.float32(1.0), np.float32(0.0)]",1.0,99484.0,18
2025-08-14_08-18-36,5935,"[np.float32(0.0), np.float32(1.0), np.float32(0.0), np.float32(0.0), np.float32(1.0), np.float32(1.0), np.float32(1.0), np.float32(1.0), np.float32(1.0), np.float32(1.0), np.float32(1.0), np.float32(0.0), np.float32(0.0), np.float32(1.0), np.float32(0.0), np.float32(0.0)]",1.0,99485.0,10
2025-08-14_08-18-36,5936,"[np.float32(0.0), np.float32(0.0), np.float32(1.0), np.float32(1.0), np.float32(1.0), np.float32(1.0), np.float32(1.0), np.float32(1.0), np.float32(1.0), np.float32(0.0), np.float32(0.0), np.float32(1.0), np.float32(1.0), np.float32(1.0), np.float32(0.0), np.float32(0.0)]",0.0,99485.0,29
2025-08-14_08-18-36,5937,"[np.float32(0.0), np.float32(1.0), np.float32(1.0), np.float32(1.0), np.float32(0.0), np.float32(1.0), np.float32(1.0), np.float32(0.0), np.float32(0.0), np.float32(1.0), np.float32(0.0), np.float32(0.0), np.float32(1.0), np.float32(0.0), np.float32(0.0), np.float32(1.0)]",-4.0,99481.0,36
2025-08-14_08-18-36,5938,"[np.float32(1.0), np.float32(1.0), np.float32(0.0), np.float32(1.0), np.float32(0.0), np.float32(0.0), np.float32(1.0), np.float32(1.0), np.float32(0.0), np.float32(1.0), np.float32(1.0), np.float32(1.0), np.float32(0.0), np.float32(0.0), np.float32(0.0), np.float32(1.0)]",1.0,99482.0,31
2025-08-14_08-18-36,5939,"[np.float32(1.0), np.float32(0.0), np.float32(1.0), np.float32(0.0), np.float32(1.0), np.float32(1.0), np.float32(1.0), np.float32(1.0), np.float32(1.0), np.float32(0.0), np.float32(1.0), np.float32(0.0), np.float32(0.0), np.float32(0.0), np.float32(1.0), np.float32(1.0)]",0.0,99482.0,1
2025-08-14_08-18-36,5940,"[np.float32(0.0), np.float32(0.0), np.float32(0.0), np.float32(0.0), np.float32(0.0), np.float32(0.0), np.float32(1.0), np.float32(1.0), np.float32(1.0), np.float32(1.0), np.float32(1.0), np.float32(1.0), np.float32(1.0), np.float32(1.0), np.float32(1.0), np.float32(1.0)]",-1.0,99481.0,26
2025-08-14_08-18-36,5941,"[np.float32(1.0), np.float32(0.0), np.float32(0.0), np.float32(0.0), np.float32(1.0), np.float32(0.0), np.float32(1.0), np.float32(1.0), np.float32(0.0), np.float32(0.0), np.float32(0.0), np.float32(0.0), np.float32(1.0), np.float32(0.0), np.float32(1.0), np.float32(0.0)]",2.0,99483.0,13
2025-08-14_08-18-36,5942,"[np.float32(1.0), np.float32(1.0), np.float32(1.0), np.float32(0.0), np.float32(0.0), np.float32(1.0), np.float32(0.0), np.float32(1.0), np.float32(1.0), np.float32(1.0), np.float32(0.0), np.float32(1.0), np.float32(1.0), np.float32(1.0), np.float32(0.0), np.float32(0.0)]",0.0,99483.0,12
2025-08-14_08-18-36,5943,"[np.float32(0.0), np.float32(0.0), np.float32(1.0), np.float32(1.0), np.float32(0.0), np.float32(0.0), np.float32(1.0), np.float32(0.0), np.float32(1.0), np.float32(1.0), np.float32(0.0), np.float32(1.0), np.float32(0.0), np.float32(1.0), np.float32(0.0), np.float32(1.0)]",3.0,99486.0,31
2025-08-14_08-18-36,5944,"[np.float32(1.0), np.float32(0.0), np.float32(0.0), np.float32(0.0), np.float32(0.0), np.float32(0.0), np.float32(1.0), np.float32(0.0), np.float32(0.0), np.float32(0.0), np.float32(0.0), np.float32(1.0), np.float32(0.0), np.float32(1.0), np.float32(0.0), np.float32(1.0)]",0.0,99486.0,19
2025-08-14_08-18-36,5945,"[np.float32(1.0), np.float32(0.0), np.float32(0.0), np.float32(1.0), np.float32(1.0), np.float32(1.0), np.float32(0.0), np.float32(0.0), np.float32(0.0), np.float32(0.0), np.float32(0.0), np.float32(1.0), np.float32(1.0), np.float32(0.0), np.float32(1.0), np.float32(1.0)]",-1.0,99485.0,18
2025-08-14_08-18-36,5946,"[np.float32(1.0), np.float32(1.0), np.float32(0.0), np.float32(0.0), np.float32(0.0), np.float32(0.0), np.float32(1.0), np.float32(1.0), np.float32(1.0), np.float32(1.0), np.float32(1.0), np.float32(1.0), np.float32(0.0), np.float32(1.0), np.float32(1.0), np.float32(1.0)]",0.0,99485.0,14
2025-08-14_08-18-36,5947,"[np.float32(1.0), np.float32(1.0), np.float32(1.0), np.float32(1.0), np.float32(0.0), np.float32(1.0), np.float32(0.0), np.float32(1.0), np.float32(0.0), np.float32(0.0), np.float32(0.0), np.float32(1.0), np.float32(0.0), np.float32(1.0), np.float32(0.0), np.float32(1.0)]",1.0,99486.0,14
2025-08-14_08-18-36,5948,"[np.float32(0.0), np.float32(1.0), np.float32(1.0), np.float32(0.0), np.float32(1.0), np.float32(0.0), np.float32(0.0), np.float32(0.0), np.float32(1.0), np.float32(0.0), np.float32(0.0), np.float32(0.0), np.float32(0.0), np.float32(0.0), np.float32(1.0), np.float32(0.0)]",3.0,99489.0,30
2025-08-14_08-18-36,5949,"[np.float32(1.0), np.float32(0.0), np.float32(0.0), np.float32(0.0), np.float32(0.0), np.float32(1.0), np.float32(0.0), np.float32(1.0), np.float32(1.0), np.float32(0.0), np.float32(0.0), np.float32(0.0), np.float32(0.0), np.float32(0.0), np.float32(0.0), np.float32(0.0)]",3.0,99492.0,19
2025-08-14_08-18-36,5950,"[np.float32(1.0), np.float32(1.0), np.float32(1.0), np.float32(1.0), np.float32(0.0), np.float32(1.0), np.float32(1.0), np.float32(0.0), np.float32(0.0), np.float32(1.0), np.float32(0.0), np.float32(0.0), np.float32(0.0), np.float32(1.0), np.float32(1.0), np.float32(1.0)]",-1.0,99491.0,27
2025-08-14_08-18-36,5951,"[np.float32(1.0), np.float32(0.0), np.float32(1.0), np.float32(1.0), np.float32(0.0), np.float32(0.0), np.float32(1.0), np.float32(1.0), np.float32(1.0), np.float32(0.0), np.float32(1.0), np.float32(1.0), np.float32(0.0), np.float32(1.0), np.float32(0.0), np.float32(0.0)]",1.0,99492.0,27
2025-08-14_08-18-36,5952,"[np.float32(1.0), np.float32(0.0), np.float32(1.0), np.float32(0.0), np.float32(1.0), np.float32(0.0), np.float32(1.0), np.float32(1.0), np.float32(0.0), np.float32(1.0), np.float32(0.0), np.float32(0.0), np.float32(1.0), np.float32(0.0), np.float32(0.0), np.float32(0.0)]",-2.0,99490.0,15
2025-08-14_08-18-36,5953,"[np.float32(0.0), np.float32(0.0), np.float32(1.0), np.float32(1.0), np.float32(1.0), np.float32(1.0), np.float32(0.0), np.float32(1.0), np.float32(0.0), np.float32(1.0), np.float32(0.0), np.float32(0.0), np.float32(1.0), np.float32(0.0), np.float32(1.0), np.float32(0.0)]",-1.0,99489.0,1
2025-08-14_08-18-36,5954,"[np.float32(0.0), np.float32(1.0), np.float32(0.0), np.float32(0.0), np.float32(0.0), np.float32(1.0), np.float32(1.0), np.float32(0.0), np.float32(1.0), np.float32(1.0), np.float32(1.0), np.float32(0.0), np.float32(1.0), np.float32(0.0), np.float32(0.0), np.float32(0.0)]",-2.0,99487.0,19
2025-08-14_08-18-36,5955,"[np.float32(1.0), np.float32(0.0), np.float32(1.0), np.float32(0.0), np.float32(0.0), np.float32(1.0), np.float32(1.0), np.float32(1.0), np.float32(0.0), np.float32(1.0), np.float32(1.0), np.float32(0.0), np.float32(0.0), np.float32(1.0), np.float32(1.0), np.float32(0.0)]",-1.0,99486.0,35
2025-08-14_08-18-36,5956,"[np.float32(0.0), np.float32(0.0), np.float32(0.0), np.float32(0.0), np.float32(0.0), np.float32(0.0), np.float32(0.0), np.float32(0.0), np.float32(1.0), np.float32(0.0), np.float32(0.0), np.float32(0.0), np.float32(1.0), np.float32(0.0), np.float32(0.0), np.float32(1.0)]",0.0,99486.0,26
2025-08-14_08-18-36,5957,"[np.float32(1.0), np.float32(0.0), np.float32(1.0), np.float32(0.0), np.float32(1.0), np.float32(1.0), np.float32(0.0), np.float32(1.0), np.float32(1.0), np.float32(0.0), np.float32(1.0), np.float32(0.0), np.float32(1.0), np.float32(0.0), np.float32(0.0), np.float32(0.0)]",2.0,99488.0,23
2025-08-14_08-18-36,5958,"[np.float32(0.0), np.float32(0.0), np.float32(0.0), np.float32(0.0), np.float32(1.0), np.float32(0.0), np.float32(1.0), np.float32(1.0), np.float32(1.0), np.float32(1.0), np.float32(1.0), np.float32(0.0), np.float32(1.0), np.float32(0.0), np.float32(0.0), np.float32(0.0)]",-2.0,99486.0,3
2025-08-14_08-18-36,5959,"[np.float32(1.0), np.float32(1.0), np.float32(0.0), np.float32(0.0), np.float32(1.0), np.float32(1.0), np.float32(0.0), np.float32(1.0), np.float32(0.0), np.float32(1.0), np.float32(0.0), np.float32(0.0), np.float32(0.0), np.float32(0.0), np.float32(0.0), np.float32(0.0)]",4.0,99490.0,22
2025-08-14_08-18-36,5960,"[np.float32(1.0), np.float32(0.0), np.float32(0.0), np.float32(1.0), np.float32(0.0), np.float32(1.0), np.float32(0.0), np.float32(1.0), np.float32(0.0), np.float32(0.0), np.float32(1.0), np.float32(0.0), np.float32(0.0), np.float32(1.0), np.float32(0.0), np.float32(1.0)]",0.0,99490.0,34
2025-08-14_08-18-36,5961,"[np.float32(0.0), np.float32(0.0), np.float32(0.0), np.float32(0.0), np.float32(1.0), np.float32(0.0), np.float32(0.0), np.float32(0.0), np.float32(0.0), np.float32(1.0), np.float32(0.0), np.float32(0.0), np.float32(1.0), np.float32(0.0), np.float32(0.0), np.float32(1.0)]",-2.0,99488.0,18
2025-08-14_08-18-36,5962,"[np.float32(0.0), np.float32(0.0), np.float32(1.0), np.float32(1.0), np.float32(0.0), np.float32(1.0), np.float32(0.0), np.float32(1.0), np.float32(1.0), np.float32(0.0), np.float32(1.0), np.float32(0.0), np.float32(0.0), np.float32(0.0), np.float32(0.0), np.float32(1.0)]",3.0,99491.0,29
2025-08-14_08-18-36,5963,"[np.float32(1.0), np.float32(1.0), np.float32(0.0), np.float32(1.0), np.float32(0.0), np.float32(1.0), np.float32(0.0), np.float32(1.0), np.float32(1.0), np.float32(0.0), np.float32(1.0), np.float32(1.0), np.float32(0.0), np.float32(0.0), np.float32(1.0), np.float32(0.0)]",0.0,99491.0,25
2025-08-14_08-18-36,5964,"[np.float32(1.0), np.float32(0.0), np.float32(1.0), np.float32(0.0), np.float32(1.0), np.float32(0.0), np.float32(0.0), np.float32(0.0), np.float32(0.0), np.float32(1.0), np.float32(0.0), np.float32(0.0), np.float32(1.0), np.float32(1.0), np.float32(0.0), np.float32(0.0)]",3.0,99494.0,18
2025-08-14_08-18-36,5965,"[np.float32(1.0), np.float32(1.0), np.float32(1.0), np.float32(0.0), np.float32(0.0), np.float32(1.0), np.float32(0.0), np.float32(1.0), np.float32(0.0), np.float32(0.0), np.float32(1.0), np.float32(1.0), np.float32(0.0), np.float32(1.0), np.float32(1.0), np.float32(0.0)]",-2.0,99492.0,6
2025-08-14_08-18-36,5966,"[np.float32(0.0), np.float32(1.0), np.float32(0.0), np.float32(1.0), np.float32(1.0), np.float32(1.0), np.float32(0.0), np.float32(0.0), np.float32(0.0), np.float32(1.0), np.float32(1.0), np.float32(1.0), np.float32(1.0), np.float32(0.0), np.float32(0.0), np.float32(1.0)]",-2.0,99490.0,24
2025-08-14_08-18-36,5967,"[np.float32(1.0), np.float32(0.0), np.float32(0.0), np.float32(0.0), np.float32(0.0), np.float32(0.0), np.float32(1.0), np.float32(0.0), np.float32(1.0), np.float32(1.0), np.float32(0.0), np.float32(0.0), np.float32(1.0), np.float32(0.0), np.float32(0.0), np.float32(0.0)]",-2.0,99488.0,8
2025-08-14_08-18-36,5968,"[np.float32(1.0), np.float32(1.0), np.float32(1.0), np.float32(0.0), np.float32(0.0), np.float32(0.0), np.float32(0.0), np.float32(0.0), np.float32(1.0), np.float32(1.0), np.float32(1.0), np.float32(0.0), np.float32(0.0), np.float32(1.0), np.float32(1.0), np.float32(0.0)]",-1.0,99487.0,12
2025-08-14_08-18-36,5969,"[np.float32(1.0), np.float32(1.0), np.float32(1.0), np.float32(0.0), np.float32(0.0), np.float32(0.0), np.float32(1.0), np.float32(0.0), np.float32(0.0), np.float32(0.0), np.float32(0.0), np.float32(1.0), np.float32(1.0), np.float32(0.0), np.float32(0.0), np.float32(1.0)]",-3.0,99484.0,26
2025-08-14_08-18-36,5970,"[np.float32(0.0), np.float32(0.0), np.float32(0.0), np.float32(1.0), np.float32(1.0), np.float32(0.0), np.float32(1.0), np.float32(1.0), np.float32(1.0), np.float32(0.0), np.float32(1.0), np.float32(1.0), np.float32(0.0), np.float32(0.0), np.float32(0.0), np.float32(0.0)]",-2.0,99482.0,16
2025-08-14_08-18-36,5971,"[np.float32(1.0), np.float32(1.0), np.float32(1.0), np.float32(1.0), np.float32(0.0), np.float32(1.0), np.float32(0.0), np.float32(1.0), np.float32(0.0), np.float32(1.0), np.float32(1.0), np.float32(0.0), np.float32(1.0), np.float32(0.0), np.float32(0.0), np.float32(1.0)]",2.0,99484.0,23
2025-08-14_08-18-36,5972,"[np.float32(0.0), np.float32(1.0), np.float32(0.0), np.float32(1.0), np.float32(0.0), np.float32(1.0), np.float32(0.0), np.float32(1.0), np.float32(0.0), np.float32(1.0), np.float32(1.0), np.float32(1.0), np.float32(0.0), np.float32(0.0), np.float32(1.0), np.float32(0.0)]",-3.0,99481.0,34
2025-08-14_08-18-36,5973,"[np.float32(0.0), np.float32(0.0), np.float32(0.0), np.float32(1.0), np.float32(0.0), np.float32(1.0), np.float32(1.0), np.float32(0.0), np.float32(1.0), np.float32(1.0), np.float32(0.0), np.float32(1.0), np.float32(0.0), np.float32(1.0), np.float32(0.0), np.float32(0.0)]",-1.0,99480.0,10
2025-08-14_08-18-36,5974,"[np.float32(1.0), np.float32(1.0), np.float32(0.0), np.float32(0.0), np.float32(0.0), np.float32(1.0), np.float32(1.0), np.float32(0.0), np.float32(1.0), np.float32(1.0), np.float32(0.0), np.float32(0.0), np.float32(1.0), np.float32(1.0), np.float32(0.0), np.float32(0.0)]",2.0,99482.0,29
2025-08-14_08-18-36,5975,"[np.float32(1.0), np.float32(0.0), np.float32(1.0), np.float32(0.0), np.float32(0.0), np.float32(0.0), np.float32(1.0), np.float32(1.0), np.float32(1.0), np.float32(1.0), np.float32(0.0), np.float32(0.0), np.float32(1.0), np.float32(1.0), np.float32(1.0), np.float32(0.0)]",-1.0,99481.0,26
2025-08-14_08-18-36,5976,"[np.float32(0.0), np.float32(1.0), np.float32(1.0), np.float32(1.0), np.float32(1.0), np.float32(0.0), np.float32(1.0), np.float32(1.0), np.float32(0.0), np.float32(1.0), np.float32(1.0), np.float32(0.0), np.float32(1.0), np.float32(0.0), np.float32(1.0), np.float32(0.0)]",-1.0,99480.0,15
2025-08-14_08-18-36,5977,"[np.float32(1.0), np.float32(0.0), np.float32(0.0), np.float32(1.0), np.float32(0.0), np.float32(1.0), np.float32(1.0), np.float32(1.0), np.float32(1.0), np.float32(0.0), np.float32(0.0), np.float32(1.0), np.float32(0.0), np.float32(0.0), np.float32(1.0), np.float32(1.0)]",-1.0,99479.0,18
2025-08-14_08-18-36,5978,"[np.float32(0.0), np.float32(1.0), np.float32(1.0), np.float32(0.0), np.float32(0.0), np.float32(0.0), np.float32(0.0), np.float32(1.0), np.float32(1.0), np.float32(1.0), np.float32(1.0), np.float32(1.0), np.float32(1.0), np.float32(1.0), np.float32(1.0), np.float32(0.0)]",3.0,99482.0,22
2025-08-14_08-18-36,5979,"[np.float32(0.0), np.float32(1.0), np.float32(0.0), np.float32(0.0), np.float32(1.0), np.float32(0.0), np.float32(0.0), np.float32(1.0), np.float32(1.0), np.float32(0.0), np.float32(0.0), np.float32(0.0), np.float32(0.0), np.float32(1.0), np.float32(1.0), np.float32(0.0)]",-4.0,99478.0,1
2025-08-14_08-18-36,5980,"[np.float32(0.0), np.float32(1.0), np.float32(0.0), np.float32(1.0), np.float32(0.0), np.float32(1.0), np.float32(1.0), np.float32(0.0), np.float32(0.0), np.float32(0.0), np.float32(0.0), np.float32(0.0), np.float32(1.0), np.float32(1.0), np.float32(0.0), np.float32(0.0)]",1.0,99479.0,25
2025-08-14_08-18-36,5981,"[np.float32(1.0), np.float32(1.0), np.float32(1.0), np.float32(0.0), np.float32(0.0), np.float32(1.0), np.float32(0.0), np.float32(1.0), np.float32(1.0), np.float32(0.0), np.float32(0.0), np.float32(1.0), np.float32(1.0), np.float32(1.0), np.float32(0.0), np.float32(0.0)]",0.0,99479.0,20
2025-08-14_08-18-36,5982,"[np.float32(0.0), np.float32(1.0), np.float32(1.0), np.float32(1.0), np.float32(0.0), np.float32(0.0), np.float32(1.0), np.float32(1.0), np.float32(1.0), np.float32(0.0), np.float32(0.0), np.float32(0.0), np.float32(1.0), np.float32(1.0), np.float32(1.0), np.float32(1.0)]",-2.0,99477.0,34
2025-08-14_08-18-36,5983,"[np.float32(0.0), np.float32(1.0), np.float32(1.0), np.float32(1.0), np.float32(1.0), np.float32(0.0), np.float32(1.0), np.float32(1.0), np.float32(1.0), np.float32(0.0), np.float32(0.0), np.float32(1.0), np.float32(0.0), np.float32(0.0), np.float32(0.0), np.float32(0.0)]",2.0,99479.0,9
2025-08-14_08-18-36,5984,"[np.float32(1.0), np.float32(0.0), np.float32(0.0), np.float32(1.0), np.float32(0.0), np.float32(0.0), np.float32(0.0), np.float32(1.0), np.float32(1.0), np.float32(1.0), np.float32(0.0), np.float32(0.0), np.float32(1.0), np.float32(1.0), np.float32(1.0), np.float32(0.0)]",3.0,99482.0,16
2025-08-14_08-18-36,5985,"[np.float32(1.0), np.float32(0.0), np.float32(0.0), np.float32(1.0), np.float32(0.0), np.float32(1.0), np.float32(0.0), np.float32(1.0), np.float32(0.0), np.float32(0.0), np.float32(0.0), np.float32(0.0), np.float32(0.0), np.float32(0.0), np.float32(1.0), np.float32(1.0)]",-6.0,99476.0,2
2025-08-14_08-18-36,5986,"[np.float32(1.0), np.float32(1.0), np.float32(1.0), np.float32(0.0), np.float32(0.0), np.float32(0.0), np.float32(0.0), np.float32(0.0), np.float32(0.0), np.float32(1.0), np.float32(0.0), np.float32(0.0), np.float32(1.0), np.float32(1.0), np.float32(0.0), np.float32(0.0)]",-1.0,99475.0,35
2025-08-14_08-18-36,5987,"[np.float32(0.0), np.float32(1.0), np.float32(1.0), np.float32(0.0), np.float32(1.0), np.float32(1.0), np.float32(1.0), np.float32(0.0), np.float32(0.0), np.float32(1.0), np.float32(0.0), np.float32(1.0), np.float32(1.0), np.float32(1.0), np.float32(1.0), np.float32(0.0)]",0.0,99475.0,30
2025-08-14_08-18-36,5988,"[np.float32(1.0), np.float32(1.0), np.float32(0.0), np.float32(0.0), np.float32(1.0), np.float32(0.0), np.float32(0.0), np.float32(0.0), np.float32(1.0), np.float32(1.0), np.float32(0.0), np.float32(1.0), np.float32(1.0), np.float32(0.0), np.float32(0.0), np.float32(0.0)]",-3.0,99472.0,8
2025-08-14_08-18-36,5989,"[np.float32(0.0), np.float32(1.0), np.float32(1.0), np.float32(1.0), np.float32(1.0), np.float32(0.0), np.float32(1.0), np.float32(0.0), np.float32(1.0), np.float32(0.0), np.float32(0.0), np.float32(0.0), np.float32(0.0), np.float32(0.0), np.float32(1.0), np.float32(1.0)]",1.0,99473.0,17
2025-08-14_08-18-36,5990,"[np.float32(0.0), np.float32(1.0), np.float32(1.0), np.float32(0.0), np.float32(0.0), np.float32(1.0), np.float32(1.0), np.float32(1.0), np.float32(0.0), np.float32(1.0), np.float32(0.0), np.float32(1.0), np.float32(0.0), np.float32(0.0), np.float32(0.0), np.float32(0.0)]",0.0,99473.0,8
2025-08-14_08-18-36,5991,"[np.float32(1.0), np.float32(0.0), np.float32(0.0), np.float32(0.0), np.float32(1.0), np.float32(1.0), np.float32(0.0), np.float32(0.0), np.float32(1.0), np.float32(1.0), np.float32(0.0), np.float32(0.0), np.float32(0.0), np.float32(1.0), np.float32(1.0), np.float32(0.0)]",3.0,99476.0,7
2025-08-14_08-18-36,5992,"[np.float32(1.0), np.float32(0.0), np.float32(0.0), np.float32(0.0), np.float32(0.0), np.float32(0.0), np.float32(1.0), np.float32(0.0), np.float32(1.0), np.float32(0.0), np.float32(0.0), np.float32(0.0), np.float32(0.0), np.float32(1.0), np.float32(0.0), np.float32(0.0)]",1.0,99477.0,19
2025-08-14_08-18-36,5993,"[np.float32(1.0), np.float32(0.0), np.float32(1.0), np.float32(1.0), np.float32(0.0), np.float32(1.0), np.float32(0.0), np.float32(1.0), np.float32(1.0), np.float32(1.0), np.float32(1.0), np.float32(1.0), np.float32(1.0), np.float32(1.0), np.float32(1.0), np.float32(1.0)]",2.0,99479.0,23
2025-08-14_08-18-36,5994,"[np.float32(0.0), np.float32(0.0), np.float32(0.0), np.float32(0.0), np.float32(1.0), np.float32(1.0), np.float32(1.0), np.float32(1.0), np.float32(0.0), np.float32(0.0), np.float32(0.0), np.float32(1.0), np.float32(1.0), np.float32(1.0), np.float32(0.0), np.float32(0.0)]",1.0,99480.0,22
2025-08-14_08-18-36,5995,"[np.float32(1.0), np.float32(1.0), np.float32(0.0), np.float32(0.0), np.float32(0.0), np.float32(1.0), np.float32(0.0), np.float32(1.0), np.float32(1.0), np.float32(1.0), np.float32(0.0), np.float32(1.0), np.float32(0.0), np.float32(0.0), np.float32(1.0), np.float32(0.0)]",5.0,99485.0,27
2025-08-14_08-18-36,5996,"[np.float32(0.0), np.float32(1.0), np.float32(1.0), np.float32(1.0), np.float32(0.0), np.float32(1.0), np.float32(0.0), np.float32(1.0), np.float32(0.0), np.float32(0.0), np.float32(1.0), np.float32(1.0), np.float32(1.0), np.float32(1.0), np.float32(0.0), np.float32(1.0)]",-5.0,99480.0,16
2025-08-14_08-18-36,5997,"[np.float32(1.0), np.float32(0.0), np.float32(1.0), np.float32(1.0), np.float32(0.0), np.float32(0.0), np.float32(0.0), np.float32(0.0), np.float32(1.0), np.float32(1.0), np.float32(0.0), np.float32(0.0), np.float32(1.0), np.float32(1.0), np.float32(0.0), np.float32(1.0)]",5.0,99485.0,25
2025-08-14_08-18-36,5998,"[np.float32(1.0), np.float32(1.0), np.float32(0.0), np.float32(1.0), np.float32(1.0), np.float32(0.0), np.float32(1.0), np.float32(1.0), np.float32(0.0), np.float32(1.0), np.float32(0.0), np.float32(0.0), np.float32(0.0), np.float32(1.0), np.float32(0.0), np.float32(0.0)]",2.0,99487.0,12
2025-08-14_08-18-36,5999,"[np.float32(1.0), np.float32(1.0), np.float32(0.0), np.float32(1.0), np.float32(0.0), np.float32(1.0), np.float32(0.0), np.float32(0.0), np.float32(1.0), np.float32(1.0), np.float32(0.0), np.float32(1.0), np.float32(1.0), np.float32(1.0), np.float32(0.0), np.float32(0.0)]",37.0,99524.0,7
2025-08-14_08-18-36,6000,"[np.float32(1.0), np.float32(0.0), np.float32(1.0), np.float32(1.0), np.float32(1.0), np.float32(1.0), np.float32(1.0), np.float32(1.0), np.float32(0.0), np.float32(1.0), np.float32(0.0), np.float32(1.0), np.float32(0.0), np.float32(1.0), np.float32(1.0), np.float32(1.0)]",1.0,99525.0,24
2025-08-14_08-18-36,6001,"[np.float32(0.0), np.float32(1.0), np.float32(1.0), np.float32(1.0), np.float32(1.0), np.float32(0.0), np.float32(0.0), np.float32(0.0), np.float32(0.0), np.float32(1.0), np.float32(0.0), np.float32(1.0), np.float32(0.0), np.float32(1.0), np.float32(1.0), np.float32(1.0)]",-1.0,99646.0,21
2025-08-14_08-18-36,6002,"[np.float32(0.0), np.float32(0.0), np.float32(1.0), np.float32(1.0), np.float32(0.0), np.float32(0.0), np.float32(0.0), np.float32(1.0), np.float32(0.0), np.float32(0.0), np.float32(1.0), np.float32(0.0), np.float32(0.0), np.float32(0.0), np.float32(1.0), np.float32(0.0)]",3.0,99649.0,14
2025-08-14_08-18-36,6003,"[np.float32(0.0), np.float32(0.0), np.float32(0.0), np.float32(1.0), np.float32(1.0), np.float32(1.0), np.float32(1.0), np.float32(1.0), np.float32(1.0), np.float32(1.0), np.float32(1.0), np.float32(0.0), np.float32(1.0), np.float32(1.0), np.float32(1.0), np.float32(0.0)]",0.0,99649.0,16
2025-08-14_08-18-36,6004,"[np.float32(0.0), np.float32(0.0), np.float32(1.0), np.float32(1.0), np.float32(0.0), np.float32(0.0), np.float32(0.0), np.float32(0.0), np.float32(1.0), np.float32(0.0), np.float32(1.0), np.float32(1.0), np.float32(1.0), np.float32(1.0), np.float32(0.0), np.float32(0.0)]",-2.0,99647.0,22
2025-08-14_08-18-36,6005,"[np.float32(0.0), np.float32(0.0), np.float32(0.0), np.float32(1.0), np.float32(1.0), np.float32(1.0), np.float32(1.0), np.float32(0.0), np.float32(0.0), np.float32(0.0), np.float32(1.0), np.float32(0.0), np.float32(1.0), np.float32(1.0), np.float32(1.0), np.float32(1.0)]",-1.0,99646.0,32
2025-08-14_08-18-36,6006,"[np.float32(0.0), np.float32(0.0), np.float32(1.0), np.float32(0.0), np.float32(0.0), np.float32(1.0), np.float32(1.0), np.float32(0.0), np.float32(0.0), np.float32(0.0), np.float32(1.0), np.float32(1.0), np.float32(0.0), np.float32(1.0), np.float32(0.0), np.float32(1.0)]",1.0,99647.0,4
2025-08-14_08-18-36,6007,"[np.float32(1.0), np.float32(0.0), np.float32(0.0), np.float32(1.0), np.float32(1.0), np.float32(0.0), np.float32(1.0), np.float32(0.0), np.float32(1.0), np.float32(1.0), np.float32(0.0), np.float32(0.0), np.float32(1.0), np.float32(1.0), np.float32(0.0), np.float32(1.0)]",-1.0,99646.0,6
2025-08-14_08-18-36,6008,"[np.float32(1.0), np.float32(0.0), np.float32(1.0), np.float32(1.0), np.float32(1.0), np.float32(1.0), np.float32(0.0), np.float32(1.0), np.float32(0.0), np.float32(1.0), np.float32(0.0), np.float32(0.0), np.float32(0.0), np.float32(0.0), np.float32(1.0), np.float32(1.0)]",1.0,99647.0,20
2025-08-14_08-18-36,6009,"[np.float32(0.0), np.float32(1.0), np.float32(0.0), np.float32(1.0), np.float32(1.0), np.float32(1.0), np.float32(1.0), np.float32(1.0), np.float32(1.0), np.float32(0.0), np.float32(1.0), np.float32(1.0), np.float32(0.0), np.float32(1.0), np.float32(1.0), np.float32(1.0)]",-1.0,99646.0,32
2025-08-14_08-18-36,6010,"[np.float32(0.0), np.float32(1.0), np.float32(1.0), np.float32(0.0), np.float32(1.0), np.float32(1.0), np.float32(0.0), np.float32(1.0), np.float32(1.0), np.float32(0.0), np.float32(1.0), np.float32(1.0), np.float32(1.0), np.float32(1.0), np.float32(0.0), np.float32(1.0)]",2.0,99648.0,29
2025-08-14_08-18-36,6011,"[np.float32(0.0), np.float32(0.0), np.float32(1.0), np.float32(1.0), np.float32(0.0), np.float32(1.0), np.float32(1.0), np.float32(0.0), np.float32(0.0), np.float32(1.0), np.float32(0.0), np.float32(0.0), np.float32(0.0), np.float32(0.0), np.float32(0.0), np.float32(1.0)]",-1.0,99647.0,8
2025-08-14_08-18-36,6012,"[np.float32(1.0), np.float32(1.0), np.float32(1.0), np.float32(1.0), np.float32(1.0), np.float32(1.0), np.float32(1.0), np.float32(0.0), np.float32(1.0), np.float32(0.0), np.float32(1.0), np.float32(1.0), np.float32(1.0), np.float32(1.0), np.float32(1.0), np.float32(1.0)]",1.0,99648.0,2
2025-08-14_08-18-36,6013,"[np.float32(0.0), np.float32(0.0), np.float32(0.0), np.float32(0.0), np.float32(0.0), np.float32(1.0), np.float32(0.0), np.float32(0.0), np.float32(0.0), np.float32(0.0), np.float32(1.0), np.float32(1.0), np.float32(1.0), np.float32(1.0), np.float32(1.0), np.float32(0.0)]",-3.0,99645.0,4
2025-08-14_08-18-36,6014,"[np.float32(0.0), np.float32(1.0), np.float32(1.0), np.float32(0.0), np.float32(0.0), np.float32(0.0), np.float32(0.0), np.float32(0.0), np.float32(1.0), np.float32(1.0), np.float32(0.0), np.float32(1.0), np.float32(0.0), np.float32(1.0), np.float32(1.0), np.float32(0.0)]",3.0,99648.0,24
2025-08-14_08-18-36,6015,"[np.float32(1.0), np.float32(1.0), np.float32(1.0), np.float32(0.0), np.float32(0.0), np.float32(1.0), np.float32(1.0), np.float32(0.0), np.float32(0.0), np.float32(0.0), np.float32(0.0), np.float32(0.0), np.float32(0.0), np.float32(0.0), np.float32(0.0), np.float32(1.0)]",0.0,99648.0,26
2025-08-14_08-18-36,6016,"[np.float32(1.0), np.float32(1.0), np.float32(0.0), np.float32(1.0), np.float32(1.0), np.float32(1.0), np.float32(0.0), np.float32(0.0), np.float32(1.0), np.float32(1.0), np.float32(1.0), np.float32(1.0), np.float32(0.0), np.float32(1.0), np.float32(0.0), np.float32(1.0)]",-2.0,99646.0,11
2025-08-14_08-18-36,6017,"[np.float32(1.0), np.float32(1.0), np.float32(0.0), np.float32(0.0), np.float32(0.0), np.float32(0.0), np.float32(1.0), np.float32(1.0), np.float32(0.0), np.float32(0.0), np.float32(0.0), np.float32(0.0), np.float32(1.0), np.float32(0.0), np.float32(1.0), np.float32(0.0)]",-4.0,99642.0,35
2025-08-14_08-18-36,6018,"[np.float32(0.0), np.float32(1.0), np.float32(0.0), np.float32(0.0), np.float32(0.0), np.float32(1.0), np.float32(0.0), np.float32(0.0), np.float32(1.0), np.float32(1.0), np.float32(1.0), np.float32(0.0), np.float32(1.0), np.float32(1.0), np.float32(1.0), np.float32(1.0)]",4.0,99646.0,28
2025-08-14_08-18-36,6019,"[np.float32(1.0), np.float32(1.0), np.float32(0.0), np.float32(0.0), np.float32(1.0), np.float32(1.0), np.float32(1.0), np.float32(1.0), np.float32(0.0), np.float32(0.0), np.float32(1.0), np.float32(0.0), np.float32(1.0), np.float32(1.0), np.float32(1.0), np.float32(1.0)]",2.0,99648.0,2
2025-08-14_08-18-36,6020,"[np.float32(0.0), np.float32(1.0), np.float32(1.0), np.float32(1.0), np.float32(0.0), np.float32(1.0), np.float32(1.0), np.float32(0.0), np.float32(1.0), np.float32(1.0), np.float32(0.0), np.float32(1.0), np.float32(1.0), np.float32(0.0), np.float32(0.0), np.float32(1.0)]",-5.0,99643.0,16
2025-08-14_08-18-36,6021,"[np.float32(1.0), np.float32(1.0), np.float32(1.0), np.float32(1.0), np.float32(1.0), np.float32(0.0), np.float32(0.0), np.float32(1.0), np.float32(1.0), np.float32(0.0), np.float32(1.0), np.float32(0.0), np.float32(1.0), np.float32(0.0), np.float32(0.0), np.float32(0.0)]",3.0,99646.0,14
2025-08-14_08-18-36,6022,"[np.float32(0.0), np.float32(1.0), np.float32(0.0), np.float32(0.0), np.float32(1.0), np.float32(1.0), np.float32(1.0), np.float32(1.0), np.float32(1.0), np.float32(1.0), np.float32(0.0), np.float32(0.0), np.float32(1.0), np.float32(1.0), np.float32(1.0), np.float32(0.0)]",-3.0,99643.0,20
2025-08-14_08-18-36,6023,"[np.float32(0.0), np.float32(0.0), np.float32(0.0), np.float32(0.0), np.float32(0.0), np.float32(1.0), np.float32(0.0), np.float32(0.0), np.float32(0.0), np.float32(1.0), np.float32(0.0), np.float32(1.0), np.float32(0.0), np.float32(1.0), np.float32(0.0), np.float32(1.0)]",-2.0,99641.0,16
2025-08-14_08-18-36,6024,"[np.float32(0.0), np.float32(1.0), np.float32(0.0), np.float32(1.0), np.float32(1.0), np.float32(0.0), np.float32(0.0), np.float32(1.0), np.float32(0.0), np.float32(0.0), np.float32(0.0), np.float32(0.0), np.float32(1.0), np.float32(0.0), np.float32(1.0), np.float32(1.0)]",5.0,99646.0,13
2025-08-14_08-18-36,6025,"[np.float32(1.0), np.float32(1.0), np.float32(1.0), np.float32(0.0), np.float32(1.0), np.float32(1.0), np.float32(0.0), np.float32(1.0), np.float32(1.0), np.float32(1.0), np.float32(0.0), np.float32(0.0), np.float32(0.0), np.float32(0.0), np.float32(0.0), np.float32(1.0)]",-2.0,99644.0,33
2025-08-14_08-18-36,6026,"[np.float32(0.0), np.float32(1.0), np.float32(1.0), np.float32(0.0), np.float32(1.0), np.float32(0.0), np.float32(1.0), np.float32(1.0), np.float32(1.0), np.float32(0.0), np.float32(1.0), np.float32(0.0), np.float32(1.0), np.float32(0.0), np.float32(0.0), np.float32(0.0)]",0.0,99644.0,29
2025-08-14_08-18-36,6027,"[np.float32(1.0), np.float32(1.0), np.float32(0.0), np.float32(1.0), np.float32(1.0), np.float32(1.0), np.float32(1.0), np.float32(0.0), np.float32(0.0), np.float32(0.0), np.float32(0.0), np.float32(0.0), np.float32(1.0), np.float32(1.0), np.float32(0.0), np.float32(1.0)]",-5.0,99639.0,30
2025-08-14_08-18-36,6028,"[np.float32(0.0), np.float32(1.0), np.float32(1.0), np.float32(1.0), np.float32(0.0), np.float32(1.0), np.float32(0.0), np.float32(1.0), np.float32(0.0), np.float32(1.0), np.float32(0.0), np.float32(1.0), np.float32(0.0), np.float32(0.0), np.float32(0.0), np.float32(0.0)]",0.0,99639.0,27
2025-08-14_08-18-36,6029,"[np.float32(1.0), np.float32(0.0), np.float32(1.0), np.float32(0.0), np.float32(0.0), np.float32(0.0), np.float32(0.0), np.float32(1.0), np.float32(0.0), np.float32(0.0), np.float32(1.0), np.float32(0.0), np.float32(0.0), np.float32(0.0), np.float32(0.0), np.float32(0.0)]",1.0,99640.0,5
2025-08-14_08-18-36,6030,"[np.float32(0.0), np.float32(0.0), np.float32(1.0), np.float32(1.0), np.float32(0.0), np.float32(0.0), np.float32(1.0), np.float32(1.0), np.float32(0.0), np.float32(1.0), np.float32(0.0), np.float32(0.0), np.float32(0.0), np.float32(0.0), np.float32(1.0), np.float32(0.0)]",2.0,99642.0,23
2025-08-14_08-18-36,6031,"[np.float32(1.0), np.float32(0.0), np.float32(1.0), np.float32(1.0), np.float32(1.0), np.float32(0.0), np.float32(0.0), np.float32(1.0), np.float32(1.0), np.float32(0.0), np.float32(1.0), np.float32(1.0), np.float32(1.0), np.float32(0.0), np.float32(0.0), np.float32(0.0)]",0.0,99642.0,5
2025-08-14_08-18-36,6032,"[np.float32(0.0), np.float32(0.0), np.float32(1.0), np.float32(1.0), np.float32(1.0), np.float32(1.0), np.float32(0.0), np.float32(1.0), np.float32(1.0), np.float32(0.0), np.float32(0.0), np.float32(0.0), np.float32(0.0), np.float32(0.0), np.float32(0.0), np.float32(0.0)]",1.0,99643.0,14
2025-08-14_08-18-36,6033,"[np.float32(1.0), np.float32(1.0), np.float32(0.0), np.float32(0.0), np.float32(0.0), np.float32(1.0), np.float32(1.0), np.float32(1.0), np.float32(0.0), np.float32(0.0), np.float32(0.0), np.float32(0.0), np.float32(0.0), np.float32(0.0), np.float32(0.0), np.float32(1.0)]",-1.0,99642.0,13
2025-08-14_08-18-36,6034,"[np.float32(0.0), np.float32(0.0), np.float32(1.0), np.float32(0.0), np.float32(1.0), np.float32(1.0), np.float32(1.0), np.float32(1.0), np.float32(1.0), np.float32(0.0), np.float32(0.0), np.float32(0.0), np.float32(1.0), np.float32(1.0), np.float32(0.0), np.float32(0.0)]",0.0,99642.0,15
2025-08-14_08-18-36,6035,"[np.float32(0.0), np.float32(1.0), np.float32(0.0), np.float32(1.0), np.float32(1.0), np.float32(0.0), np.float32(1.0), np.float32(1.0), np.float32(1.0), np.float32(0.0), np.float32(1.0), np.float32(0.0), np.float32(0.0), np.float32(0.0), np.float32(1.0), np.float32(1.0)]",4.0,99646.0,5
2025-08-14_08-18-36,6036,"[np.float32(0.0), np.float32(1.0), np.float32(1.0), np.float32(1.0), np.float32(0.0), np.float32(1.0), np.float32(1.0), np.float32(0.0), np.float32(0.0), np.float32(0.0), np.float32(0.0), np.float32(1.0), np.float32(0.0), np.float32(1.0), np.float32(0.0), np.float32(1.0)]",-1.0,99645.0,10
2025-08-14_08-18-36,6037,"[np.float32(0.0), np.float32(0.0), np.float32(0.0), np.float32(1.0), np.float32(0.0), np.float32(0.0), np.float32(1.0), np.float32(1.0), np.float32(1.0), np.float32(1.0), np.float32(1.0), np.float32(0.0), np.float32(0.0), np.float32(0.0), np.float32(1.0), np.float32(0.0)]",4.0,99649.0,23
2025-08-14_08-18-36,6038,"[np.float32(0.0), np.float32(0.0), np.float32(0.0), np.float32(1.0), np.float32(1.0), np.float32(1.0), np.float32(0.0), np.float32(1.0), np.float32(0.0), np.float32(1.0), np.float32(0.0), np.float32(0.0), np.float32(0.0), np.float32(1.0), np.float32(0.0), np.float32(0.0)]",-1.0,99648.0,12
2025-08-14_08-18-36,6039,"[np.float32(1.0), np.float32(1.0), np.float32(0.0), np.float32(1.0), np.float32(0.0), np.float32(1.0), np.float32(0.0), np.float32(1.0), np.float32(1.0), np.float32(1.0), np.float32(1.0), np.float32(1.0), np.float32(1.0), np.float32(1.0), np.float32(0.0), np.float32(0.0)]",-1.0,99647.0,30
2025-08-14_08-18-36,6040,"[np.float32(1.0), np.float32(1.0), np.float32(0.0), np.float32(1.0), np.float32(1.0), np.float32(1.0), np.float32(0.0), np.float32(1.0), np.float32(1.0), np.float32(0.0), np.float32(1.0), np.float32(1.0), np.float32(1.0), np.float32(1.0), np.float32(0.0), np.float32(1.0)]",3.0,99650.0,21
2025-08-14_08-18-36,6041,"[np.float32(1.0), np.float32(0.0), np.float32(1.0), np.float32(0.0), np.float32(1.0), np.float32(0.0), np.float32(1.0), np.float32(0.0), np.float32(0.0), np.float32(0.0), np.float32(1.0), np.float32(0.0), np.float32(0.0), np.float32(0.0), np.float32(0.0), np.float32(0.0)]",-3.0,99647.0,28
2025-08-14_08-18-36,6042,"[np.float32(1.0), np.float32(0.0), np.float32(0.0), np.float32(1.0), np.float32(0.0), np.float32(1.0), np.float32(1.0), np.float32(0.0), np.float32(0.0), np.float32(0.0), np.float32(0.0), np.float32(0.0), np.float32(0.0), np.float32(0.0), np.float32(0.0), np.float32(0.0)]",2.0,99649.0,25
2025-08-14_08-18-36,6043,"[np.float32(1.0), np.float32(1.0), np.float32(1.0), np.float32(1.0), np.float32(0.0), np.float32(0.0), np.float32(1.0), np.float32(1.0), np.float32(0.0), np.float32(0.0), np.float32(0.0), np.float32(1.0), np.float32(0.0), np.float32(0.0), np.float32(1.0), np.float32(1.0)]",1.0,99650.0,13
2025-08-14_08-18-36,6044,"[np.float32(1.0), np.float32(0.0), np.float32(1.0), np.float32(1.0), np.float32(0.0), np.float32(1.0), np.float32(0.0), np.float32(1.0), np.float32(1.0), np.float32(1.0), np.float32(0.0), np.float32(0.0), np.float32(1.0), np.float32(0.0), np.float32(0.0), np.float32(0.0)]",2.0,99652.0,16
2025-08-14_08-18-36,6045,"[np.float32(0.0), np.float32(0.0), np.float32(0.0), np.float32(1.0), np.float32(0.0), np.float32(0.0), np.float32(0.0), np.float32(0.0), np.float32(1.0), np.float32(0.0), np.float32(1.0), np.float32(0.0), np.float32(1.0), np.float32(1.0), np.float32(1.0), np.float32(0.0)]",2.0,99654.0,27
2025-08-14_08-18-36,6046,"[np.float32(1.0), np.float32(1.0), np.float32(1.0), np.float32(1.0), np.float32(0.0), np.float32(1.0), np.float32(0.0), np.float32(1.0), np.float32(0.0), np.float32(0.0), np.float32(0.0), np.float32(1.0), np.float32(1.0), np.float32(1.0), np.float32(1.0), np.float32(0.0)]",-3.0,99651.0,4
2025-08-14_08-18-36,6047,"[np.float32(1.0), np.float32(0.0), np.float32(1.0), np.float32(0.0), np.float32(1.0), np.float32(0.0), np.float32(1.0), np.float32(1.0), np.float32(1.0), np.float32(0.0), np.float32(1.0), np.float32(0.0), np.float32(0.0), np.float32(1.0), np.float32(1.0), np.float32(0.0)]",1.0,99652.0,7
2025-08-14_08-18-36,6048,"[np.float32(1.0), np.float32(1.0), np.float32(0.0), np.float32(0.0), np.float32(0.0), np.float32(1.0), np.float32(1.0), np.float32(1.0), np.float32(0.0), np.float32(1.0), np.float32(1.0), np.float32(0.0), np.float32(1.0), np.float32(0.0), np.float32(1.0), np.float32(1.0)]",0.0,99652.0,31
2025-08-14_08-18-36,6049,"[np.float32(0.0), np.float32(1.0), np.float32(1.0), np.float32(1.0), np.float32(1.0), np.float32(0.0), np.float32(1.0), np.float32(1.0), np.float32(1.0), np.float32(1.0), np.float32(0.0), np.float32(0.0), np.float32(1.0), np.float32(0.0), np.float32(0.0), np.float32(0.0)]",-2.0,99650.0,33
2025-08-14_08-18-36,6050,"[np.float32(1.0), np.float32(0.0), np.float32(0.0), np.float32(1.0), np.float32(1.0), np.float32(1.0), np.float32(0.0), np.float32(0.0), np.float32(1.0), np.float32(0.0), np.float32(1.0), np.float32(1.0), np.float32(1.0), np.float32(0.0), np.float32(0.0), np.float32(1.0)]",-1.0,99649.0,6
2025-08-14_08-18-36,6051,"[np.float32(1.0), np.float32(1.0), np.float32(0.0), np.float32(1.0), np.float32(1.0), np.float32(1.0), np.float32(0.0), np.float32(1.0), np.float32(1.0), np.float32(0.0), np.float32(1.0), np.float32(0.0), np.float32(1.0), np.float32(1.0), np.float32(1.0), np.float32(0.0)]",2.0,99651.0,26
2025-08-14_08-18-36,6052,"[np.float32(1.0), np.float32(0.0), np.float32(0.0), np.float32(1.0), np.float32(0.0), np.float32(0.0), np.float32(0.0), np.float32(0.0), np.float32(1.0), np.float32(0.0), np.float32(1.0), np.float32(1.0), np.float32(1.0), np.float32(0.0), np.float32(0.0), np.float32(0.0)]",1.0,99652.0,23
2025-08-14_08-18-36,6053,"[np.float32(1.0), np.float32(0.0), np.float32(1.0), np.float32(1.0), np.float32(1.0), np.float32(1.0), np.float32(1.0), np.float32(1.0), np.float32(1.0), np.float32(0.0), np.float32(0.0), np.float32(1.0), np.float32(1.0), np.float32(1.0), np.float32(1.0), np.float32(1.0)]",35.0,99687.0,7
2025-08-14_08-18-36,6054,"[np.float32(1.0), np.float32(1.0), np.float32(0.0), np.float32(1.0), np.float32(1.0), np.float32(0.0), np.float32(1.0), np.float32(1.0), np.float32(0.0), np.float32(0.0), np.float32(0.0), np.float32(0.0), np.float32(1.0), np.float32(0.0), np.float32(0.0), np.float32(1.0)]",-1.0,99686.0,19
2025-08-14_08-18-36,6055,"[np.float32(1.0), np.float32(0.0), np.float32(0.0), np.float32(0.0), np.float32(0.0), np.float32(0.0), np.float32(1.0), np.float32(1.0), np.float32(0.0), np.float32(0.0), np.float32(1.0), np.float32(1.0), np.float32(1.0), np.float32(0.0), np.float32(0.0), np.float32(0.0)]",2.0,99688.0,9
2025-08-14_08-18-36,6056,"[np.float32(0.0), np.float32(1.0), np.float32(1.0), np.float32(1.0), np.float32(0.0), np.float32(0.0), np.float32(0.0), np.float32(0.0), np.float32(0.0), np.float32(0.0), np.float32(0.0), np.float32(1.0), np.float32(0.0), np.float32(1.0), np.float32(0.0), np.float32(0.0)]",0.0,99688.0,7
2025-08-14_08-18-36,6057,"[np.float32(0.0), np.float32(1.0), np.float32(1.0), np.float32(1.0), np.float32(1.0), np.float32(0.0), np.float32(1.0), np.float32(1.0), np.float32(1.0), np.float32(1.0), np.float32(1.0), np.float32(1.0), np.float32(0.0), np.float32(0.0), np.float32(0.0), np.float32(0.0)]",-2.0,99686.0,32
2025-08-14_08-18-36,6058,"[np.float32(0.0), np.float32(0.0), np.float32(1.0), np.float32(1.0), np.float32(1.0), np.float32(1.0), np.float32(0.0), np.float32(1.0), np.float32(0.0), np.float32(0.0), np.float32(0.0), np.float32(1.0), np.float32(1.0), np.float32(1.0), np.float32(0.0), np.float32(0.0)]",2.0,99688.0,12
2025-08-14_08-18-36,6059,"[np.float32(0.0), np.float32(1.0), np.float32(1.0), np.float32(1.0), np.float32(0.0), np.float32(1.0), np.float32(1.0), np.float32(1.0), np.float32(1.0), np.float32(0.0), np.float32(1.0), np.float32(0.0), np.float32(0.0), np.float32(0.0), np.float32(0.0), np.float32(0.0)]",-1.0,99687.0,10
2025-08-14_08-18-36,6060,"[np.float32(0.0), np.float32(1.0), np.float32(0.0), np.float32(0.0), np.float32(1.0), np.float32(1.0), np.float32(1.0), np.float32(1.0), np.float32(0.0), np.float32(1.0), np.float32(1.0), np.float32(0.0), np.float32(0.0), np.float32(0.0), np.float32(0.0), np.float32(0.0)]",-2.0,99685.0,3
2025-08-14_08-18-36,6061,"[np.float32(0.0), np.float32(0.0), np.float32(1.0), np.float32(0.0), np.float32(1.0), np.float32(0.0), np.float32(0.0), np.float32(1.0), np.float32(0.0), np.float32(0.0), np.float32(0.0), np.float32(0.0), np.float32(1.0), np.float32(1.0), np.float32(1.0), np.float32(0.0)]",0.0,99685.0,19
2025-08-14_08-18-36,6062,"[np.float32(0.0), np.float32(1.0), np.float32(0.0), np.float32(1.0), np.float32(1.0), np.float32(1.0), np.float32(1.0), np.float32(0.0), np.float32(0.0), np.float32(1.0), np.float32(0.0), np.float32(1.0), np.float32(1.0), np.float32(0.0), np.float32(1.0), np.float32(1.0)]",-5.0,99680.0,18
2025-08-14_08-18-36,6063,"[np.float32(0.0), np.float32(1.0), np.float32(0.0), np.float32(1.0), np.float32(0.0), np.float32(0.0), np.float32(1.0), np.float32(1.0), np.float32(1.0), np.float32(1.0), np.float32(0.0), np.float32(0.0), np.float32(0.0), np.float32(0.0), np.float32(0.0), np.float32(1.0)]",0.0,99680.0,33
2025-08-14_08-18-36,6064,"[np.float32(0.0), np.float32(0.0), np.float32(1.0), np.float32(1.0), np.float32(0.0), np.float32(0.0), np.float32(0.0), np.float32(1.0), np.float32(0.0), np.float32(0.0), np.float32(1.0), np.float32(1.0), np.float32(0.0), np.float32(1.0), np.float32(0.0), np.float32(0.0)]",-1.0,99679.0,27
2025-08-14_08-18-36,6065,"[np.float32(0.0), np.float32(0.0), np.float32(0.0), np.float32(1.0), np.float32(1.0), np.float32(0.0), np.float32(1.0), np.float32(1.0), np.float32(0.0), np.float32(1.0), np.float32(1.0), np.float32(0.0), np.float32(1.0), np.float32(0.0), np.float32(0.0), np.float32(1.0)]",-8.0,99671.0,36
2025-08-14_08-18-36,6066,"[np.float32(0.0), np.float32(0.0), np.float32(0.0), np.float32(0.0), np.float32(1.0), np.float32(0.0), np.float32(0.0), np.float32(0.0), np.float32(1.0), np.float32(1.0), np.float32(1.0), np.float32(1.0), np.float32(0.0), np.float32(1.0), np.float32(0.0), np.float32(0.0)]",-1.0,99670.0,9
2025-08-14_08-18-36,6067,"[np.float32(1.0), np.float32(1.0), np.float32(0.0), np.float32(1.0), np.float32(1.0), np.float32(0.0), np.float32(0.0), np.float32(1.0), np.float32(0.0), np.float32(0.0), np.float32(0.0), np.float32(1.0), np.float32(0.0), np.float32(1.0), np.float32(1.0), np.float32(0.0)]",-1.0,99669.0,35
2025-08-14_08-18-36,6068,"[np.float32(1.0), np.float32(1.0), np.float32(0.0), np.float32(0.0), np.float32(0.0), np.float32(0.0), np.float32(0.0), np.float32(0.0), np.float32(1.0), np.float32(1.0), np.float32(1.0), np.float32(0.0), np.float32(0.0), np.float32(1.0), np.float32(0.0), np.float32(0.0)]",-1.0,99668.0,13
2025-08-14_08-18-36,6069,"[np.float32(0.0), np.float32(1.0), np.float32(1.0), np.float32(0.0), np.float32(1.0), np.float32(1.0), np.float32(0.0), np.float32(1.0), np.float32(1.0), np.float32(1.0), np.float32(1.0), np.float32(1.0), np.float32(1.0), np.float32(0.0), np.float32(0.0), np.float32(1.0)]",-1.0,99667.0,15
2025-08-14_08-18-36,6070,"[np.float32(1.0), np.float32(1.0), np.float32(0.0), np.float32(0.0), np.float32(0.0), np.float32(0.0), np.float32(0.0), np.float32(0.0), np.float32(1.0), np.float32(0.0), np.float32(1.0), np.float32(0.0), np.float32(0.0), np.float32(0.0), np.float32(1.0), np.float32(0.0)]",-3.0,99664.0,0
2025-08-14_08-18-36,6071,"[np.float32(0.0), np.float32(1.0), np.float32(1.0), np.float32(0.0), np.float32(1.0), np.float32(0.0), np.float32(0.0), np.float32(1.0), np.float32(1.0), np.float32(0.0), np.float32(0.0), np.float32(0.0), np.float32(0.0), np.float32(1.0), np.float32(0.0), np.float32(0.0)]",4.0,99668.0,18
2025-08-14_08-18-36,6072,"[np.float32(1.0), np.float32(1.0), np.float32(1.0), np.float32(0.0), np.float32(1.0), np.float32(1.0), np.float32(1.0), np.float32(1.0), np.float32(1.0), np.float32(0.0), np.float32(0.0), np.float32(0.0), np.float32(1.0), np.float32(0.0), np.float32(0.0), np.float32(1.0)]",2.0,99670.0,20
2025-08-14_08-18-36,6073,"[np.float32(0.0), np.float32(1.0), np.float32(1.0), np.float32(0.0), np.float32(1.0), np.float32(1.0), np.float32(1.0), np.float32(0.0), np.float32(0.0), np.float32(0.0), np.float32(1.0), np.float32(1.0), np.float32(1.0), np.float32(0.0), np.float32(0.0), np.float32(0.0)]",-3.0,99667.0,21
2025-08-14_08-18-36,6074,"[np.float32(1.0), np.float32(0.0), np.float32(0.0), np.float32(1.0), np.float32(1.0), np.float32(0.0), np.float32(0.0), np.float32(1.0), np.float32(1.0), np.float32(0.0), np.float32(1.0), np.float32(1.0), np.float32(1.0), np.float32(1.0), np.float32(1.0), np.float32(0.0)]",1.0,99668.0,36
2025-08-14_08-18-36,6075,"[np.float32(0.0), np.float32(1.0), np.float32(0.0), np.float32(0.0), np.float32(0.0), np.float32(1.0), np.float32(1.0), np.float32(1.0), np.float32(1.0), np.float32(0.0), np.float32(1.0), np.float32(1.0), np.float32(1.0), np.float32(0.0), np.float32(1.0), np.float32(0.0)]",1.0,99669.0,20
2025-08-14_08-18-36,6076,"[np.float32(0.0), np.float32(0.0), np.float32(0.0), np.float32(0.0), np.float32(1.0), np.float32(0.0), np.float32(1.0), np.float32(0.0), np.float32(1.0), np.float32(0.0), np.float32(0.0), np.float32(1.0), np.float32(1.0), np.float32(1.0), np.float32(0.0), np.float32(1.0)]",4.0,99673.0,9
2025-08-14_08-18-36,6077,"[np.float32(0.0), np.float32(1.0), np.float32(0.0), np.float32(1.0), np.float32(1.0), np.float32(1.0), np.float32(1.0), np.float32(0.0), np.float32(1.0), np.float32(1.0), np.float32(1.0), np.float32(0.0), np.float32(1.0), np.float32(1.0), np.float32(1.0), np.float32(1.0)]",3.0,99676.0,35
2025-08-14_08-18-36,6078,"[np.float32(1.0), np.float32(1.0), np.float32(1.0), np.float32(1.0), np.float32(1.0), np.float32(0.0), np.float32(1.0), np.float32(1.0), np.float32(1.0), np.float32(0.0), np.float32(0.0), np.float32(0.0), np.float32(1.0), np.float32(0.0), np.float32(0.0), np.float32(0.0)]",-2.0,99674.0,28
2025-08-14_08-18-36,6079,"[np.float32(1.0), np.float32(1.0), np.float32(1.0), np.float32(1.0), np.float32(0.0), np.float32(0.0), np.float32(1.0), np.float32(1.0), np.float32(1.0), np.float32(0.0), np.float32(0.0), np.float32(0.0), np.float32(0.0), np.float32(0.0), np.float32(1.0), np.float32(0.0)]",-4.0,99670.0,0
2025-08-14_08-18-36,6080,"[np.float32(1.0), np.float32(1.0), np.float32(0.0), np.float32(1.0), np.float32(0.0), np.float32(1.0), np.float32(0.0), np.float32(1.0), np.float32(0.0), np.float32(0.0), np.float32(1.0), np.float32(0.0), np.float32(1.0), np.float32(1.0), np.float32(0.0), np.float32(0.0)]",4.0,99674.0,23
2025-08-14_08-18-36,6081,"[np.float32(0.0), np.float32(1.0), np.float32(1.0), np.float32(0.0), np.float32(1.0), np.float32(1.0), np.float32(0.0), np.float32(1.0), np.float32(0.0), np.float32(0.0), np.float32(0.0), np.float32(1.0), np.float32(0.0), np.float32(0.0), np.float32(0.0), np.float32(0.0)]",3.0,99677.0,20
2025-08-14_08-18-36,6082,"[np.float32(0.0), np.float32(1.0), np.float32(1.0), np.float32(0.0), np.float32(0.0), np.float32(0.0), np.float32(0.0), np.float32(0.0), np.float32(1.0), np.float32(1.0), np.float32(0.0), np.float32(0.0), np.float32(0.0), np.float32(0.0), np.float32(0.0), np.float32(0.0)]",-4.0,99673.0,3
2025-08-14_08-18-36,6083,"[np.float32(0.0), np.float32(0.0), np.float32(1.0), np.float32(1.0), np.float32(1.0), np.float32(0.0), np.float32(1.0), np.float32(0.0), np.float32(1.0), np.float32(1.0), np.float32(1.0), np.float32(0.0), np.float32(1.0), np.float32(0.0), np.float32(1.0), np.float32(1.0)]",1.0,99674.0,34
2025-08-14_08-18-36,6084,"[np.float32(1.0), np.float32(1.0), np.float32(0.0), np.float32(0.0), np.float32(1.0), np.float32(0.0), np.float32(1.0), np.float32(1.0), np.float32(0.0), np.float32(0.0), np.float32(0.0), np.float32(0.0), np.float32(1.0), np.float32(0.0), np.float32(0.0), np.float32(0.0)]",-4.0,99670.0,34
2025-08-14_08-18-36,6085,"[np.float32(0.0), np.float32(0.0), np.float32(0.0), np.float32(0.0), np.float32(0.0), np.float32(0.0), np.float32(1.0), np.float32(1.0), np.float32(1.0), np.float32(1.0), np.float32(0.0), np.float32(0.0), np.float32(0.0), np.float32(1.0), np.float32(0.0), np.float32(1.0)]",0.0,99670.0,18
2025-08-14_08-18-36,6086,"[np.float32(1.0), np.float32(0.0), np.float32(0.0), np.float32(0.0), np.float32(1.0), np.float32(1.0), np.float32(1.0), np.float32(1.0), np.float32(1.0), np.float32(0.0), np.float32(0.0), np.float32(0.0), np.float32(1.0), np.float32(1.0), np.float32(0.0), np.float32(1.0)]",-4.0,99666.0,8
2025-08-14_08-18-36,6087,"[np.float32(1.0), np.float32(0.0), np.float32(1.0), np.float32(0.0), np.float32(1.0), np.float32(1.0), np.float32(0.0), np.float32(0.0), np.float32(1.0), np.float32(0.0), np.float32(1.0), np.float32(0.0), np.float32(1.0), np.float32(0.0), np.float32(1.0), np.float32(0.0)]",-4.0,99662.0,1
2025-08-14_08-18-36,6088,"[np.float32(0.0), np.float32(1.0), np.float32(0.0), np.float32(0.0), np.float32(0.0), np.float32(0.0), np.float32(1.0), np.float32(1.0), np.float32(0.0), np.float32(1.0), np.float32(1.0), np.float32(1.0), np.float32(1.0), np.float32(0.0), np.float32(0.0), np.float32(1.0)]",-5.0,99657.0,25
2025-08-14_08-18-36,6089,"[np.float32(0.0), np.float32(0.0), np.float32(1.0), np.float32(0.0), np.float32(1.0), np.float32(1.0), np.float32(0.0), np.float32(0.0), np.float32(1.0), np.float32(0.0), np.float32(1.0), np.float32(1.0), np.float32(0.0), np.float32(0.0), np.float32(0.0), np.float32(0.0)]",2.0,99659.0,29
2025-08-14_08-18-36,6090,"[np.float32(1.0), np.float32(1.0), np.float32(0.0), np.float32(1.0), np.float32(0.0), np.float32(0.0), np.float32(1.0), np.float32(1.0), np.float32(1.0), np.float32(0.0), np.float32(1.0), np.float32(0.0), np.float32(0.0), np.float32(1.0), np.float32(1.0), np.float32(1.0)]",1.0,99660.0,26
2025-08-14_08-18-36,6091,"[np.float32(0.0), np.float32(1.0), np.float32(0.0), np.float32(0.0), np.float32(1.0), np.float32(1.0), np.float32(1.0), np.float32(1.0), np.float32(0.0), np.float32(1.0), np.float32(0.0), np.float32(1.0), np.float32(0.0), np.float32(0.0), np.float32(1.0), np.float32(1.0)]",1.0,99661.0,8
2025-08-14_08-18-36,6092,"[np.float32(0.0), np.float32(0.0), np.float32(1.0), np.float32(0.0), np.float32(0.0), np.float32(0.0), np.float32(0.0), np.float32(0.0), np.float32(0.0), np.float32(1.0), np.float32(0.0), np.float32(0.0), np.float32(1.0), np.float32(1.0), np.float32(1.0), np.float32(0.0)]",3.0,99664.0,10
2025-08-14_08-18-36,6093,"[np.float32(1.0), np.float32(0.0), np.float32(0.0), np.float32(0.0), np.float32(0.0), np.float32(0.0), np.float32(0.0), np.float32(1.0), np.float32(1.0), np.float32(1.0), np.float32(0.0), np.float32(0.0), np.float32(1.0), np.float32(1.0), np.float32(0.0), np.float32(0.0)]",2.0,99666.0,18
2025-08-14_08-18-36,6094,"[np.float32(0.0), np.float32(0.0), np.float32(1.0), np.float32(1.0), np.float32(0.0), np.float32(1.0), np.float32(1.0), np.float32(1.0), np.float32(1.0), np.float32(0.0), np.float32(1.0), np.float32(1.0), np.float32(0.0), np.float32(1.0), np.float32(0.0), np.float32(0.0)]",1.0,99667.0,20
2025-08-14_08-18-36,6095,"[np.float32(0.0), np.float32(1.0), np.float32(0.0), np.float32(0.0), np.float32(1.0), np.float32(1.0), np.float32(0.0), np.float32(0.0), np.float32(0.0), np.float32(1.0), np.float32(1.0), np.float32(0.0), np.float32(1.0), np.float32(1.0), np.float32(0.0), np.float32(0.0)]",-2.0,99665.0,5
2025-08-14_08-18-36,6096,"[np.float32(0.0), np.float32(0.0), np.float32(1.0), np.float32(1.0), np.float32(1.0), np.float32(1.0), np.float32(1.0), np.float32(0.0), np.float32(0.0), np.float32(1.0), np.float32(1.0), np.float32(1.0), np.float32(1.0), np.float32(1.0), np.float32(1.0), np.float32(1.0)]",1.0,99666.0,1
2025-08-14_08-18-36,6097,"[np.float32(0.0), np.float32(1.0), np.float32(1.0), np.float32(1.0), np.float32(0.0), np.float32(1.0), np.float32(0.0), np.float32(1.0), np.float32(1.0), np.float32(1.0), np.float32(0.0), np.float32(0.0), np.float32(0.0), np.float32(1.0), np.float32(1.0), np.float32(0.0)]",-2.0,99664.0,11
2025-08-14_08-18-36,6098,"[np.float32(0.0), np.float32(0.0), np.float32(0.0), np.float32(0.0), np.float32(0.0), np.float32(0.0), np.float32(1.0), np.float32(1.0), np.float32(1.0), np.float32(1.0), np.float32(1.0), np.float32(0.0), np.float32(1.0), np.float32(0.0), np.float32(0.0), np.float32(1.0)]",-1.0,99663.0,13
2025-08-14_08-18-36,6099,"[np.float32(0.0), np.float32(1.0), np.float32(1.0), np.float32(0.0), np.float32(0.0), np.float32(1.0), np.float32(0.0), np.float32(1.0), np.float32(1.0), np.float32(1.0), np.float32(1.0), np.float32(0.0), np.float32(1.0), np.float32(0.0), np.float32(1.0), np.float32(1.0)]",-2.0,99661.0,27
2025-08-14_08-18-36,6100,"[np.float32(0.0), np.float32(1.0), np.float32(1.0), np.float32(1.0), np.float32(0.0), np.float32(0.0), np.float32(1.0), np.float32(0.0), np.float32(0.0), np.float32(0.0), np.float32(1.0), np.float32(0.0), np.float32(1.0), np.float32(1.0), np.float32(0.0), np.float32(0.0)]",0.0,99661.0,22
2025-08-14_08-18-36,6101,"[np.float32(1.0), np.float32(0.0), np.float32(0.0), np.float32(1.0), np.float32(1.0), np.float32(0.0), np.float32(1.0), np.float32(1.0), np.float32(0.0), np.float32(0.0), np.float32(0.0), np.float32(0.0), np.float32(0.0), np.float32(0.0), np.float32(0.0), np.float32(0.0)]",2.0,99663.0,13
2025-08-14_08-18-36,6102,"[np.float32(0.0), np.float32(0.0), np.float32(1.0), np.float32(1.0), np.float32(1.0), np.float32(1.0), np.float32(0.0), np.float32(1.0), np.float32(1.0), np.float32(0.0), np.float32(1.0), np.float32(0.0), np.float32(1.0), np.float32(1.0), np.float32(1.0), np.float32(0.0)]",-3.0,99660.0,12
2025-08-14_08-18-36,6103,"[np.float32(0.0), np.float32(1.0), np.float32(1.0), np.float32(0.0), np.float32(1.0), np.float32(0.0), np.float32(1.0), np.float32(1.0), np.float32(1.0), np.float32(0.0), np.float32(0.0), np.float32(0.0), np.float32(1.0), np.float32(0.0), np.float32(0.0), np.float32(1.0)]",-1.0,99659.0,24
2025-08-14_08-18-36,6104,"[np.float32(1.0), np.float32(1.0), np.float32(1.0), np.float32(0.0), np.float32(0.0), np.float32(0.0), np.float32(1.0), np.float32(1.0), np.float32(0.0), np.float32(0.0), np.float32(1.0), np.float32(1.0), np.float32(1.0), np.float32(1.0), np.float32(0.0), np.float32(1.0)]",-2.0,99657.0,1
2025-08-14_08-18-36,6105,"[np.float32(1.0), np.float32(1.0), np.float32(0.0), np.float32(0.0), np.float32(0.0), np.float32(0.0), np.float32(0.0), np.float32(1.0), np.float32(1.0), np.float32(0.0), np.float32(1.0), np.float32(1.0), np.float32(1.0), np.float32(0.0), np.float32(0.0), np.float32(0.0)]",-2.0,99655.0,28
2025-08-14_08-18-36,6106,"[np.float32(1.0), np.float32(1.0), np.float32(1.0), np.float32(0.0), np.float32(1.0), np.float32(0.0), np.float32(1.0), np.float32(1.0), np.float32(1.0), np.float32(1.0), np.float32(1.0), np.float32(0.0), np.float32(0.0), np.float32(1.0), np.float32(0.0), np.float32(1.0)]",0.0,99655.0,19
2025-08-14_08-18-36,6107,"[np.float32(0.0), np.float32(0.0), np.float32(1.0), np.float32(0.0), np.float32(0.0), np.float32(0.0), np.float32(1.0), np.float32(1.0), np.float32(0.0), np.float32(1.0), np.float32(1.0), np.float32(1.0), np.float32(1.0), np.float32(1.0), np.float32(0.0), np.float32(0.0)]",-2.0,99653.0,5
2025-08-14_08-18-36,6108,"[np.float32(1.0), np.float32(0.0), np.float32(1.0), np.float32(1.0), np.float32(1.0), np.float32(1.0), np.float32(0.0), np.float32(1.0), np.float32(0.0), np.float32(0.0), np.float32(0.0), np.float32(0.0), np.float32(0.0), np.float32(1.0), np.float32(0.0), np.float32(0.0)]",-3.0,99650.0,11
2025-08-14_08-18-36,6109,"[np.float32(0.0), np.float32(0.0), np.float32(0.0), np.float32(0.0), np.float32(1.0), np.float32(1.0), np.float32(0.0), np.float32(1.0), np.float32(1.0), np.float32(1.0), np.float32(1.0), np.float32(0.0), np.float32(1.0), np.float32(1.0), np.float32(1.0), np.float32(0.0)]",-1.0,99649.0,30
2025-08-14_08-18-36,6110,"[np.float32(0.0), np.float32(0.0), np.float32(1.0), np.float32(1.0), np.float32(0.0), np.float32(1.0), np.float32(0.0), np.float32(0.0), np.float32(1.0), np.float32(0.0), np.float32(0.0), np.float32(1.0), np.float32(1.0), np.float32(1.0), np.float32(0.0), np.float32(0.0)]",-3.0,99646.0,20
2025-08-14_08-18-36,6111,"[np.float32(1.0), np.float32(1.0), np.float32(1.0), np.float32(0.0), np.float32(1.0), np.float32(0.0), np.float32(1.0), np.float32(1.0), np.float32(1.0), np.float32(0.0), np.float32(1.0), np.float32(0.0), np.float32(1.0), np.float32(0.0), np.float32(1.0), np.float32(1.0)]",1.0,99647.0,10
2025-08-14_08-18-36,6112,"[np.float32(1.0), np.float32(1.0), np.float32(0.0), np.float32(0.0), np.float32(0.0), np.float32(0.0), np.float32(1.0), np.float32(1.0), np.float32(0.0), np.float32(1.0), np.float32(0.0), np.float32(1.0), np.float32(1.0), np.float32(1.0), np.float32(0.0), np.float32(0.0)]",0.0,99647.0,25
2025-08-14_08-18-36,6113,"[np.float32(0.0), np.float32(0.0), np.float32(0.0), np.float32(1.0), np.float32(0.0), np.float32(1.0), np.float32(1.0), np.float32(0.0), np.float32(1.0), np.float32(0.0), np.float32(1.0), np.float32(0.0), np.float32(0.0), np.float32(0.0), np.float32(1.0), np.float32(0.0)]",-1.0,99646.0,34
2025-08-14_08-18-36,6114,"[np.float32(0.0), np.float32(0.0), np.float32(0.0), np.float32(0.0), np.float32(1.0), np.float32(1.0), np.float32(1.0), np.float32(0.0), np.float32(1.0), np.float32(1.0), np.float32(0.0), np.float32(0.0), np.float32(1.0), np.float32(0.0), np.float32(0.0), np.float32(0.0)]",-1.0,99645.0,30
2025-08-14_08-18-36,6115,"[np.float32(1.0), np.float32(1.0), np.float32(0.0), np.float32(0.0), np.float32(0.0), np.float32(1.0), np.float32(1.0), np.float32(0.0), np.float32(0.0), np.float32(1.0), np.float32(1.0), np.float32(0.0), np.float32(0.0), np.float32(0.0), np.float32(1.0), np.float32(0.0)]",4.0,99649.0,10
2025-08-14_08-18-36,6116,"[np.float32(1.0), np.float32(1.0), np.float32(0.0), np.float32(1.0), np.float32(0.0), np.float32(1.0), np.float32(0.0), np.float32(0.0), np.float32(0.0), np.float32(1.0), np.float32(1.0), np.float32(0.0), np.float32(0.0), np.float32(1.0), np.float32(0.0), np.float32(0.0)]",3.0,99652.0,26
2025-08-14_08-18-36,6117,"[np.float32(1.0), np.float32(0.0), np.float32(1.0), np.float32(0.0), np.float32(0.0), np.float32(1.0), np.float32(1.0), np.float32(1.0), np.float32(1.0), np.float32(1.0), np.float32(0.0), np.float32(0.0), np.float32(0.0), np.float32(0.0), np.float32(0.0), np.float32(0.0)]",0.0,99652.0,14
2025-08-14_08-18-36,6118,"[np.float32(0.0), np.float32(1.0), np.float32(1.0), np.float32(0.0), np.float32(1.0), np.float32(1.0), np.float32(0.0), np.float32(1.0), np.float32(1.0), np.float32(1.0), np.float32(0.0), np.float32(1.0), np.float32(1.0), np.float32(1.0), np.float32(1.0), np.float32(1.0)]",-4.0,99648.0,3
2025-08-14_08-18-36,6119,"[np.float32(1.0), np.float32(0.0), np.float32(0.0), np.float32(0.0), np.float32(1.0), np.float32(1.0), np.float32(0.0), np.float32(0.0), np.float32(1.0), np.float32(0.0), np.float32(1.0), np.float32(0.0), np.float32(1.0), np.float32(1.0), np.float32(1.0), np.float32(0.0)]",-1.0,99647.0,12
2025-08-14_08-18-36,6120,"[np.float32(1.0), np.float32(1.0), np.float32(1.0), np.float32(1.0), np.float32(1.0), np.float32(1.0), np.float32(0.0), np.float32(1.0), np.float32(0.0), np.float32(0.0), np.float32(0.0), np.float32(0.0), np.float32(1.0), np.float32(0.0), np.float32(0.0), np.float32(0.0)]",1.0,99648.0,20
2025-08-14_08-18-36,6121,"[np.float32(1.0), np.float32(1.0), np.float32(1.0), np.float32(1.0), np.float32(1.0), np.float32(0.0), np.float32(1.0), np.float32(1.0), np.float32(1.0), np.float32(0.0), np.float32(0.0), np.float32(0.0), np.float32(0.0), np.float32(1.0), np.float32(0.0), np.float32(0.0)]",-2.0,99646.0,33
2025-08-14_08-18-36,6122,"[np.float32(1.0), np.float32(1.0), np.float32(0.0), np.float32(0.0), np.float32(0.0), np.float32(0.0), np.float32(1.0), np.float32(0.0), np.float32(0.0), np.float32(1.0), np.float32(1.0), np.float32(0.0), np.float32(1.0), np.float32(0.0), np.float32(0.0), np.float32(1.0)]",37.0,99683.0,7
2025-08-14_08-18-36,6123,"[np.float32(1.0), np.float32(1.0), np.float32(0.0), np.float32(0.0), np.float32(0.0), np.float32(1.0), np.float32(0.0), np.float32(1.0), np.float32(0.0), np.float32(1.0), np.float32(1.0), np.float32(1.0), np.float32(0.0), np.float32(1.0), np.float32(0.0), np.float32(1.0)]",1.0,99684.0,35
2025-08-14_08-18-36,6124,"[np.float32(1.0), np.float32(1.0), np.float32(0.0), np.float32(1.0), np.float32(0.0), np.float32(0.0), np.float32(0.0), np.float32(0.0), np.float32(1.0), np.float32(1.0), np.float32(1.0), np.float32(0.0), np.float32(0.0), np.float32(0.0), np.float32(0.0), np.float32(0.0)]",-1.0,99683.0,4
2025-08-14_08-18-36,6125,"[np.float32(1.0), np.float32(1.0), np.float32(1.0), np.float32(0.0), np.float32(1.0), np.float32(1.0), np.float32(1.0), np.float32(0.0), np.float32(0.0), np.float32(0.0), np.float32(0.0), np.float32(0.0), np.float32(0.0), np.float32(0.0), np.float32(0.0), np.float32(1.0)]",-3.0,99680.0,13
2025-08-14_08-18-36,6126,"[np.float32(1.0), np.float32(1.0), np.float32(0.0), np.float32(1.0), np.float32(0.0), np.float32(0.0), np.float32(1.0), np.float32(1.0), np.float32(1.0), np.float32(0.0), np.float32(0.0), np.float32(0.0), np.float32(0.0), np.float32(0.0), np.float32(0.0), np.float32(0.0)]",-1.0,99679.0,22
2025-08-14_08-18-36,6127,"[np.float32(0.0), np.float32(0.0), np.float32(0.0), np.float32(1.0), np.float32(1.0), np.float32(1.0), np.float32(0.0), np.float32(1.0), np.float32(1.0), np.float32(1.0), np.float32(0.0), np.float32(0.0), np.float32(1.0), np.float32(1.0), np.float32(0.0), np.float32(1.0)]",2.0,99681.0,28
2025-08-14_08-18-36,6128,"[np.float32(1.0), np.float32(1.0), np.float32(0.0), np.float32(1.0), np.float32(1.0), np.float32(0.0), np.float32(0.0), np.float32(0.0), np.float32(0.0), np.float32(0.0), np.float32(0.0), np.float32(0.0), np.float32(1.0), np.float32(1.0), np.float32(1.0), np.float32(1.0)]",-1.0,99680.0,21
2025-08-14_08-18-36,6129,"[np.float32(1.0), np.float32(1.0), np.float32(0.0), np.float32(1.0), np.float32(1.0), np.float32(1.0), np.float32(1.0), np.float32(1.0), np.float32(0.0), np.float32(1.0), np.float32(1.0), np.float32(1.0), np.float32(1.0), np.float32(1.0), np.float32(1.0), np.float32(0.0)]",-1.0,99679.0,1
2025-08-14_08-18-36,6130,"[np.float32(1.0), np.float32(0.0), np.float32(0.0), np.float32(1.0), np.float32(0.0), np.float32(0.0), np.float32(0.0), np.float32(1.0), np.float32(1.0), np.float32(1.0), np.float32(1.0), np.float32(0.0), np.float32(1.0), np.float32(0.0), np.float32(1.0), np.float32(0.0)]",-8.0,99671.0,0
2025-08-14_08-18-36,6131,"[np.float32(0.0), np.float32(1.0), np.float32(0.0), np.float32(0.0), np.float32(1.0), np.float32(1.0), np.float32(0.0), np.float32(1.0), np.float32(1.0), np.float32(0.0), np.float32(1.0), np.float32(0.0), np.float32(0.0), np.float32(0.0), np.float32(0.0), np.float32(0.0)]",1.0,99672.0,2
2025-08-14_08-18-36,6132,"[np.float32(0.0), np.float32(0.0), np.float32(0.0), np.float32(1.0), np.float32(0.0), np.float32(0.0), np.float32(1.0), np.float32(1.0), np.float32(0.0), np.float32(0.0), np.float32(1.0), np.float32(0.0), np.float32(0.0), np.float32(1.0), np.float32(0.0), np.float32(0.0)]",3.0,99675.0,35
2025-08-14_08-18-36,6133,"[np.float32(1.0), np.float32(0.0), np.float32(0.0), np.float32(0.0), np.float32(0.0), np.float32(1.0), np.float32(1.0), np.float32(0.0), np.float32(1.0), np.float32(0.0), np.float32(1.0), np.float32(1.0), np.float32(0.0), np.float32(1.0), np.float32(0.0), np.float32(0.0)]",3.0,99678.0,21
2025-08-14_08-18-36,6134,"[np.float32(0.0), np.float32(0.0), np.float32(1.0), np.float32(0.0), np.float32(0.0), np.float32(0.0), np.float32(1.0), np.float32(1.0), np.float32(1.0), np.float32(0.0), np.float32(0.0), np.float32(1.0), np.float32(0.0), np.float32(1.0), np.float32(0.0), np.float32(0.0)]",-1.0,99677.0,14
2025-08-14_08-18-36,6135,"[np.float32(1.0), np.float32(1.0), np.float32(0.0), np.float32(1.0), np.float32(1.0), np.float32(0.0), np.float32(0.0), np.float32(1.0), np.float32(1.0), np.float32(1.0), np.float32(0.0), np.float32(0.0), np.float32(0.0), np.float32(0.0), np.float32(1.0), np.float32(1.0)]",-1.0,99676.0,24
2025-08-14_08-18-36,6136,"[np.float32(1.0), np.float32(0.0), np.float32(0.0), np.float32(1.0), np.float32(1.0), np.float32(1.0), np.float32(1.0), np.float32(0.0), np.float32(0.0), np.float32(1.0), np.float32(0.0), np.float32(0.0), np.float32(0.0), np.float32(0.0), np.float32(0.0), np.float32(1.0)]",0.0,99676.0,11
2025-08-14_08-18-36,6137,"[np.float32(0.0), np.float32(1.0), np.float32(0.0), np.float32(1.0), np.float32(1.0), np.float32(1.0), np.float32(0.0), np.float32(1.0), np.float32(1.0), np.float32(1.0), np.float32(1.0), np.float32(0.0), np.float32(1.0), np.float32(1.0), np.float32(0.0), np.float32(0.0)]",1.0,99677.0,32
2025-08-14_08-18-36,6138,"[np.float32(1.0), np.float32(1.0), np.float32(0.0), np.float32(1.0), np.float32(0.0), np.float32(0.0), np.float32(1.0), np.float32(0.0), np.float32(1.0), np.float32(1.0), np.float32(0.0), np.float32(1.0), np.float32(1.0), np.float32(1.0), np.float32(0.0), np.float32(0.0)]",-1.0,99676.0,18
2025-08-14_08-18-36,6139,"[np.float32(0.0), np.float32(1.0), np.float32(0.0), np.float32(0.0), np.float32(1.0), np.float32(0.0), np.float32(1.0), np.float32(0.0), np.float32(1.0), np.float32(0.0), np.float32(1.0), np.float32(1.0), np.float32(1.0), np.float32(1.0), np.float32(1.0), np.float32(0.0)]",2.0,99678.0,3
2025-08-14_08-18-36,6140,"[np.float32(1.0), np.float32(1.0), np.float32(0.0), np.float32(1.0), np.float32(0.0), np.float32(0.0), np.float32(1.0), np.float32(1.0), np.float32(1.0), np.float32(1.0), np.float32(0.0), np.float32(0.0), np.float32(1.0), np.float32(0.0), np.float32(1.0), np.float32(0.0)]",2.0,99680.0,16
2025-08-14_08-18-36,6141,"[np.float32(0.0), np.float32(1.0), np.float32(1.0), np.float32(1.0), np.float32(0.0), np.float32(1.0), np.float32(0.0), np.float32(1.0), np.float32(0.0), np.float32(0.0), np.float32(1.0), np.float32(1.0), np.float32(1.0), np.float32(1.0), np.float32(1.0), np.float32(0.0)]",0.0,99680.0,32
2025-08-14_08-18-36,6142,"[np.float32(1.0), np.float32(0.0), np.float32(1.0), np.float32(1.0), np.float32(1.0), np.float32(0.0), np.float32(1.0), np.float32(1.0), np.float32(0.0), np.float32(1.0), np.float32(1.0), np.float32(0.0), np.float32(1.0), np.float32(0.0), np.float32(1.0), np.float32(0.0)]",-5.0,99675.0,33
2025-08-14_08-18-36,6143,"[np.float32(0.0), np.float32(1.0), np.float32(0.0), np.float32(0.0), np.float32(0.0), np.float32(0.0), np.float32(0.0), np.float32(0.0), np.float32(1.0), np.float32(1.0), np.float32(0.0), np.float32(0.0), np.float32(0.0), np.float32(1.0), np.float32(0.0), np.float32(0.0)]",7.0,99682.0,28
2025-08-14_08-18-36,6144,"[np.float32(1.0), np.float32(0.0), np.float32(0.0), np.float32(0.0), np.float32(0.0), np.float32(1.0), np.float32(1.0), np.float32(0.0), np.float32(1.0), np.float32(0.0), np.float32(0.0), np.float32(1.0), np.float32(1.0), np.float32(1.0), np.float32(1.0), np.float32(1.0)]",2.0,99684.0,12
2025-08-14_08-18-36,6145,"[np.float32(0.0), np.float32(0.0), np.float32(0.0), np.float32(1.0), np.float32(1.0), np.float32(0.0), np.float32(1.0), np.float32(1.0), np.float32(0.0), np.float32(1.0), np.float32(0.0), np.float32(0.0), np.float32(0.0), np.float32(0.0), np.float32(0.0), np.float32(0.0)]",0.0,99684.0,14
2025-08-14_08-18-36,6146,"[np.float32(0.0), np.float32(0.0), np.float32(1.0), np.float32(0.0), np.float32(0.0), np.float32(0.0), np.float32(0.0), np.float32(0.0), np.float32(1.0), np.float32(1.0), np.float32(1.0), np.float32(1.0), np.float32(1.0), np.float32(0.0), np.float32(0.0), np.float32(0.0)]",-3.0,99681.0,5
2025-08-14_08-18-36,6147,"[np.float32(0.0), np.float32(1.0), np.float32(1.0), np.float32(0.0), np.float32(0.0), np.float32(1.0), np.float32(1.0), np.float32(1.0), np.float32(1.0), np.float32(0.0), np.float32(1.0), np.float32(1.0), np.float32(0.0), np.float32(1.0), np.float32(1.0), np.float32(1.0)]",2.0,99683.0,32
2025-08-14_08-18-36,6148,"[np.float32(0.0), np.float32(0.0), np.float32(0.0), np.float32(1.0), np.float32(0.0), np.float32(0.0), np.float32(0.0), np.float32(1.0), np.float32(1.0), np.float32(1.0), np.float32(1.0), np.float32(0.0), np.float32(1.0), np.float32(1.0), np.float32(1.0), np.float32(0.0)]",0.0,99683.0,21
2025-08-14_08-18-36,6149,"[np.float32(0.0), np.float32(1.0), np.float32(0.0), np.float32(0.0), np.float32(0.0), np.float32(1.0), np.float32(0.0), np.float32(0.0), np.float32(1.0), np.float32(0.0), np.float32(0.0), np.float32(1.0), np.float32(0.0), np.float32(0.0), np.float32(0.0), np.float32(0.0)]",-2.0,99681.0,19
2025-08-14_08-18-36,6150,"[np.float32(0.0), np.float32(0.0), np.float32(0.0), np.float32(1.0), np.float32(0.0), np.float32(1.0), np.float32(0.0), np.float32(1.0), np.float32(0.0), np.float32(0.0), np.float32(1.0), np.float32(0.0), np.float32(0.0), np.float32(0.0), np.float32(0.0), np.float32(1.0)]",-2.0,99679.0,8
2025-08-14_08-18-36,6151,"[np.float32(0.0), np.float32(0.0), np.float32(0.0), np.float32(0.0), np.float32(1.0), np.float32(1.0), np.float32(0.0), np.float32(1.0), np.float32(0.0), np.float32(0.0), np.float32(0.0), np.float32(1.0), np.float32(1.0), np.float32(0.0), np.float32(1.0), np.float32(0.0)]",-4.0,99675.0,31
2025-08-14_08-18-36,6152,"[np.float32(1.0), np.float32(0.0), np.float32(0.0), np.float32(1.0), np.float32(0.0), np.float32(0.0), np.float32(0.0), np.float32(1.0), np.float32(1.0), np.float32(0.0), np.float32(1.0), np.float32(0.0), np.float32(0.0), np.float32(0.0), np.float32(0.0), np.float32(0.0)]",0.0,99675.0,15
2025-08-14_08-18-36,6153,"[np.float32(0.0), np.float32(0.0), np.float32(0.0), np.float32(1.0), np.float32(1.0), np.float32(1.0), np.float32(0.0), np.float32(1.0), np.float32(0.0), np.float32(1.0), np.float32(0.0), np.float32(1.0), np.float32(0.0), np.float32(1.0), np.float32(0.0), np.float32(1.0)]",-3.0,99672.0,26
2025-08-14_08-18-36,6154,"[np.float32(1.0), np.float32(0.0), np.float32(0.0), np.float32(0.0), np.float32(0.0), np.float32(1.0), np.float32(1.0), np.float32(1.0), np.float32(0.0), np.float32(1.0), np.float32(1.0), np.float32(0.0), np.float32(1.0), np.float32(1.0), np.float32(1.0), np.float32(0.0)]",-6.0,99666.0,6
2025-08-14_08-18-36,6155,"[np.float32(1.0), np.float32(1.0), np.float32(1.0), np.float32(1.0), np.float32(0.0), np.float32(0.0), np.float32(0.0), np.float32(1.0), np.float32(1.0), np.float32(0.0), np.float32(0.0), np.float32(1.0), np.float32(1.0), np.float32(0.0), np.float32(1.0), np.float32(0.0)]",-2.0,99664.0,26
2025-08-14_08-18-36,6156,"[np.float32(1.0), np.float32(0.0), np.float32(1.0), np.float32(0.0), np.float32(0.0), np.float32(0.0), np.float32(0.0), np.float32(1.0), np.float32(1.0), np.float32(1.0), np.float32(0.0), np.float32(1.0), np.float32(1.0), np.float32(1.0), np.float32(0.0), np.float32(1.0)]",-7.0,99657.0,8
2025-08-14_08-18-36,6157,"[np.float32(1.0), np.float32(0.0), np.float32(0.0), np.float32(0.0), np.float32(1.0), np.float32(1.0), np.float32(1.0), np.float32(1.0), np.float32(1.0), np.float32(1.0), np.float32(0.0), np.float32(1.0), np.float32(1.0), np.float32(0.0), np.float32(0.0), np.float32(1.0)]",-5.0,99652.0,11
2025-08-14_08-18-36,6158,"[np.float32(1.0), np.float32(0.0), np.float32(0.0), np.float32(1.0), np.float32(1.0), np.float32(1.0), np.float32(1.0), np.float32(1.0), np.float32(0.0), np.float32(1.0), np.float32(1.0), np.float32(0.0), np.float32(1.0), np.float32(0.0), np.float32(0.0), np.float32(0.0)]",-2.0,99650.0,32
2025-08-14_08-18-36,6159,"[np.float32(0.0), np.float32(0.0), np.float32(1.0), np.float32(0.0), np.float32(1.0), np.float32(1.0), np.float32(1.0), np.float32(1.0), np.float32(0.0), np.float32(1.0), np.float32(0.0), np.float32(0.0), np.float32(1.0), np.float32(0.0), np.float32(0.0), np.float32(0.0)]",0.0,99650.0,12
2025-08-14_08-18-36,6160,"[np.float32(0.0), np.float32(1.0), np.float32(1.0), np.float32(0.0), np.float32(0.0), np.float32(0.0), np.float32(1.0), np.float32(1.0), np.float32(1.0), np.float32(1.0), np.float32(0.0), np.float32(1.0), np.float32(1.0), np.float32(0.0), np.float32(0.0), np.float32(0.0)]",-5.0,99645.0,23
2025-08-14_08-18-36,6161,"[np.float32(0.0), np.float32(0.0), np.float32(1.0), np.float32(0.0), np.float32(1.0), np.float32(1.0), np.float32(1.0), np.float32(1.0), np.float32(1.0), np.float32(0.0), np.float32(1.0), np.float32(0.0), np.float32(0.0), np.float32(1.0), np.float32(0.0), np.float32(1.0)]",-1.0,99644.0,3
2025-08-14_08-18-36,6162,"[np.float32(0.0), np.float32(0.0), np.float32(1.0), np.float32(0.0), np.float32(1.0), np.float32(0.0), np.float32(0.0), np.float32(0.0), np.float32(1.0), np.float32(1.0), np.float32(1.0), np.float32(1.0), np.float32(1.0), np.float32(0.0), np.float32(0.0), np.float32(1.0)]",-3.0,99641.0,24
2025-08-14_08-18-36,6163,"[np.float32(0.0), np.float32(0.0), np.float32(0.0), np.float32(1.0), np.float32(0.0), np.float32(1.0), np.float32(1.0), np.float32(1.0), np.float32(1.0), np.float32(1.0), np.float32(1.0), np.float32(0.0), np.float32(1.0), np.float32(0.0), np.float32(0.0), np.float32(0.0)]",2.0,99643.0,19
2025-08-14_08-18-36,6164,"[np.float32(1.0), np.float32(1.0), np.float32(0.0), np.float32(1.0), np.float32(0.0), np.float32(0.0), np.float32(0.0), np.float32(0.0), np.float32(1.0), np.float32(1.0), np.float32(0.0), np.float32(1.0), np.float32(0.0), np.float32(1.0), np.float32(0.0), np.float32(0.0)]",0.0,99643.0,9
2025-08-14_08-18-36,6165,"[np.float32(0.0), np.float32(0.0), np.float32(1.0), np.float32(0.0), np.float32(0.0), np.float32(0.0), np.float32(0.0), np.float32(1.0), np.float32(1.0), np.float32(0.0), np.float32(0.0), np.float32(0.0), np.float32(0.0), np.float32(1.0), np.float32(0.0), np.float32(1.0)]",1.0,99644.0,15
2025-08-14_08-18-36,6166,"[np.float32(0.0), np.float32(0.0), np.float32(1.0), np.float32(0.0), np.float32(0.0), np.float32(1.0), np.float32(1.0), np.float32(0.0), np.float32(1.0), np.float32(1.0), np.float32(0.0), np.float32(0.0), np.float32(1.0), np.float32(1.0), np.float32(1.0), np.float32(0.0)]",2.0,99646.0,36
2025-08-14_08-18-36,6167,"[np.float32(0.0), np.float32(1.0), np.float32(1.0), np.float32(0.0), np.float32(1.0), np.float32(1.0), np.float32(1.0), np.float32(0.0), np.float32(0.0), np.float32(1.0), np.float32(1.0), np.float32(0.0), np.float32(0.0), np.float32(1.0), np.float32(1.0), np.float32(0.0)]",2.0,99648.0,5
2025-08-14_08-18-36,6168,"[np.float32(0.0), np.float32(1.0), np.float32(1.0), np.float32(0.0), np.float32(0.0), np.float32(1.0), np.float32(1.0), np.float32(1.0), np.float32(1.0), np.float32(1.0), np.float32(0.0), np.float32(0.0), np.float32(0.0), np.float32(1.0), np.float32(0.0), np.float32(0.0)]",2.0,99650.0,31
2025-08-14_08-18-36,6169,"[np.float32(0.0), np.float32(0.0), np.float32(1.0), np.float32(1.0), np.float32(1.0), np.float32(0.0), np.float32(0.0), np.float32(1.0), np.float32(0.0), np.float32(1.0), np.float32(1.0), np.float32(1.0), np.float32(0.0), np.float32(0.0), np.float32(0.0), np.float32(1.0)]",-3.0,99647.0,29
2025-08-14_08-18-36,6170,"[np.float32(1.0), np.float32(1.0), np.float32(0.0), np.float32(1.0), np.float32(1.0), np.float32(0.0), np.float32(0.0), np.float32(0.0), np.float32(0.0), np.float32(0.0), np.float32(1.0), np.float32(0.0), np.float32(1.0), np.float32(1.0), np.float32(0.0), np.float32(0.0)]",0.0,99647.0,23
2025-08-14_08-18-36,6171,"[np.float32(0.0), np.float32(0.0), np.float32(1.0), np.float32(1.0), np.float32(1.0), np.float32(1.0), np.float32(0.0), np.float32(1.0), np.float32(1.0), np.float32(0.0), np.float32(0.0), np.float32(1.0), np.float32(1.0), np.float32(0.0), np.float32(1.0), np.float32(1.0)]",0.0,99647.0,16
2025-08-14_08-18-36,6172,"[np.float32(0.0), np.float32(1.0), np.float32(1.0), np.float32(0.0), np.float32(0.0), np.float32(1.0), np.float32(1.0), np.float32(1.0), np.float32(1.0), np.float32(0.0), np.float32(0.0), np.float32(0.0), np.float32(1.0), np.float32(1.0), np.float32(0.0), np.float32(0.0)]",1.0,99648.0,24
2025-08-14_08-18-36,6173,"[np.float32(1.0), np.float32(1.0), np.float32(0.0), np.float32(1.0), np.float32(0.0), np.float32(1.0), np.float32(1.0), np.float32(1.0), np.float32(1.0), np.float32(1.0), np.float32(0.0), np.float32(1.0), np.float32(1.0), np.float32(0.0), np.float32(1.0), np.float32(0.0)]",1.0,99649.0,25
2025-08-14_08-18-36,6174,"[np.float32(1.0), np.float32(1.0), np.float32(1.0), np.float32(0.0), np.float32(1.0), np.float32(0.0), np.float32(1.0), np.float32(0.0), np.float32(0.0), np.float32(0.0), np.float32(0.0), np.float32(0.0), np.float32(0.0), np.float32(1.0), np.float32(1.0), np.float32(0.0)]",0.0,99649.0,13
2025-08-14_08-18-36,6175,"[np.float32(1.0), np.float32(0.0), np.float32(0.0), np.float32(0.0), np.float32(0.0), np.float32(1.0), np.float32(1.0), np.float32(0.0), np.float32(1.0), np.float32(0.0), np.float32(0.0), np.float32(0.0), np.float32(0.0), np.float32(1.0), np.float32(1.0), np.float32(0.0)]",-1.0,99648.0,16
2025-08-14_08-18-36,6176,"[np.float32(1.0), np.float32(1.0), np.float32(0.0), np.float32(0.0), np.float32(0.0), np.float32(1.0), np.float32(0.0), np.float32(1.0), np.float32(1.0), np.float32(1.0), np.float32(0.0), np.float32(1.0), np.float32(0.0), np.float32(0.0), np.float32(1.0), np.float32(0.0)]",5.0,99653.0,33
2025-08-14_08-18-36,6177,"[np.float32(1.0), np.float32(0.0), np.float32(0.0), np.float32(1.0), np.float32(0.0), np.float32(1.0), np.float32(0.0), np.float32(1.0), np.float32(1.0), np.float32(0.0), np.float32(1.0), np.float32(1.0), np.float32(1.0), np.float32(0.0), np.float32(0.0), np.float32(1.0)]",1.0,99654.0,32
2025-08-14_08-18-36,6178,"[np.float32(0.0), np.float32(0.0), np.float32(1.0), np.float32(1.0), np.float32(1.0), np.float32(1.0), np.float32(0.0), np.float32(1.0), np.float32(0.0), np.float32(0.0), np.float32(0.0), np.float32(1.0), np.float32(1.0), np.float32(1.0), np.float32(0.0), np.float32(0.0)]",-1.0,99653.0,6
2025-08-14_08-18-36,6179,"[np.float32(1.0), np.float32(0.0), np.float32(1.0), np.float32(0.0), np.float32(0.0), np.float32(0.0), np.float32(0.0), np.float32(1.0), np.float32(1.0), np.float32(1.0), np.float32(1.0), np.float32(0.0), np.float32(0.0), np.float32(0.0), np.float32(0.0), np.float32(0.0)]",4.0,99657.0,16
2025-08-14_08-18-36,6180,"[np.float32(0.0), np.float32(1.0), np.float32(1.0), np.float32(0.0), np.float32(0.0), np.float32(0.0), np.float32(1.0), np.float32(1.0), np.float32(1.0), np.float32(1.0), np.float32(1.0), np.float32(1.0), np.float32(0.0), np.float32(1.0), np.float32(1.0), np.float32(0.0)]",3.0,99660.0,2
2025-08-14_08-18-36,6181,"[np.float32(1.0), np.float32(1.0), np.float32(0.0), np.float32(1.0), np.float32(0.0), np.float32(0.0), np.float32(1.0), np.float32(1.0), np.float32(1.0), np.float32(0.0), np.float32(0.0), np.float32(0.0), np.float32(1.0), np.float32(0.0), np.float32(1.0), np.float32(0.0)]",2.0,99662.0,13
2025-08-14_08-18-36,6182,"[np.float32(0.0), np.float32(1.0), np.float32(1.0), np.float32(1.0), np.float32(0.0), np.float32(0.0), np.float32(0.0), np.float32(1.0), np.float32(0.0), np.float32(1.0), np.float32(1.0), np.float32(0.0), np.float32(1.0), np.float32(1.0), np.float32(0.0), np.float32(0.0)]",-6.0,99656.0,27
2025-08-14_08-18-36,6183,"[np.float32(1.0), np.float32(0.0), np.float32(1.0), np.float32(1.0), np.float32(1.0), np.float32(0.0), np.float32(1.0), np.float32(0.0), np.float32(0.0), np.float32(0.0), np.float32(0.0), np.float32(1.0), np.float32(1.0), np.float32(1.0), np.float32(0.0), np.float32(0.0)]",40.0,99696.0,7
2025-08-14_08-18-36,6184,"[np.float32(0.0), np.float32(1.0), np.float32(1.0), np.float32(0.0), np.float32(1.0), np.float32(0.0), np.float32(1.0), np.float32(1.0), np.float32(1.0), np.float32(1.0), np.float32(1.0), np.float32(0.0), np.float32(0.0), np.float32(1.0), np.float32(0.0), np.float32(0.0)]",1.0,99697.0,13
2025-08-14_08-18-36,6185,"[np.float32(1.0), np.float32(1.0), np.float32(1.0), np.float32(1.0), np.float32(0.0), np.float32(1.0), np.float32(0.0), np.float32(1.0), np.float32(0.0), np.float32(0.0), np.float32(0.0), np.float32(1.0), np.float32(0.0), np.float32(0.0), np.float32(0.0), np.float32(0.0)]",0.0,99697.0,13
2025-08-14_08-18-36,6186,"[np.float32(0.0), np.float32(1.0), np.float32(1.0), np.float32(1.0), np.float32(0.0), np.float32(0.0), np.float32(1.0), np.float32(0.0), np.float32(0.0), np.float32(0.0), np.float32(1.0), np.float32(1.0), np.float32(1.0), np.float32(0.0), np.float32(0.0), np.float32(1.0)]",2.0,99699.0,11
2025-08-14_08-18-36,6187,"[np.float32(0.0), np.float32(0.0), np.float32(1.0), np.float32(0.0), np.float32(0.0), np.float32(1.0), np.float32(1.0), np.float32(1.0), np.float32(1.0), np.float32(1.0), np.float32(1.0), np.float32(0.0), np.float32(0.0), np.float32(0.0), np.float32(1.0), np.float32(1.0)]",1.0,99700.0,28
2025-08-14_08-18-36,6188,"[np.float32(1.0), np.float32(1.0), np.float32(0.0), np.float32(1.0), np.float32(0.0), np.float32(1.0), np.float32(0.0), np.float32(1.0), np.float32(0.0), np.float32(0.0), np.float32(1.0), np.float32(0.0), np.float32(0.0), np.float32(0.0), np.float32(1.0), np.float32(0.0)]",-3.0,99697.0,28
2025-08-14_08-18-36,6189,"[np.float32(0.0), np.float32(1.0), np.float32(1.0), np.float32(0.0), np.float32(0.0), np.float32(1.0), np.float32(0.0), np.float32(0.0), np.float32(1.0), np.float32(1.0), np.float32(0.0), np.float32(0.0), np.float32(1.0), np.float32(1.0), np.float32(0.0), np.float32(1.0)]",-3.0,99694.0,27
2025-08-14_08-18-36,6190,"[np.float32(1.0), np.float32(0.0), np.float32(0.0), np.float32(1.0), np.float32(0.0), np.float32(0.0), np.float32(1.0), np.float32(1.0), np.float32(0.0), np.float32(0.0), np.float32(0.0), np.float32(1.0), np.float32(1.0), np.float32(0.0), np.float32(0.0), np.float32(0.0)]",-4.0,99690.0,34
2025-08-14_08-18-36,6191,"[np.float32(1.0), np.float32(1.0), np.float32(1.0), np.float32(0.0), np.float32(1.0), np.float32(1.0), np.float32(1.0), np.float32(0.0), np.float32(0.0), np.float32(0.0), np.float32(0.0), np.float32(0.0), np.float32(1.0), np.float32(0.0), np.float32(1.0), np.float32(0.0)]",-2.0,99688.0,26
2025-08-14_08-18-36,6192,"[np.float32(0.0), np.float32(1.0), np.float32(0.0), np.float32(1.0), np.float32(1.0), np.float32(0.0), np.float32(1.0), np.float32(0.0), np.float32(1.0), np.float32(1.0), np.float32(0.0), np.float32(0.0), np.float32(1.0), np.float32(0.0), np.float32(0.0), np.float32(0.0)]",-4.0,99684.0,30
2025-08-14_08-18-36,6193,"[np.float32(1.0), np.float32(1.0), np.float32(0.0), np.float32(0.0), np.float32(1.0), np.float32(1.0), np.float32(1.0), np.float32(0.0), np.float32(1.0), np.float32(0.0), np.float32(1.0), np.float32(0.0), np.float32(0.0), np.float32(0.0), np.float32(0.0), np.float32(0.0)]",3.0,99687.0,29
2025-08-14_08-18-36,6194,"[np.float32(0.0), np.float32(1.0), np.float32(1.0), np.float32(1.0), np.float32(1.0), np.float32(0.0), np.float32(1.0), np.float32(0.0), np.float32(0.0), np.float32(1.0), np.float32(1.0), np.float32(0.0), np.float32(0.0), np.float32(0.0), np.float32(1.0), np.float32(0.0)]",-3.0,99684.0,30
2025-08-14_08-18-36,6195,"[np.float32(0.0), np.float32(0.0), np.float32(1.0), np.float32(1.0), np.float32(1.0), np.float32(1.0), np.float32(0.0), np.float32(0.0), np.float32(0.0), np.float32(0.0), np.float32(1.0), np.float32(0.0), np.float32(0.0), np.float32(1.0), np.float32(1.0), np.float32(0.0)]",0.0,99684.0,30
2025-08-14_08-18-36,6196,"[np.float32(1.0), np.float32(0.0), np.float32(0.0), np.float32(1.0), np.float32(0.0), np.float32(0.0), np.float32(0.0), np.float32(0.0), np.float32(1.0), np.float32(1.0), np.float32(1.0), np.float32(0.0), np.float32(0.0), np.float32(1.0), np.float32(0.0), np.float32(0.0)]",4.0,99688.0,7
2025-08-14_08-18-36,6197,"[np.float32(1.0), np.float32(0.0), np.float32(0.0), np.float32(1.0), np.float32(1.0), np.float32(1.0), np.float32(1.0), np.float32(1.0), np.float32(1.0), np.float32(0.0), np.float32(0.0), np.float32(0.0), np.float32(1.0), np.float32(0.0), np.float32(1.0), np.float32(0.0)]",0.0,99688.0,9
2025-08-14_08-18-36,6198,"[np.float32(0.0), np.float32(0.0), np.float32(1.0), np.float32(0.0), np.float32(1.0), np.float32(0.0), np.float32(1.0), np.float32(0.0), np.float32(1.0), np.float32(1.0), np.float32(0.0), np.float32(0.0), np.float32(1.0), np.float32(0.0), np.float32(0.0), np.float32(1.0)]",3.0,99691.0,4
2025-08-14_08-18-36,6199,"[np.float32(0.0), np.float32(0.0), np.float32(0.0), np.float32(0.0), np.float32(0.0), np.float32(1.0), np.float32(1.0), np.float32(0.0), np.float32(1.0), np.float32(1.0), np.float32(0.0), np.float32(0.0), np.float32(0.0), np.float32(1.0), np.float32(1.0), np.float32(0.0)]",2.0,99693.0,27
2025-08-14_08-18-36,6200,"[np.float32(0.0), np.float32(1.0), np.float32(0.0), np.float32(0.0), np.float32(1.0), np.float32(0.0), np.float32(1.0), np.float32(0.0), np.float32(1.0), np.float32(0.0), np.float32(0.0), np.float32(1.0), np.float32(1.0), np.float32(1.0), np.float32(0.0), np.float32(0.0)]",-1.0,99692.0,27
2025-08-14_08-18-36,6201,"[np.float32(1.0), np.float32(0.0), np.float32(1.0), np.float32(1.0), np.float32(0.0), np.float32(1.0), np.float32(0.0), np.float32(1.0), np.float32(0.0), np.float32(1.0), np.float32(0.0), np.float32(0.0), np.float32(0.0), np.float32(0.0), np.float32(1.0), np.float32(1.0)]",2.0,99694.0,20
2025-08-14_08-18-36,6202,"[np.float32(0.0), np.float32(1.0), np.float32(1.0), np.float32(0.0), np.float32(0.0), np.float32(1.0), np.float32(1.0), np.float32(1.0), np.float32(0.0), np.float32(1.0), np.float32(1.0), np.float32(0.0), np.float32(1.0), np.float32(1.0), np.float32(1.0), np.float32(0.0)]",1.0,99695.0,23
2025-08-14_08-18-36,6203,"[np.float32(1.0), np.float32(0.0), np.float32(1.0), np.float32(0.0), np.float32(1.0), np.float32(1.0), np.float32(1.0), np.float32(0.0), np.float32(0.0), np.float32(1.0), np.float32(1.0), np.float32(0.0), np.float32(1.0), np.float32(1.0), np.float32(1.0), np.float32(0.0)]",-5.0,99690.0,31
2025-08-14_08-18-36,6204,"[np.float32(0.0), np.float32(0.0), np.float32(1.0), np.float32(0.0), np.float32(0.0), np.float32(0.0), np.float32(1.0), np.float32(1.0), np.float32(1.0), np.float32(1.0), np.float32(0.0), np.float32(0.0), np.float32(0.0), np.float32(1.0), np.float32(1.0), np.float32(0.0)]",4.0,99694.0,28
2025-08-14_08-18-36,6205,"[np.float32(1.0), np.float32(1.0), np.float32(1.0), np.float32(0.0), np.float32(0.0), np.float32(1.0), np.float32(1.0), np.float32(1.0), np.float32(1.0), np.float32(0.0), np.float32(0.0), np.float32(1.0), np.float32(1.0), np.float32(0.0), np.float32(1.0), np.float32(0.0)]",31.0,99725.0,7
2025-08-14_08-18-36,6206,"[np.float32(1.0), np.float32(1.0), np.float32(1.0), np.float32(1.0), np.float32(1.0), np.float32(1.0), np.float32(1.0), np.float32(0.0), np.float32(0.0), np.float32(0.0), np.float32(0.0), np.float32(0.0), np.float32(0.0), np.float32(1.0), np.float32(1.0), np.float32(0.0)]",0.0,99725.0,13
2025-08-14_08-18-36,6207,"[np.float32(0.0), np.float32(1.0), np.float32(1.0), np.float32(0.0), np.float32(1.0), np.float32(0.0), np.float32(0.0), np.float32(1.0), np.float32(1.0), np.float32(1.0), np.float32(1.0), np.float32(1.0), np.float32(0.0), np.float32(1.0), np.float32(0.0), np.float32(0.0)]",4.0,99729.0,18
2025-08-14_08-18-36,6208,"[np.float32(0.0), np.float32(0.0), np.float32(1.0), np.float32(1.0), np.float32(0.0), np.float32(0.0), np.float32(1.0), np.float32(1.0), np.float32(0.0), np.float32(0.0), np.float32(1.0), np.float32(1.0), np.float32(1.0), np.float32(1.0), np.float32(0.0), np.float32(0.0)]",0.0,99729.0,29
2025-08-14_08-18-36,6209,"[np.float32(0.0), np.float32(0.0), np.float32(0.0), np.float32(1.0), np.float32(0.0), np.float32(1.0), np.float32(0.0), np.float32(1.0), np.float32(0.0), np.float32(0.0), np.float32(0.0), np.float32(1.0), np.float32(0.0), np.float32(0.0), np.float32(1.0), np.float32(1.0)]",2.0,99731.0,15
2025-08-14_08-18-36,6210,"[np.float32(0.0), np.float32(1.0), np.float32(1.0), np.float32(0.0), np.float32(1.0), np.float32(1.0), np.float32(0.0), np.float32(1.0), np.float32(1.0), np.float32(0.0), np.float32(0.0), np.float32(1.0), np.float32(1.0), np.float32(0.0), np.float32(1.0), np.float32(0.0)]",-3.0,99728.0,0
2025-08-14_08-18-36,6211,"[np.float32(1.0), np.float32(0.0), np.float32(0.0), np.float32(1.0), np.float32(0.0), np.float32(1.0), np.float32(0.0), np.float32(1.0), np.float32(0.0), np.float32(1.0), np.float32(0.0), np.float32(0.0), np.float32(0.0), np.float32(0.0), np.float32(0.0), np.float32(0.0)]",2.0,99730.0,1
2025-08-14_08-18-36,6212,"[np.float32(0.0), np.float32(1.0), np.float32(1.0), np.float32(1.0), np.float32(1.0), np.float32(0.0), np.float32(0.0), np.float32(1.0), np.float32(0.0), np.float32(0.0), np.float32(1.0), np.float32(1.0), np.float32(1.0), np.float32(0.0), np.float32(1.0), np.float32(0.0)]",-2.0,99728.0,26
2025-08-14_08-18-36,6213,"[np.float32(1.0), np.float32(1.0), np.float32(1.0), np.float32(1.0), np.float32(0.0), np.float32(0.0), np.float32(1.0), np.float32(0.0), np.float32(1.0), np.float32(1.0), np.float32(1.0), np.float32(0.0), np.float32(0.0), np.float32(0.0), np.float32(0.0), np.float32(1.0)]",1.0,99729.0,14
2025-08-14_08-18-36,6214,"[np.float32(0.0), np.float32(1.0), np.float32(1.0), np.float32(0.0), np.float32(0.0), np.float32(0.0), np.float32(1.0), np.float32(1.0), np.float32(0.0), np.float32(1.0), np.float32(1.0), np.float32(0.0), np.float32(0.0), np.float32(1.0), np.float32(0.0), np.float32(0.0)]",1.0,99730.0,35
2025-08-14_08-18-36,6215,"[np.float32(0.0), np.float32(0.0), np.float32(1.0), np.float32(0.0), np.float32(0.0), np.float32(0.0), np.float32(1.0), np.float32(1.0), np.float32(0.0), np.float32(0.0), np.float32(1.0), np.float32(0.0), np.float32(1.0), np.float32(0.0), np.float32(0.0), np.float32(0.0)]",0.0,99730.0,26
2025-08-14_08-18-36,6216,"[np.float32(1.0), np.float32(0.0), np.float32(1.0), np.float32(0.0), np.float32(0.0), np.float32(0.0), np.float32(1.0), np.float32(0.0), np.float32(0.0), np.float32(0.0), np.float32(1.0), np.float32(1.0), np.float32(0.0), np.float32(1.0), np.float32(1.0), np.float32(0.0)]",1.0,99731.0,4
2025-08-14_08-18-36,6217,"[np.float32(0.0), np.float32(0.0), np.float32(0.0), np.float32(0.0), np.float32(1.0), np.float32(1.0), np.float32(0.0), np.float32(1.0), np.float32(0.0), np.float32(1.0), np.float32(0.0), np.float32(0.0), np.float32(0.0), np.float32(1.0), np.float32(1.0), np.float32(0.0)]",-1.0,99730.0,1
2025-08-14_08-18-36,6218,"[np.float32(0.0), np.float32(1.0), np.float32(0.0), np.float32(1.0), np.float32(1.0), np.float32(1.0), np.float32(0.0), np.float32(0.0), np.float32(1.0), np.float32(1.0), np.float32(1.0), np.float32(0.0), np.float32(0.0), np.float32(0.0), np.float32(1.0), np.float32(0.0)]",4.0,99734.0,31
2025-08-14_08-18-36,6219,"[np.float32(1.0), np.float32(0.0), np.float32(0.0), np.float32(1.0), np.float32(0.0), np.float32(1.0), np.float32(1.0), np.float32(0.0), np.float32(1.0), np.float32(0.0), np.float32(0.0), np.float32(1.0), np.float32(1.0), np.float32(0.0), np.float32(0.0), np.float32(0.0)]",3.0,99737.0,36
2025-08-14_08-18-36,6220,"[np.float32(1.0), np.float32(1.0), np.float32(1.0), np.float32(1.0), np.float32(0.0), np.float32(0.0), np.float32(1.0), np.float32(1.0), np.float32(1.0), np.float32(1.0), np.float32(1.0), np.float32(0.0), np.float32(1.0), np.float32(1.0), np.float32(1.0), np.float32(1.0)]",-3.0,99734.0,15
2025-08-14_08-18-36,6221,"[np.float32(0.0), np.float32(1.0), np.float32(0.0), np.float32(1.0), np.float32(1.0), np.float32(1.0), np.float32(1.0), np.float32(1.0), np.float32(1.0), np.float32(0.0), np.float32(0.0), np.float32(0.0), np.float32(1.0), np.float32(1.0), np.float32(0.0), np.float32(1.0)]",-3.0,99731.0,27
2025-08-14_08-18-36,6222,"[np.float32(1.0), np.float32(0.0), np.float32(0.0), np.float32(1.0), np.float32(0.0), np.float32(1.0), np.float32(1.0), np.float32(1.0), np.float32(0.0), np.float32(0.0), np.float32(0.0), np.float32(0.0), np.float32(1.0), np.float32(0.0), np.float32(0.0), np.float32(1.0)]",-2.0,99729.0,12
2025-08-14_08-18-36,6223,"[np.float32(0.0), np.float32(0.0), np.float32(1.0), np.float32(1.0), np.float32(0.0), np.float32(0.0), np.float32(0.0), np.float32(1.0), np.float32(0.0), np.float32(0.0), np.float32(0.0), np.float32(1.0), np.float32(0.0), np.float32(1.0), np.float32(1.0), np.float32(1.0)]",1.0,99730.0,19
2025-08-14_08-18-36,6224,"[np.float32(1.0), np.float32(1.0), np.float32(0.0), np.float32(0.0), np.float32(1.0), np.float32(0.0), np.float32(0.0), np.float32(1.0), np.float32(1.0), np.float32(1.0), np.float32(0.0), np.float32(0.0), np.float32(0.0), np.float32(1.0), np.float32(1.0), np.float32(1.0)]",-1.0,99729.0,29
2025-08-14_08-18-36,6225,"[np.float32(0.0), np.float32(0.0), np.float32(1.0), np.float32(0.0), np.float32(0.0), np.float32(1.0), np.float32(1.0), np.float32(0.0), np.float32(0.0), np.float32(0.0), np.float32(1.0), np.float32(1.0), np.float32(0.0), np.float32(1.0), np.float32(1.0), np.float32(0.0)]",1.0,99730.0,33
2025-08-14_08-18-36,6226,"[np.float32(1.0), np.float32(1.0), np.float32(1.0), np.float32(0.0), np.float32(0.0), np.float32(1.0), np.float32(0.0), np.float32(1.0), np.float32(1.0), np.float32(1.0), np.float32(1.0), np.float32(0.0), np.float32(0.0), np.float32(0.0), np.float32(0.0), np.float32(0.0)]",0.0,99730.0,17
2025-08-14_08-18-36,6227,"[np.float32(0.0), np.float32(0.0), np.float32(1.0), np.float32(0.0), np.float32(0.0), np.float32(0.0), np.float32(0.0), np.float32(1.0), np.float32(0.0), np.float32(1.0), np.float32(0.0), np.float32(1.0), np.float32(0.0), np.float32(0.0), np.float32(1.0), np.float32(1.0)]",0.0,99730.0,9
2025-08-14_08-18-36,6228,"[np.float32(1.0), np.float32(0.0), np.float32(1.0), np.float32(1.0), np.float32(1.0), np.float32(1.0), np.float32(0.0), np.float32(1.0), np.float32(0.0), np.float32(0.0), np.float32(0.0), np.float32(1.0), np.float32(1.0), np.float32(0.0), np.float32(0.0), np.float32(1.0)]",-5.0,99725.0,4
2025-08-14_08-18-36,6229,"[np.float32(0.0), np.float32(0.0), np.float32(1.0), np.float32(1.0), np.float32(0.0), np.float32(1.0), np.float32(0.0), np.float32(1.0), np.float32(0.0), np.float32(1.0), np.float32(1.0), np.float32(0.0), np.float32(1.0), np.float32(1.0), np.float32(1.0), np.float32(0.0)]",-4.0,99721.0,3
2025-08-14_08-18-36,6230,"[np.float32(1.0), np.float32(1.0), np.float32(1.0), np.float32(0.0), np.float32(1.0), np.float32(1.0), np.float32(0.0), np.float32(1.0), np.float32(0.0), np.float32(1.0), np.float32(1.0), np.float32(1.0), np.float32(1.0), np.float32(1.0), np.float32(0.0), np.float32(0.0)]",1.0,99722.0,2
2025-08-14_08-18-36,6231,"[np.float32(1.0), np.float32(1.0), np.float32(1.0), np.float32(1.0), np.float32(1.0), np.float32(0.0), np.float32(1.0), np.float32(1.0), np.float32(0.0), np.float32(1.0), np.float32(0.0), np.float32(0.0), np.float32(0.0), np.float32(1.0), np.float32(1.0), np.float32(0.0)]",-1.0,99721.0,6
2025-08-14_08-18-36,6232,"[np.float32(1.0), np.float32(1.0), np.float32(1.0), np.float32(0.0), np.float32(0.0), np.float32(1.0), np.float32(0.0), np.float32(1.0), np.float32(0.0), np.float32(1.0), np.float32(1.0), np.float32(0.0), np.float32(0.0), np.float32(0.0), np.float32(0.0), np.float32(0.0)]",-3.0,99718.0,27
2025-08-14_08-18-36,6233,"[np.float32(0.0), np.float32(1.0), np.float32(0.0), np.float32(1.0), np.float32(0.0), np.float32(0.0), np.float32(0.0), np.float32(1.0), np.float32(0.0), np.float32(0.0), np.float32(1.0), np.float32(0.0), np.float32(0.0), np.float32(1.0), np.float32(0.0), np.float32(0.0)]",5.0,99723.0,17
2025-08-14_08-18-36,6234,"[np.float32(0.0), np.float32(0.0), np.float32(0.0), np.float32(0.0), np.float32(0.0), np.float32(0.0), np.float32(1.0), np.float32(0.0), np.float32(1.0), np.float32(1.0), np.float32(1.0), np.float32(1.0), np.float32(1.0), np.float32(1.0), np.float32(0.0), np.float32(1.0)]",-2.0,99721.0,14
2025-08-14_08-18-36,6235,"[np.float32(0.0), np.float32(1.0), np.float32(0.0), np.float32(1.0), np.float32(0.0), np.float32(1.0), np.float32(1.0), np.float32(1.0), np.float32(1.0), np.float32(0.0), np.float32(0.0), np.float32(0.0), np.float32(0.0), np.float32(0.0), np.float32(0.0), np.float32(1.0)]",0.0,99721.0,11
2025-08-14_08-18-36,6236,"[np.float32(0.0), np.float32(0.0), np.float32(0.0), np.float32(0.0), np.float32(0.0), np.float32(1.0), np.float32(0.0), np.float32(0.0), np.float32(1.0), np.float32(0.0), np.float32(0.0), np.float32(0.0), np.float32(0.0), np.float32(1.0), np.float32(0.0), np.float32(1.0)]",-1.0,99720.0,6
2025-08-14_08-18-36,6237,"[np.float32(0.0), np.float32(1.0), np.float32(1.0), np.float32(0.0), np.float32(1.0), np.float32(1.0), np.float32(0.0), np.float32(0.0), np.float32(1.0), np.float32(1.0), np.float32(1.0), np.float32(0.0), np.float32(0.0), np.float32(1.0), np.float32(1.0), np.float32(0.0)]",-2.0,99718.0,15
2025-08-14_08-18-36,6238,"[np.float32(1.0), np.float32(0.0), np.float32(0.0), np.float32(1.0), np.float32(1.0), np.float32(0.0), np.float32(0.0), np.float32(0.0), np.float32(0.0), np.float32(0.0), np.float32(0.0), np.float32(0.0), np.float32(0.0), np.float32(1.0), np.float32(0.0), np.float32(1.0)]",-3.0,99715.0,8
2025-08-14_08-18-36,6239,"[np.float32(0.0), np.float32(0.0), np.float32(0.0), np.float32(1.0), np.float32(1.0), np.float32(0.0), np.float32(0.0), np.float32(1.0), np.float32(0.0), np.float32(1.0), np.float32(0.0), np.float32(0.0), np.float32(0.0), np.float32(1.0), np.float32(1.0), np.float32(1.0)]",0.0,99715.0,3
2025-08-14_08-18-36,6240,"[np.float32(0.0), np.float32(0.0), np.float32(0.0), np.float32(0.0), np.float32(1.0), np.float32(0.0), np.float32(1.0), np.float32(1.0), np.float32(0.0), np.float32(0.0), np.float32(0.0), np.float32(0.0), np.float32(1.0), np.float32(1.0), np.float32(1.0), np.float32(1.0)]",-1.0,99714.0,22
2025-08-14_08-18-36,6241,"[np.float32(0.0), np.float32(0.0), np.float32(0.0), np.float32(0.0), np.float32(0.0), np.float32(1.0), np.float32(0.0), np.float32(1.0), np.float32(0.0), np.float32(1.0), np.float32(0.0), np.float32(1.0), np.float32(0.0), np.float32(0.0), np.float32(0.0), np.float32(0.0)]",-1.0,99713.0,12
2025-08-14_08-18-36,6242,"[np.float32(0.0), np.float32(0.0), np.float32(1.0), np.float32(0.0), np.float32(1.0), np.float32(1.0), np.float32(1.0), np.float32(1.0), np.float32(1.0), np.float32(1.0), np.float32(0.0), np.float32(1.0), np.float32(1.0), np.float32(1.0), np.float32(0.0), np.float32(0.0)]",1.0,99714.0,21
2025-08-14_08-18-36,6243,"[np.float32(1.0), np.float32(1.0), np.float32(1.0), np.float32(1.0), np.float32(0.0), np.float32(0.0), np.float32(1.0), np.float32(1.0), np.float32(0.0), np.float32(0.0), np.float32(1.0), np.float32(1.0), np.float32(1.0), np.float32(1.0), np.float32(0.0), np.float32(1.0)]",-1.0,99713.0,22
2025-08-14_08-18-36,6244,"[np.float32(0.0), np.float32(0.0), np.float32(1.0), np.float32(0.0), np.float32(1.0), np.float32(1.0), np.float32(0.0), np.float32(1.0), np.float32(0.0), np.float32(1.0), np.float32(1.0), np.float32(0.0), np.float32(0.0), np.float32(1.0), np.float32(1.0), np.float32(1.0)]",1.0,99714.0,2
2025-08-14_08-18-36,6245,"[np.float32(1.0), np.float32(1.0), np.float32(1.0), np.float32(1.0), np.float32(0.0), np.float32(0.0), np.float32(1.0), np.float32(1.0), np.float32(1.0), np.float32(0.0), np.float32(0.0), np.float32(0.0), np.float32(1.0), np.float32(1.0), np.float32(1.0), np.float32(0.0)]",-3.0,99711.0,17
2025-08-14_08-18-36,6246,"[np.float32(1.0), np.float32(0.0), np.float32(1.0), np.float32(1.0), np.float32(0.0), np.float32(0.0), np.float32(1.0), np.float32(1.0), np.float32(0.0), np.float32(1.0), np.float32(0.0), np.float32(1.0), np.float32(0.0), np.float32(1.0), np.float32(0.0), np.float32(1.0)]",-4.0,99707.0,29
2025-08-14_08-18-36,6247,"[np.float32(0.0), np.float32(1.0), np.float32(0.0), np.float32(1.0), np.float32(1.0), np.float32(1.0), np.float32(1.0), np.float32(0.0), np.float32(1.0), np.float32(1.0), np.float32(0.0), np.float32(0.0), np.float32(0.0), np.float32(1.0), np.float32(0.0), np.float32(1.0)]",1.0,99708.0,19
2025-08-14_08-18-36,6248,"[np.float32(1.0), np.float32(1.0), np.float32(1.0), np.float32(0.0), np.float32(0.0), np.float32(1.0), np.float32(0.0), np.float32(1.0), np.float32(1.0), np.float32(1.0), np.float32(1.0), np.float32(0.0), np.float32(1.0), np.float32(1.0), np.float32(1.0), np.float32(0.0)]",2.0,99710.0,16
2025-08-14_08-18-36,6249,"[np.float32(1.0), np.float32(0.0), np.float32(1.0), np.float32(0.0), np.float32(1.0), np.float32(0.0), np.float32(0.0), np.float32(1.0), np.float32(1.0), np.float32(1.0), np.float32(1.0), np.float32(0.0), np.float32(0.0), np.float32(0.0), np.float32(1.0), np.float32(0.0)]",2.0,99712.0,36
2025-08-14_08-18-36,6250,"[np.float32(0.0), np.float32(1.0), np.float32(1.0), np.float32(0.0), np.float32(1.0), np.float32(1.0), np.float32(1.0), np.float32(0.0), np.float32(1.0), np.float32(1.0), np.float32(0.0), np.float32(0.0), np.float32(1.0), np.float32(0.0), np.float32(0.0), np.float32(0.0)]",-4.0,99708.0,18
2025-08-14_08-18-36,6251,"[np.float32(0.0), np.float32(1.0), np.float32(0.0), np.float32(0.0), np.float32(0.0), np.float32(1.0), np.float32(0.0), np.float32(0.0), np.float32(1.0), np.float32(1.0), np.float32(0.0), np.float32(0.0), np.float32(1.0), np.float32(1.0), np.float32(1.0), np.float32(0.0)]",-2.0,99706.0,15
2025-08-14_08-18-36,6252,"[np.float32(0.0), np.float32(1.0), np.float32(0.0), np.float32(0.0), np.float32(0.0), np.float32(1.0), np.float32(1.0), np.float32(1.0), np.float32(1.0), np.float32(0.0), np.float32(0.0), np.float32(0.0), np.float32(0.0), np.float32(0.0), np.float32(1.0), np.float32(1.0)]",-2.0,99704.0,19
2025-08-14_08-18-36,6253,"[np.float32(1.0), np.float32(1.0), np.float32(0.0), np.float32(0.0), np.float32(0.0), np.float32(1.0), np.float32(0.0), np.float32(0.0), np.float32(0.0), np.float32(0.0), np.float32(1.0), np.float32(1.0), np.float32(1.0), np.float32(1.0), np.float32(1.0), np.float32(0.0)]",-3.0,99701.0,10
2025-08-14_08-18-36,6254,"[np.float32(1.0), np.float32(1.0), np.float32(1.0), np.float32(1.0), np.float32(0.0), np.float32(0.0), np.float32(0.0), np.float32(1.0), np.float32(1.0), np.float32(0.0), np.float32(1.0), np.float32(1.0), np.float32(1.0), np.float32(0.0), np.float32(0.0), np.float32(0.0)]",-2.0,99699.0,6
2025-08-14_08-18-36,6255,"[np.float32(0.0), np.float32(1.0), np.float32(1.0), np.float32(0.0), np.float32(0.0), np.float32(1.0), np.float32(1.0), np.float32(1.0), np.float32(1.0), np.float32(0.0), np.float32(0.0), np.float32(1.0), np.float32(1.0), np.float32(0.0), np.float32(0.0), np.float32(1.0)]",-1.0,99698.0,17
2025-08-14_08-18-36,6256,"[np.float32(0.0), np.float32(1.0), np.float32(0.0), np.float32(0.0), np.float32(0.0), np.float32(1.0), np.float32(0.0), np.float32(0.0), np.float32(0.0), np.float32(0.0), np.float32(1.0), np.float32(1.0), np.float32(1.0), np.float32(0.0), np.float32(1.0), np.float32(0.0)]",1.0,99699.0,35
2025-08-14_08-18-36,6257,"[np.float32(0.0), np.float32(1.0), np.float32(1.0), np.float32(1.0), np.float32(1.0), np.float32(1.0), np.float32(0.0), np.float32(0.0), np.float32(0.0), np.float32(0.0), np.float32(0.0), np.float32(0.0), np.float32(1.0), np.float32(1.0), np.float32(1.0), np.float32(0.0)]",35.0,99734.0,7
2025-08-14_08-18-36,6258,"[np.float32(1.0), np.float32(1.0), np.float32(0.0), np.float32(1.0), np.float32(1.0), np.float32(1.0), np.float32(1.0), np.float32(1.0), np.float32(1.0), np.float32(0.0), np.float32(1.0), np.float32(1.0), np.float32(0.0), np.float32(0.0), np.float32(0.0), np.float32(0.0)]",2.0,99736.0,21
2025-08-14_08-18-36,6259,"[np.float32(1.0), np.float32(0.0), np.float32(1.0), np.float32(1.0), np.float32(1.0), np.float32(1.0), np.float32(1.0), np.float32(1.0), np.float32(1.0), np.float32(1.0), np.float32(1.0), np.float32(0.0), np.float32(0.0), np.float32(0.0), np.float32(0.0), np.float32(0.0)]",0.0,99736.0,2
2025-08-14_08-18-36,6260,"[np.float32(1.0), np.float32(0.0), np.float32(0.0), np.float32(0.0), np.float32(0.0), np.float32(0.0), np.float32(1.0), np.float32(1.0), np.float32(0.0), np.float32(1.0), np.float32(0.0), np.float32(1.0), np.float32(1.0), np.float32(0.0), np.float32(1.0), np.float32(1.0)]",36.0,99772.0,7
2025-08-14_08-18-36,6261,"[np.float32(0.0), np.float32(0.0), np.float32(0.0), np.float32(0.0), np.float32(0.0), np.float32(1.0), np.float32(1.0), np.float32(0.0), np.float32(1.0), np.float32(1.0), np.float32(1.0), np.float32(0.0), np.float32(1.0), np.float32(1.0), np.float32(0.0), np.float32(1.0)]",-6.0,99766.0,24
2025-08-14_08-18-36,6262,"[np.float32(1.0), np.float32(0.0), np.float32(1.0), np.float32(1.0), np.float32(0.0), np.float32(1.0), np.float32(1.0), np.float32(1.0), np.float32(1.0), np.float32(1.0), np.float32(1.0), np.float32(0.0), np.float32(1.0), np.float32(0.0), np.float32(1.0), np.float32(0.0)]",-4.0,99762.0,9
2025-08-14_08-18-36,6263,"[np.float32(0.0), np.float32(0.0), np.float32(0.0), np.float32(0.0), np.float32(1.0), np.float32(1.0), np.float32(0.0), np.float32(1.0), np.float32(1.0), np.float32(0.0), np.float32(0.0), np.float32(0.0), np.float32(0.0), np.float32(1.0), np.float32(1.0), np.float32(1.0)]",1.0,99763.0,24
2025-08-14_08-18-36,6264,"[np.float32(1.0), np.float32(1.0), np.float32(0.0), np.float32(1.0), np.float32(0.0), np.float32(1.0), np.float32(1.0), np.float32(0.0), np.float32(1.0), np.float32(1.0), np.float32(0.0), np.float32(0.0), np.float32(1.0), np.float32(1.0), np.float32(1.0), np.float32(1.0)]",-4.0,99759.0,20
2025-08-14_08-18-36,6265,"[np.float32(1.0), np.float32(0.0), np.float32(1.0), np.float32(1.0), np.float32(0.0), np.float32(1.0), np.float32(1.0), np.float32(1.0), np.float32(1.0), np.float32(1.0), np.float32(0.0), np.float32(0.0), np.float32(0.0), np.float32(0.0), np.float32(1.0), np.float32(0.0)]",3.0,99762.0,30
2025-08-14_08-18-36,6266,"[np.float32(0.0), np.float32(0.0), np.float32(0.0), np.float32(0.0), np.float32(0.0), np.float32(1.0), np.float32(1.0), np.float32(1.0), np.float32(0.0), np.float32(0.0), np.float32(1.0), np.float32(1.0), np.float32(1.0), np.float32(0.0), np.float32(0.0), np.float32(0.0)]",-3.0,99759.0,16
2025-08-14_08-18-36,6267,"[np.float32(1.0), np.float32(1.0), np.float32(0.0), np.float32(1.0), np.float32(0.0), np.float32(1.0), np.float32(1.0), np.float32(1.0), np.float32(1.0), np.float32(1.0), np.float32(1.0), np.float32(1.0), np.float32(1.0), np.float32(1.0), np.float32(1.0), np.float32(0.0)]",2.0,99761.0,23
2025-08-14_08-18-36,6268,"[np.float32(1.0), np.float32(0.0), np.float32(0.0), np.float32(1.0), np.float32(1.0), np.float32(1.0), np.float32(1.0), np.float32(1.0), np.float32(1.0), np.float32(1.0), np.float32(0.0), np.float32(0.0), np.float32(1.0), np.float32(0.0), np.float32(0.0), np.float32(1.0)]",-3.0,99758.0,15
2025-08-14_08-18-36,6269,"[np.float32(0.0), np.float32(0.0), np.float32(1.0), np.float32(1.0), np.float32(1.0), np.float32(0.0), np.float32(0.0), np.float32(1.0), np.float32(1.0), np.float32(0.0), np.float32(0.0), np.float32(0.0), np.float32(1.0), np.float32(0.0), np.float32(0.0), np.float32(0.0)]",-1.0,99757.0,31
2025-08-14_08-18-36,6270,"[np.float32(1.0), np.float32(1.0), np.float32(1.0), np.float32(0.0), np.float32(0.0), np.float32(0.0), np.float32(1.0), np.float32(0.0), np.float32(0.0), np.float32(0.0), np.float32(1.0), np.float32(0.0), np.float32(0.0), np.float32(1.0), np.float32(0.0), np.float32(1.0)]",3.0,99760.0,12
2025-08-14_08-18-36,6271,"[np.float32(0.0), np.float32(1.0), np.float32(0.0), np.float32(1.0), np.float32(1.0), np.float32(0.0), np.float32(1.0), np.float32(0.0), np.float32(0.0), np.float32(1.0), np.float32(0.0), np.float32(0.0), np.float32(0.0), np.float32(1.0), np.float32(0.0), np.float32(1.0)]",0.0,99760.0,29
2025-08-14_08-18-36,6272,"[np.float32(1.0), np.float32(0.0), np.float32(1.0), np.float32(1.0), np.float32(0.0), np.float32(1.0), np.float32(0.0), np.float32(1.0), np.float32(1.0), np.float32(0.0), np.float32(1.0), np.float32(0.0), np.float32(0.0), np.float32(1.0), np.float32(0.0), np.float32(0.0)]",1.0,99761.0,36
2025-08-14_08-18-36,6273,"[np.float32(0.0), np.float32(1.0), np.float32(0.0), np.float32(0.0), np.float32(0.0), np.float32(0.0), np.float32(1.0), np.float32(1.0), np.float32(1.0), np.float32(0.0), np.float32(1.0), np.float32(0.0), np.float32(1.0), np.float32(0.0), np.float32(0.0), np.float32(1.0)]",4.0,99765.0,20
2025-08-14_08-18-36,6274,"[np.float32(0.0), np.float32(1.0), np.float32(1.0), np.float32(0.0), np.float32(1.0), np.float32(1.0), np.float32(1.0), np.float32(0.0), np.float32(1.0), np.float32(0.0), np.float32(0.0), np.float32(0.0), np.float32(1.0), np.float32(1.0), np.float32(1.0), np.float32(0.0)]",0.0,99765.0,6
2025-08-14_08-18-36,6275,"[np.float32(0.0), np.float32(0.0), np.float32(0.0), np.float32(1.0), np.float32(0.0), np.float32(0.0), np.float32(0.0), np.float32(1.0), np.float32(1.0), np.float32(0.0), np.float32(1.0), np.float32(1.0), np.float32(1.0), np.float32(0.0), np.float32(1.0), np.float32(1.0)]",-5.0,99760.0,10
2025-08-14_08-18-36,6276,"[np.float32(0.0), np.float32(0.0), np.float32(1.0), np.float32(0.0), np.float32(1.0), np.float32(1.0), np.float32(0.0), np.float32(1.0), np.float32(1.0), np.float32(0.0), np.float32(1.0), np.float32(0.0), np.float32(1.0), np.float32(1.0), np.float32(0.0), np.float32(0.0)]",-1.0,99759.0,30
2025-08-14_08-18-36,6277,"[np.float32(0.0), np.float32(0.0), np.float32(0.0), np.float32(1.0), np.float32(0.0), np.float32(1.0), np.float32(1.0), np.float32(0.0), np.float32(1.0), np.float32(0.0), np.float32(1.0), np.float32(1.0), np.float32(1.0), np.float32(0.0), np.float32(1.0), np.float32(0.0)]",1.0,99760.0,8
2025-08-14_08-18-36,6278,"[np.float32(0.0), np.float32(1.0), np.float32(1.0), np.float32(0.0), np.float32(1.0), np.float32(1.0), np.float32(1.0), np.float32(0.0), np.float32(1.0), np.float32(0.0), np.float32(1.0), np.float32(0.0), np.float32(1.0), np.float32(1.0), np.float32(1.0), np.float32(1.0)]",4.0,99764.0,8
2025-08-14_08-18-36,6279,"[np.float32(0.0), np.float32(1.0), np.float32(0.0), np.float32(1.0), np.float32(0.0), np.float32(0.0), np.float32(1.0), np.float32(1.0), np.float32(1.0), np.float32(0.0), np.float32(1.0), np.float32(1.0), np.float32(1.0), np.float32(1.0), np.float32(0.0), np.float32(0.0)]",-3.0,99761.0,36
2025-08-14_08-18-36,6280,"[np.float32(0.0), np.float32(0.0), np.float32(1.0), np.float32(1.0), np.float32(0.0), np.float32(1.0), np.float32(1.0), np.float32(1.0), np.float32(1.0), np.float32(0.0), np.float32(0.0), np.float32(1.0), np.float32(1.0), np.float32(0.0), np.float32(0.0), np.float32(0.0)]",0.0,99761.0,6
2025-08-14_08-18-36,6281,"[np.float32(1.0), np.float32(1.0), np.float32(1.0), np.float32(0.0), np.float32(1.0), np.float32(1.0), np.float32(1.0), np.float32(0.0), np.float32(1.0), np.float32(1.0), np.float32(1.0), np.float32(1.0), np.float32(1.0), np.float32(1.0), np.float32(0.0), np.float32(0.0)]",-5.0,99756.0,17
2025-08-14_08-18-36,6282,"[np.float32(1.0), np.float32(0.0), np.float32(1.0), np.float32(1.0), np.float32(0.0), np.float32(1.0), np.float32(0.0), np.float32(1.0), np.float32(1.0), np.float32(0.0), np.float32(0.0), np.float32(0.0), np.float32(1.0), np.float32(0.0), np.float32(1.0), np.float32(0.0)]",1.0,99757.0,25
2025-08-14_08-18-36,6283,"[np.float32(1.0), np.float32(1.0), np.float32(0.0), np.float32(0.0), np.float32(1.0), np.float32(0.0), np.float32(1.0), np.float32(1.0), np.float32(1.0), np.float32(0.0), np.float32(0.0), np.float32(0.0), np.float32(0.0), np.float32(0.0), np.float32(0.0), np.float32(0.0)]",-1.0,99756.0,20
2025-08-14_08-18-36,6284,"[np.float32(0.0), np.float32(1.0), np.float32(0.0), np.float32(0.0), np.float32(1.0), np.float32(0.0), np.float32(0.0), np.float32(1.0), np.float32(0.0), np.float32(1.0), np.float32(1.0), np.float32(1.0), np.float32(0.0), np.float32(1.0), np.float32(1.0), np.float32(0.0)]",0.0,99756.0,35
2025-08-14_08-18-36,6285,"[np.float32(0.0), np.float32(0.0), np.float32(1.0), np.float32(0.0), np.float32(1.0), np.float32(0.0), np.float32(1.0), np.float32(1.0), np.float32(1.0), np.float32(0.0), np.float32(0.0), np.float32(0.0), np.float32(1.0), np.float32(1.0), np.float32(1.0), np.float32(0.0)]",0.0,99756.0,32
2025-08-14_08-18-36,6286,"[np.float32(0.0), np.float32(0.0), np.float32(0.0), np.float32(0.0), np.float32(0.0), np.float32(1.0), np.float32(1.0), np.float32(1.0), np.float32(0.0), np.float32(0.0), np.float32(1.0), np.float32(1.0), np.float32(0.0), np.float32(1.0), np.float32(0.0), np.float32(1.0)]",-1.0,99755.0,5
2025-08-14_08-18-36,6287,"[np.float32(1.0), np.float32(0.0), np.float32(1.0), np.float32(0.0), np.float32(0.0), np.float32(0.0), np.float32(0.0), np.float32(1.0), np.float32(1.0), np.float32(0.0), np.float32(0.0), np.float32(0.0), np.float32(0.0), np.float32(0.0), np.float32(1.0), np.float32(0.0)]",-3.0,99752.0,9
2025-08-14_08-18-36,6288,"[np.float32(1.0), np.float32(0.0), np.float32(0.0), np.float32(1.0), np.float32(0.0), np.float32(1.0), np.float32(1.0), np.float32(1.0), np.float32(0.0), np.float32(0.0), np.float32(0.0), np.float32(0.0), np.float32(0.0), np.float32(0.0), np.float32(1.0), np.float32(0.0)]",-4.0,99748.0,28
2025-08-14_08-18-36,6289,"[np.float32(1.0), np.float32(0.0), np.float32(1.0), np.float32(0.0), np.float32(1.0), np.float32(1.0), np.float32(1.0), np.float32(0.0), np.float32(0.0), np.float32(0.0), np.float32(0.0), np.float32(0.0), np.float32(0.0), np.float32(1.0), np.float32(0.0), np.float32(0.0)]",1.0,99749.0,6
2025-08-14_08-18-36,6290,"[np.float32(0.0), np.float32(1.0), np.float32(1.0), np.float32(1.0), np.float32(0.0), np.float32(1.0), np.float32(1.0), np.float32(0.0), np.float32(1.0), np.float32(0.0), np.float32(0.0), np.float32(1.0), np.float32(0.0), np.float32(0.0), np.float32(1.0), np.float32(1.0)]",2.0,99751.0,9
2025-08-14_08-18-36,6291,"[np.float32(0.0), np.float32(0.0), np.float32(0.0), np.float32(1.0), np.float32(0.0), np.float32(1.0), np.float32(0.0), np.float32(0.0), np.float32(1.0), np.float32(1.0), np.float32(0.0), np.float32(1.0), np.float32(1.0), np.float32(0.0), np.float32(1.0), np.float32(1.0)]",3.0,99754.0,34
2025-08-14_08-18-36,6292,"[np.float32(0.0), np.float32(0.0), np.float32(1.0), np.float32(0.0), np.float32(0.0), np.float32(1.0), np.float32(0.0), np.float32(0.0), np.float32(0.0), np.float32(1.0), np.float32(0.0), np.float32(0.0), np.float32(0.0), np.float32(1.0), np.float32(1.0), np.float32(1.0)]",2.0,99756.0,25
2025-08-14_08-18-36,6293,"[np.float32(0.0), np.float32(0.0), np.float32(1.0), np.float32(1.0), np.float32(0.0), np.float32(0.0), np.float32(1.0), np.float32(1.0), np.float32(0.0), np.float32(0.0), np.float32(0.0), np.float32(1.0), np.float32(1.0), np.float32(1.0), np.float32(0.0), np.float32(0.0)]",4.0,99760.0,18
2025-08-14_08-18-36,6294,"[np.float32(0.0), np.float32(1.0), np.float32(1.0), np.float32(0.0), np.float32(0.0), np.float32(0.0), np.float32(1.0), np.float32(0.0), np.float32(1.0), np.float32(1.0), np.float32(0.0), np.float32(0.0), np.float32(1.0), np.float32(0.0), np.float32(1.0), np.float32(0.0)]",-7.0,99753.0,21
2025-08-14_08-18-36,6295,"[np.float32(0.0), np.float32(1.0), np.float32(1.0), np.float32(0.0), np.float32(0.0), np.float32(1.0), np.float32(1.0), np.float32(1.0), np.float32(1.0), np.float32(0.0), np.float32(0.0), np.float32(0.0), np.float32(1.0), np.float32(0.0), np.float32(0.0), np.float32(0.0)]",-2.0,99751.0,14
2025-08-14_08-18-36,6296,"[np.float32(0.0), np.float32(1.0), np.float32(0.0), np.float32(0.0), np.float32(0.0), np.float32(0.0), np.float32(1.0), np.float32(0.0), np.float32(1.0), np.float32(1.0), np.float32(0.0), np.float32(0.0), np.float32(0.0), np.float32(1.0), np.float32(0.0), np.float32(0.0)]",-2.0,99749.0,30
2025-08-14_08-18-36,6297,"[np.float32(1.0), np.float32(1.0), np.float32(0.0), np.float32(1.0), np.float32(1.0), np.float32(1.0), np.float32(1.0), np.float32(0.0), np.float32(0.0), np.float32(0.0), np.float32(1.0), np.float32(0.0), np.float32(0.0), np.float32(0.0), np.float32(1.0), np.float32(0.0)]",-1.0,99748.0,16
2025-08-14_08-18-36,6298,"[np.float32(0.0), np.float32(0.0), np.float32(1.0), np.float32(0.0), np.float32(0.0), np.float32(0.0), np.float32(0.0), np.float32(1.0), np.float32(0.0), np.float32(0.0), np.float32(0.0), np.float32(0.0), np.float32(0.0), np.float32(0.0), np.float32(0.0), np.float32(1.0)]",0.0,99748.0,13
2025-08-14_08-18-36,6299,"[np.float32(0.0), np.float32(0.0), np.float32(0.0), np.float32(0.0), np.float32(0.0), np.float32(1.0), np.float32(1.0), np.float32(0.0), np.float32(1.0), np.float32(0.0), np.float32(0.0), np.float32(0.0), np.float32(0.0), np.float32(1.0), np.float32(0.0), np.float32(0.0)]",-2.0,99746.0,24
2025-08-14_08-18-36,6300,"[np.float32(0.0), np.float32(0.0), np.float32(1.0), np.float32(1.0), np.float32(1.0), np.float32(0.0), np.float32(0.0), np.float32(1.0), np.float32(0.0), np.float32(0.0), np.float32(1.0), np.float32(1.0), np.float32(1.0), np.float32(1.0), np.float32(0.0), np.float32(1.0)]",-2.0,99744.0,13
2025-08-14_08-18-36,6301,"[np.float32(0.0), np.float32(1.0), np.float32(1.0), np.float32(0.0), np.float32(0.0), np.float32(1.0), np.float32(0.0), np.float32(0.0), np.float32(0.0), np.float32(0.0), np.float32(1.0), np.float32(1.0), np.float32(0.0), np.float32(1.0), np.float32(1.0), np.float32(0.0)]",3.0,99747.0,30
2025-08-14_08-18-36,6302,"[np.float32(0.0), np.float32(0.0), np.float32(1.0), np.float32(1.0), np.float32(0.0), np.float32(1.0), np.float32(0.0), np.float32(0.0), np.float32(1.0), np.float32(1.0), np.float32(1.0), np.float32(1.0), np.float32(1.0), np.float32(0.0), np.float32(1.0), np.float32(0.0)]",1.0,99748.0,23
2025-08-14_08-18-36,6303,"[np.float32(0.0), np.float32(1.0), np.float32(1.0), np.float32(1.0), np.float32(1.0), np.float32(0.0), np.float32(1.0), np.float32(1.0), np.float32(1.0), np.float32(1.0), np.float32(0.0), np.float32(0.0), np.float32(0.0), np.float32(1.0), np.float32(0.0), np.float32(0.0)]",1.0,99749.0,16
2025-08-14_08-18-36,6304,"[np.float32(1.0), np.float32(1.0), np.float32(0.0), np.float32(0.0), np.float32(1.0), np.float32(0.0), np.float32(1.0), np.float32(1.0), np.float32(1.0), np.float32(0.0), np.float32(0.0), np.float32(1.0), np.float32(0.0), np.float32(1.0), np.float32(0.0), np.float32(1.0)]",4.0,99753.0,9
2025-08-14_08-18-36,6305,"[np.float32(0.0), np.float32(0.0), np.float32(0.0), np.float32(1.0), np.float32(0.0), np.float32(1.0), np.float32(1.0), np.float32(1.0), np.float32(1.0), np.float32(0.0), np.float32(1.0), np.float32(0.0), np.float32(1.0), np.float32(1.0), np.float32(1.0), np.float32(0.0)]",2.0,99755.0,11
2025-08-14_08-18-36,6306,"[np.float32(0.0), np.float32(0.0), np.float32(1.0), np.float32(1.0), np.float32(1.0), np.float32(0.0), np.float32(1.0), np.float32(0.0), np.float32(0.0), np.float32(0.0), np.float32(1.0), np.float32(1.0), np.float32(1.0), np.float32(0.0), np.float32(1.0), np.float32(1.0)]",4.0,99759.0,5
2025-08-14_08-18-36,6307,"[np.float32(0.0), np.float32(1.0), np.float32(1.0), np.float32(1.0), np.float32(1.0), np.float32(1.0), np.float32(0.0), np.float32(0.0), np.float32(1.0), np.float32(1.0), np.float32(1.0), np.float32(0.0), np.float32(0.0), np.float32(1.0), np.float32(0.0), np.float32(1.0)]",0.0,99759.0,14
2025-08-14_08-18-36,6308,"[np.float32(0.0), np.float32(0.0), np.float32(0.0), np.float32(1.0), np.float32(0.0), np.float32(0.0), np.float32(0.0), np.float32(1.0), np.float32(1.0), np.float32(0.0), np.float32(0.0), np.float32(0.0), np.float32(0.0), np.float32(0.0), np.float32(1.0), np.float32(1.0)]",3.0,99762.0,33
2025-08-14_08-18-36,6309,"[np.float32(0.0), np.float32(0.0), np.float32(0.0), np.float32(0.0), np.float32(1.0), np.float32(0.0), np.float32(1.0), np.float32(0.0), np.float32(0.0), np.float32(1.0), np.float32(0.0), np.float32(0.0), np.float32(1.0), np.float32(0.0), np.float32(1.0), np.float32(0.0)]",39.0,99801.0,7
2025-08-14_08-18-36,6310,"[np.float32(0.0), np.float32(0.0), np.float32(0.0), np.float32(1.0), np.float32(0.0), np.float32(0.0), np.float32(1.0), np.float32(1.0), np.float32(0.0), np.float32(1.0), np.float32(0.0), np.float32(0.0), np.float32(0.0), np.float32(1.0), np.float32(0.0), np.float32(0.0)]",4.0,99805.0,22
2025-08-14_08-18-36,6311,"[np.float32(1.0), np.float32(0.0), np.float32(0.0), np.float32(0.0), np.float32(1.0), np.float32(0.0), np.float32(0.0), np.float32(1.0), np.float32(1.0), np.float32(1.0), np.float32(0.0), np.float32(1.0), np.float32(0.0), np.float32(0.0), np.float32(0.0), np.float32(1.0)]",2.0,99807.0,31
2025-08-14_08-18-36,6312,"[np.float32(0.0), np.float32(0.0), np.float32(1.0), np.float32(0.0), np.float32(0.0), np.float32(0.0), np.float32(1.0), np.float32(0.0), np.float32(1.0), np.float32(0.0), np.float32(0.0), np.float32(1.0), np.float32(0.0), np.float32(0.0), np.float32(0.0), np.float32(1.0)]",1.0,99808.0,33
2025-08-14_08-18-36,6313,"[np.float32(0.0), np.float32(0.0), np.float32(0.0), np.float32(0.0), np.float32(1.0), np.float32(0.0), np.float32(1.0), np.float32(1.0), np.float32(1.0), np.float32(0.0), np.float32(1.0), np.float32(0.0), np.float32(0.0), np.float32(1.0), np.float32(1.0), np.float32(0.0)]",1.0,99809.0,4
2025-08-14_08-18-36,6314,"[np.float32(0.0), np.float32(0.0), np.float32(1.0), np.float32(0.0), np.float32(0.0), np.float32(1.0), np.float32(1.0), np.float32(0.0), np.float32(1.0), np.float32(0.0), np.float32(0.0), np.float32(0.0), np.float32(0.0), np.float32(0.0), np.float32(0.0), np.float32(0.0)]",-1.0,99808.0,3
2025-08-14_08-18-36,6315,"[np.float32(1.0), np.float32(1.0), np.float32(0.0), np.float32(0.0), np.float32(0.0), np.float32(1.0), np.float32(0.0), np.float32(0.0), np.float32(1.0), np.float32(0.0), np.float32(0.0), np.float32(1.0), np.float32(0.0), np.float32(0.0), np.float32(0.0), np.float32(0.0)]",2.0,99810.0,24
2025-08-14_08-18-36,6316,"[np.float32(1.0), np.float32(0.0), np.float32(0.0), np.float32(1.0), np.float32(0.0), np.float32(0.0), np.float32(1.0), np.float32(1.0), np.float32(1.0), np.float32(1.0), np.float32(0.0), np.float32(0.0), np.float32(1.0), np.float32(1.0), np.float32(0.0), np.float32(0.0)]",-5.0,99805.0,8
2025-08-14_08-18-36,6317,"[np.float32(0.0), np.float32(0.0), np.float32(1.0), np.float32(0.0), np.float32(0.0), np.float32(0.0), np.float32(1.0), np.float32(1.0), np.float32(1.0), np.float32(1.0), np.float32(1.0), np.float32(1.0), np.float32(1.0), np.float32(0.0), np.float32(0.0), np.float32(1.0)]",2.0,99807.0,20
2025-08-14_08-18-36,6318,"[np.float32(1.0), np.float32(0.0), np.float32(0.0), np.float32(0.0), np.float32(0.0), np.float32(1.0), np.float32(0.0), np.float32(1.0), np.float32(0.0), np.float32(1.0), np.float32(0.0), np.float32(0.0), np.float32(1.0), np.float32(0.0), np.float32(0.0), np.float32(0.0)]",0.0,99807.0,24
2025-08-14_08-18-36,6319,"[np.float32(0.0), np.float32(0.0), np.float32(0.0), np.float32(0.0), np.float32(1.0), np.float32(0.0), np.float32(0.0), np.float32(1.0), np.float32(0.0), np.float32(0.0), np.float32(1.0), np.float32(0.0), np.float32(0.0), np.float32(1.0), np.float32(0.0), np.float32(0.0)]",-2.0,99805.0,1
2025-08-14_08-18-36,6320,"[np.float32(1.0), np.float32(0.0), np.float32(1.0), np.float32(0.0), np.float32(0.0), np.float32(0.0), np.float32(1.0), np.float32(1.0), np.float32(0.0), np.float32(0.0), np.float32(1.0), np.float32(1.0), np.float32(0.0), np.float32(1.0), np.float32(1.0), np.float32(1.0)]",-1.0,99804.0,27
2025-08-14_08-18-36,6321,"[np.float32(1.0), np.float32(1.0), np.float32(1.0), np.float32(0.0), np.float32(1.0), np.float32(1.0), np.float32(1.0), np.float32(1.0), np.float32(1.0), np.float32(0.0), np.float32(0.0), np.float32(1.0), np.float32(1.0), np.float32(1.0), np.float32(0.0), np.float32(0.0)]",-1.0,99803.0,25
2025-08-14_08-18-36,6322,"[np.float32(0.0), np.float32(0.0), np.float32(1.0), np.float32(1.0), np.float32(1.0), np.float32(1.0), np.float32(0.0), np.float32(1.0), np.float32(1.0), np.float32(1.0), np.float32(0.0), np.float32(1.0), np.float32(0.0), np.float32(0.0), np.float32(0.0), np.float32(0.0)]",-1.0,99802.0,17
2025-08-14_08-18-36,6323,"[np.float32(0.0), np.float32(0.0), np.float32(1.0), np.float32(0.0), np.float32(0.0), np.float32(0.0), np.float32(0.0), np.float32(1.0), np.float32(1.0), np.float32(1.0), np.float32(0.0), np.float32(1.0), np.float32(1.0), np.float32(0.0), np.float32(0.0), np.float32(0.0)]",2.0,99804.0,18
2025-08-14_08-18-36,6324,"[np.float32(0.0), np.float32(1.0), np.float32(1.0), np.float32(0.0), np.float32(1.0), np.float32(0.0), np.float32(1.0), np.float32(0.0), np.float32(0.0), np.float32(1.0), np.float32(0.0), np.float32(0.0), np.float32(0.0), np.float32(0.0), np.float32(1.0), np.float32(0.0)]",-6.0,99798.0,21
2025-08-14_08-18-36,6325,"[np.float32(0.0), np.float32(1.0), np.float32(0.0), np.float32(1.0), np.float32(1.0), np.float32(0.0), np.float32(1.0), np.float32(0.0), np.float32(0.0), np.float32(1.0), np.float32(0.0), np.float32(0.0), np.float32(0.0), np.float32(1.0), np.float32(0.0), np.float32(1.0)]",6.0,99804.0,1
2025-08-14_08-18-36,6326,"[np.float32(0.0), np.float32(1.0), np.float32(1.0), np.float32(1.0), np.float32(0.0), np.float32(1.0), np.float32(1.0), np.float32(1.0), np.float32(0.0), np.float32(1.0), np.float32(1.0), np.float32(1.0), np.float32(0.0), np.float32(1.0), np.float32(1.0), np.float32(0.0)]",-1.0,99803.0,36
2025-08-14_08-18-36,6327,"[np.float32(0.0), np.float32(1.0), np.float32(1.0), np.float32(1.0), np.float32(0.0), np.float32(0.0), np.float32(0.0), np.float32(1.0), np.float32(1.0), np.float32(0.0), np.float32(1.0), np.float32(0.0), np.float32(0.0), np.float32(1.0), np.float32(0.0), np.float32(1.0)]",-3.0,99800.0,27
2025-08-14_08-18-36,6328,"[np.float32(1.0), np.float32(1.0), np.float32(1.0), np.float32(1.0), np.float32(0.0), np.float32(1.0), np.float32(0.0), np.float32(1.0), np.float32(1.0), np.float32(0.0), np.float32(0.0), np.float32(1.0), np.float32(1.0), np.float32(1.0), np.float32(1.0), np.float32(0.0)]",-7.0,99793.0,1
2025-08-14_08-18-36,6329,"[np.float32(0.0), np.float32(1.0), np.float32(0.0), np.float32(0.0), np.float32(0.0), np.float32(0.0), np.float32(1.0), np.float32(1.0), np.float32(0.0), np.float32(1.0), np.float32(0.0), np.float32(1.0), np.float32(1.0), np.float32(0.0), np.float32(0.0), np.float32(0.0)]",-1.0,99792.0,28
2025-08-14_08-18-36,6330,"[np.float32(0.0), np.float32(1.0), np.float32(1.0), np.float32(0.0), np.float32(0.0), np.float32(1.0), np.float32(1.0), np.float32(1.0), np.float32(1.0), np.float32(1.0), np.float32(1.0), np.float32(0.0), np.float32(1.0), np.float32(1.0), np.float32(1.0), np.float32(1.0)]",-1.0,99791.0,16
2025-08-14_08-18-36,6331,"[np.float32(1.0), np.float32(0.0), np.float32(1.0), np.float32(1.0), np.float32(0.0), np.float32(1.0), np.float32(1.0), np.float32(1.0), np.float32(1.0), np.float32(0.0), np.float32(0.0), np.float32(1.0), np.float32(0.0), np.float32(0.0), np.float32(0.0), np.float32(1.0)]",3.0,99794.0,21
2025-08-14_08-18-36,6332,"[np.float32(1.0), np.float32(0.0), np.float32(0.0), np.float32(1.0), np.float32(1.0), np.float32(1.0), np.float32(1.0), np.float32(1.0), np.float32(0.0), np.float32(0.0), np.float32(1.0), np.float32(0.0), np.float32(0.0), np.float32(0.0), np.float32(0.0), np.float32(0.0)]",-3.0,99791.0,36
2025-08-14_08-18-36,6333,"[np.float32(0.0), np.float32(0.0), np.float32(1.0), np.float32(1.0), np.float32(0.0), np.float32(1.0), np.float32(1.0), np.float32(1.0), np.float32(1.0), np.float32(0.0), np.float32(0.0), np.float32(0.0), np.float32(0.0), np.float32(1.0), np.float32(0.0), np.float32(0.0)]",3.0,99794.0,25
2025-08-14_08-18-36,6334,"[np.float32(1.0), np.float32(1.0), np.float32(0.0), np.float32(1.0), np.float32(0.0), np.float32(1.0), np.float32(0.0), np.float32(1.0), np.float32(1.0), np.float32(1.0), np.float32(0.0), np.float32(1.0), np.float32(1.0), np.float32(0.0), np.float32(0.0), np.float32(1.0)]",0.0,99794.0,17
2025-08-14_08-18-36,6335,"[np.float32(1.0), np.float32(0.0), np.float32(1.0), np.float32(1.0), np.float32(1.0), np.float32(0.0), np.float32(1.0), np.float32(1.0), np.float32(1.0), np.float32(0.0), np.float32(1.0), np.float32(1.0), np.float32(1.0), np.float32(0.0), np.float32(1.0), np.float32(0.0)]",-3.0,99791.0,29
2025-08-14_08-18-36,6336,"[np.float32(1.0), np.float32(0.0), np.float32(0.0), np.float32(0.0), np.float32(0.0), np.float32(1.0), np.float32(0.0), np.float32(0.0), np.float32(1.0), np.float32(0.0), np.float32(0.0), np.float32(1.0), np.float32(1.0), np.float32(1.0), np.float32(1.0), np.float32(0.0)]",0.0,99791.0,19
2025-08-14_08-18-36,6337,"[np.float32(0.0), np.float32(0.0), np.float32(1.0), np.float32(1.0), np.float32(0.0), np.float32(0.0), np.float32(0.0), np.float32(1.0), np.float32(1.0), np.float32(1.0), np.float32(0.0), np.float32(0.0), np.float32(0.0), np.float32(1.0), np.float32(0.0), np.float32(1.0)]",1.0,99792.0,35
2025-08-14_08-18-36,6338,"[np.float32(1.0), np.float32(1.0), np.float32(0.0), np.float32(0.0), np.float32(0.0), np.float32(1.0), np.float32(0.0), np.float32(1.0), np.float32(0.0), np.float32(1.0), np.float32(1.0), np.float32(0.0), np.float32(1.0), np.float32(1.0), np.float32(1.0), np.float32(0.0)]",-2.0,99790.0,34
2025-08-14_08-18-36,6339,"[np.float32(1.0), np.float32(1.0), np.float32(1.0), np.float32(0.0), np.float32(1.0), np.float32(1.0), np.float32(0.0), np.float32(1.0), np.float32(0.0), np.float32(1.0), np.float32(0.0), np.float32(0.0), np.float32(1.0), np.float32(0.0), np.float32(0.0), np.float32(0.0)]",1.0,99791.0,10
2025-08-14_08-18-36,6340,"[np.float32(0.0), np.float32(1.0), np.float32(1.0), np.float32(0.0), np.float32(0.0), np.float32(1.0), np.float32(0.0), np.float32(1.0), np.float32(0.0), np.float32(1.0), np.float32(0.0), np.float32(0.0), np.float32(1.0), np.float32(0.0), np.float32(1.0), np.float32(0.0)]",0.0,99791.0,34
2025-08-14_08-18-36,6341,"[np.float32(0.0), np.float32(1.0), np.float32(0.0), np.float32(0.0), np.float32(1.0), np.float32(1.0), np.float32(0.0), np.float32(1.0), np.float32(0.0), np.float32(1.0), np.float32(0.0), np.float32(0.0), np.float32(1.0), np.float32(1.0), np.float32(1.0), np.float32(0.0)]",3.0,99794.0,19
2025-08-14_08-18-36,6342,"[np.float32(0.0), np.float32(1.0), np.float32(0.0), np.float32(1.0), np.float32(1.0), np.float32(1.0), np.float32(0.0), np.float32(0.0), np.float32(0.0), np.float32(0.0), np.float32(0.0), np.float32(1.0), np.float32(0.0), np.float32(0.0), np.float32(1.0), np.float32(0.0)]",0.0,99794.0,35
2025-08-14_08-18-36,6343,"[np.float32(1.0), np.float32(0.0), np.float32(1.0), np.float32(0.0), np.float32(0.0), np.float32(0.0), np.float32(1.0), np.float32(0.0), np.float32(1.0), np.float32(0.0), np.float32(1.0), np.float32(1.0), np.float32(1.0), np.float32(0.0), np.float32(0.0), np.float32(0.0)]",1.0,99795.0,9
2025-08-14_08-18-36,6344,"[np.float32(1.0), np.float32(0.0), np.float32(0.0), np.float32(0.0), np.float32(0.0), np.float32(0.0), np.float32(0.0), np.float32(1.0), np.float32(1.0), np.float32(1.0), np.float32(0.0), np.float32(0.0), np.float32(0.0), np.float32(0.0), np.float32(0.0), np.float32(0.0)]",-4.0,99791.0,8
2025-08-14_08-18-36,6345,"[np.float32(1.0), np.float32(1.0), np.float32(0.0), np.float32(0.0), np.float32(1.0), np.float32(1.0), np.float32(0.0), np.float32(0.0), np.float32(0.0), np.float32(0.0), np.float32(1.0), np.float32(0.0), np.float32(0.0), np.float32(1.0), np.float32(0.0), np.float32(1.0)]",-3.0,99788.0,10
2025-08-14_08-18-36,6346,"[np.float32(1.0), np.float32(1.0), np.float32(0.0), np.float32(1.0), np.float32(1.0), np.float32(0.0), np.float32(1.0), np.float32(1.0), np.float32(0.0), np.float32(1.0), np.float32(0.0), np.float32(0.0), np.float32(1.0), np.float32(1.0), np.float32(1.0), np.float32(0.0)]",-3.0,99785.0,35
2025-08-14_08-18-36,6347,"[np.float32(1.0), np.float32(1.0), np.float32(0.0), np.float32(0.0), np.float32(1.0), np.float32(1.0), np.float32(0.0), np.float32(1.0), np.float32(1.0), np.float32(1.0), np.float32(1.0), np.float32(0.0), np.float32(0.0), np.float32(0.0), np.float32(1.0), np.float32(1.0)]",3.0,99788.0,16
2025-08-14_08-18-36,6348,"[np.float32(0.0), np.float32(0.0), np.float32(1.0), np.float32(0.0), np.float32(1.0), np.float32(1.0), np.float32(0.0), np.float32(0.0), np.float32(0.0), np.float32(0.0), np.float32(0.0), np.float32(0.0), np.float32(0.0), np.float32(0.0), np.float32(1.0), np.float32(0.0)]",3.0,99791.0,30
2025-08-14_08-18-36,6349,"[np.float32(0.0), np.float32(0.0), np.float32(0.0), np.float32(0.0), np.float32(1.0), np.float32(1.0), np.float32(0.0), np.float32(1.0), np.float32(1.0), np.float32(0.0), np.float32(1.0), np.float32(0.0), np.float32(0.0), np.float32(1.0), np.float32(0.0), np.float32(1.0)]",-2.0,99789.0,24
2025-08-14_08-18-36,6350,"[np.float32(0.0), np.float32(0.0), np.float32(1.0), np.float32(1.0), np.float32(1.0), np.float32(0.0), np.float32(0.0), np.float32(0.0), np.float32(0.0), np.float32(0.0), np.float32(1.0), np.float32(1.0), np.float32(0.0), np.float32(1.0), np.float32(0.0), np.float32(1.0)]",-2.0,99787.0,34
2025-08-14_08-18-36,6351,"[np.float32(0.0), np.float32(1.0), np.float32(0.0), np.float32(0.0), np.float32(1.0), np.float32(0.0), np.float32(1.0), np.float32(0.0), np.float32(1.0), np.float32(0.0), np.float32(0.0), np.float32(0.0), np.float32(1.0), np.float32(0.0), np.float32(0.0), np.float32(0.0)]",2.0,99789.0,11
2025-08-14_08-18-36,6352,"[np.float32(0.0), np.float32(0.0), np.float32(1.0), np.float32(1.0), np.float32(1.0), np.float32(1.0), np.float32(1.0), np.float32(1.0), np.float32(1.0), np.float32(0.0), np.float32(1.0), np.float32(0.0), np.float32(0.0), np.float32(1.0), np.float32(1.0), np.float32(1.0)]",-1.0,99788.0,19
2025-08-14_08-18-36,6353,"[np.float32(0.0), np.float32(0.0), np.float32(0.0), np.float32(1.0), np.float32(1.0), np.float32(1.0), np.float32(1.0), np.float32(1.0), np.float32(0.0), np.float32(1.0), np.float32(0.0), np.float32(1.0), np.float32(0.0), np.float32(1.0), np.float32(0.0), np.float32(0.0)]",-3.0,99785.0,36
2025-08-14_08-18-36,6354,"[np.float32(0.0), np.float32(0.0), np.float32(0.0), np.float32(0.0), np.float32(1.0), np.float32(0.0), np.float32(0.0), np.float32(0.0), np.float32(0.0), np.float32(1.0), np.float32(1.0), np.float32(1.0), np.float32(0.0), np.float32(0.0), np.float32(1.0), np.float32(0.0)]",0.0,99785.0,3
2025-08-14_08-18-36,6355,"[np.float32(0.0), np.float32(0.0), np.float32(0.0), np.float32(0.0), np.float32(1.0), np.float32(0.0), np.float32(0.0), np.float32(1.0), np.float32(1.0), np.float32(0.0), np.float32(1.0), np.float32(0.0), np.float32(0.0), np.float32(1.0), np.float32(0.0), np.float32(1.0)]",-1.0,99784.0,1
2025-08-14_08-18-36,6356,"[np.float32(1.0), np.float32(0.0), np.float32(0.0), np.float32(0.0), np.float32(1.0), np.float32(0.0), np.float32(1.0), np.float32(0.0), np.float32(1.0), np.float32(0.0), np.float32(0.0), np.float32(0.0), np.float32(0.0), np.float32(1.0), np.float32(0.0), np.float32(0.0)]",2.0,99786.0,1
2025-08-14_08-18-36,6357,"[np.float32(1.0), np.float32(0.0), np.float32(1.0), np.float32(1.0), np.float32(0.0), np.float32(0.0), np.float32(1.0), np.float32(1.0), np.float32(0.0), np.float32(1.0), np.float32(1.0), np.float32(1.0), np.float32(0.0), np.float32(1.0), np.float32(0.0), np.float32(1.0)]",0.0,99786.0,25
2025-08-14_08-18-36,6358,"[np.float32(0.0), np.float32(0.0), np.float32(0.0), np.float32(0.0), np.float32(1.0), np.float32(1.0), np.float32(1.0), np.float32(1.0), np.float32(1.0), np.float32(1.0), np.float32(1.0), np.float32(0.0), np.float32(0.0), np.float32(1.0), np.float32(1.0), np.float32(0.0)]",-1.0,99785.0,3
2025-08-14_08-18-36,6359,"[np.float32(0.0), np.float32(0.0), np.float32(1.0), np.float32(0.0), np.float32(1.0), np.float32(1.0), np.float32(1.0), np.float32(1.0), np.float32(0.0), np.float32(1.0), np.float32(0.0), np.float32(0.0), np.float32(0.0), np.float32(1.0), np.float32(0.0), np.float32(0.0)]",0.0,99785.0,0
2025-08-14_08-18-36,6360,"[np.float32(0.0), np.float32(1.0), np.float32(0.0), np.float32(0.0), np.float32(0.0), np.float32(0.0), np.float32(0.0), np.float32(0.0), np.float32(0.0), np.float32(1.0), np.float32(0.0), np.float32(1.0), np.float32(1.0), np.float32(1.0), np.float32(0.0), np.float32(1.0)]",-1.0,99784.0,20
2025-08-14_08-18-36,6361,"[np.float32(0.0), np.float32(1.0), np.float32(0.0), np.float32(0.0), np.float32(0.0), np.float32(0.0), np.float32(1.0), np.float32(0.0), np.float32(1.0), np.float32(1.0), np.float32(0.0), np.float32(0.0), np.float32(0.0), np.float32(1.0), np.float32(0.0), np.float32(0.0)]",3.0,99787.0,10
2025-08-14_08-18-36,6362,"[np.float32(0.0), np.float32(1.0), np.float32(0.0), np.float32(1.0), np.float32(0.0), np.float32(1.0), np.float32(0.0), np.float32(1.0), np.float32(1.0), np.float32(1.0), np.float32(1.0), np.float32(0.0), np.float32(1.0), np.float32(1.0), np.float32(1.0), np.float32(1.0)]",-6.0,99781.0,6
2025-08-14_08-18-36,6363,"[np.float32(0.0), np.float32(1.0), np.float32(0.0), np.float32(0.0), np.float32(1.0), np.float32(0.0), np.float32(0.0), np.float32(1.0), np.float32(1.0), np.float32(1.0), np.float32(0.0), np.float32(0.0), np.float32(0.0), np.float32(1.0), np.float32(1.0), np.float32(0.0)]",1.0,99782.0,35
2025-08-14_08-18-36,6364,"[np.float32(1.0), np.float32(1.0), np.float32(0.0), np.float32(1.0), np.float32(0.0), np.float32(0.0), np.float32(0.0), np.float32(1.0), np.float32(0.0), np.float32(1.0), np.float32(1.0), np.float32(0.0), np.float32(0.0), np.float32(0.0), np.float32(1.0), np.float32(1.0)]",-3.0,99779.0,2
2025-08-14_08-18-36,6365,"[np.float32(1.0), np.float32(0.0), np.float32(0.0), np.float32(1.0), np.float32(1.0), np.float32(1.0), np.float32(1.0), np.float32(1.0), np.float32(0.0), np.float32(0.0), np.float32(0.0), np.float32(1.0), np.float32(0.0), np.float32(1.0), np.float32(1.0), np.float32(0.0)]",1.0,99780.0,13
2025-08-14_08-18-36,6366,"[np.float32(0.0), np.float32(1.0), np.float32(0.0), np.float32(1.0), np.float32(0.0), np.float32(0.0), np.float32(0.0), np.float32(1.0), np.float32(1.0), np.float32(0.0), np.float32(0.0), np.float32(0.0), np.float32(1.0), np.float32(0.0), np.float32(0.0), np.float32(1.0)]",-1.0,99779.0,9
2025-08-14_08-18-36,6367,"[np.float32(0.0), np.float32(0.0), np.float32(0.0), np.float32(1.0), np.float32(0.0), np.float32(0.0), np.float32(1.0), np.float32(1.0), np.float32(1.0), np.float32(1.0), np.float32(1.0), np.float32(0.0), np.float32(1.0), np.float32(0.0), np.float32(1.0), np.float32(0.0)]",3.0,99782.0,5
2025-08-14_08-18-36,6368,"[np.float32(1.0), np.float32(1.0), np.float32(1.0), np.float32(0.0), np.float32(1.0), np.float32(1.0), np.float32(0.0), np.float32(0.0), np.float32(1.0), np.float32(1.0), np.float32(0.0), np.float32(0.0), np.float32(1.0), np.float32(1.0), np.float32(0.0), np.float32(1.0)]",3.0,99785.0,25
2025-08-14_08-18-36,6369,"[np.float32(1.0), np.float32(0.0), np.float32(1.0), np.float32(1.0), np.float32(0.0), np.float32(1.0), np.float32(1.0), np.float32(0.0), np.float32(0.0), np.float32(1.0), np.float32(0.0), np.float32(1.0), np.float32(1.0), np.float32(0.0), np.float32(1.0), np.float32(0.0)]",-2.0,99783.0,31
2025-08-14_08-18-36,6370,"[np.float32(0.0), np.float32(1.0), np.float32(1.0), np.float32(0.0), np.float32(1.0), np.float32(0.0), np.float32(0.0), np.float32(1.0), np.float32(0.0), np.float32(0.0), np.float32(0.0), np.float32(0.0), np.float32(1.0), np.float32(0.0), np.float32(1.0), np.float32(1.0)]",-3.0,99780.0,0
2025-08-14_08-18-36,6371,"[np.float32(1.0), np.float32(1.0), np.float32(0.0), np.float32(0.0), np.float32(0.0), np.float32(1.0), np.float32(0.0), np.float32(1.0), np.float32(1.0), np.float32(0.0), np.float32(0.0), np.float32(1.0), np.float32(1.0), np.float32(0.0), np.float32(1.0), np.float32(1.0)]",1.0,99781.0,31
2025-08-14_08-18-36,6372,"[np.float32(0.0), np.float32(1.0), np.float32(0.0), np.float32(0.0), np.float32(0.0), np.float32(0.0), np.float32(1.0), np.float32(1.0), np.float32(0.0), np.float32(1.0), np.float32(0.0), np.float32(1.0), np.float32(1.0), np.float32(0.0), np.float32(1.0), np.float32(1.0)]",-2.0,99779.0,12
2025-08-14_08-18-36,6373,"[np.float32(1.0), np.float32(1.0), np.float32(0.0), np.float32(1.0), np.float32(1.0), np.float32(1.0), np.float32(1.0), np.float32(1.0), np.float32(0.0), np.float32(0.0), np.float32(0.0), np.float32(0.0), np.float32(1.0), np.float32(1.0), np.float32(1.0), np.float32(0.0)]",-1.0,99778.0,1
2025-08-14_08-18-36,6374,"[np.float32(0.0), np.float32(0.0), np.float32(1.0), np.float32(1.0), np.float32(1.0), np.float32(0.0), np.float32(1.0), np.float32(0.0), np.float32(0.0), np.float32(1.0), np.float32(1.0), np.float32(1.0), np.float32(1.0), np.float32(0.0), np.float32(1.0), np.float32(1.0)]",-2.0,99776.0,24
2025-08-14_08-18-36,6375,"[np.float32(1.0), np.float32(1.0), np.float32(0.0), np.float32(0.0), np.float32(0.0), np.float32(1.0), np.float32(1.0), np.float32(1.0), np.float32(1.0), np.float32(0.0), np.float32(0.0), np.float32(0.0), np.float32(1.0), np.float32(0.0), np.float32(0.0), np.float32(1.0)]",-1.0,99775.0,21
2025-08-14_08-18-36,6376,"[np.float32(1.0), np.float32(0.0), np.float32(1.0), np.float32(0.0), np.float32(1.0), np.float32(0.0), np.float32(0.0), np.float32(1.0), np.float32(1.0), np.float32(0.0), np.float32(0.0), np.float32(0.0), np.float32(1.0), np.float32(0.0), np.float32(1.0), np.float32(0.0)]",2.0,99777.0,18
2025-08-14_08-18-36,6377,"[np.float32(1.0), np.float32(0.0), np.float32(1.0), np.float32(1.0), np.float32(0.0), np.float32(1.0), np.float32(1.0), np.float32(1.0), np.float32(1.0), np.float32(0.0), np.float32(0.0), np.float32(0.0), np.float32(1.0), np.float32(1.0), np.float32(0.0), np.float32(0.0)]",-2.0,99775.0,20
2025-08-14_08-18-36,6378,"[np.float32(1.0), np.float32(1.0), np.float32(0.0), np.float32(1.0), np.float32(1.0), np.float32(1.0), np.float32(0.0), np.float32(1.0), np.float32(1.0), np.float32(1.0), np.float32(0.0), np.float32(0.0), np.float32(1.0), np.float32(1.0), np.float32(0.0), np.float32(0.0)]",-4.0,99771.0,11
2025-08-14_08-18-36,6379,"[np.float32(1.0), np.float32(1.0), np.float32(0.0), np.float32(0.0), np.float32(0.0), np.float32(0.0), np.float32(0.0), np.float32(1.0), np.float32(0.0), np.float32(1.0), np.float32(1.0), np.float32(1.0), np.float32(1.0), np.float32(0.0), np.float32(1.0), np.float32(1.0)]",-7.0,99764.0,0
2025-08-14_08-18-36,6380,"[np.float32(0.0), np.float32(0.0), np.float32(0.0), np.float32(1.0), np.float32(1.0), np.float32(0.0), np.float32(1.0), np.float32(1.0), np.float32(1.0), np.float32(0.0), np.float32(0.0), np.float32(1.0), np.float32(0.0), np.float32(1.0), np.float32(1.0), np.float32(0.0)]",5.0,99769.0,3
2025-08-14_08-18-36,6381,"[np.float32(0.0), np.float32(0.0), np.float32(1.0), np.float32(0.0), np.float32(1.0), np.float32(1.0), np.float32(0.0), np.float32(0.0), np.float32(1.0), np.float32(1.0), np.float32(0.0), np.float32(1.0), np.float32(1.0), np.float32(0.0), np.float32(0.0), np.float32(1.0)]",-3.0,99766.0,15
2025-08-14_08-18-36,6382,"[np.float32(0.0), np.float32(0.0), np.float32(1.0), np.float32(0.0), np.float32(1.0), np.float32(0.0), np.float32(0.0), np.float32(0.0), np.float32(1.0), np.float32(0.0), np.float32(1.0), np.float32(1.0), np.float32(0.0), np.float32(0.0), np.float32(1.0), np.float32(0.0)]",3.0,99769.0,33
2025-08-14_08-18-36,6383,"[np.float32(1.0), np.float32(1.0), np.float32(1.0), np.float32(0.0), np.float32(1.0), np.float32(1.0), np.float32(0.0), np.float32(1.0), np.float32(0.0), np.float32(1.0), np.float32(1.0), np.float32(1.0), np.float32(1.0), np.float32(1.0), np.float32(0.0), np.float32(0.0)]",-2.0,99767.0,30
2025-08-14_08-18-36,6384,"[np.float32(1.0), np.float32(0.0), np.float32(0.0), np.float32(1.0), np.float32(0.0), np.float32(1.0), np.float32(1.0), np.float32(0.0), np.float32(1.0), np.float32(1.0), np.float32(1.0), np.float32(0.0), np.float32(1.0), np.float32(1.0), np.float32(0.0), np.float32(1.0)]",-3.0,99764.0,33
2025-08-14_08-18-36,6385,"[np.float32(0.0), np.float32(1.0), np.float32(1.0), np.float32(1.0), np.float32(1.0), np.float32(1.0), np.float32(0.0), np.float32(1.0), np.float32(0.0), np.float32(1.0), np.float32(1.0), np.float32(0.0), np.float32(1.0), np.float32(1.0), np.float32(0.0), np.float32(0.0)]",-4.0,99760.0,33
2025-08-14_08-18-36,6386,"[np.float32(0.0), np.float32(0.0), np.float32(1.0), np.float32(1.0), np.float32(1.0), np.float32(0.0), np.float32(1.0), np.float32(1.0), np.float32(0.0), np.float32(0.0), np.float32(0.0), np.float32(1.0), np.float32(1.0), np.float32(1.0), np.float32(0.0), np.float32(0.0)]",5.0,99765.0,12
2025-08-14_08-18-36,6387,"[np.float32(0.0), np.float32(1.0), np.float32(1.0), np.float32(1.0), np.float32(0.0), np.float32(1.0), np.float32(1.0), np.float32(0.0), np.float32(1.0), np.float32(0.0), np.float32(1.0), np.float32(0.0), np.float32(0.0), np.float32(0.0), np.float32(1.0), np.float32(1.0)]",3.0,99768.0,31
2025-08-14_08-18-36,6388,"[np.float32(0.0), np.float32(0.0), np.float32(1.0), np.float32(0.0), np.float32(0.0), np.float32(0.0), np.float32(1.0), np.float32(0.0), np.float32(0.0), np.float32(1.0), np.float32(1.0), np.float32(0.0), np.float32(0.0), np.float32(1.0), np.float32(0.0), np.float32(0.0)]",0.0,99768.0,16
2025-08-14_08-18-36,6389,"[np.float32(0.0), np.float32(0.0), np.float32(1.0), np.float32(0.0), np.float32(0.0), np.float32(0.0), np.float32(1.0), np.float32(1.0), np.float32(1.0), np.float32(1.0), np.float32(0.0), np.float32(0.0), np.float32(1.0), np.float32(0.0), np.float32(1.0), np.float32(0.0)]",-4.0,99764.0,35
2025-08-14_08-18-36,6390,"[np.float32(0.0), np.float32(0.0), np.float32(0.0), np.float32(0.0), np.float32(0.0), np.float32(0.0), np.float32(1.0), np.float32(1.0), np.float32(0.0), np.float32(1.0), np.float32(1.0), np.float32(1.0), np.float32(1.0), np.float32(1.0), np.float32(0.0), np.float32(0.0)]",-4.0,99760.0,30
2025-08-14_08-18-36,6391,"[np.float32(0.0), np.float32(0.0), np.float32(1.0), np.float32(1.0), np.float32(1.0), np.float32(1.0), np.float32(1.0), np.float32(1.0), np.float32(1.0), np.float32(1.0), np.float32(1.0), np.float32(1.0), np.float32(1.0), np.float32(0.0), np.float32(0.0), np.float32(0.0)]",-1.0,99759.0,1
2025-08-14_08-18-36,6392,"[np.float32(0.0), np.float32(0.0), np.float32(0.0), np.float32(0.0), np.float32(1.0), np.float32(0.0), np.float32(1.0), np.float32(1.0), np.float32(0.0), np.float32(0.0), np.float32(1.0), np.float32(0.0), np.float32(0.0), np.float32(0.0), np.float32(0.0), np.float32(1.0)]",3.0,99762.0,8
2025-08-14_08-18-36,6393,"[np.float32(0.0), np.float32(0.0), np.float32(1.0), np.float32(0.0), np.float32(1.0), np.float32(0.0), np.float32(1.0), np.float32(1.0), np.float32(1.0), np.float32(0.0), np.float32(0.0), np.float32(1.0), np.float32(0.0), np.float32(1.0), np.float32(1.0), np.float32(1.0)]",-1.0,99761.0,17
2025-08-14_08-18-36,6394,"[np.float32(1.0), np.float32(1.0), np.float32(0.0), np.float32(1.0), np.float32(1.0), np.float32(0.0), np.float32(1.0), np.float32(1.0), np.float32(1.0), np.float32(1.0), np.float32(1.0), np.float32(0.0), np.float32(0.0), np.float32(0.0), np.float32(1.0), np.float32(0.0)]",0.0,99761.0,2
2025-08-14_08-18-36,6395,"[np.float32(1.0), np.float32(1.0), np.float32(1.0), np.float32(1.0), np.float32(1.0), np.float32(0.0), np.float32(0.0), np.float32(1.0), np.float32(1.0), np.float32(1.0), np.float32(1.0), np.float32(1.0), np.float32(1.0), np.float32(1.0), np.float32(1.0), np.float32(0.0)]",2.0,99763.0,15
2025-08-14_08-18-36,6396,"[np.float32(1.0), np.float32(1.0), np.float32(0.0), np.float32(0.0), np.float32(0.0), np.float32(1.0), np.float32(0.0), np.float32(1.0), np.float32(1.0), np.float32(1.0), np.float32(0.0), np.float32(1.0), np.float32(1.0), np.float32(1.0), np.float32(1.0), np.float32(0.0)]",3.0,99766.0,33
2025-08-14_08-18-36,6397,"[np.float32(1.0), np.float32(1.0), np.float32(1.0), np.float32(1.0), np.float32(1.0), np.float32(1.0), np.float32(0.0), np.float32(1.0), np.float32(1.0), np.float32(1.0), np.float32(1.0), np.float32(0.0), np.float32(1.0), np.float32(0.0), np.float32(0.0), np.float32(1.0)]",0.0,99766.0,29
2025-08-14_08-18-36,6398,"[np.float32(1.0), np.float32(0.0), np.float32(0.0), np.float32(1.0), np.float32(1.0), np.float32(0.0), np.float32(1.0), np.float32(1.0), np.float32(0.0), np.float32(0.0), np.float32(1.0), np.float32(0.0), np.float32(0.0), np.float32(0.0), np.float32(1.0), np.float32(0.0)]",-2.0,99764.0,6
2025-08-14_08-18-36,6399,"[np.float32(0.0), np.float32(1.0), np.float32(0.0), np.float32(1.0), np.float32(1.0), np.float32(1.0), np.float32(1.0), np.float32(1.0), np.float32(1.0), np.float32(1.0), np.float32(1.0), np.float32(1.0), np.float32(1.0), np.float32(0.0), np.float32(0.0), np.float32(1.0)]",0.0,99764.0,13
2025-08-14_08-18-36,6400,"[np.float32(0.0), np.float32(1.0), np.float32(1.0), np.float32(1.0), np.float32(0.0), np.float32(1.0), np.float32(0.0), np.float32(1.0), np.float32(0.0), np.float32(0.0), np.float32(1.0), np.float32(0.0), np.float32(0.0), np.float32(0.0), np.float32(1.0), np.float32(1.0)]",-4.0,99760.0,4
2025-08-14_08-18-36,6401,"[np.float32(0.0), np.float32(0.0), np.float32(1.0), np.float32(0.0), np.float32(0.0), np.float32(0.0), np.float32(0.0), np.float32(1.0), np.float32(1.0), np.float32(0.0), np.float32(0.0), np.float32(0.0), np.float32(1.0), np.float32(0.0), np.float32(0.0), np.float32(0.0)]",1.0,99761.0,34
2025-08-14_08-18-36,6402,"[np.float32(0.0), np.float32(1.0), np.float32(1.0), np.float32(0.0), np.float32(0.0), np.float32(0.0), np.float32(1.0), np.float32(1.0), np.float32(0.0), np.float32(1.0), np.float32(0.0), np.float32(0.0), np.float32(1.0), np.float32(0.0), np.float32(1.0), np.float32(0.0)]",-3.0,99758.0,0
2025-08-14_08-18-36,6403,"[np.float32(1.0), np.float32(1.0), np.float32(0.0), np.float32(0.0), np.float32(1.0), np.float32(0.0), np.float32(0.0), np.float32(0.0), np.float32(1.0), np.float32(0.0), np.float32(1.0), np.float32(0.0), np.float32(1.0), np.float32(0.0), np.float32(0.0), np.float32(0.0)]",-1.0,99757.0,23
2025-08-14_08-18-36,6404,"[np.float32(1.0), np.float32(1.0), np.float32(0.0), np.float32(1.0), np.float32(0.0), np.float32(1.0), np.float32(1.0), np.float32(0.0), np.float32(1.0), np.float32(0.0), np.float32(0.0), np.float32(1.0), np.float32(1.0), np.float32(1.0), np.float32(0.0), np.float32(0.0)]",1.0,99758.0,28
2025-08-14_08-18-36,6405,"[np.float32(1.0), np.float32(1.0), np.float32(0.0), np.float32(0.0), np.float32(1.0), np.float32(1.0), np.float32(1.0), np.float32(1.0), np.float32(0.0), np.float32(0.0), np.float32(0.0), np.float32(0.0), np.float32(0.0), np.float32(0.0), np.float32(1.0), np.float32(0.0)]",-3.0,99755.0,29
2025-08-14_08-18-36,6406,"[np.float32(1.0), np.float32(1.0), np.float32(0.0), np.float32(0.0), np.float32(0.0), np.float32(1.0), np.float32(1.0), np.float32(0.0), np.float32(1.0), np.float32(0.0), np.float32(0.0), np.float32(0.0), np.float32(0.0), np.float32(0.0), np.float32(1.0), np.float32(0.0)]",-1.0,99754.0,2
2025-08-14_08-18-36,6407,"[np.float32(1.0), np.float32(1.0), np.float32(1.0), np.float32(1.0), np.float32(1.0), np.float32(0.0), np.float32(1.0), np.float32(0.0), np.float32(0.0), np.float32(1.0), np.float32(0.0), np.float32(1.0), np.float32(0.0), np.float32(0.0), np.float32(1.0), np.float32(1.0)]",-6.0,99748.0,0
2025-08-14_08-18-36,6408,"[np.float32(0.0), np.float32(1.0), np.float32(0.0), np.float32(0.0), np.float32(0.0), np.float32(1.0), np.float32(1.0), np.float32(1.0), np.float32(1.0), np.float32(1.0), np.float32(1.0), np.float32(0.0), np.float32(0.0), np.float32(1.0), np.float32(1.0), np.float32(1.0)]",-2.0,99746.0,6
2025-08-14_08-18-36,6409,"[np.float32(0.0), np.float32(1.0), np.float32(0.0), np.float32(1.0), np.float32(0.0), np.float32(1.0), np.float32(0.0), np.float32(0.0), np.float32(1.0), np.float32(0.0), np.float32(0.0), np.float32(0.0), np.float32(1.0), np.float32(0.0), np.float32(0.0), np.float32(0.0)]",2.0,99748.0,28
2025-08-14_08-18-36,6410,"[np.float32(0.0), np.float32(0.0), np.float32(1.0), np.float32(1.0), np.float32(1.0), np.float32(1.0), np.float32(0.0), np.float32(1.0), np.float32(0.0), np.float32(1.0), np.float32(0.0), np.float32(0.0), np.float32(1.0), np.float32(1.0), np.float32(0.0), np.float32(0.0)]",-4.0,99744.0,11
2025-08-14_08-18-36,6411,"[np.float32(1.0), np.float32(0.0), np.float32(0.0), np.float32(0.0), np.float32(1.0), np.float32(0.0), np.float32(1.0), np.float32(0.0), np.float32(1.0), np.float32(1.0), np.float32(0.0), np.float32(1.0), np.float32(1.0), np.float32(0.0), np.float32(1.0), np.float32(1.0)]",0.0,99744.0,31
2025-08-14_08-18-36,6412,"[np.float32(0.0), np.float32(0.0), np.float32(0.0), np.float32(1.0), np.float32(0.0), np.float32(1.0), np.float32(1.0), np.float32(1.0), np.float32(1.0), np.float32(0.0), np.float32(1.0), np.float32(0.0), np.float32(0.0), np.float32(0.0), np.float32(0.0), np.float32(1.0)]",-1.0,99743.0,8
2025-08-14_08-18-36,6413,"[np.float32(1.0), np.float32(1.0), np.float32(0.0), np.float32(0.0), np.float32(0.0), np.float32(1.0), np.float32(1.0), np.float32(1.0), np.float32(1.0), np.float32(1.0), np.float32(1.0), np.float32(1.0), np.float32(1.0), np.float32(0.0), np.float32(1.0), np.float32(1.0)]",-2.0,99741.0,35
2025-08-14_08-18-36,6414,"[np.float32(0.0), np.float32(1.0), np.float32(0.0), np.float32(0.0), np.float32(1.0), np.float32(1.0), np.float32(0.0), np.float32(1.0), np.float32(0.0), np.float32(1.0), np.float32(0.0), np.float32(0.0), np.float32(1.0), np.float32(0.0), np.float32(1.0), np.float32(1.0)]",2.0,99743.0,10
2025-08-14_08-18-36,6415,"[np.float32(0.0), np.float32(1.0), np.float32(0.0), np.float32(1.0), np.float32(0.0), np.float32(1.0), np.float32(0.0), np.float32(1.0), np.float32(0.0), np.float32(1.0), np.float32(1.0), np.float32(1.0), np.float32(1.0), np.float32(1.0), np.float32(0.0), np.float32(0.0)]",-1.0,99742.0,3
2025-08-14_08-18-36,6416,"[np.float32(1.0), np.float32(1.0), np.float32(1.0), np.float32(1.0), np.float32(0.0), np.float32(0.0), np.float32(0.0), np.float32(0.0), np.float32(0.0), np.float32(1.0), np.float32(1.0), np.float32(0.0), np.float32(0.0), np.float32(0.0), np.float32(0.0), np.float32(1.0)]",-3.0,99739.0,15
2025-08-14_08-18-36,6417,"[np.float32(0.0), np.float32(1.0), np.float32(0.0), np.float32(0.0), np.float32(1.0), np.float32(0.0), np.float32(0.0), np.float32(1.0), np.float32(0.0), np.float32(0.0), np.float32(0.0), np.float32(0.0), np.float32(0.0), np.float32(1.0), np.float32(1.0), np.float32(0.0)]",0.0,99739.0,33
2025-08-14_08-18-36,6418,"[np.float32(0.0), np.float32(0.0), np.float32(0.0), np.float32(1.0), np.float32(1.0), np.float32(1.0), np.float32(1.0), np.float32(1.0), np.float32(1.0), np.float32(0.0), np.float32(1.0), np.float32(1.0), np.float32(0.0), np.float32(0.0), np.float32(0.0), np.float32(1.0)]",1.0,99740.0,11
2025-08-14_08-18-36,6419,"[np.float32(0.0), np.float32(1.0), np.float32(0.0), np.float32(1.0), np.float32(0.0), np.float32(1.0), np.float32(0.0), np.float32(1.0), np.float32(1.0), np.float32(0.0), np.float32(1.0), np.float32(0.0), np.float32(1.0), np.float32(1.0), np.float32(0.0), np.float32(1.0)]",-1.0,99739.0,2
2025-08-14_08-18-36,6420,"[np.float32(1.0), np.float32(1.0), np.float32(1.0), np.float32(1.0), np.float32(0.0), np.float32(1.0), np.float32(1.0), np.float32(1.0), np.float32(1.0), np.float32(1.0), np.float32(0.0), np.float32(0.0), np.float32(1.0), np.float32(1.0), np.float32(0.0), np.float32(1.0)]",-2.0,99737.0,17
2025-08-14_08-18-36,6421,"[np.float32(1.0), np.float32(1.0), np.float32(0.0), np.float32(0.0), np.float32(0.0), np.float32(1.0), np.float32(1.0), np.float32(0.0), np.float32(1.0), np.float32(1.0), np.float32(0.0), np.float32(0.0), np.float32(1.0), np.float32(1.0), np.float32(0.0), np.float32(1.0)]",-1.0,99736.0,2
2025-08-14_08-18-36,6422,"[np.float32(0.0), np.float32(1.0), np.float32(1.0), np.float32(0.0), np.float32(0.0), np.float32(1.0), np.float32(1.0), np.float32(0.0), np.float32(1.0), np.float32(1.0), np.float32(0.0), np.float32(0.0), np.float32(1.0), np.float32(0.0), np.float32(0.0), np.float32(1.0)]",-6.0,99730.0,18
2025-08-14_08-18-36,6423,"[np.float32(0.0), np.float32(0.0), np.float32(0.0), np.float32(1.0), np.float32(1.0), np.float32(0.0), np.float32(0.0), np.float32(1.0), np.float32(1.0), np.float32(1.0), np.float32(1.0), np.float32(0.0), np.float32(1.0), np.float32(1.0), np.float32(1.0), np.float32(0.0)]",-7.0,99723.0,6
2025-08-14_08-18-36,6424,"[np.float32(0.0), np.float32(1.0), np.float32(1.0), np.float32(1.0), np.float32(1.0), np.float32(0.0), np.float32(0.0), np.float32(1.0), np.float32(1.0), np.float32(1.0), np.float32(1.0), np.float32(1.0), np.float32(1.0), np.float32(0.0), np.float32(1.0), np.float32(0.0)]",-7.0,99716.0,0
2025-08-14_08-18-36,6425,"[np.float32(0.0), np.float32(1.0), np.float32(1.0), np.float32(1.0), np.float32(0.0), np.float32(1.0), np.float32(1.0), np.float32(1.0), np.float32(1.0), np.float32(0.0), np.float32(0.0), np.float32(0.0), np.float32(1.0), np.float32(0.0), np.float32(1.0), np.float32(0.0)]",1.0,99717.0,27
2025-08-14_08-18-36,6426,"[np.float32(0.0), np.float32(0.0), np.float32(0.0), np.float32(1.0), np.float32(0.0), np.float32(1.0), np.float32(0.0), np.float32(1.0), np.float32(1.0), np.float32(1.0), np.float32(1.0), np.float32(1.0), np.float32(0.0), np.float32(0.0), np.float32(0.0), np.float32(0.0)]",1.0,99718.0,32
2025-08-14_08-18-36,6427,"[np.float32(0.0), np.float32(1.0), np.float32(1.0), np.float32(1.0), np.float32(0.0), np.float32(1.0), np.float32(1.0), np.float32(1.0), np.float32(0.0), np.float32(0.0), np.float32(0.0), np.float32(1.0), np.float32(0.0), np.float32(1.0), np.float32(1.0), np.float32(1.0)]",-2.0,99716.0,7
2025-08-14_08-18-36,6428,"[np.float32(1.0), np.float32(0.0), np.float32(0.0), np.float32(1.0), np.float32(1.0), np.float32(0.0), np.float32(1.0), np.float32(1.0), np.float32(1.0), np.float32(0.0), np.float32(1.0), np.float32(0.0), np.float32(0.0), np.float32(0.0), np.float32(1.0), np.float32(0.0)]",0.0,99716.0,30
2025-08-14_08-18-36,6429,"[np.float32(1.0), np.float32(1.0), np.float32(1.0), np.float32(1.0), np.float32(0.0), np.float32(1.0), np.float32(1.0), np.float32(1.0), np.float32(1.0), np.float32(1.0), np.float32(0.0), np.float32(1.0), np.float32(0.0), np.float32(1.0), np.float32(0.0), np.float32(0.0)]",-2.0,99714.0,0
2025-08-14_08-18-36,6430,"[np.float32(1.0), np.float32(0.0), np.float32(1.0), np.float32(1.0), np.float32(1.0), np.float32(0.0), np.float32(1.0), np.float32(0.0), np.float32(1.0), np.float32(0.0), np.float32(0.0), np.float32(0.0), np.float32(0.0), np.float32(0.0), np.float32(0.0), np.float32(0.0)]",-1.0,99713.0,33
2025-08-14_08-18-36,6431,"[np.float32(1.0), np.float32(0.0), np.float32(1.0), np.float32(0.0), np.float32(1.0), np.float32(1.0), np.float32(0.0), np.float32(1.0), np.float32(0.0), np.float32(1.0), np.float32(0.0), np.float32(0.0), np.float32(1.0), np.float32(1.0), np.float32(1.0), np.float32(0.0)]",1.0,99714.0,10
2025-08-14_08-18-36,6432,"[np.float32(0.0), np.float32(1.0), np.float32(0.0), np.float32(1.0), np.float32(0.0), np.float32(1.0), np.float32(0.0), np.float32(1.0), np.float32(0.0), np.float32(0.0), np.float32(0.0), np.float32(1.0), np.float32(0.0), np.float32(1.0), np.float32(1.0), np.float32(0.0)]",1.0,99715.0,36
2025-08-14_08-18-36,6433,"[np.float32(0.0), np.float32(1.0), np.float32(0.0), np.float32(0.0), np.float32(1.0), np.float32(1.0), np.float32(0.0), np.float32(1.0), np.float32(0.0), np.float32(1.0), np.float32(1.0), np.float32(0.0), np.float32(1.0), np.float32(0.0), np.float32(0.0), np.float32(0.0)]",-2.0,99713.0,25
2025-08-14_08-18-36,6434,"[np.float32(1.0), np.float32(1.0), np.float32(1.0), np.float32(1.0), np.float32(0.0), np.float32(0.0), np.float32(1.0), np.float32(0.0), np.float32(1.0), np.float32(0.0), np.float32(0.0), np.float32(0.0), np.float32(0.0), np.float32(0.0), np.float32(1.0), np.float32(1.0)]",-4.0,99709.0,0
2025-08-14_08-18-36,6435,"[np.float32(0.0), np.float32(0.0), np.float32(1.0), np.float32(0.0), np.float32(0.0), np.float32(1.0), np.float32(0.0), np.float32(0.0), np.float32(1.0), np.float32(1.0), np.float32(0.0), np.float32(1.0), np.float32(0.0), np.float32(0.0), np.float32(1.0), np.float32(1.0)]",-2.0,99707.0,4
2025-08-14_08-18-36,6436,"[np.float32(0.0), np.float32(1.0), np.float32(1.0), np.float32(0.0), np.float32(0.0), np.float32(1.0), np.float32(1.0), np.float32(1.0), np.float32(0.0), np.float32(1.0), np.float32(1.0), np.float32(1.0), np.float32(1.0), np.float32(0.0), np.float32(1.0), np.float32(0.0)]",-1.0,99706.0,28
2025-08-14_08-18-36,6437,"[np.float32(0.0), np.float32(1.0), np.float32(1.0), np.float32(0.0), np.float32(0.0), np.float32(1.0), np.float32(0.0), np.float32(1.0), np.float32(0.0), np.float32(0.0), np.float32(1.0), np.float32(0.0), np.float32(1.0), np.float32(1.0), np.float32(1.0), np.float32(1.0)]",30.0,99736.0,7
2025-08-14_08-18-36,6438,"[np.float32(0.0), np.float32(1.0), np.float32(1.0), np.float32(1.0), np.float32(1.0), np.float32(0.0), np.float32(0.0), np.float32(0.0), np.float32(0.0), np.float32(0.0), np.float32(1.0), np.float32(0.0), np.float32(1.0), np.float32(1.0), np.float32(0.0), np.float32(1.0)]",-6.0,99730.0,27
2025-08-14_08-18-36,6439,"[np.float32(0.0), np.float32(1.0), np.float32(0.0), np.float32(0.0), np.float32(1.0), np.float32(0.0), np.float32(0.0), np.float32(0.0), np.float32(1.0), np.float32(1.0), np.float32(1.0), np.float32(1.0), np.float32(0.0), np.float32(0.0), np.float32(1.0), np.float32(1.0)]",0.0,99730.0,35
2025-08-14_08-18-36,6440,"[np.float32(0.0), np.float32(0.0), np.float32(1.0), np.float32(0.0), np.float32(0.0), np.float32(1.0), np.float32(1.0), np.float32(1.0), np.float32(0.0), np.float32(1.0), np.float32(0.0), np.float32(1.0), np.float32(0.0), np.float32(0.0), np.float32(1.0), np.float32(1.0)]",-2.0,99728.0,17
2025-08-14_08-18-36,6441,"[np.float32(1.0), np.float32(1.0), np.float32(1.0), np.float32(1.0), np.float32(0.0), np.float32(0.0), np.float32(0.0), np.float32(0.0), np.float32(0.0), np.float32(1.0), np.float32(0.0), np.float32(0.0), np.float32(0.0), np.float32(1.0), np.float32(0.0), np.float32(0.0)]",-2.0,99726.0,5
2025-08-14_08-18-36,6442,"[np.float32(1.0), np.float32(0.0), np.float32(1.0), np.float32(1.0), np.float32(0.0), np.float32(1.0), np.float32(1.0), np.float32(0.0), np.float32(1.0), np.float32(0.0), np.float32(0.0), np.float32(1.0), np.float32(1.0), np.float32(0.0), np.float32(1.0), np.float32(1.0)]",1.0,99727.0,6
2025-08-14_08-18-36,6443,"[np.float32(1.0), np.float32(1.0), np.float32(1.0), np.float32(1.0), np.float32(1.0), np.float32(0.0), np.float32(1.0), np.float32(1.0), np.float32(0.0), np.float32(0.0), np.float32(1.0), np.float32(0.0), np.float32(0.0), np.float32(0.0), np.float32(1.0), np.float32(1.0)]",0.0,99727.0,24
2025-08-14_08-18-36,6444,"[np.float32(1.0), np.float32(1.0), np.float32(1.0), np.float32(0.0), np.float32(1.0), np.float32(1.0), np.float32(1.0), np.float32(0.0), np.float32(1.0), np.float32(1.0), np.float32(0.0), np.float32(1.0), np.float32(1.0), np.float32(0.0), np.float32(0.0), np.float32(0.0)]",0.0,99727.0,31
2025-08-14_08-18-36,6445,"[np.float32(1.0), np.float32(1.0), np.float32(0.0), np.float32(1.0), np.float32(0.0), np.float32(0.0), np.float32(0.0), np.float32(1.0), np.float32(1.0), np.float32(1.0), np.float32(0.0), np.float32(0.0), np.float32(0.0), np.float32(1.0), np.float32(0.0), np.float32(0.0)]",-3.0,99724.0,5
2025-08-14_08-18-36,6446,"[np.float32(1.0), np.float32(1.0), np.float32(1.0), np.float32(0.0), np.float32(0.0), np.float32(0.0), np.float32(0.0), np.float32(1.0), np.float32(1.0), np.float32(0.0), np.float32(1.0), np.float32(1.0), np.float32(0.0), np.float32(1.0), np.float32(0.0), np.float32(1.0)]",-2.0,99722.0,0
2025-08-14_08-18-36,6447,"[np.float32(0.0), np.float32(1.0), np.float32(1.0), np.float32(0.0), np.float32(0.0), np.float32(1.0), np.float32(0.0), np.float32(1.0), np.float32(1.0), np.float32(0.0), np.float32(0.0), np.float32(0.0), np.float32(1.0), np.float32(1.0), np.float32(1.0), np.float32(1.0)]",1.0,99723.0,36
2025-08-14_08-18-36,6448,"[np.float32(0.0), np.float32(0.0), np.float32(0.0), np.float32(0.0), np.float32(0.0), np.float32(0.0), np.float32(1.0), np.float32(1.0), np.float32(1.0), np.float32(1.0), np.float32(1.0), np.float32(0.0), np.float32(1.0), np.float32(0.0), np.float32(0.0), np.float32(0.0)]",36.0,99759.0,7
2025-08-14_08-18-36,6449,"[np.float32(1.0), np.float32(0.0), np.float32(1.0), np.float32(0.0), np.float32(1.0), np.float32(0.0), np.float32(0.0), np.float32(0.0), np.float32(1.0), np.float32(1.0), np.float32(0.0), np.float32(1.0), np.float32(0.0), np.float32(0.0), np.float32(1.0), np.float32(0.0)]",3.0,99762.0,34
2025-08-14_08-18-36,6450,"[np.float32(0.0), np.float32(1.0), np.float32(0.0), np.float32(0.0), np.float32(1.0), np.float32(0.0), np.float32(0.0), np.float32(1.0), np.float32(0.0), np.float32(0.0), np.float32(0.0), np.float32(0.0), np.float32(0.0), np.float32(1.0), np.float32(0.0), np.float32(0.0)]",1.0,99763.0,24
2025-08-14_08-18-36,6451,"[np.float32(1.0), np.float32(1.0), np.float32(0.0), np.float32(1.0), np.float32(1.0), np.float32(1.0), np.float32(0.0), np.float32(1.0), np.float32(0.0), np.float32(0.0), np.float32(0.0), np.float32(1.0), np.float32(0.0), np.float32(1.0), np.float32(0.0), np.float32(0.0)]",-1.0,99762.0,28
2025-08-14_08-18-36,6452,"[np.float32(0.0), np.float32(1.0), np.float32(1.0), np.float32(0.0), np.float32(0.0), np.float32(1.0), np.float32(0.0), np.float32(1.0), np.float32(1.0), np.float32(1.0), np.float32(0.0), np.float32(1.0), np.float32(1.0), np.float32(0.0), np.float32(0.0), np.float32(1.0)]",-1.0,99761.0,19
2025-08-14_08-18-36,6453,"[np.float32(1.0), np.float32(0.0), np.float32(1.0), np.float32(0.0), np.float32(0.0), np.float32(0.0), np.float32(0.0), np.float32(0.0), np.float32(0.0), np.float32(0.0), np.float32(0.0), np.float32(0.0), np.float32(1.0), np.float32(1.0), np.float32(0.0), np.float32(0.0)]",1.0,99762.0,28
2025-08-14_08-18-36,6454,"[np.float32(0.0), np.float32(1.0), np.float32(1.0), np.float32(1.0), np.float32(0.0), np.float32(1.0), np.float32(1.0), np.float32(0.0), np.float32(0.0), np.float32(1.0), np.float32(1.0), np.float32(0.0), np.float32(1.0), np.float32(0.0), np.float32(1.0), np.float32(0.0)]",-2.0,99760.0,36
2025-08-14_08-18-36,6455,"[np.float32(0.0), np.float32(0.0), np.float32(1.0), np.float32(0.0), np.float32(0.0), np.float32(0.0), np.float32(1.0), np.float32(0.0), np.float32(0.0), np.float32(0.0), np.float32(1.0), np.float32(0.0), np.float32(1.0), np.float32(0.0), np.float32(1.0), np.float32(1.0)]",-6.0,99754.0,25
2025-08-14_08-18-36,6456,"[np.float32(0.0), np.float32(1.0), np.float32(0.0), np.float32(1.0), np.float32(0.0), np.float32(0.0), np.float32(1.0), np.float32(0.0), np.float32(1.0), np.float32(0.0), np.float32(1.0), np.float32(0.0), np.float32(0.0), np.float32(0.0), np.float32(0.0), np.float32(1.0)]",2.0,99756.0,26
2025-08-14_08-18-36,6457,"[np.float32(1.0), np.float32(1.0), np.float32(1.0), np.float32(1.0), np.float32(0.0), np.float32(0.0), np.float32(0.0), np.float32(1.0), np.float32(1.0), np.float32(0.0), np.float32(1.0), np.float32(1.0), np.float32(1.0), np.float32(0.0), np.float32(0.0), np.float32(0.0)]",-2.0,99754.0,9
2025-08-14_08-18-36,6458,"[np.float32(0.0), np.float32(0.0), np.float32(0.0), np.float32(1.0), np.float32(0.0), np.float32(0.0), np.float32(1.0), np.float32(1.0), np.float32(1.0), np.float32(1.0), np.float32(1.0), np.float32(1.0), np.float32(0.0), np.float32(1.0), np.float32(1.0), np.float32(0.0)]",0.0,99754.0,10
2025-08-14_08-18-36,6459,"[np.float32(1.0), np.float32(0.0), np.float32(0.0), np.float32(0.0), np.float32(0.0), np.float32(0.0), np.float32(1.0), np.float32(0.0), np.float32(0.0), np.float32(0.0), np.float32(1.0), np.float32(1.0), np.float32(1.0), np.float32(0.0), np.float32(0.0), np.float32(0.0)]",0.0,99754.0,23
2025-08-14_08-18-36,6460,"[np.float32(0.0), np.float32(1.0), np.float32(0.0), np.float32(1.0), np.float32(0.0), np.float32(1.0), np.float32(1.0), np.float32(0.0), np.float32(1.0), np.float32(0.0), np.float32(0.0), np.float32(0.0), np.float32(0.0), np.float32(0.0), np.float32(1.0), np.float32(0.0)]",1.0,99755.0,28
2025-08-14_08-18-36,6461,"[np.float32(1.0), np.float32(0.0), np.float32(0.0), np.float32(0.0), np.float32(1.0), np.float32(1.0), np.float32(0.0), np.float32(1.0), np.float32(0.0), np.float32(0.0), np.float32(1.0), np.float32(1.0), np.float32(0.0), np.float32(0.0), np.float32(0.0), np.float32(1.0)]",-2.0,99753.0,13
2025-08-14_08-18-36,6462,"[np.float32(1.0), np.float32(0.0), np.float32(0.0), np.float32(0.0), np.float32(0.0), np.float32(1.0), np.float32(0.0), np.float32(1.0), np.float32(1.0), np.float32(0.0), np.float32(1.0), np.float32(1.0), np.float32(0.0), np.float32(1.0), np.float32(0.0), np.float32(0.0)]",-4.0,99749.0,11
2025-08-14_08-18-36,6463,"[np.float32(0.0), np.float32(0.0), np.float32(0.0), np.float32(1.0), np.float32(0.0), np.float32(0.0), np.float32(0.0), np.float32(1.0), np.float32(1.0), np.float32(0.0), np.float32(0.0), np.float32(1.0), np.float32(0.0), np.float32(0.0), np.float32(0.0), np.float32(1.0)]",-3.0,99746.0,7
2025-08-14_08-18-36,6464,"[np.float32(0.0), np.float32(0.0), np.float32(0.0), np.float32(1.0), np.float32(0.0), np.float32(1.0), np.float32(0.0), np.float32(1.0), np.float32(1.0), np.float32(1.0), np.float32(0.0), np.float32(1.0), np.float32(0.0), np.float32(1.0), np.float32(0.0), np.float32(1.0)]",3.0,99749.0,15
2025-08-14_08-18-36,6465,"[np.float32(0.0), np.float32(1.0), np.float32(1.0), np.float32(0.0), np.float32(0.0), np.float32(0.0), np.float32(1.0), np.float32(1.0), np.float32(1.0), np.float32(1.0), np.float32(0.0), np.float32(0.0), np.float32(0.0), np.float32(1.0), np.float32(1.0), np.float32(0.0)]",-1.0,99748.0,0
2025-08-14_08-18-36,6466,"[np.float32(1.0), np.float32(0.0), np.float32(1.0), np.float32(1.0), np.float32(0.0), np.float32(1.0), np.float32(0.0), np.float32(1.0), np.float32(0.0), np.float32(0.0), np.float32(1.0), np.float32(1.0), np.float32(1.0), np.float32(1.0), np.float32(1.0), np.float32(1.0)]",-4.0,99744.0,28
2025-08-14_08-18-36,6467,"[np.float32(1.0), np.float32(0.0), np.float32(1.0), np.float32(0.0), np.float32(1.0), np.float32(0.0), np.float32(0.0), np.float32(1.0), np.float32(1.0), np.float32(1.0), np.float32(0.0), np.float32(0.0), np.float32(1.0), np.float32(0.0), np.float32(0.0), np.float32(0.0)]",5.0,99749.0,16
2025-08-14_08-18-36,6468,"[np.float32(0.0), np.float32(1.0), np.float32(1.0), np.float32(1.0), np.float32(1.0), np.float32(1.0), np.float32(0.0), np.float32(1.0), np.float32(0.0), np.float32(1.0), np.float32(1.0), np.float32(0.0), np.float32(1.0), np.float32(0.0), np.float32(1.0), np.float32(1.0)]",-1.0,99748.0,19
2025-08-14_08-18-36,6469,"[np.float32(0.0), np.float32(1.0), np.float32(1.0), np.float32(0.0), np.float32(1.0), np.float32(1.0), np.float32(1.0), np.float32(0.0), np.float32(0.0), np.float32(0.0), np.float32(0.0), np.float32(1.0), np.float32(0.0), np.float32(0.0), np.float32(1.0), np.float32(1.0)]",-4.0,99744.0,32
2025-08-14_08-18-36,6470,"[np.float32(1.0), np.float32(1.0), np.float32(1.0), np.float32(1.0), np.float32(0.0), np.float32(0.0), np.float32(0.0), np.float32(0.0), np.float32(1.0), np.float32(0.0), np.float32(1.0), np.float32(1.0), np.float32(1.0), np.float32(0.0), np.float32(0.0), np.float32(1.0)]",-2.0,99742.0,25
2025-08-14_08-18-36,6471,"[np.float32(0.0), np.float32(1.0), np.float32(0.0), np.float32(1.0), np.float32(0.0), np.float32(1.0), np.float32(1.0), np.float32(1.0), np.float32(1.0), np.float32(0.0), np.float32(0.0), np.float32(1.0), np.float32(0.0), np.float32(1.0), np.float32(0.0), np.float32(0.0)]",2.0,99744.0,27
2025-08-14_08-18-36,6472,"[np.float32(1.0), np.float32(1.0), np.float32(0.0), np.float32(0.0), np.float32(1.0), np.float32(0.0), np.float32(0.0), np.float32(1.0), np.float32(1.0), np.float32(0.0), np.float32(0.0), np.float32(0.0), np.float32(0.0), np.float32(0.0), np.float32(0.0), np.float32(0.0)]",0.0,99744.0,20
2025-08-14_08-18-36,6473,"[np.float32(1.0), np.float32(0.0), np.float32(0.0), np.float32(1.0), np.float32(1.0), np.float32(0.0), np.float32(0.0), np.float32(1.0), np.float32(0.0), np.float32(0.0), np.float32(0.0), np.float32(1.0), np.float32(0.0), np.float32(0.0), np.float32(1.0), np.float32(0.0)]",-6.0,99738.0,0
2025-08-14_08-18-36,6474,"[np.float32(1.0), np.float32(1.0), np.float32(1.0), np.float32(0.0), np.float32(0.0), np.float32(1.0), np.float32(0.0), np.float32(0.0), np.float32(1.0), np.float32(0.0), np.float32(1.0), np.float32(0.0), np.float32(1.0), np.float32(0.0), np.float32(0.0), np.float32(0.0)]",-3.0,99735.0,4
2025-08-14_08-18-36,6475,"[np.float32(0.0), np.float32(0.0), np.float32(1.0), np.float32(0.0), np.float32(0.0), np.float32(1.0), np.float32(0.0), np.float32(1.0), np.float32(0.0), np.float32(0.0), np.float32(1.0), np.float32(1.0), np.float32(1.0), np.float32(0.0), np.float32(0.0), np.float32(0.0)]",1.0,99736.0,32
2025-08-14_08-18-36,6476,"[np.float32(1.0), np.float32(1.0), np.float32(1.0), np.float32(0.0), np.float32(1.0), np.float32(0.0), np.float32(1.0), np.float32(0.0), np.float32(1.0), np.float32(0.0), np.float32(1.0), np.float32(0.0), np.float32(0.0), np.float32(1.0), np.float32(0.0), np.float32(0.0)]",0.0,99736.0,25
2025-08-14_08-18-36,6477,"[np.float32(0.0), np.float32(1.0), np.float32(0.0), np.float32(0.0), np.float32(1.0), np.float32(0.0), np.float32(1.0), np.float32(1.0), np.float32(0.0), np.float32(1.0), np.float32(1.0), np.float32(1.0), np.float32(0.0), np.float32(1.0), np.float32(1.0), np.float32(0.0)]",-3.0,99733.0,30
2025-08-14_08-18-36,6478,"[np.float32(1.0), np.float32(0.0), np.float32(0.0), np.float32(1.0), np.float32(1.0), np.float32(0.0), np.float32(1.0), np.float32(0.0), np.float32(1.0), np.float32(1.0), np.float32(1.0), np.float32(1.0), np.float32(0.0), np.float32(1.0), np.float32(0.0), np.float32(0.0)]",2.0,99735.0,35
2025-08-14_08-18-36,6479,"[np.float32(0.0), np.float32(1.0), np.float32(0.0), np.float32(0.0), np.float32(0.0), np.float32(0.0), np.float32(0.0), np.float32(0.0), np.float32(0.0), np.float32(1.0), np.float32(0.0), np.float32(0.0), np.float32(0.0), np.float32(1.0), np.float32(0.0), np.float32(1.0)]",2.0,99737.0,19
2025-08-14_08-18-36,6480,"[np.float32(0.0), np.float32(1.0), np.float32(0.0), np.float32(0.0), np.float32(0.0), np.float32(1.0), np.float32(1.0), np.float32(0.0), np.float32(1.0), np.float32(1.0), np.float32(1.0), np.float32(1.0), np.float32(1.0), np.float32(0.0), np.float32(1.0), np.float32(1.0)]",0.0,99737.0,29
2025-08-14_08-18-36,6481,"[np.float32(0.0), np.float32(1.0), np.float32(0.0), np.float32(0.0), np.float32(0.0), np.float32(1.0), np.float32(0.0), np.float32(1.0), np.float32(1.0), np.float32(0.0), np.float32(1.0), np.float32(1.0), np.float32(1.0), np.float32(0.0), np.float32(0.0), np.float32(0.0)]",-4.0,99733.0,12
2025-08-14_08-18-36,6482,"[np.float32(1.0), np.float32(1.0), np.float32(0.0), np.float32(1.0), np.float32(1.0), np.float32(1.0), np.float32(1.0), np.float32(1.0), np.float32(0.0), np.float32(0.0), np.float32(1.0), np.float32(1.0), np.float32(1.0), np.float32(1.0), np.float32(1.0), np.float32(1.0)]",0.0,99733.0,12
2025-08-14_08-18-36,6483,"[np.float32(0.0), np.float32(0.0), np.float32(1.0), np.float32(0.0), np.float32(0.0), np.float32(1.0), np.float32(0.0), np.float32(1.0), np.float32(1.0), np.float32(0.0), np.float32(0.0), np.float32(0.0), np.float32(0.0), np.float32(0.0), np.float32(0.0), np.float32(0.0)]",-4.0,99729.0,9
2025-08-14_08-18-36,6484,"[np.float32(0.0), np.float32(0.0), np.float32(1.0), np.float32(0.0), np.float32(0.0), np.float32(0.0), np.float32(1.0), np.float32(0.0), np.float32(1.0), np.float32(0.0), np.float32(1.0), np.float32(0.0), np.float32(1.0), np.float32(1.0), np.float32(1.0), np.float32(0.0)]",1.0,99730.0,12
2025-08-14_08-18-36,6485,"[np.float32(0.0), np.float32(0.0), np.float32(1.0), np.float32(0.0), np.float32(0.0), np.float32(1.0), np.float32(0.0), np.float32(1.0), np.float32(1.0), np.float32(1.0), np.float32(0.0), np.float32(0.0), np.float32(1.0), np.float32(0.0), np.float32(0.0), np.float32(0.0)]",-6.0,99724.0,3
2025-08-14_08-18-36,6486,"[np.float32(0.0), np.float32(0.0), np.float32(0.0), np.float32(1.0), np.float32(1.0), np.float32(0.0), np.float32(1.0), np.float32(1.0), np.float32(1.0), np.float32(0.0), np.float32(1.0), np.float32(0.0), np.float32(0.0), np.float32(0.0), np.float32(1.0), np.float32(1.0)]",-3.0,99721.0,4
2025-08-14_08-18-36,6487,"[np.float32(1.0), np.float32(0.0), np.float32(1.0), np.float32(1.0), np.float32(1.0), np.float32(1.0), np.float32(1.0), np.float32(0.0), np.float32(1.0), np.float32(0.0), np.float32(0.0), np.float32(1.0), np.float32(1.0), np.float32(0.0), np.float32(0.0), np.float32(1.0)]",-1.0,99720.0,5
2025-08-14_08-18-36,6488,"[np.float32(0.0), np.float32(0.0), np.float32(0.0), np.float32(1.0), np.float32(1.0), np.float32(0.0), np.float32(1.0), np.float32(0.0), np.float32(1.0), np.float32(0.0), np.float32(0.0), np.float32(1.0), np.float32(1.0), np.float32(0.0), np.float32(1.0), np.float32(1.0)]",5.0,99725.0,9
2025-08-14_08-18-36,6489,"[np.float32(0.0), np.float32(1.0), np.float32(1.0), np.float32(1.0), np.float32(1.0), np.float32(0.0), np.float32(0.0), np.float32(1.0), np.float32(1.0), np.float32(0.0), np.float32(1.0), np.float32(1.0), np.float32(1.0), np.float32(1.0), np.float32(0.0), np.float32(1.0)]",4.0,99729.0,17
2025-08-14_08-18-36,6490,"[np.float32(0.0), np.float32(0.0), np.float32(1.0), np.float32(0.0), np.float32(0.0), np.float32(1.0), np.float32(1.0), np.float32(1.0), np.float32(0.0), np.float32(0.0), np.float32(0.0), np.float32(0.0), np.float32(1.0), np.float32(1.0), np.float32(1.0), np.float32(1.0)]",-2.0,99727.0,5
2025-08-14_08-18-36,6491,"[np.float32(0.0), np.float32(1.0), np.float32(0.0), np.float32(0.0), np.float32(0.0), np.float32(1.0), np.float32(0.0), np.float32(0.0), np.float32(1.0), np.float32(1.0), np.float32(1.0), np.float32(0.0), np.float32(1.0), np.float32(1.0), np.float32(0.0), np.float32(0.0)]",0.0,99727.0,20
2025-08-14_08-18-36,6492,"[np.float32(0.0), np.float32(1.0), np.float32(0.0), np.float32(0.0), np.float32(0.0), np.float32(0.0), np.float32(1.0), np.float32(1.0), np.float32(0.0), np.float32(0.0), np.float32(1.0), np.float32(0.0), np.float32(0.0), np.float32(1.0), np.float32(0.0), np.float32(1.0)]",-1.0,99726.0,13
2025-08-14_08-18-36,6493,"[np.float32(0.0), np.float32(0.0), np.float32(1.0), np.float32(1.0), np.float32(0.0), np.float32(1.0), np.float32(1.0), np.float32(0.0), np.float32(1.0), np.float32(0.0), np.float32(0.0), np.float32(0.0), np.float32(1.0), np.float32(1.0), np.float32(0.0), np.float32(0.0)]",-2.0,99724.0,5
2025-08-14_08-18-36,6494,"[np.float32(0.0), np.float32(0.0), np.float32(0.0), np.float32(0.0), np.float32(1.0), np.float32(1.0), np.float32(0.0), np.float32(1.0), np.float32(0.0), np.float32(1.0), np.float32(0.0), np.float32(0.0), np.float32(1.0), np.float32(1.0), np.float32(0.0), np.float32(1.0)]",1.0,99725.0,17
2025-08-14_08-18-36,6495,"[np.float32(1.0), np.float32(1.0), np.float32(1.0), np.float32(0.0), np.float32(0.0), np.float32(1.0), np.float32(1.0), np.float32(0.0), np.float32(1.0), np.float32(0.0), np.float32(0.0), np.float32(0.0), np.float32(1.0), np.float32(0.0), np.float32(1.0), np.float32(1.0)]",-2.0,99723.0,35
2025-08-14_08-18-36,6496,"[np.float32(1.0), np.float32(1.0), np.float32(0.0), np.float32(1.0), np.float32(0.0), np.float32(1.0), np.float32(1.0), np.float32(1.0), np.float32(1.0), np.float32(1.0), np.float32(1.0), np.float32(0.0), np.float32(1.0), np.float32(1.0), np.float32(0.0), np.float32(1.0)]",-4.0,99719.0,16
2025-08-14_08-18-36,6497,"[np.float32(1.0), np.float32(0.0), np.float32(0.0), np.float32(1.0), np.float32(1.0), np.float32(1.0), np.float32(0.0), np.float32(1.0), np.float32(0.0), np.float32(1.0), np.float32(1.0), np.float32(0.0), np.float32(0.0), np.float32(1.0), np.float32(0.0), np.float32(1.0)]",2.0,99721.0,22
2025-08-14_08-18-36,6498,"[np.float32(0.0), np.float32(0.0), np.float32(1.0), np.float32(0.0), np.float32(1.0), np.float32(1.0), np.float32(1.0), np.float32(1.0), np.float32(1.0), np.float32(0.0), np.float32(1.0), np.float32(0.0), np.float32(0.0), np.float32(1.0), np.float32(0.0), np.float32(1.0)]",-4.0,99717.0,27
2025-08-14_08-18-36,6499,"[np.float32(1.0), np.float32(1.0), np.float32(0.0), np.float32(1.0), np.float32(1.0), np.float32(0.0), np.float32(1.0), np.float32(0.0), np.float32(1.0), np.float32(0.0), np.float32(1.0), np.float32(0.0), np.float32(0.0), np.float32(1.0), np.float32(0.0), np.float32(0.0)]",4.0,99721.0,11
2025-08-14_08-18-36,6500,"[np.float32(1.0), np.float32(1.0), np.float32(1.0), np.float32(1.0), np.float32(0.0), np.float32(0.0), np.float32(0.0), np.float32(0.0), np.float32(0.0), np.float32(1.0), np.float32(1.0), np.float32(0.0), np.float32(0.0), np.float32(0.0), np.float32(1.0), np.float32(1.0)]",2.0,99723.0,23
2025-08-14_08-18-36,6501,"[np.float32(0.0), np.float32(0.0), np.float32(0.0), np.float32(1.0), np.float32(1.0), np.float32(0.0), np.float32(0.0), np.float32(1.0), np.float32(1.0), np.float32(1.0), np.float32(1.0), np.float32(0.0), np.float32(1.0), np.float32(1.0), np.float32(1.0), np.float32(1.0)]",3.0,99726.0,17
2025-08-14_08-18-36,6502,"[np.float32(0.0), np.float32(0.0), np.float32(1.0), np.float32(0.0), np.float32(1.0), np.float32(0.0), np.float32(1.0), np.float32(1.0), np.float32(0.0), np.float32(0.0), np.float32(0.0), np.float32(0.0), np.float32(1.0), np.float32(0.0), np.float32(0.0), np.float32(0.0)]",0.0,99726.0,20
2025-08-14_08-18-36,6503,"[np.float32(0.0), np.float32(1.0), np.float32(0.0), np.float32(1.0), np.float32(1.0), np.float32(0.0), np.float32(1.0), np.float32(1.0), np.float32(0.0), np.float32(1.0), np.float32(0.0), np.float32(1.0), np.float32(0.0), np.float32(0.0), np.float32(0.0), np.float32(0.0)]",-4.0,99722.0,30
2025-08-14_08-18-36,6504,"[np.float32(0.0), np.float32(1.0), np.float32(1.0), np.float32(0.0), np.float32(0.0), np.float32(0.0), np.float32(1.0), np.float32(1.0), np.float32(0.0), np.float32(1.0), np.float32(0.0), np.float32(0.0), np.float32(1.0), np.float32(1.0), np.float32(0.0), np.float32(1.0)]",0.0,99722.0,12
2025-08-14_08-18-36,6505,"[np.float32(1.0), np.float32(1.0), np.float32(0.0), np.float32(1.0), np.float32(1.0), np.float32(1.0), np.float32(0.0), np.float32(1.0), np.float32(0.0), np.float32(1.0), np.float32(1.0), np.float32(0.0), np.float32(1.0), np.float32(1.0), np.float32(0.0), np.float32(1.0)]",-4.0,99718.0,24
2025-08-14_08-18-36,6506,"[np.float32(0.0), np.float32(1.0), np.float32(1.0), np.float32(0.0), np.float32(1.0), np.float32(1.0), np.float32(0.0), np.float32(1.0), np.float32(0.0), np.float32(1.0), np.float32(0.0), np.float32(1.0), np.float32(1.0), np.float32(1.0), np.float32(1.0), np.float32(0.0)]",-1.0,99717.0,2
2025-08-14_08-18-36,6507,"[np.float32(1.0), np.float32(0.0), np.float32(0.0), np.float32(1.0), np.float32(0.0), np.float32(0.0), np.float32(0.0), np.float32(1.0), np.float32(1.0), np.float32(0.0), np.float32(0.0), np.float32(1.0), np.float32(1.0), np.float32(1.0), np.float32(0.0), np.float32(0.0)]",3.0,99720.0,19
2025-08-14_08-18-36,6508,"[np.float32(1.0), np.float32(0.0), np.float32(0.0), np.float32(1.0), np.float32(0.0), np.float32(0.0), np.float32(1.0), np.float32(1.0), np.float32(1.0), np.float32(1.0), np.float32(1.0), np.float32(1.0), np.float32(0.0), np.float32(0.0), np.float32(1.0), np.float32(0.0)]",-3.0,99717.0,28
2025-08-14_08-18-36,6509,"[np.float32(1.0), np.float32(1.0), np.float32(0.0), np.float32(0.0), np.float32(1.0), np.float32(0.0), np.float32(1.0), np.float32(1.0), np.float32(1.0), np.float32(1.0), np.float32(0.0), np.float32(0.0), np.float32(1.0), np.float32(1.0), np.float32(1.0), np.float32(0.0)]",3.0,99720.0,4
2025-08-14_08-18-36,6510,"[np.float32(0.0), np.float32(0.0), np.float32(1.0), np.float32(1.0), np.float32(1.0), np.float32(0.0), np.float32(0.0), np.float32(0.0), np.float32(0.0), np.float32(1.0), np.float32(0.0), np.float32(0.0), np.float32(1.0), np.float32(0.0), np.float32(0.0), np.float32(1.0)]",-2.0,99718.0,11
2025-08-14_08-18-36,6511,"[np.float32(0.0), np.float32(1.0), np.float32(1.0), np.float32(1.0), np.float32(1.0), np.float32(1.0), np.float32(0.0), np.float32(1.0), np.float32(0.0), np.float32(0.0), np.float32(1.0), np.float32(1.0), np.float32(1.0), np.float32(0.0), np.float32(0.0), np.float32(1.0)]",-3.0,99715.0,3
2025-08-14_08-18-36,6512,"[np.float32(0.0), np.float32(0.0), np.float32(1.0), np.float32(0.0), np.float32(0.0), np.float32(1.0), np.float32(0.0), np.float32(0.0), np.float32(0.0), np.float32(0.0), np.float32(1.0), np.float32(1.0), np.float32(0.0), np.float32(1.0), np.float32(0.0), np.float32(1.0)]",4.0,99719.0,20
2025-08-14_08-18-36,6513,"[np.float32(1.0), np.float32(1.0), np.float32(1.0), np.float32(1.0), np.float32(0.0), np.float32(0.0), np.float32(0.0), np.float32(0.0), np.float32(0.0), np.float32(0.0), np.float32(1.0), np.float32(0.0), np.float32(0.0), np.float32(0.0), np.float32(0.0), np.float32(0.0)]",-1.0,99718.0,9
2025-08-14_08-18-36,6514,"[np.float32(0.0), np.float32(1.0), np.float32(0.0), np.float32(0.0), np.float32(0.0), np.float32(1.0), np.float32(1.0), np.float32(1.0), np.float32(0.0), np.float32(1.0), np.float32(0.0), np.float32(0.0), np.float32(0.0), np.float32(0.0), np.float32(0.0), np.float32(1.0)]",-3.0,99715.0,3
2025-08-14_08-18-36,6515,"[np.float32(0.0), np.float32(1.0), np.float32(0.0), np.float32(0.0), np.float32(1.0), np.float32(1.0), np.float32(1.0), np.float32(1.0), np.float32(1.0), np.float32(0.0), np.float32(0.0), np.float32(0.0), np.float32(1.0), np.float32(0.0), np.float32(0.0), np.float32(1.0)]",-1.0,99714.0,2
2025-08-14_08-18-36,6516,"[np.float32(1.0), np.float32(1.0), np.float32(1.0), np.float32(1.0), np.float32(1.0), np.float32(0.0), np.float32(1.0), np.float32(1.0), np.float32(1.0), np.float32(1.0), np.float32(1.0), np.float32(0.0), np.float32(0.0), np.float32(1.0), np.float32(1.0), np.float32(0.0)]",0.0,99714.0,17
2025-08-14_08-18-36,6517,"[np.float32(0.0), np.float32(1.0), np.float32(0.0), np.float32(0.0), np.float32(1.0), np.float32(1.0), np.float32(1.0), np.float32(1.0), np.float32(1.0), np.float32(0.0), np.float32(0.0), np.float32(0.0), np.float32(0.0), np.float32(0.0), np.float32(0.0), np.float32(0.0)]",-1.0,99713.0,34
2025-08-14_08-18-36,6518,"[np.float32(1.0), np.float32(0.0), np.float32(0.0), np.float32(0.0), np.float32(0.0), np.float32(0.0), np.float32(0.0), np.float32(1.0), np.float32(0.0), np.float32(0.0), np.float32(0.0), np.float32(0.0), np.float32(1.0), np.float32(0.0), np.float32(0.0), np.float32(0.0)]",-3.0,99710.0,4
2025-08-14_08-18-36,6519,"[np.float32(1.0), np.float32(1.0), np.float32(1.0), np.float32(0.0), np.float32(1.0), np.float32(1.0), np.float32(1.0), np.float32(1.0), np.float32(1.0), np.float32(1.0), np.float32(0.0), np.float32(1.0), np.float32(1.0), np.float32(1.0), np.float32(1.0), np.float32(0.0)]",2.0,99712.0,16
2025-08-14_08-18-36,6520,"[np.float32(0.0), np.float32(0.0), np.float32(0.0), np.float32(0.0), np.float32(1.0), np.float32(0.0), np.float32(0.0), np.float32(1.0), np.float32(1.0), np.float32(1.0), np.float32(1.0), np.float32(0.0), np.float32(0.0), np.float32(1.0), np.float32(0.0), np.float32(0.0)]",2.0,99714.0,16
2025-08-14_08-18-36,6521,"[np.float32(0.0), np.float32(0.0), np.float32(0.0), np.float32(1.0), np.float32(1.0), np.float32(0.0), np.float32(0.0), np.float32(0.0), np.float32(1.0), np.float32(1.0), np.float32(1.0), np.float32(1.0), np.float32(0.0), np.float32(1.0), np.float32(0.0), np.float32(1.0)]",0.0,99714.0,2
2025-08-14_08-18-36,6522,"[np.float32(0.0), np.float32(0.0), np.float32(1.0), np.float32(1.0), np.float32(0.0), np.float32(1.0), np.float32(0.0), np.float32(0.0), np.float32(0.0), np.float32(1.0), np.float32(0.0), np.float32(0.0), np.float32(1.0), np.float32(1.0), np.float32(0.0), np.float32(1.0)]",1.0,99715.0,1
2025-08-14_08-18-36,6523,"[np.float32(0.0), np.float32(0.0), np.float32(0.0), np.float32(1.0), np.float32(1.0), np.float32(1.0), np.float32(0.0), np.float32(1.0), np.float32(1.0), np.float32(0.0), np.float32(1.0), np.float32(0.0), np.float32(1.0), np.float32(0.0), np.float32(0.0), np.float32(1.0)]",-3.0,99712.0,16
2025-08-14_08-18-36,6524,"[np.float32(0.0), np.float32(1.0), np.float32(1.0), np.float32(0.0), np.float32(0.0), np.float32(1.0), np.float32(0.0), np.float32(1.0), np.float32(1.0), np.float32(1.0), np.float32(1.0), np.float32(0.0), np.float32(0.0), np.float32(1.0), np.float32(0.0), np.float32(0.0)]",-1.0,99711.0,8
2025-08-14_08-18-36,6525,"[np.float32(0.0), np.float32(1.0), np.float32(1.0), np.float32(1.0), np.float32(0.0), np.float32(1.0), np.float32(1.0), np.float32(1.0), np.float32(0.0), np.float32(1.0), np.float32(1.0), np.float32(0.0), np.float32(0.0), np.float32(0.0), np.float32(0.0), np.float32(0.0)]",0.0,99711.0,14
2025-08-14_08-18-36,6526,"[np.float32(1.0), np.float32(0.0), np.float32(0.0), np.float32(0.0), np.float32(0.0), np.float32(0.0), np.float32(1.0), np.float32(1.0), np.float32(1.0), np.float32(0.0), np.float32(0.0), np.float32(0.0), np.float32(1.0), np.float32(1.0), np.float32(0.0), np.float32(0.0)]",0.0,99711.0,15
2025-08-14_08-18-36,6527,"[np.float32(1.0), np.float32(0.0), np.float32(0.0), np.float32(1.0), np.float32(0.0), np.float32(1.0), np.float32(0.0), np.float32(1.0), np.float32(1.0), np.float32(0.0), np.float32(1.0), np.float32(0.0), np.float32(0.0), np.float32(1.0), np.float32(1.0), np.float32(1.0)]",3.0,99714.0,19
2025-08-14_08-18-36,6528,"[np.float32(0.0), np.float32(1.0), np.float32(0.0), np.float32(0.0), np.float32(1.0), np.float32(1.0), np.float32(0.0), np.float32(0.0), np.float32(1.0), np.float32(0.0), np.float32(0.0), np.float32(0.0), np.float32(1.0), np.float32(1.0), np.float32(0.0), np.float32(1.0)]",-3.0,99711.0,11
2025-08-14_08-18-36,6529,"[np.float32(0.0), np.float32(1.0), np.float32(1.0), np.float32(0.0), np.float32(1.0), np.float32(1.0), np.float32(1.0), np.float32(1.0), np.float32(1.0), np.float32(1.0), np.float32(0.0), np.float32(1.0), np.float32(0.0), np.float32(0.0), np.float32(1.0), np.float32(0.0)]",2.0,99713.0,4
2025-08-14_08-18-36,6530,"[np.float32(0.0), np.float32(0.0), np.float32(1.0), np.float32(1.0), np.float32(1.0), np.float32(0.0), np.float32(0.0), np.float32(1.0), np.float32(0.0), np.float32(1.0), np.float32(1.0), np.float32(0.0), np.float32(0.0), np.float32(1.0), np.float32(1.0), np.float32(0.0)]",3.0,99716.0,22
2025-08-14_08-18-36,6531,"[np.float32(0.0), np.float32(0.0), np.float32(0.0), np.float32(1.0), np.float32(0.0), np.float32(1.0), np.float32(0.0), np.float32(1.0), np.float32(0.0), np.float32(0.0), np.float32(0.0), np.float32(1.0), np.float32(1.0), np.float32(0.0), np.float32(1.0), np.float32(0.0)]",-3.0,99713.0,14
2025-08-14_08-18-36,6532,"[np.float32(1.0), np.float32(1.0), np.float32(1.0), np.float32(0.0), np.float32(1.0), np.float32(1.0), np.float32(0.0), np.float32(1.0), np.float32(0.0), np.float32(0.0), np.float32(1.0), np.float32(0.0), np.float32(0.0), np.float32(1.0), np.float32(1.0), np.float32(0.0)]",1.0,99714.0,21
2025-08-14_08-18-36,6533,"[np.float32(0.0), np.float32(1.0), np.float32(0.0), np.float32(1.0), np.float32(0.0), np.float32(1.0), np.float32(1.0), np.float32(1.0), np.float32(1.0), np.float32(1.0), np.float32(0.0), np.float32(0.0), np.float32(0.0), np.float32(0.0), np.float32(0.0), np.float32(0.0)]",3.0,99717.0,28
2025-08-14_08-18-36,6534,"[np.float32(1.0), np.float32(1.0), np.float32(1.0), np.float32(0.0), np.float32(1.0), np.float32(0.0), np.float32(0.0), np.float32(1.0), np.float32(0.0), np.float32(1.0), np.float32(0.0), np.float32(0.0), np.float32(1.0), np.float32(0.0), np.float32(1.0), np.float32(0.0)]",35.0,99752.0,7
2025-08-14_08-18-36,6535,"[np.float32(0.0), np.float32(0.0), np.float32(0.0), np.float32(1.0), np.float32(0.0), np.float32(0.0), np.float32(1.0), np.float32(1.0), np.float32(1.0), np.float32(0.0), np.float32(1.0), np.float32(1.0), np.float32(1.0), np.float32(1.0), np.float32(0.0), np.float32(1.0)]",-3.0,99749.0,24
2025-08-14_08-18-36,6536,"[np.float32(1.0), np.float32(0.0), np.float32(1.0), np.float32(1.0), np.float32(1.0), np.float32(1.0), np.float32(0.0), np.float32(1.0), np.float32(1.0), np.float32(1.0), np.float32(0.0), np.float32(1.0), np.float32(0.0), np.float32(0.0), np.float32(1.0), np.float32(0.0)]",-1.0,99748.0,12
2025-08-14_08-18-36,6537,"[np.float32(0.0), np.float32(0.0), np.float32(1.0), np.float32(1.0), np.float32(1.0), np.float32(1.0), np.float32(1.0), np.float32(1.0), np.float32(1.0), np.float32(1.0), np.float32(0.0), np.float32(0.0), np.float32(1.0), np.float32(0.0), np.float32(1.0), np.float32(1.0)]",-1.0,99747.0,28
2025-08-14_08-18-36,6538,"[np.float32(0.0), np.float32(0.0), np.float32(0.0), np.float32(1.0), np.float32(0.0), np.float32(1.0), np.float32(0.0), np.float32(1.0), np.float32(1.0), np.float32(1.0), np.float32(0.0), np.float32(0.0), np.float32(0.0), np.float32(1.0), np.float32(0.0), np.float32(0.0)]",5.0,99752.0,22
2025-08-14_08-18-36,6539,"[np.float32(0.0), np.float32(1.0), np.float32(0.0), np.float32(0.0), np.float32(1.0), np.float32(1.0), np.float32(0.0), np.float32(1.0), np.float32(0.0), np.float32(1.0), np.float32(0.0), np.float32(1.0), np.float32(1.0), np.float32(1.0), np.float32(0.0), np.float32(1.0)]",1.0,99753.0,4
2025-08-14_08-18-36,6540,"[np.float32(1.0), np.float32(1.0), np.float32(1.0), np.float32(1.0), np.float32(1.0), np.float32(1.0), np.float32(1.0), np.float32(1.0), np.float32(1.0), np.float32(0.0), np.float32(0.0), np.float32(1.0), np.float32(1.0), np.float32(1.0), np.float32(0.0), np.float32(1.0)]",-4.0,99749.0,13
2025-08-14_08-18-36,6541,"[np.float32(0.0), np.float32(1.0), np.float32(1.0), np.float32(0.0), np.float32(1.0), np.float32(0.0), np.float32(0.0), np.float32(0.0), np.float32(0.0), np.float32(1.0), np.float32(0.0), np.float32(1.0), np.float32(1.0), np.float32(1.0), np.float32(0.0), np.float32(1.0)]",-2.0,99747.0,8
2025-08-14_08-18-36,6542,"[np.float32(0.0), np.float32(1.0), np.float32(0.0), np.float32(1.0), np.float32(1.0), np.float32(1.0), np.float32(0.0), np.float32(0.0), np.float32(0.0), np.float32(0.0), np.float32(1.0), np.float32(1.0), np.float32(0.0), np.float32(0.0), np.float32(0.0), np.float32(0.0)]",-2.0,99745.0,10
2025-08-14_08-18-36,6543,"[np.float32(1.0), np.float32(1.0), np.float32(0.0), np.float32(1.0), np.float32(0.0), np.float32(1.0), np.float32(1.0), np.float32(1.0), np.float32(1.0), np.float32(0.0), np.float32(1.0), np.float32(1.0), np.float32(0.0), np.float32(1.0), np.float32(0.0), np.float32(0.0)]",3.0,99748.0,26
2025-08-14_08-18-36,6544,"[np.float32(1.0), np.float32(1.0), np.float32(0.0), np.float32(0.0), np.float32(1.0), np.float32(1.0), np.float32(1.0), np.float32(1.0), np.float32(0.0), np.float32(0.0), np.float32(1.0), np.float32(0.0), np.float32(1.0), np.float32(0.0), np.float32(0.0), np.float32(0.0)]",-1.0,99747.0,18
2025-08-14_08-18-36,6545,"[np.float32(1.0), np.float32(1.0), np.float32(0.0), np.float32(1.0), np.float32(1.0), np.float32(1.0), np.float32(1.0), np.float32(1.0), np.float32(0.0), np.float32(0.0), np.float32(0.0), np.float32(0.0), np.float32(1.0), np.float32(0.0), np.float32(0.0), np.float32(1.0)]",1.0,99748.0,20
2025-08-14_08-18-36,6546,"[np.float32(1.0), np.float32(0.0), np.float32(1.0), np.float32(1.0), np.float32(0.0), np.float32(0.0), np.float32(1.0), np.float32(1.0), np.float32(0.0), np.float32(0.0), np.float32(1.0), np.float32(1.0), np.float32(1.0), np.float32(1.0), np.float32(0.0), np.float32(0.0)]",-2.0,99746.0,16
2025-08-14_08-18-36,6547,"[np.float32(1.0), np.float32(0.0), np.float32(0.0), np.float32(0.0), np.float32(0.0), np.float32(1.0), np.float32(1.0), np.float32(1.0), np.float32(1.0), np.float32(0.0), np.float32(1.0), np.float32(1.0), np.float32(1.0), np.float32(0.0), np.float32(0.0), np.float32(1.0)]",1.0,99747.0,36
2025-08-14_08-18-36,6548,"[np.float32(1.0), np.float32(1.0), np.float32(0.0), np.float32(0.0), np.float32(1.0), np.float32(0.0), np.float32(1.0), np.float32(1.0), np.float32(1.0), np.float32(1.0), np.float32(1.0), np.float32(1.0), np.float32(0.0), np.float32(1.0), np.float32(0.0), np.float32(0.0)]",-2.0,99745.0,27
2025-08-14_08-18-36,6549,"[np.float32(1.0), np.float32(1.0), np.float32(1.0), np.float32(0.0), np.float32(1.0), np.float32(0.0), np.float32(1.0), np.float32(0.0), np.float32(1.0), np.float32(1.0), np.float32(0.0), np.float32(1.0), np.float32(1.0), np.float32(0.0), np.float32(0.0), np.float32(0.0)]",3.0,99748.0,4
2025-08-14_08-18-36,6550,"[np.float32(1.0), np.float32(1.0), np.float32(0.0), np.float32(0.0), np.float32(0.0), np.float32(1.0), np.float32(1.0), np.float32(1.0), np.float32(0.0), np.float32(0.0), np.float32(0.0), np.float32(0.0), np.float32(1.0), np.float32(0.0), np.float32(0.0), np.float32(1.0)]",-2.0,99746.0,2
2025-08-14_08-18-36,6551,"[np.float32(1.0), np.float32(1.0), np.float32(1.0), np.float32(1.0), np.float32(1.0), np.float32(0.0), np.float32(1.0), np.float32(1.0), np.float32(1.0), np.float32(1.0), np.float32(1.0), np.float32(1.0), np.float32(1.0), np.float32(1.0), np.float32(0.0), np.float32(0.0)]",-1.0,99745.0,13
2025-08-14_08-18-36,6552,"[np.float32(0.0), np.float32(0.0), np.float32(0.0), np.float32(0.0), np.float32(1.0), np.float32(1.0), np.float32(1.0), np.float32(0.0), np.float32(1.0), np.float32(1.0), np.float32(0.0), np.float32(0.0), np.float32(0.0), np.float32(0.0), np.float32(1.0), np.float32(0.0)]",2.0,99747.0,25
2025-08-14_08-18-36,6553,"[np.float32(1.0), np.float32(0.0), np.float32(0.0), np.float32(0.0), np.float32(1.0), np.float32(0.0), np.float32(0.0), np.float32(1.0), np.float32(1.0), np.float32(1.0), np.float32(0.0), np.float32(0.0), np.float32(0.0), np.float32(0.0), np.float32(1.0), np.float32(0.0)]",2.0,99749.0,10
2025-08-14_08-18-36,6554,"[np.float32(0.0), np.float32(0.0), np.float32(0.0), np.float32(1.0), np.float32(0.0), np.float32(1.0), np.float32(0.0), np.float32(0.0), np.float32(1.0), np.float32(1.0), np.float32(0.0), np.float32(1.0), np.float32(0.0), np.float32(0.0), np.float32(0.0), np.float32(0.0)]",0.0,99749.0,32
2025-08-14_08-18-36,6555,"[np.float32(1.0), np.float32(0.0), np.float32(0.0), np.float32(1.0), np.float32(1.0), np.float32(0.0), np.float32(0.0), np.float32(0.0), np.float32(1.0), np.float32(1.0), np.float32(0.0), np.float32(0.0), np.float32(1.0), np.float32(0.0), np.float32(1.0), np.float32(0.0)]",-7.0,99742.0,0
2025-08-14_08-18-36,6556,"[np.float32(0.0), np.float32(0.0), np.float32(0.0), np.float32(1.0), np.float32(1.0), np.float32(0.0), np.float32(1.0), np.float32(1.0), np.float32(1.0), np.float32(1.0), np.float32(0.0), np.float32(0.0), np.float32(0.0), np.float32(0.0), np.float32(1.0), np.float32(0.0)]",-1.0,99741.0,28
2025-08-14_08-18-36,6557,"[np.float32(1.0), np.float32(0.0), np.float32(0.0), np.float32(1.0), np.float32(1.0), np.float32(1.0), np.float32(0.0), np.float32(1.0), np.float32(1.0), np.float32(1.0), np.float32(0.0), np.float32(0.0), np.float32(0.0), np.float32(1.0), np.float32(0.0), np.float32(0.0)]",2.0,99743.0,31
2025-08-14_08-18-36,6558,"[np.float32(0.0), np.float32(1.0), np.float32(1.0), np.float32(0.0), np.float32(0.0), np.float32(0.0), np.float32(0.0), np.float32(1.0), np.float32(1.0), np.float32(0.0), np.float32(0.0), np.float32(0.0), np.float32(1.0), np.float32(1.0), np.float32(1.0), np.float32(1.0)]",-1.0,99742.0,8
2025-08-14_08-18-36,6559,"[np.float32(0.0), np.float32(0.0), np.float32(0.0), np.float32(1.0), np.float32(0.0), np.float32(0.0), np.float32(0.0), np.float32(1.0), np.float32(0.0), np.float32(1.0), np.float32(0.0), np.float32(1.0), np.float32(1.0), np.float32(1.0), np.float32(0.0), np.float32(1.0)]",-4.0,99738.0,36
2025-08-14_08-18-36,6560,"[np.float32(1.0), np.float32(1.0), np.float32(0.0), np.float32(1.0), np.float32(0.0), np.float32(1.0), np.float32(0.0), np.float32(1.0), np.float32(0.0), np.float32(1.0), np.float32(0.0), np.float32(0.0), np.float32(0.0), np.float32(0.0), np.float32(0.0), np.float32(1.0)]",3.0,99741.0,20
2025-08-14_08-18-36,6561,"[np.float32(1.0), np.float32(1.0), np.float32(1.0), np.float32(0.0), np.float32(1.0), np.float32(1.0), np.float32(1.0), np.float32(1.0), np.float32(1.0), np.float32(1.0), np.float32(1.0), np.float32(1.0), np.float32(1.0), np.float32(1.0), np.float32(1.0), np.float32(1.0)]",-2.0,99739.0,23
2025-08-14_08-18-36,6562,"[np.float32(1.0), np.float32(1.0), np.float32(1.0), np.float32(0.0), np.float32(1.0), np.float32(0.0), np.float32(1.0), np.float32(0.0), np.float32(1.0), np.float32(0.0), np.float32(0.0), np.float32(1.0), np.float32(1.0), np.float32(0.0), np.float32(1.0), np.float32(0.0)]",-4.0,99735.0,29
2025-08-14_08-18-36,6563,"[np.float32(0.0), np.float32(1.0), np.float32(1.0), np.float32(1.0), np.float32(1.0), np.float32(0.0), np.float32(1.0), np.float32(1.0), np.float32(1.0), np.float32(1.0), np.float32(1.0), np.float32(0.0), np.float32(1.0), np.float32(1.0), np.float32(1.0), np.float32(1.0)]",-2.0,99733.0,34
2025-08-14_08-18-36,6564,"[np.float32(0.0), np.float32(1.0), np.float32(1.0), np.float32(0.0), np.float32(0.0), np.float32(1.0), np.float32(1.0), np.float32(1.0), np.float32(0.0), np.float32(0.0), np.float32(0.0), np.float32(1.0), np.float32(1.0), np.float32(1.0), np.float32(1.0), np.float32(0.0)]",-1.0,99732.0,27
2025-08-14_08-18-36,6565,"[np.float32(0.0), np.float32(0.0), np.float32(1.0), np.float32(1.0), np.float32(1.0), np.float32(0.0), np.float32(0.0), np.float32(1.0), np.float32(0.0), np.float32(1.0), np.float32(0.0), np.float32(0.0), np.float32(0.0), np.float32(1.0), np.float32(0.0), np.float32(0.0)]",5.0,99737.0,22
2025-08-14_08-18-36,6566,"[np.float32(1.0), np.float32(1.0), np.float32(0.0), np.float32(0.0), np.float32(0.0), np.float32(1.0), np.float32(0.0), np.float32(0.0), np.float32(0.0), np.float32(0.0), np.float32(1.0), np.float32(0.0), np.float32(0.0), np.float32(1.0), np.float32(1.0), np.float32(0.0)]",-1.0,99736.0,10
2025-08-14_08-18-36,6567,"[np.float32(1.0), np.float32(1.0), np.float32(1.0), np.float32(1.0), np.float32(0.0), np.float32(0.0), np.float32(0.0), np.float32(1.0), np.float32(0.0), np.float32(1.0), np.float32(0.0), np.float32(1.0), np.float32(1.0), np.float32(0.0), np.float32(1.0), np.float32(0.0)]",-2.0,99734.0,9
2025-08-14_08-18-36,6568,"[np.float32(1.0), np.float32(0.0), np.float32(0.0), np.float32(0.0), np.float32(0.0), np.float32(1.0), np.float32(1.0), np.float32(0.0), np.float32(0.0), np.float32(0.0), np.float32(1.0), np.float32(1.0), np.float32(1.0), np.float32(0.0), np.float32(1.0), np.float32(1.0)]",-3.0,99731.0,16
2025-08-14_08-18-36,6569,"[np.float32(0.0), np.float32(1.0), np.float32(0.0), np.float32(0.0), np.float32(0.0), np.float32(1.0), np.float32(1.0), np.float32(0.0), np.float32(1.0), np.float32(1.0), np.float32(0.0), np.float32(0.0), np.float32(0.0), np.float32(0.0), np.float32(0.0), np.float32(0.0)]",-3.0,99728.0,15
2025-08-14_08-18-36,6570,"[np.float32(0.0), np.float32(1.0), np.float32(1.0), np.float32(0.0), np.float32(1.0), np.float32(1.0), np.float32(0.0), np.float32(1.0), np.float32(0.0), np.float32(0.0), np.float32(1.0), np.float32(1.0), np.float32(0.0), np.float32(0.0), np.float32(1.0), np.float32(0.0)]",2.0,99730.0,18
2025-08-14_08-18-36,6571,"[np.float32(0.0), np.float32(1.0), np.float32(0.0), np.float32(0.0), np.float32(0.0), np.float32(0.0), np.float32(0.0), np.float32(1.0), np.float32(0.0), np.float32(1.0), np.float32(1.0), np.float32(0.0), np.float32(1.0), np.float32(0.0), np.float32(1.0), np.float32(0.0)]",-3.0,99727.0,32
2025-08-14_08-18-36,6572,"[np.float32(0.0), np.float32(1.0), np.float32(0.0), np.float32(0.0), np.float32(1.0), np.float32(1.0), np.float32(0.0), np.float32(1.0), np.float32(0.0), np.float32(1.0), np.float32(1.0), np.float32(0.0), np.float32(1.0), np.float32(1.0), np.float32(0.0), np.float32(0.0)]",-6.0,99721.0,27
2025-08-14_08-18-36,6573,"[np.float32(1.0), np.float32(1.0), np.float32(0.0), np.float32(0.0), np.float32(0.0), np.float32(0.0), np.float32(0.0), np.float32(1.0), np.float32(1.0), np.float32(1.0), np.float32(1.0), np.float32(0.0), np.float32(1.0), np.float32(1.0), np.float32(1.0), np.float32(1.0)]",1.0,99722.0,23
2025-08-14_08-18-36,6574,"[np.float32(0.0), np.float32(0.0), np.float32(0.0), np.float32(0.0), np.float32(1.0), np.float32(1.0), np.float32(0.0), np.float32(1.0), np.float32(0.0), np.float32(1.0), np.float32(1.0), np.float32(1.0), np.float32(1.0), np.float32(0.0), np.float32(0.0), np.float32(0.0)]",1.0,99723.0,24
2025-08-14_08-18-36,6575,"[np.float32(0.0), np.float32(0.0), np.float32(1.0), np.float32(0.0), np.float32(1.0), np.float32(1.0), np.float32(1.0), np.float32(1.0), np.float32(1.0), np.float32(0.0), np.float32(1.0), np.float32(0.0), np.float32(0.0), np.float32(1.0), np.float32(1.0), np.float32(0.0)]",-1.0,99722.0,3
2025-08-14_08-18-36,6576,"[np.float32(1.0), np.float32(1.0), np.float32(0.0), np.float32(1.0), np.float32(0.0), np.float32(0.0), np.float32(1.0), np.float32(0.0), np.float32(0.0), np.float32(1.0), np.float32(1.0), np.float32(0.0), np.float32(0.0), np.float32(0.0), np.float32(1.0), np.float32(0.0)]",-2.0,99720.0,26
2025-08-14_08-18-36,6577,"[np.float32(0.0), np.float32(0.0), np.float32(0.0), np.float32(0.0), np.float32(0.0), np.float32(1.0), np.float32(0.0), np.float32(1.0), np.float32(0.0), np.float32(0.0), np.float32(1.0), np.float32(1.0), np.float32(0.0), np.float32(1.0), np.float32(1.0), np.float32(1.0)]",-1.0,99719.0,16
2025-08-14_08-18-36,6578,"[np.float32(1.0), np.float32(1.0), np.float32(0.0), np.float32(1.0), np.float32(0.0), np.float32(0.0), np.float32(1.0), np.float32(1.0), np.float32(0.0), np.float32(1.0), np.float32(0.0), np.float32(0.0), np.float32(0.0), np.float32(0.0), np.float32(1.0), np.float32(0.0)]",0.0,99719.0,17
2025-08-14_08-18-36,6579,"[np.float32(1.0), np.float32(0.0), np.float32(1.0), np.float32(1.0), np.float32(1.0), np.float32(0.0), np.float32(0.0), np.float32(1.0), np.float32(1.0), np.float32(1.0), np.float32(0.0), np.float32(1.0), np.float32(0.0), np.float32(0.0), np.float32(1.0), np.float32(1.0)]",2.0,99721.0,9
2025-08-14_08-18-36,6580,"[np.float32(1.0), np.float32(1.0), np.float32(0.0), np.float32(0.0), np.float32(0.0), np.float32(1.0), np.float32(0.0), np.float32(0.0), np.float32(1.0), np.float32(0.0), np.float32(1.0), np.float32(1.0), np.float32(0.0), np.float32(0.0), np.float32(0.0), np.float32(1.0)]",1.0,99722.0,6
2025-08-14_08-18-36,6581,"[np.float32(0.0), np.float32(1.0), np.float32(0.0), np.float32(1.0), np.float32(0.0), np.float32(1.0), np.float32(0.0), np.float32(0.0), np.float32(0.0), np.float32(1.0), np.float32(1.0), np.float32(1.0), np.float32(0.0), np.float32(0.0), np.float32(0.0), np.float32(0.0)]",1.0,99723.0,13
2025-08-14_08-18-36,6582,"[np.float32(1.0), np.float32(0.0), np.float32(0.0), np.float32(1.0), np.float32(1.0), np.float32(1.0), np.float32(0.0), np.float32(1.0), np.float32(1.0), np.float32(0.0), np.float32(1.0), np.float32(1.0), np.float32(1.0), np.float32(1.0), np.float32(1.0), np.float32(0.0)]",-1.0,99722.0,17
2025-08-14_08-18-36,6583,"[np.float32(1.0), np.float32(0.0), np.float32(0.0), np.float32(0.0), np.float32(0.0), np.float32(1.0), np.float32(1.0), np.float32(1.0), np.float32(0.0), np.float32(0.0), np.float32(0.0), np.float32(0.0), np.float32(1.0), np.float32(1.0), np.float32(1.0), np.float32(1.0)]",2.0,99724.0,21
2025-08-14_08-18-36,6584,"[np.float32(1.0), np.float32(1.0), np.float32(0.0), np.float32(1.0), np.float32(1.0), np.float32(1.0), np.float32(0.0), np.float32(1.0), np.float32(0.0), np.float32(0.0), np.float32(0.0), np.float32(0.0), np.float32(1.0), np.float32(0.0), np.float32(0.0), np.float32(1.0)]",1.0,99725.0,1
2025-08-14_08-18-36,6585,"[np.float32(1.0), np.float32(1.0), np.float32(0.0), np.float32(1.0), np.float32(0.0), np.float32(0.0), np.float32(1.0), np.float32(0.0), np.float32(1.0), np.float32(1.0), np.float32(1.0), np.float32(0.0), np.float32(0.0), np.float32(0.0), np.float32(1.0), np.float32(1.0)]",-1.0,99724.0,32
2025-08-14_08-18-36,6586,"[np.float32(0.0), np.float32(1.0), np.float32(0.0), np.float32(1.0), np.float32(1.0), np.float32(1.0), np.float32(0.0), np.float32(0.0), np.float32(1.0), np.float32(1.0), np.float32(1.0), np.float32(0.0), np.float32(0.0), np.float32(1.0), np.float32(0.0), np.float32(0.0)]",-1.0,99723.0,20
2025-08-14_08-18-36,6587,"[np.float32(1.0), np.float32(1.0), np.float32(1.0), np.float32(1.0), np.float32(0.0), np.float32(0.0), np.float32(1.0), np.float32(1.0), np.float32(1.0), np.float32(1.0), np.float32(1.0), np.float32(0.0), np.float32(0.0), np.float32(0.0), np.float32(0.0), np.float32(0.0)]",-2.0,99721.0,9
2025-08-14_08-18-36,6588,"[np.float32(1.0), np.float32(0.0), np.float32(0.0), np.float32(1.0), np.float32(1.0), np.float32(1.0), np.float32(1.0), np.float32(1.0), np.float32(0.0), np.float32(0.0), np.float32(1.0), np.float32(0.0), np.float32(0.0), np.float32(0.0), np.float32(0.0), np.float32(0.0)]",0.0,99721.0,32
2025-08-14_08-18-36,6589,"[np.float32(1.0), np.float32(0.0), np.float32(0.0), np.float32(0.0), np.float32(1.0), np.float32(0.0), np.float32(0.0), np.float32(1.0), np.float32(1.0), np.float32(0.0), np.float32(0.0), np.float32(0.0), np.float32(0.0), np.float32(0.0), np.float32(0.0), np.float32(0.0)]",1.0,99722.0,21
2025-08-14_08-18-36,6590,"[np.float32(1.0), np.float32(0.0), np.float32(1.0), np.float32(1.0), np.float32(1.0), np.float32(0.0), np.float32(0.0), np.float32(1.0), np.float32(1.0), np.float32(1.0), np.float32(1.0), np.float32(0.0), np.float32(1.0), np.float32(1.0), np.float32(0.0), np.float32(1.0)]",2.0,99724.0,34
2025-08-14_08-18-36,6591,"[np.float32(1.0), np.float32(1.0), np.float32(0.0), np.float32(1.0), np.float32(1.0), np.float32(0.0), np.float32(0.0), np.float32(0.0), np.float32(1.0), np.float32(1.0), np.float32(0.0), np.float32(0.0), np.float32(0.0), np.float32(1.0), np.float32(1.0), np.float32(0.0)]",2.0,99726.0,27
2025-08-14_08-18-36,6592,"[np.float32(0.0), np.float32(1.0), np.float32(1.0), np.float32(0.0), np.float32(0.0), np.float32(1.0), np.float32(0.0), np.float32(0.0), np.float32(1.0), np.float32(1.0), np.float32(1.0), np.float32(1.0), np.float32(0.0), np.float32(1.0), np.float32(0.0), np.float32(0.0)]",5.0,99731.0,32
2025-08-14_08-18-36,6593,"[np.float32(0.0), np.float32(0.0), np.float32(1.0), np.float32(0.0), np.float32(1.0), np.float32(1.0), np.float32(1.0), np.float32(1.0), np.float32(0.0), np.float32(0.0), np.float32(0.0), np.float32(1.0), np.float32(1.0), np.float32(0.0), np.float32(1.0), np.float32(1.0)]",-5.0,99726.0,0
2025-08-14_08-18-36,6594,"[np.float32(0.0), np.float32(0.0), np.float32(1.0), np.float32(1.0), np.float32(1.0), np.float32(1.0), np.float32(0.0), np.float32(1.0), np.float32(1.0), np.float32(1.0), np.float32(1.0), np.float32(1.0), np.float32(0.0), np.float32(0.0), np.float32(1.0), np.float32(0.0)]",0.0,99726.0,11
2025-08-14_08-18-36,6595,"[np.float32(1.0), np.float32(0.0), np.float32(0.0), np.float32(1.0), np.float32(1.0), np.float32(0.0), np.float32(1.0), np.float32(0.0), np.float32(1.0), np.float32(0.0), np.float32(0.0), np.float32(1.0), np.float32(0.0), np.float32(1.0), np.float32(1.0), np.float32(1.0)]",1.0,99727.0,25
2025-08-14_08-18-36,6596,"[np.float32(1.0), np.float32(1.0), np.float32(1.0), np.float32(0.0), np.float32(1.0), np.float32(1.0), np.float32(0.0), np.float32(0.0), np.float32(1.0), np.float32(0.0), np.float32(1.0), np.float32(0.0), np.float32(1.0), np.float32(0.0), np.float32(1.0), np.float32(0.0)]",0.0,99727.0,24
2025-08-14_08-18-36,6597,"[np.float32(0.0), np.float32(1.0), np.float32(1.0), np.float32(0.0), np.float32(0.0), np.float32(1.0), np.float32(0.0), np.float32(1.0), np.float32(1.0), np.float32(0.0), np.float32(1.0), np.float32(0.0), np.float32(0.0), np.float32(0.0), np.float32(0.0), np.float32(0.0)]",-6.0,99721.0,7
2025-08-14_08-18-36,6598,"[np.float32(0.0), np.float32(1.0), np.float32(1.0), np.float32(0.0), np.float32(0.0), np.float32(0.0), np.float32(1.0), np.float32(0.0), np.float32(1.0), np.float32(0.0), np.float32(0.0), np.float32(1.0), np.float32(1.0), np.float32(1.0), np.float32(1.0), np.float32(0.0)]",-1.0,99720.0,22
2025-08-14_08-18-36,6599,"[np.float32(0.0), np.float32(0.0), np.float32(1.0), np.float32(0.0), np.float32(1.0), np.float32(0.0), np.float32(1.0), np.float32(0.0), np.float32(0.0), np.float32(1.0), np.float32(0.0), np.float32(0.0), np.float32(0.0), np.float32(1.0), np.float32(1.0), np.float32(0.0)]",7.0,99727.0,10
2025-08-14_08-18-36,6600,"[np.float32(0.0), np.float32(1.0), np.float32(1.0), np.float32(0.0), np.float32(1.0), np.float32(1.0), np.float32(1.0), np.float32(1.0), np.float32(1.0), np.float32(0.0), np.float32(0.0), np.float32(0.0), np.float32(1.0), np.float32(0.0), np.float32(1.0), np.float32(0.0)]",-3.0,99724.0,0
2025-08-14_08-18-36,6601,"[np.float32(0.0), np.float32(1.0), np.float32(1.0), np.float32(0.0), np.float32(0.0), np.float32(1.0), np.float32(1.0), np.float32(0.0), np.float32(0.0), np.float32(0.0), np.float32(1.0), np.float32(0.0), np.float32(0.0), np.float32(0.0), np.float32(0.0), np.float32(0.0)]",-1.0,99723.0,31
2025-08-14_08-18-36,6602,"[np.float32(1.0), np.float32(1.0), np.float32(0.0), np.float32(0.0), np.float32(1.0), np.float32(0.0), np.float32(1.0), np.float32(0.0), np.float32(0.0), np.float32(0.0), np.float32(0.0), np.float32(0.0), np.float32(0.0), np.float32(1.0), np.float32(1.0), np.float32(0.0)]",4.0,99727.0,2
2025-08-14_08-18-36,6603,"[np.float32(0.0), np.float32(0.0), np.float32(0.0), np.float32(1.0), np.float32(0.0), np.float32(1.0), np.float32(0.0), np.float32(1.0), np.float32(1.0), np.float32(1.0), np.float32(1.0), np.float32(1.0), np.float32(1.0), np.float32(0.0), np.float32(1.0), np.float32(0.0)]",-1.0,99726.0,32
2025-08-14_08-18-36,6604,"[np.float32(0.0), np.float32(0.0), np.float32(0.0), np.float32(1.0), np.float32(1.0), np.float32(1.0), np.float32(0.0), np.float32(0.0), np.float32(1.0), np.float32(0.0), np.float32(1.0), np.float32(0.0), np.float32(1.0), np.float32(0.0), np.float32(0.0), np.float32(0.0)]",1.0,99727.0,17
2025-08-14_08-18-36,6605,"[np.float32(1.0), np.float32(1.0), np.float32(0.0), np.float32(1.0), np.float32(1.0), np.float32(1.0), np.float32(1.0), np.float32(1.0), np.float32(1.0), np.float32(1.0), np.float32(1.0), np.float32(0.0), np.float32(0.0), np.float32(0.0), np.float32(0.0), np.float32(0.0)]",0.0,99727.0,28
2025-08-14_08-18-36,6606,"[np.float32(1.0), np.float32(1.0), np.float32(1.0), np.float32(1.0), np.float32(1.0), np.float32(1.0), np.float32(0.0), np.float32(0.0), np.float32(0.0), np.float32(1.0), np.float32(1.0), np.float32(0.0), np.float32(0.0), np.float32(1.0), np.float32(0.0), np.float32(0.0)]",3.0,99730.0,25
2025-08-14_08-18-36,6607,"[np.float32(1.0), np.float32(1.0), np.float32(0.0), np.float32(1.0), np.float32(0.0), np.float32(1.0), np.float32(1.0), np.float32(1.0), np.float32(0.0), np.float32(0.0), np.float32(0.0), np.float32(0.0), np.float32(1.0), np.float32(1.0), np.float32(0.0), np.float32(0.0)]",-2.0,99728.0,33
2025-08-14_08-18-36,6608,"[np.float32(1.0), np.float32(1.0), np.float32(0.0), np.float32(1.0), np.float32(0.0), np.float32(1.0), np.float32(1.0), np.float32(0.0), np.float32(0.0), np.float32(0.0), np.float32(1.0), np.float32(1.0), np.float32(1.0), np.float32(0.0), np.float32(0.0), np.float32(0.0)]",1.0,99729.0,33
2025-08-14_08-18-36,6609,"[np.float32(1.0), np.float32(1.0), np.float32(0.0), np.float32(1.0), np.float32(0.0), np.float32(1.0), np.float32(0.0), np.float32(0.0), np.float32(1.0), np.float32(0.0), np.float32(0.0), np.float32(0.0), np.float32(1.0), np.float32(0.0), np.float32(1.0), np.float32(0.0)]",-2.0,99727.0,16
2025-08-14_08-18-36,6610,"[np.float32(1.0), np.float32(1.0), np.float32(1.0), np.float32(1.0), np.float32(0.0), np.float32(0.0), np.float32(1.0), np.float32(1.0), np.float32(1.0), np.float32(1.0), np.float32(1.0), np.float32(0.0), np.float32(0.0), np.float32(1.0), np.float32(0.0), np.float32(0.0)]",3.0,99730.0,29
2025-08-14_08-18-36,6611,"[np.float32(1.0), np.float32(0.0), np.float32(1.0), np.float32(0.0), np.float32(0.0), np.float32(1.0), np.float32(0.0), np.float32(0.0), np.float32(1.0), np.float32(0.0), np.float32(0.0), np.float32(0.0), np.float32(0.0), np.float32(0.0), np.float32(0.0), np.float32(0.0)]",-2.0,99728.0,4
2025-08-14_08-18-36,6612,"[np.float32(1.0), np.float32(0.0), np.float32(0.0), np.float32(0.0), np.float32(0.0), np.float32(1.0), np.float32(1.0), np.float32(1.0), np.float32(0.0), np.float32(0.0), np.float32(1.0), np.float32(0.0), np.float32(1.0), np.float32(0.0), np.float32(1.0), np.float32(0.0)]",-4.0,99724.0,15
2025-08-14_08-18-36,6613,"[np.float32(0.0), np.float32(1.0), np.float32(1.0), np.float32(0.0), np.float32(1.0), np.float32(1.0), np.float32(0.0), np.float32(1.0), np.float32(1.0), np.float32(0.0), np.float32(0.0), np.float32(0.0), np.float32(0.0), np.float32(0.0), np.float32(0.0), np.float32(0.0)]",1.0,99725.0,16
2025-08-14_08-18-36,6614,"[np.float32(1.0), np.float32(0.0), np.float32(1.0), np.float32(1.0), np.float32(1.0), np.float32(0.0), np.float32(1.0), np.float32(1.0), np.float32(1.0), np.float32(0.0), np.float32(1.0), np.float32(1.0), np.float32(1.0), np.float32(1.0), np.float32(1.0), np.float32(0.0)]",-4.0,99721.0,22
2025-08-14_08-18-36,6615,"[np.float32(1.0), np.float32(0.0), np.float32(0.0), np.float32(1.0), np.float32(0.0), np.float32(0.0), np.float32(0.0), np.float32(1.0), np.float32(1.0), np.float32(1.0), np.float32(1.0), np.float32(1.0), np.float32(1.0), np.float32(1.0), np.float32(1.0), np.float32(0.0)]",1.0,99722.0,13
2025-08-14_08-18-36,6616,"[np.float32(0.0), np.float32(1.0), np.float32(0.0), np.float32(1.0), np.float32(0.0), np.float32(0.0), np.float32(0.0), np.float32(1.0), np.float32(1.0), np.float32(0.0), np.float32(1.0), np.float32(0.0), np.float32(1.0), np.float32(0.0), np.float32(0.0), np.float32(0.0)]",-3.0,99719.0,34
2025-08-14_08-18-36,6617,"[np.float32(0.0), np.float32(1.0), np.float32(0.0), np.float32(1.0), np.float32(0.0), np.float32(0.0), np.float32(0.0), np.float32(1.0), np.float32(1.0), np.float32(1.0), np.float32(0.0), np.float32(0.0), np.float32(1.0), np.float32(0.0), np.float32(0.0), np.float32(0.0)]",-4.0,99715.0,2
2025-08-14_08-18-36,6618,"[np.float32(0.0), np.float32(1.0), np.float32(1.0), np.float32(0.0), np.float32(0.0), np.float32(1.0), np.float32(0.0), np.float32(1.0), np.float32(1.0), np.float32(1.0), np.float32(0.0), np.float32(0.0), np.float32(1.0), np.float32(0.0), np.float32(0.0), np.float32(0.0)]",2.0,99717.0,24
2025-08-14_08-18-36,6619,"[np.float32(1.0), np.float32(1.0), np.float32(1.0), np.float32(0.0), np.float32(1.0), np.float32(0.0), np.float32(0.0), np.float32(1.0), np.float32(0.0), np.float32(0.0), np.float32(1.0), np.float32(1.0), np.float32(1.0), np.float32(1.0), np.float32(1.0), np.float32(0.0)]",-3.0,99714.0,28
2025-08-14_08-18-36,6620,"[np.float32(0.0), np.float32(1.0), np.float32(1.0), np.float32(0.0), np.float32(1.0), np.float32(1.0), np.float32(1.0), np.float32(1.0), np.float32(1.0), np.float32(0.0), np.float32(1.0), np.float32(0.0), np.float32(0.0), np.float32(1.0), np.float32(0.0), np.float32(0.0)]",1.0,99715.0,15
2025-08-14_08-18-36,6621,"[np.float32(1.0), np.float32(1.0), np.float32(1.0), np.float32(1.0), np.float32(1.0), np.float32(0.0), np.float32(0.0), np.float32(1.0), np.float32(1.0), np.float32(0.0), np.float32(0.0), np.float32(1.0), np.float32(0.0), np.float32(0.0), np.float32(0.0), np.float32(1.0)]",-2.0,99713.0,26
2025-08-14_08-18-36,6622,"[np.float32(1.0), np.float32(1.0), np.float32(0.0), np.float32(0.0), np.float32(1.0), np.float32(0.0), np.float32(1.0), np.float32(0.0), np.float32(1.0), np.float32(0.0), np.float32(1.0), np.float32(0.0), np.float32(0.0), np.float32(1.0), np.float32(0.0), np.float32(1.0)]",-3.0,99710.0,0
2025-08-14_08-18-36,6623,"[np.float32(1.0), np.float32(1.0), np.float32(0.0), np.float32(0.0), np.float32(1.0), np.float32(1.0), np.float32(1.0), np.float32(0.0), np.float32(1.0), np.float32(0.0), np.float32(1.0), np.float32(1.0), np.float32(1.0), np.float32(1.0), np.float32(0.0), np.float32(1.0)]",2.0,99712.0,6
2025-08-14_08-18-36,6624,"[np.float32(1.0), np.float32(0.0), np.float32(1.0), np.float32(0.0), np.float32(0.0), np.float32(0.0), np.float32(1.0), np.float32(0.0), np.float32(0.0), np.float32(1.0), np.float32(0.0), np.float32(0.0), np.float32(0.0), np.float32(1.0), np.float32(1.0), np.float32(0.0)]",-1.0,99711.0,0
2025-08-14_08-18-36,6625,"[np.float32(0.0), np.float32(1.0), np.float32(1.0), np.float32(1.0), np.float32(0.0), np.float32(0.0), np.float32(1.0), np.float32(1.0), np.float32(1.0), np.float32(0.0), np.float32(0.0), np.float32(0.0), np.float32(1.0), np.float32(0.0), np.float32(0.0), np.float32(0.0)]",-2.0,99709.0,36
2025-08-14_08-18-36,6626,"[np.float32(1.0), np.float32(1.0), np.float32(1.0), np.float32(1.0), np.float32(0.0), np.float32(1.0), np.float32(0.0), np.float32(0.0), np.float32(1.0), np.float32(1.0), np.float32(0.0), np.float32(0.0), np.float32(1.0), np.float32(0.0), np.float32(0.0), np.float32(1.0)]",0.0,99709.0,27
2025-08-14_08-18-36,6627,"[np.float32(1.0), np.float32(0.0), np.float32(0.0), np.float32(1.0), np.float32(0.0), np.float32(1.0), np.float32(1.0), np.float32(1.0), np.float32(0.0), np.float32(0.0), np.float32(1.0), np.float32(0.0), np.float32(1.0), np.float32(1.0), np.float32(0.0), np.float32(0.0)]",-4.0,99705.0,34
2025-08-14_08-18-36,6628,"[np.float32(0.0), np.float32(0.0), np.float32(1.0), np.float32(0.0), np.float32(0.0), np.float32(0.0), np.float32(0.0), np.float32(1.0), np.float32(1.0), np.float32(0.0), np.float32(0.0), np.float32(0.0), np.float32(1.0), np.float32(0.0), np.float32(0.0), np.float32(0.0)]",1.0,99706.0,18
2025-08-14_08-18-36,6629,"[np.float32(1.0), np.float32(1.0), np.float32(0.0), np.float32(0.0), np.float32(1.0), np.float32(1.0), np.float32(0.0), np.float32(1.0), np.float32(1.0), np.float32(0.0), np.float32(0.0), np.float32(1.0), np.float32(0.0), np.float32(0.0), np.float32(0.0), np.float32(0.0)]",0.0,99706.0,26
2025-08-14_08-18-36,6630,"[np.float32(0.0), np.float32(1.0), np.float32(0.0), np.float32(0.0), np.float32(1.0), np.float32(0.0), np.float32(1.0), np.float32(1.0), np.float32(0.0), np.float32(1.0), np.float32(1.0), np.float32(0.0), np.float32(0.0), np.float32(1.0), np.float32(1.0), np.float32(0.0)]",1.0,99707.0,19
2025-08-14_08-18-36,6631,"[np.float32(0.0), np.float32(0.0), np.float32(1.0), np.float32(0.0), np.float32(0.0), np.float32(1.0), np.float32(0.0), np.float32(0.0), np.float32(0.0), np.float32(0.0), np.float32(0.0), np.float32(0.0), np.float32(0.0), np.float32(0.0), np.float32(1.0), np.float32(1.0)]",-2.0,99705.0,4
2025-08-14_08-18-36,6632,"[np.float32(1.0), np.float32(0.0), np.float32(1.0), np.float32(1.0), np.float32(1.0), np.float32(1.0), np.float32(0.0), np.float32(1.0), np.float32(0.0), np.float32(0.0), np.float32(1.0), np.float32(0.0), np.float32(1.0), np.float32(1.0), np.float32(0.0), np.float32(0.0)]",-3.0,99702.0,34
2025-08-14_08-18-36,6633,"[np.float32(1.0), np.float32(1.0), np.float32(1.0), np.float32(0.0), np.float32(1.0), np.float32(0.0), np.float32(0.0), np.float32(0.0), np.float32(1.0), np.float32(0.0), np.float32(0.0), np.float32(0.0), np.float32(1.0), np.float32(0.0), np.float32(1.0), np.float32(1.0)]",2.0,99704.0,34
2025-08-14_08-18-36,6634,"[np.float32(1.0), np.float32(0.0), np.float32(1.0), np.float32(1.0), np.float32(1.0), np.float32(1.0), np.float32(0.0), np.float32(1.0), np.float32(1.0), np.float32(0.0), np.float32(0.0), np.float32(1.0), np.float32(1.0), np.float32(1.0), np.float32(0.0), np.float32(0.0)]",-3.0,99701.0,6
2025-08-14_08-18-36,6635,"[np.float32(1.0), np.float32(0.0), np.float32(1.0), np.float32(0.0), np.float32(0.0), np.float32(0.0), np.float32(0.0), np.float32(0.0), np.float32(1.0), np.float32(1.0), np.float32(1.0), np.float32(1.0), np.float32(1.0), np.float32(1.0), np.float32(0.0), np.float32(0.0)]",-3.0,99698.0,1
2025-08-14_08-18-36,6636,"[np.float32(0.0), np.float32(1.0), np.float32(1.0), np.float32(1.0), np.float32(0.0), np.float32(1.0), np.float32(1.0), np.float32(0.0), np.float32(0.0), np.float32(0.0), np.float32(0.0), np.float32(0.0), np.float32(0.0), np.float32(0.0), np.float32(0.0), np.float32(0.0)]",0.0,99698.0,1
2025-08-14_08-18-36,6637,"[np.float32(0.0), np.float32(0.0), np.float32(1.0), np.float32(0.0), np.float32(1.0), np.float32(0.0), np.float32(0.0), np.float32(1.0), np.float32(1.0), np.float32(1.0), np.float32(0.0), np.float32(0.0), np.float32(0.0), np.float32(0.0), np.float32(1.0), np.float32(0.0)]",2.0,99700.0,28
2025-08-14_08-18-36,6638,"[np.float32(1.0), np.float32(0.0), np.float32(1.0), np.float32(1.0), np.float32(1.0), np.float32(1.0), np.float32(0.0), np.float32(1.0), np.float32(0.0), np.float32(0.0), np.float32(0.0), np.float32(1.0), np.float32(1.0), np.float32(0.0), np.float32(0.0), np.float32(0.0)]",1.0,99701.0,30
2025-08-14_08-18-36,6639,"[np.float32(1.0), np.float32(1.0), np.float32(0.0), np.float32(0.0), np.float32(0.0), np.float32(1.0), np.float32(0.0), np.float32(0.0), np.float32(1.0), np.float32(1.0), np.float32(1.0), np.float32(0.0), np.float32(1.0), np.float32(1.0), np.float32(1.0), np.float32(1.0)]",-2.0,99699.0,4
2025-08-14_08-18-36,6640,"[np.float32(1.0), np.float32(0.0), np.float32(1.0), np.float32(0.0), np.float32(0.0), np.float32(1.0), np.float32(1.0), np.float32(0.0), np.float32(1.0), np.float32(1.0), np.float32(1.0), np.float32(0.0), np.float32(1.0), np.float32(0.0), np.float32(1.0), np.float32(1.0)]",-3.0,99696.0,22
2025-08-14_08-18-36,6641,"[np.float32(1.0), np.float32(0.0), np.float32(0.0), np.float32(1.0), np.float32(0.0), np.float32(0.0), np.float32(0.0), np.float32(1.0), np.float32(1.0), np.float32(1.0), np.float32(0.0), np.float32(1.0), np.float32(0.0), np.float32(0.0), np.float32(1.0), np.float32(0.0)]",-4.0,99692.0,26
2025-08-14_08-18-36,6642,"[np.float32(0.0), np.float32(1.0), np.float32(1.0), np.float32(1.0), np.float32(0.0), np.float32(1.0), np.float32(1.0), np.float32(0.0), np.float32(0.0), np.float32(0.0), np.float32(1.0), np.float32(0.0), np.float32(0.0), np.float32(0.0), np.float32(0.0), np.float32(0.0)]",1.0,99693.0,23
2025-08-14_08-18-36,6643,"[np.float32(1.0), np.float32(1.0), np.float32(0.0), np.float32(1.0), np.float32(0.0), np.float32(1.0), np.float32(0.0), np.float32(0.0), np.float32(1.0), np.float32(1.0), np.float32(0.0), np.float32(1.0), np.float32(1.0), np.float32(1.0), np.float32(1.0), np.float32(0.0)]",-1.0,99692.0,23
2025-08-14_08-18-36,6644,"[np.float32(1.0), np.float32(1.0), np.float32(1.0), np.float32(1.0), np.float32(0.0), np.float32(1.0), np.float32(0.0), np.float32(0.0), np.float32(0.0), np.float32(0.0), np.float32(1.0), np.float32(0.0), np.float32(0.0), np.float32(1.0), np.float32(1.0), np.float32(0.0)]",-1.0,99691.0,7
2025-08-14_08-18-36,6645,"[np.float32(0.0), np.float32(0.0), np.float32(0.0), np.float32(0.0), np.float32(0.0), np.float32(1.0), np.float32(0.0), np.float32(1.0), np.float32(1.0), np.float32(0.0), np.float32(0.0), np.float32(1.0), np.float32(1.0), np.float32(1.0), np.float32(0.0), np.float32(1.0)]",-7.0,99684.0,11
2025-08-14_08-18-36,6646,"[np.float32(1.0), np.float32(0.0), np.float32(0.0), np.float32(1.0), np.float32(0.0), np.float32(0.0), np.float32(1.0), np.float32(1.0), np.float32(0.0), np.float32(0.0), np.float32(0.0), np.float32(1.0), np.float32(0.0), np.float32(0.0), np.float32(0.0), np.float32(1.0)]",-4.0,99680.0,29
2025-08-14_08-18-36,6647,"[np.float32(1.0), np.float32(0.0), np.float32(1.0), np.float32(0.0), np.float32(0.0), np.float32(1.0), np.float32(1.0), np.float32(1.0), np.float32(0.0), np.float32(0.0), np.float32(1.0), np.float32(0.0), np.float32(1.0), np.float32(1.0), np.float32(0.0), np.float32(0.0)]",2.0,99682.0,23
2025-08-14_08-18-36,6648,"[np.float32(1.0), np.float32(0.0), np.float32(1.0), np.float32(0.0), np.float32(0.0), np.float32(0.0), np.float32(0.0), np.float32(0.0), np.float32(1.0), np.float32(0.0), np.float32(1.0), np.float32(0.0), np.float32(1.0), np.float32(0.0), np.float32(0.0), np.float32(0.0)]",-5.0,99677.0,13
2025-08-14_08-18-36,6649,"[np.float32(0.0), np.float32(1.0), np.float32(0.0), np.float32(1.0), np.float32(1.0), np.float32(1.0), np.float32(1.0), np.float32(1.0), np.float32(1.0), np.float32(0.0), np.float32(0.0), np.float32(0.0), np.float32(0.0), np.float32(1.0), np.float32(0.0), np.float32(1.0)]",1.0,99678.0,22
2025-08-14_08-18-36,6650,"[np.float32(1.0), np.float32(1.0), np.float32(0.0), np.float32(1.0), np.float32(0.0), np.float32(1.0), np.float32(1.0), np.float32(0.0), np.float32(1.0), np.float32(1.0), np.float32(1.0), np.float32(0.0), np.float32(1.0), np.float32(0.0), np.float32(0.0), np.float32(0.0)]",-5.0,99673.0,0
2025-08-14_08-18-36,6651,"[np.float32(0.0), np.float32(1.0), np.float32(0.0), np.float32(1.0), np.float32(1.0), np.float32(1.0), np.float32(1.0), np.float32(0.0), np.float32(1.0), np.float32(1.0), np.float32(0.0), np.float32(1.0), np.float32(1.0), np.float32(1.0), np.float32(0.0), np.float32(1.0)]",2.0,99675.0,9
2025-08-14_08-18-36,6652,"[np.float32(0.0), np.float32(1.0), np.float32(1.0), np.float32(0.0), np.float32(0.0), np.float32(1.0), np.float32(0.0), np.float32(1.0), np.float32(1.0), np.float32(1.0), np.float32(1.0), np.float32(1.0), np.float32(1.0), np.float32(0.0), np.float32(1.0), np.float32(0.0)]",-7.0,99668.0,9
2025-08-14_08-18-36,6653,"[np.float32(1.0), np.float32(1.0), np.float32(1.0), np.float32(0.0), np.float32(0.0), np.float32(0.0), np.float32(0.0), np.float32(0.0), np.float32(1.0), np.float32(0.0), np.float32(1.0), np.float32(1.0), np.float32(1.0), np.float32(0.0), np.float32(0.0), np.float32(1.0)]",-4.0,99664.0,0
2025-08-14_08-18-36,6654,"[np.float32(1.0), np.float32(0.0), np.float32(0.0), np.float32(0.0), np.float32(1.0), np.float32(0.0), np.float32(1.0), np.float32(0.0), np.float32(0.0), np.float32(0.0), np.float32(1.0), np.float32(1.0), np.float32(1.0), np.float32(0.0), np.float32(0.0), np.float32(0.0)]",-3.0,99661.0,20
2025-08-14_08-18-36,6655,"[np.float32(0.0), np.float32(1.0), np.float32(1.0), np.float32(1.0), np.float32(0.0), np.float32(0.0), np.float32(1.0), np.float32(1.0), np.float32(1.0), np.float32(0.0), np.float32(1.0), np.float32(0.0), np.float32(0.0), np.float32(1.0), np.float32(1.0), np.float32(0.0)]",-1.0,99660.0,21
2025-08-14_08-18-36,6656,"[np.float32(1.0), np.float32(0.0), np.float32(0.0), np.float32(0.0), np.float32(1.0), np.float32(0.0), np.float32(0.0), np.float32(1.0), np.float32(1.0), np.float32(1.0), np.float32(0.0), np.float32(0.0), np.float32(0.0), np.float32(1.0), np.float32(0.0), np.float32(1.0)]",-2.0,99658.0,6
2025-08-14_08-18-36,6657,"[np.float32(1.0), np.float32(1.0), np.float32(0.0), np.float32(1.0), np.float32(0.0), np.float32(1.0), np.float32(1.0), np.float32(0.0), np.float32(0.0), np.float32(0.0), np.float32(1.0), np.float32(1.0), np.float32(0.0), np.float32(0.0), np.float32(0.0), np.float32(0.0)]",-2.0,99656.0,4
2025-08-14_08-18-36,6658,"[np.float32(0.0), np.float32(0.0), np.float32(1.0), np.float32(1.0), np.float32(1.0), np.float32(0.0), np.float32(1.0), np.float32(1.0), np.float32(1.0), np.float32(1.0), np.float32(0.0), np.float32(1.0), np.float32(0.0), np.float32(1.0), np.float32(0.0), np.float32(0.0)]",-4.0,99652.0,23
2025-08-14_08-18-36,6659,"[np.float32(0.0), np.float32(1.0), np.float32(1.0), np.float32(0.0), np.float32(0.0), np.float32(1.0), np.float32(1.0), np.float32(1.0), np.float32(1.0), np.float32(0.0), np.float32(0.0), np.float32(1.0), np.float32(0.0), np.float32(1.0), np.float32(0.0), np.float32(1.0)]",-1.0,99651.0,27
2025-08-14_08-18-36,6660,"[np.float32(0.0), np.float32(1.0), np.float32(1.0), np.float32(1.0), np.float32(0.0), np.float32(0.0), np.float32(0.0), np.float32(1.0), np.float32(1.0), np.float32(0.0), np.float32(1.0), np.float32(0.0), np.float32(0.0), np.float32(1.0), np.float32(0.0), np.float32(1.0)]",0.0,99651.0,34
2025-08-14_08-18-36,6661,"[np.float32(1.0), np.float32(1.0), np.float32(1.0), np.float32(1.0), np.float32(0.0), np.float32(0.0), np.float32(0.0), np.float32(1.0), np.float32(0.0), np.float32(1.0), np.float32(1.0), np.float32(0.0), np.float32(1.0), np.float32(1.0), np.float32(1.0), np.float32(0.0)]",0.0,99651.0,4
2025-08-14_08-18-36,6662,"[np.float32(1.0), np.float32(0.0), np.float32(1.0), np.float32(0.0), np.float32(1.0), np.float32(0.0), np.float32(0.0), np.float32(0.0), np.float32(0.0), np.float32(1.0), np.float32(1.0), np.float32(1.0), np.float32(0.0), np.float32(0.0), np.float32(0.0), np.float32(0.0)]",-3.0,99648.0,35
2025-08-14_08-18-36,6663,"[np.float32(1.0), np.float32(1.0), np.float32(0.0), np.float32(0.0), np.float32(0.0), np.float32(0.0), np.float32(0.0), np.float32(0.0), np.float32(1.0), np.float32(0.0), np.float32(0.0), np.float32(0.0), np.float32(1.0), np.float32(0.0), np.float32(0.0), np.float32(1.0)]",-3.0,99645.0,24
2025-08-14_08-18-36,6664,"[np.float32(1.0), np.float32(0.0), np.float32(1.0), np.float32(0.0), np.float32(0.0), np.float32(0.0), np.float32(1.0), np.float32(1.0), np.float32(1.0), np.float32(1.0), np.float32(0.0), np.float32(0.0), np.float32(1.0), np.float32(1.0), np.float32(0.0), np.float32(0.0)]",2.0,99647.0,32
2025-08-14_08-18-36,6665,"[np.float32(1.0), np.float32(0.0), np.float32(1.0), np.float32(1.0), np.float32(0.0), np.float32(0.0), np.float32(1.0), np.float32(1.0), np.float32(0.0), np.float32(1.0), np.float32(0.0), np.float32(1.0), np.float32(1.0), np.float32(0.0), np.float32(0.0), np.float32(0.0)]",-3.0,99644.0,2
2025-08-14_08-18-36,6666,"[np.float32(0.0), np.float32(0.0), np.float32(0.0), np.float32(1.0), np.float32(1.0), np.float32(1.0), np.float32(0.0), np.float32(0.0), np.float32(1.0), np.float32(1.0), np.float32(0.0), np.float32(0.0), np.float32(0.0), np.float32(1.0), np.float32(0.0), np.float32(0.0)]",-4.0,99640.0,6
2025-08-14_08-18-36,6667,"[np.float32(0.0), np.float32(0.0), np.float32(1.0), np.float32(1.0), np.float32(1.0), np.float32(1.0), np.float32(0.0), np.float32(0.0), np.float32(1.0), np.float32(1.0), np.float32(0.0), np.float32(0.0), np.float32(0.0), np.float32(1.0), np.float32(0.0), np.float32(0.0)]",3.0,99643.0,4
2025-08-14_08-18-36,6668,"[np.float32(1.0), np.float32(0.0), np.float32(0.0), np.float32(0.0), np.float32(0.0), np.float32(1.0), np.float32(0.0), np.float32(1.0), np.float32(0.0), np.float32(0.0), np.float32(1.0), np.float32(0.0), np.float32(1.0), np.float32(0.0), np.float32(1.0), np.float32(1.0)]",0.0,99643.0,27
2025-08-14_08-18-36,6669,"[np.float32(1.0), np.float32(1.0), np.float32(0.0), np.float32(1.0), np.float32(1.0), np.float32(0.0), np.float32(1.0), np.float32(0.0), np.float32(1.0), np.float32(0.0), np.float32(0.0), np.float32(0.0), np.float32(1.0), np.float32(0.0), np.float32(1.0), np.float32(0.0)]",-1.0,99642.0,2
2025-08-14_08-18-36,6670,"[np.float32(0.0), np.float32(0.0), np.float32(1.0), np.float32(1.0), np.float32(1.0), np.float32(1.0), np.float32(0.0), np.float32(0.0), np.float32(1.0), np.float32(0.0), np.float32(0.0), np.float32(0.0), np.float32(1.0), np.float32(0.0), np.float32(0.0), np.float32(0.0)]",-2.0,99640.0,3
2025-08-14_08-18-36,6671,"[np.float32(1.0), np.float32(1.0), np.float32(1.0), np.float32(1.0), np.float32(1.0), np.float32(1.0), np.float32(1.0), np.float32(0.0), np.float32(1.0), np.float32(1.0), np.float32(0.0), np.float32(0.0), np.float32(0.0), np.float32(1.0), np.float32(0.0), np.float32(0.0)]",2.0,99642.0,2
2025-08-14_08-18-36,6672,"[np.float32(0.0), np.float32(1.0), np.float32(0.0), np.float32(1.0), np.float32(1.0), np.float32(0.0), np.float32(1.0), np.float32(1.0), np.float32(1.0), np.float32(0.0), np.float32(0.0), np.float32(0.0), np.float32(0.0), np.float32(0.0), np.float32(1.0), np.float32(1.0)]",4.0,99646.0,11
2025-08-14_08-18-36,6673,"[np.float32(0.0), np.float32(0.0), np.float32(1.0), np.float32(0.0), np.float32(0.0), np.float32(1.0), np.float32(1.0), np.float32(1.0), np.float32(1.0), np.float32(0.0), np.float32(1.0), np.float32(0.0), np.float32(0.0), np.float32(1.0), np.float32(0.0), np.float32(1.0)]",0.0,99646.0,21
2025-08-14_08-18-36,6674,"[np.float32(1.0), np.float32(1.0), np.float32(0.0), np.float32(0.0), np.float32(0.0), np.float32(0.0), np.float32(1.0), np.float32(0.0), np.float32(0.0), np.float32(1.0), np.float32(0.0), np.float32(0.0), np.float32(0.0), np.float32(0.0), np.float32(0.0), np.float32(1.0)]",-3.0,99643.0,21
2025-08-14_08-18-36,6675,"[np.float32(1.0), np.float32(1.0), np.float32(0.0), np.float32(0.0), np.float32(1.0), np.float32(1.0), np.float32(1.0), np.float32(1.0), np.float32(1.0), np.float32(0.0), np.float32(0.0), np.float32(0.0), np.float32(1.0), np.float32(1.0), np.float32(1.0), np.float32(1.0)]",-1.0,99642.0,1
2025-08-14_08-18-36,6676,"[np.float32(0.0), np.float32(0.0), np.float32(0.0), np.float32(0.0), np.float32(1.0), np.float32(1.0), np.float32(0.0), np.float32(1.0), np.float32(0.0), np.float32(0.0), np.float32(1.0), np.float32(1.0), np.float32(1.0), np.float32(1.0), np.float32(0.0), np.float32(0.0)]",1.0,99643.0,20
2025-08-14_08-18-36,6677,"[np.float32(0.0), np.float32(1.0), np.float32(1.0), np.float32(1.0), np.float32(1.0), np.float32(0.0), np.float32(1.0), np.float32(0.0), np.float32(0.0), np.float32(0.0), np.float32(1.0), np.float32(0.0), np.float32(1.0), np.float32(0.0), np.float32(0.0), np.float32(0.0)]",2.0,99645.0,6
2025-08-14_08-18-36,6678,"[np.float32(0.0), np.float32(0.0), np.float32(0.0), np.float32(0.0), np.float32(0.0), np.float32(0.0), np.float32(1.0), np.float32(0.0), np.float32(1.0), np.float32(0.0), np.float32(1.0), np.float32(1.0), np.float32(1.0), np.float32(1.0), np.float32(0.0), np.float32(0.0)]",3.0,99648.0,3
2025-08-14_08-18-36,6679,"[np.float32(0.0), np.float32(0.0), np.float32(1.0), np.float32(1.0), np.float32(0.0), np.float32(1.0), np.float32(1.0), np.float32(1.0), np.float32(0.0), np.float32(1.0), np.float32(0.0), np.float32(0.0), np.float32(1.0), np.float32(0.0), np.float32(0.0), np.float32(0.0)]",-3.0,99645.0,26
2025-08-14_08-18-36,6680,"[np.float32(0.0), np.float32(1.0), np.float32(0.0), np.float32(0.0), np.float32(1.0), np.float32(1.0), np.float32(0.0), np.float32(0.0), np.float32(1.0), np.float32(0.0), np.float32(1.0), np.float32(0.0), np.float32(0.0), np.float32(0.0), np.float32(0.0), np.float32(1.0)]",-2.0,99643.0,13
2025-08-14_08-18-36,6681,"[np.float32(0.0), np.float32(1.0), np.float32(1.0), np.float32(0.0), np.float32(1.0), np.float32(1.0), np.float32(1.0), np.float32(1.0), np.float32(0.0), np.float32(0.0), np.float32(0.0), np.float32(1.0), np.float32(0.0), np.float32(1.0), np.float32(1.0), np.float32(0.0)]",3.0,99646.0,4
2025-08-14_08-18-36,6682,"[np.float32(0.0), np.float32(0.0), np.float32(0.0), np.float32(0.0), np.float32(0.0), np.float32(1.0), np.float32(1.0), np.float32(1.0), np.float32(1.0), np.float32(0.0), np.float32(1.0), np.float32(1.0), np.float32(0.0), np.float32(0.0), np.float32(0.0), np.float32(1.0)]",1.0,99647.0,30
2025-08-14_08-18-36,6683,"[np.float32(1.0), np.float32(0.0), np.float32(1.0), np.float32(0.0), np.float32(0.0), np.float32(1.0), np.float32(0.0), np.float32(1.0), np.float32(0.0), np.float32(0.0), np.float32(0.0), np.float32(1.0), np.float32(1.0), np.float32(0.0), np.float32(1.0), np.float32(1.0)]",4.0,99651.0,36
2025-08-14_08-18-36,6684,"[np.float32(1.0), np.float32(1.0), np.float32(0.0), np.float32(1.0), np.float32(1.0), np.float32(1.0), np.float32(1.0), np.float32(1.0), np.float32(0.0), np.float32(1.0), np.float32(0.0), np.float32(0.0), np.float32(1.0), np.float32(1.0), np.float32(1.0), np.float32(0.0)]",-2.0,99649.0,33
2025-08-14_08-18-36,6685,"[np.float32(1.0), np.float32(0.0), np.float32(1.0), np.float32(0.0), np.float32(0.0), np.float32(1.0), np.float32(1.0), np.float32(0.0), np.float32(1.0), np.float32(0.0), np.float32(1.0), np.float32(1.0), np.float32(0.0), np.float32(1.0), np.float32(0.0), np.float32(1.0)]",-1.0,99648.0,7
2025-08-14_08-18-36,6686,"[np.float32(1.0), np.float32(1.0), np.float32(0.0), np.float32(1.0), np.float32(1.0), np.float32(1.0), np.float32(0.0), np.float32(0.0), np.float32(0.0), np.float32(0.0), np.float32(1.0), np.float32(1.0), np.float32(1.0), np.float32(1.0), np.float32(0.0), np.float32(1.0)]",-1.0,99647.0,25
2025-08-14_08-18-36,6687,"[np.float32(0.0), np.float32(0.0), np.float32(1.0), np.float32(1.0), np.float32(1.0), np.float32(0.0), np.float32(1.0), np.float32(0.0), np.float32(1.0), np.float32(1.0), np.float32(0.0), np.float32(0.0), np.float32(0.0), np.float32(1.0), np.float32(1.0), np.float32(0.0)]",3.0,99650.0,25
2025-08-14_08-18-36,6688,"[np.float32(1.0), np.float32(1.0), np.float32(0.0), np.float32(1.0), np.float32(0.0), np.float32(1.0), np.float32(1.0), np.float32(0.0), np.float32(1.0), np.float32(0.0), np.float32(0.0), np.float32(0.0), np.float32(1.0), np.float32(1.0), np.float32(0.0), np.float32(0.0)]",-4.0,99646.0,17
2025-08-14_08-18-36,6689,"[np.float32(1.0), np.float32(1.0), np.float32(0.0), np.float32(0.0), np.float32(0.0), np.float32(1.0), np.float32(1.0), np.float32(0.0), np.float32(1.0), np.float32(0.0), np.float32(1.0), np.float32(0.0), np.float32(0.0), np.float32(1.0), np.float32(0.0), np.float32(1.0)]",0.0,99646.0,4
2025-08-14_08-18-36,6690,"[np.float32(1.0), np.float32(0.0), np.float32(0.0), np.float32(1.0), np.float32(0.0), np.float32(1.0), np.float32(1.0), np.float32(1.0), np.float32(1.0), np.float32(0.0), np.float32(0.0), np.float32(0.0), np.float32(1.0), np.float32(1.0), np.float32(0.0), np.float32(1.0)]",-1.0,99645.0,12
2025-08-14_08-18-36,6691,"[np.float32(1.0), np.float32(1.0), np.float32(1.0), np.float32(0.0), np.float32(1.0), np.float32(1.0), np.float32(0.0), np.float32(1.0), np.float32(1.0), np.float32(1.0), np.float32(1.0), np.float32(1.0), np.float32(1.0), np.float32(0.0), np.float32(1.0), np.float32(1.0)]",-1.0,99644.0,18
2025-08-14_08-18-36,6692,"[np.float32(1.0), np.float32(0.0), np.float32(0.0), np.float32(1.0), np.float32(0.0), np.float32(1.0), np.float32(1.0), np.float32(1.0), np.float32(1.0), np.float32(0.0), np.float32(0.0), np.float32(1.0), np.float32(1.0), np.float32(1.0), np.float32(1.0), np.float32(0.0)]",-2.0,99642.0,11
2025-08-14_08-18-36,6693,"[np.float32(0.0), np.float32(1.0), np.float32(0.0), np.float32(0.0), np.float32(0.0), np.float32(1.0), np.float32(0.0), np.float32(1.0), np.float32(0.0), np.float32(0.0), np.float32(1.0), np.float32(0.0), np.float32(1.0), np.float32(0.0), np.float32(1.0), np.float32(1.0)]",1.0,99643.0,11
2025-08-14_08-18-36,6694,"[np.float32(1.0), np.float32(0.0), np.float32(0.0), np.float32(0.0), np.float32(1.0), np.float32(0.0), np.float32(1.0), np.float32(0.0), np.float32(1.0), np.float32(0.0), np.float32(1.0), np.float32(1.0), np.float32(0.0), np.float32(0.0), np.float32(0.0), np.float32(0.0)]",2.0,99645.0,32
2025-08-14_08-18-36,6695,"[np.float32(0.0), np.float32(0.0), np.float32(1.0), np.float32(0.0), np.float32(1.0), np.float32(0.0), np.float32(1.0), np.float32(1.0), np.float32(0.0), np.float32(1.0), np.float32(0.0), np.float32(0.0), np.float32(1.0), np.float32(1.0), np.float32(1.0), np.float32(0.0)]",-3.0,99642.0,32
2025-08-14_08-18-36,6696,"[np.float32(1.0), np.float32(1.0), np.float32(1.0), np.float32(0.0), np.float32(1.0), np.float32(0.0), np.float32(1.0), np.float32(1.0), np.float32(0.0), np.float32(1.0), np.float32(1.0), np.float32(0.0), np.float32(1.0), np.float32(0.0), np.float32(0.0), np.float32(1.0)]",0.0,99642.0,22
2025-08-14_08-18-36,6697,"[np.float32(0.0), np.float32(1.0), np.float32(0.0), np.float32(1.0), np.float32(0.0), np.float32(0.0), np.float32(1.0), np.float32(1.0), np.float32(1.0), np.float32(0.0), np.float32(1.0), np.float32(0.0), np.float32(0.0), np.float32(0.0), np.float32(0.0), np.float32(0.0)]",-3.0,99639.0,34
2025-08-14_08-18-36,6698,"[np.float32(0.0), np.float32(0.0), np.float32(1.0), np.float32(0.0), np.float32(1.0), np.float32(0.0), np.float32(0.0), np.float32(1.0), np.float32(1.0), np.float32(0.0), np.float32(1.0), np.float32(1.0), np.float32(0.0), np.float32(0.0), np.float32(1.0), np.float32(0.0)]",4.0,99643.0,30
2025-08-14_08-18-36,6699,"[np.float32(1.0), np.float32(0.0), np.float32(1.0), np.float32(0.0), np.float32(0.0), np.float32(0.0), np.float32(0.0), np.float32(1.0), np.float32(0.0), np.float32(0.0), np.float32(0.0), np.float32(0.0), np.float32(1.0), np.float32(1.0), np.float32(1.0), np.float32(0.0)]",1.0,99644.0,12
2025-08-14_08-18-36,6700,"[np.float32(0.0), np.float32(1.0), np.float32(0.0), np.float32(0.0), np.float32(0.0), np.float32(0.0), np.float32(0.0), np.float32(1.0), np.float32(1.0), np.float32(1.0), np.float32(1.0), np.float32(0.0), np.float32(0.0), np.float32(0.0), np.float32(1.0), np.float32(1.0)]",-1.0,99643.0,36
2025-08-14_08-18-36,6701,"[np.float32(1.0), np.float32(0.0), np.float32(0.0), np.float32(1.0), np.float32(0.0), np.float32(0.0), np.float32(0.0), np.float32(1.0), np.float32(1.0), np.float32(1.0), np.float32(0.0), np.float32(0.0), np.float32(0.0), np.float32(1.0), np.float32(1.0), np.float32(0.0)]",2.0,99645.0,22
2025-08-14_08-18-36,6702,"[np.float32(1.0), np.float32(0.0), np.float32(0.0), np.float32(0.0), np.float32(0.0), np.float32(0.0), np.float32(1.0), np.float32(0.0), np.float32(0.0), np.float32(0.0), np.float32(0.0), np.float32(0.0), np.float32(0.0), np.float32(1.0), np.float32(0.0), np.float32(0.0)]",-1.0,99644.0,27
2025-08-14_08-18-36,6703,"[np.float32(0.0), np.float32(0.0), np.float32(0.0), np.float32(1.0), np.float32(0.0), np.float32(1.0), np.float32(0.0), np.float32(1.0), np.float32(0.0), np.float32(1.0), np.float32(0.0), np.float32(1.0), np.float32(0.0), np.float32(0.0), np.float32(1.0), np.float32(0.0)]",2.0,99646.0,30
2025-08-14_08-18-36,6704,"[np.float32(0.0), np.float32(0.0), np.float32(0.0), np.float32(0.0), np.float32(1.0), np.float32(0.0), np.float32(0.0), np.float32(1.0), np.float32(1.0), np.float32(1.0), np.float32(1.0), np.float32(0.0), np.float32(1.0), np.float32(1.0), np.float32(1.0), np.float32(0.0)]",-2.0,99644.0,21
2025-08-14_08-18-36,6705,"[np.float32(1.0), np.float32(0.0), np.float32(0.0), np.float32(1.0), np.float32(1.0), np.float32(0.0), np.float32(0.0), np.float32(1.0), np.float32(1.0), np.float32(1.0), np.float32(0.0), np.float32(0.0), np.float32(0.0), np.float32(0.0), np.float32(0.0), np.float32(1.0)]",0.0,99644.0,27
2025-08-14_08-18-36,6706,"[np.float32(0.0), np.float32(0.0), np.float32(0.0), np.float32(0.0), np.float32(1.0), np.float32(0.0), np.float32(1.0), np.float32(1.0), np.float32(1.0), np.float32(0.0), np.float32(0.0), np.float32(0.0), np.float32(0.0), np.float32(1.0), np.float32(0.0), np.float32(0.0)]",0.0,99644.0,16
2025-08-14_08-18-36,6707,"[np.float32(0.0), np.float32(0.0), np.float32(0.0), np.float32(0.0), np.float32(0.0), np.float32(0.0), np.float32(1.0), np.float32(0.0), np.float32(1.0), np.float32(0.0), np.float32(1.0), np.float32(0.0), np.float32(0.0), np.float32(0.0), np.float32(1.0), np.float32(0.0)]",-4.0,99640.0,15
2025-08-14_08-18-36,6708,"[np.float32(0.0), np.float32(1.0), np.float32(0.0), np.float32(0.0), np.float32(0.0), np.float32(1.0), np.float32(1.0), np.float32(0.0), np.float32(0.0), np.float32(0.0), np.float32(1.0), np.float32(0.0), np.float32(1.0), np.float32(0.0), np.float32(0.0), np.float32(0.0)]",-2.0,99638.0,3
2025-08-14_08-18-36,6709,"[np.float32(1.0), np.float32(0.0), np.float32(1.0), np.float32(0.0), np.float32(0.0), np.float32(0.0), np.float32(0.0), np.float32(1.0), np.float32(1.0), np.float32(0.0), np.float32(0.0), np.float32(1.0), np.float32(0.0), np.float32(1.0), np.float32(0.0), np.float32(0.0)]",7.0,99645.0,18
2025-08-14_08-18-36,6710,"[np.float32(0.0), np.float32(1.0), np.float32(1.0), np.float32(1.0), np.float32(1.0), np.float32(1.0), np.float32(0.0), np.float32(1.0), np.float32(0.0), np.float32(0.0), np.float32(1.0), np.float32(1.0), np.float32(0.0), np.float32(0.0), np.float32(1.0), np.float32(0.0)]",0.0,99645.0,6
2025-08-14_08-18-36,6711,"[np.float32(1.0), np.float32(1.0), np.float32(1.0), np.float32(0.0), np.float32(0.0), np.float32(1.0), np.float32(1.0), np.float32(1.0), np.float32(1.0), np.float32(1.0), np.float32(1.0), np.float32(0.0), np.float32(0.0), np.float32(1.0), np.float32(0.0), np.float32(0.0)]",0.0,99645.0,31
2025-08-14_08-18-36,6712,"[np.float32(1.0), np.float32(1.0), np.float32(1.0), np.float32(0.0), np.float32(0.0), np.float32(0.0), np.float32(0.0), np.float32(0.0), np.float32(1.0), np.float32(0.0), np.float32(1.0), np.float32(1.0), np.float32(1.0), np.float32(0.0), np.float32(0.0), np.float32(0.0)]",-5.0,99640.0,13
2025-08-14_08-18-36,6713,"[np.float32(0.0), np.float32(1.0), np.float32(1.0), np.float32(0.0), np.float32(1.0), np.float32(0.0), np.float32(1.0), np.float32(0.0), np.float32(1.0), np.float32(1.0), np.float32(1.0), np.float32(0.0), np.float32(1.0), np.float32(0.0), np.float32(0.0), np.float32(0.0)]",-2.0,99638.0,25
2025-08-14_08-18-36,6714,"[np.float32(0.0), np.float32(0.0), np.float32(1.0), np.float32(1.0), np.float32(0.0), np.float32(1.0), np.float32(0.0), np.float32(1.0), np.float32(1.0), np.float32(0.0), np.float32(0.0), np.float32(0.0), np.float32(1.0), np.float32(1.0), np.float32(0.0), np.float32(1.0)]",-3.0,99635.0,6
2025-08-14_08-18-36,6715,"[np.float32(0.0), np.float32(1.0), np.float32(1.0), np.float32(0.0), np.float32(0.0), np.float32(0.0), np.float32(0.0), np.float32(0.0), np.float32(0.0), np.float32(1.0), np.float32(0.0), np.float32(1.0), np.float32(0.0), np.float32(0.0), np.float32(0.0), np.float32(0.0)]",3.0,99638.0,28
2025-08-14_08-18-36,6716,"[np.float32(1.0), np.float32(0.0), np.float32(0.0), np.float32(1.0), np.float32(0.0), np.float32(1.0), np.float32(0.0), np.float32(1.0), np.float32(0.0), np.float32(0.0), np.float32(0.0), np.float32(0.0), np.float32(0.0), np.float32(0.0), np.float32(0.0), np.float32(1.0)]",2.0,99640.0,31
2025-08-14_08-18-36,6717,"[np.float32(1.0), np.float32(1.0), np.float32(0.0), np.float32(0.0), np.float32(0.0), np.float32(1.0), np.float32(0.0), np.float32(1.0), np.float32(0.0), np.float32(1.0), np.float32(0.0), np.float32(0.0), np.float32(0.0), np.float32(0.0), np.float32(0.0), np.float32(0.0)]",-1.0,99639.0,35
2025-08-14_08-18-36,6718,"[np.float32(0.0), np.float32(1.0), np.float32(1.0), np.float32(1.0), np.float32(1.0), np.float32(1.0), np.float32(1.0), np.float32(1.0), np.float32(1.0), np.float32(0.0), np.float32(0.0), np.float32(0.0), np.float32(0.0), np.float32(0.0), np.float32(0.0), np.float32(0.0)]",-1.0,99638.0,34
2025-08-14_08-18-36,6719,"[np.float32(0.0), np.float32(0.0), np.float32(1.0), np.float32(0.0), np.float32(0.0), np.float32(0.0), np.float32(0.0), np.float32(1.0), np.float32(1.0), np.float32(0.0), np.float32(0.0), np.float32(0.0), np.float32(1.0), np.float32(0.0), np.float32(0.0), np.float32(0.0)]",-1.0,99637.0,27
2025-08-14_08-18-36,6720,"[np.float32(1.0), np.float32(0.0), np.float32(0.0), np.float32(1.0), np.float32(0.0), np.float32(1.0), np.float32(1.0), np.float32(0.0), np.float32(0.0), np.float32(0.0), np.float32(1.0), np.float32(0.0), np.float32(1.0), np.float32(0.0), np.float32(1.0), np.float32(1.0)]",-1.0,99636.0,3
2025-08-14_08-18-36,6721,"[np.float32(0.0), np.float32(0.0), np.float32(0.0), np.float32(0.0), np.float32(0.0), np.float32(1.0), np.float32(0.0), np.float32(1.0), np.float32(0.0), np.float32(0.0), np.float32(1.0), np.float32(0.0), np.float32(1.0), np.float32(1.0), np.float32(0.0), np.float32(0.0)]",-2.0,99634.0,4
2025-08-14_08-18-36,6722,"[np.float32(1.0), np.float32(1.0), np.float32(0.0), np.float32(1.0), np.float32(0.0), np.float32(0.0), np.float32(1.0), np.float32(1.0), np.float32(0.0), np.float32(1.0), np.float32(1.0), np.float32(1.0), np.float32(1.0), np.float32(0.0), np.float32(0.0), np.float32(0.0)]",1.0,99635.0,5
2025-08-14_08-18-36,6723,"[np.float32(1.0), np.float32(1.0), np.float32(0.0), np.float32(0.0), np.float32(0.0), np.float32(1.0), np.float32(0.0), np.float32(1.0), np.float32(1.0), np.float32(1.0), np.float32(1.0), np.float32(0.0), np.float32(0.0), np.float32(1.0), np.float32(0.0), np.float32(0.0)]",0.0,99635.0,7
2025-08-14_08-18-36,6724,"[np.float32(1.0), np.float32(1.0), np.float32(0.0), np.float32(1.0), np.float32(0.0), np.float32(0.0), np.float32(0.0), np.float32(0.0), np.float32(1.0), np.float32(0.0), np.float32(0.0), np.float32(1.0), np.float32(1.0), np.float32(1.0), np.float32(0.0), np.float32(0.0)]",1.0,99636.0,36
2025-08-14_08-18-36,6725,"[np.float32(1.0), np.float32(0.0), np.float32(0.0), np.float32(0.0), np.float32(1.0), np.float32(0.0), np.float32(0.0), np.float32(1.0), np.float32(0.0), np.float32(0.0), np.float32(1.0), np.float32(0.0), np.float32(0.0), np.float32(1.0), np.float32(1.0), np.float32(0.0)]",4.0,99640.0,16
2025-08-14_08-18-36,6726,"[np.float32(1.0), np.float32(0.0), np.float32(1.0), np.float32(1.0), np.float32(0.0), np.float32(0.0), np.float32(0.0), np.float32(0.0), np.float32(1.0), np.float32(1.0), np.float32(0.0), np.float32(0.0), np.float32(1.0), np.float32(0.0), np.float32(0.0), np.float32(0.0)]",-1.0,99639.0,33
2025-08-14_08-18-36,6727,"[np.float32(0.0), np.float32(1.0), np.float32(0.0), np.float32(0.0), np.float32(1.0), np.float32(1.0), np.float32(1.0), np.float32(1.0), np.float32(1.0), np.float32(1.0), np.float32(1.0), np.float32(1.0), np.float32(0.0), np.float32(1.0), np.float32(0.0), np.float32(0.0)]",0.0,99639.0,11
2025-08-14_08-18-36,6728,"[np.float32(0.0), np.float32(1.0), np.float32(0.0), np.float32(1.0), np.float32(1.0), np.float32(0.0), np.float32(1.0), np.float32(0.0), np.float32(1.0), np.float32(1.0), np.float32(0.0), np.float32(1.0), np.float32(1.0), np.float32(0.0), np.float32(0.0), np.float32(0.0)]",1.0,99640.0,15
2025-08-14_08-18-36,6729,"[np.float32(0.0), np.float32(0.0), np.float32(0.0), np.float32(1.0), np.float32(0.0), np.float32(1.0), np.float32(0.0), np.float32(0.0), np.float32(1.0), np.float32(1.0), np.float32(1.0), np.float32(1.0), np.float32(0.0), np.float32(1.0), np.float32(1.0), np.float32(0.0)]",2.0,99642.0,21
2025-08-14_08-18-36,6730,"[np.float32(0.0), np.float32(1.0), np.float32(0.0), np.float32(1.0), np.float32(0.0), np.float32(1.0), np.float32(1.0), np.float32(0.0), np.float32(1.0), np.float32(0.0), np.float32(1.0), np.float32(1.0), np.float32(1.0), np.float32(0.0), np.float32(0.0), np.float32(0.0)]",-1.0,99641.0,23
2025-08-14_08-18-36,6731,"[np.float32(0.0), np.float32(1.0), np.float32(0.0), np.float32(1.0), np.float32(0.0), np.float32(1.0), np.float32(0.0), np.float32(1.0), np.float32(0.0), np.float32(0.0), np.float32(1.0), np.float32(1.0), np.float32(1.0), np.float32(1.0), np.float32(0.0), np.float32(0.0)]",-1.0,99640.0,13
2025-08-14_08-18-36,6732,"[np.float32(0.0), np.float32(0.0), np.float32(0.0), np.float32(0.0), np.float32(1.0), np.float32(1.0), np.float32(1.0), np.float32(0.0), np.float32(1.0), np.float32(0.0), np.float32(1.0), np.float32(0.0), np.float32(1.0), np.float32(1.0), np.float32(1.0), np.float32(0.0)]",0.0,99640.0,4
2025-08-14_08-18-36,6733,"[np.float32(0.0), np.float32(0.0), np.float32(1.0), np.float32(0.0), np.float32(1.0), np.float32(0.0), np.float32(0.0), np.float32(1.0), np.float32(0.0), np.float32(1.0), np.float32(0.0), np.float32(0.0), np.float32(0.0), np.float32(1.0), np.float32(1.0), np.float32(0.0)]",1.0,99641.0,14
2025-08-14_08-18-36,6734,"[np.float32(1.0), np.float32(1.0), np.float32(0.0), np.float32(0.0), np.float32(0.0), np.float32(0.0), np.float32(0.0), np.float32(1.0), np.float32(0.0), np.float32(0.0), np.float32(0.0), np.float32(1.0), np.float32(1.0), np.float32(0.0), np.float32(0.0), np.float32(1.0)]",2.0,99643.0,14
2025-08-14_08-18-36,6735,"[np.float32(1.0), np.float32(1.0), np.float32(1.0), np.float32(0.0), np.float32(1.0), np.float32(0.0), np.float32(0.0), np.float32(0.0), np.float32(0.0), np.float32(0.0), np.float32(0.0), np.float32(0.0), np.float32(0.0), np.float32(0.0), np.float32(1.0), np.float32(1.0)]",0.0,99643.0,4
2025-08-14_08-18-36,6736,"[np.float32(0.0), np.float32(0.0), np.float32(0.0), np.float32(1.0), np.float32(1.0), np.float32(1.0), np.float32(0.0), np.float32(1.0), np.float32(0.0), np.float32(1.0), np.float32(0.0), np.float32(1.0), np.float32(1.0), np.float32(1.0), np.float32(1.0), np.float32(0.0)]",-4.0,99639.0,6
2025-08-14_08-18-36,6737,"[np.float32(1.0), np.float32(0.0), np.float32(0.0), np.float32(1.0), np.float32(1.0), np.float32(1.0), np.float32(0.0), np.float32(1.0), np.float32(1.0), np.float32(1.0), np.float32(1.0), np.float32(0.0), np.float32(1.0), np.float32(0.0), np.float32(0.0), np.float32(1.0)]",3.0,99642.0,14
2025-08-14_08-18-36,6738,"[np.float32(0.0), np.float32(1.0), np.float32(0.0), np.float32(0.0), np.float32(0.0), np.float32(0.0), np.float32(0.0), np.float32(0.0), np.float32(0.0), np.float32(1.0), np.float32(1.0), np.float32(1.0), np.float32(0.0), np.float32(1.0), np.float32(1.0), np.float32(0.0)]",2.0,99644.0,13
2025-08-14_08-18-36,6739,"[np.float32(0.0), np.float32(0.0), np.float32(0.0), np.float32(0.0), np.float32(0.0), np.float32(0.0), np.float32(1.0), np.float32(1.0), np.float32(1.0), np.float32(1.0), np.float32(1.0), np.float32(0.0), np.float32(1.0), np.float32(0.0), np.float32(1.0), np.float32(0.0)]",-1.0,99643.0,14
2025-08-14_08-18-36,6740,"[np.float32(0.0), np.float32(0.0), np.float32(1.0), np.float32(1.0), np.float32(1.0), np.float32(0.0), np.float32(1.0), np.float32(1.0), np.float32(0.0), np.float32(0.0), np.float32(1.0), np.float32(0.0), np.float32(0.0), np.float32(1.0), np.float32(0.0), np.float32(0.0)]",1.0,99644.0,26
2025-08-14_08-18-36,6741,"[np.float32(1.0), np.float32(0.0), np.float32(0.0), np.float32(1.0), np.float32(1.0), np.float32(0.0), np.float32(1.0), np.float32(1.0), np.float32(0.0), np.float32(0.0), np.float32(1.0), np.float32(0.0), np.float32(1.0), np.float32(1.0), np.float32(0.0), np.float32(1.0)]",1.0,99645.0,15
2025-08-14_08-18-36,6742,"[np.float32(1.0), np.float32(0.0), np.float32(1.0), np.float32(1.0), np.float32(0.0), np.float32(0.0), np.float32(1.0), np.float32(0.0), np.float32(1.0), np.float32(1.0), np.float32(1.0), np.float32(1.0), np.float32(1.0), np.float32(0.0), np.float32(0.0), np.float32(1.0)]",36.0,99681.0,7
2025-08-14_08-18-36,6743,"[np.float32(1.0), np.float32(0.0), np.float32(0.0), np.float32(0.0), np.float32(1.0), np.float32(1.0), np.float32(1.0), np.float32(1.0), np.float32(0.0), np.float32(0.0), np.float32(0.0), np.float32(1.0), np.float32(0.0), np.float32(1.0), np.float32(1.0), np.float32(1.0)]",1.0,99682.0,5
2025-08-14_08-18-36,6744,"[np.float32(0.0), np.float32(0.0), np.float32(0.0), np.float32(1.0), np.float32(0.0), np.float32(1.0), np.float32(1.0), np.float32(0.0), np.float32(1.0), np.float32(1.0), np.float32(0.0), np.float32(1.0), np.float32(1.0), np.float32(0.0), np.float32(0.0), np.float32(0.0)]",3.0,99685.0,25
2025-08-14_08-18-36,6745,"[np.float32(1.0), np.float32(0.0), np.float32(0.0), np.float32(1.0), np.float32(1.0), np.float32(1.0), np.float32(0.0), np.float32(1.0), np.float32(0.0), np.float32(1.0), np.float32(0.0), np.float32(0.0), np.float32(0.0), np.float32(1.0), np.float32(1.0), np.float32(0.0)]",4.0,99689.0,25
2025-08-14_08-18-36,6746,"[np.float32(0.0), np.float32(0.0), np.float32(1.0), np.float32(1.0), np.float32(0.0), np.float32(0.0), np.float32(1.0), np.float32(0.0), np.float32(0.0), np.float32(1.0), np.float32(1.0), np.float32(1.0), np.float32(1.0), np.float32(1.0), np.float32(0.0), np.float32(1.0)]",-1.0,99688.0,14
2025-08-14_08-18-36,6747,"[np.float32(0.0), np.float32(1.0), np.float32(1.0), np.float32(1.0), np.float32(1.0), np.float32(0.0), np.float32(0.0), np.float32(0.0), np.float32(0.0), np.float32(0.0), np.float32(1.0), np.float32(1.0), np.float32(1.0), np.float32(1.0), np.float32(1.0), np.float32(1.0)]",-1.0,99687.0,4
2025-08-14_08-18-36,6748,"[np.float32(1.0), np.float32(1.0), np.float32(0.0), np.float32(1.0), np.float32(1.0), np.float32(1.0), np.float32(1.0), np.float32(1.0), np.float32(1.0), np.float32(0.0), np.float32(0.0), np.float32(0.0), np.float32(1.0), np.float32(0.0), np.float32(0.0), np.float32(1.0)]",-1.0,99686.0,5
2025-08-14_08-18-36,6749,"[np.float32(0.0), np.float32(0.0), np.float32(0.0), np.float32(0.0), np.float32(0.0), np.float32(0.0), np.float32(1.0), np.float32(1.0), np.float32(1.0), np.float32(1.0), np.float32(1.0), np.float32(0.0), np.float32(0.0), np.float32(1.0), np.float32(1.0), np.float32(0.0)]",2.0,99688.0,25
2025-08-14_08-18-36,6750,"[np.float32(1.0), np.float32(1.0), np.float32(1.0), np.float32(0.0), np.float32(1.0), np.float32(1.0), np.float32(1.0), np.float32(1.0), np.float32(1.0), np.float32(0.0), np.float32(0.0), np.float32(1.0), np.float32(1.0), np.float32(1.0), np.float32(0.0), np.float32(0.0)]",-2.0,99686.0,8
2025-08-14_08-18-36,6751,"[np.float32(0.0), np.float32(0.0), np.float32(0.0), np.float32(0.0), np.float32(0.0), np.float32(0.0), np.float32(1.0), np.float32(0.0), np.float32(1.0), np.float32(0.0), np.float32(1.0), np.float32(1.0), np.float32(0.0), np.float32(1.0), np.float32(1.0), np.float32(0.0)]",-3.0,99683.0,22
2025-08-14_08-18-36,6752,"[np.float32(0.0), np.float32(1.0), np.float32(1.0), np.float32(0.0), np.float32(1.0), np.float32(1.0), np.float32(0.0), np.float32(1.0), np.float32(1.0), np.float32(0.0), np.float32(0.0), np.float32(0.0), np.float32(0.0), np.float32(1.0), np.float32(0.0), np.float32(1.0)]",2.0,99685.0,29
2025-08-14_08-18-36,6753,"[np.float32(0.0), np.float32(1.0), np.float32(0.0), np.float32(1.0), np.float32(0.0), np.float32(1.0), np.float32(1.0), np.float32(1.0), np.float32(0.0), np.float32(1.0), np.float32(1.0), np.float32(0.0), np.float32(1.0), np.float32(0.0), np.float32(1.0), np.float32(0.0)]",-5.0,99680.0,0
2025-08-14_08-18-36,6754,"[np.float32(1.0), np.float32(1.0), np.float32(0.0), np.float32(0.0), np.float32(1.0), np.float32(1.0), np.float32(0.0), np.float32(1.0), np.float32(0.0), np.float32(0.0), np.float32(0.0), np.float32(1.0), np.float32(0.0), np.float32(0.0), np.float32(0.0), np.float32(0.0)]",-2.0,99678.0,31
2025-08-14_08-18-36,6755,"[np.float32(0.0), np.float32(1.0), np.float32(0.0), np.float32(1.0), np.float32(1.0), np.float32(1.0), np.float32(0.0), np.float32(1.0), np.float32(0.0), np.float32(0.0), np.float32(0.0), np.float32(0.0), np.float32(1.0), np.float32(1.0), np.float32(1.0), np.float32(0.0)]",-3.0,99675.0,30
2025-08-14_08-18-36,6756,"[np.float32(0.0), np.float32(0.0), np.float32(0.0), np.float32(1.0), np.float32(1.0), np.float32(1.0), np.float32(0.0), np.float32(1.0), np.float32(1.0), np.float32(0.0), np.float32(1.0), np.float32(1.0), np.float32(0.0), np.float32(0.0), np.float32(1.0), np.float32(1.0)]",4.0,99679.0,27
2025-08-14_08-18-36,6757,"[np.float32(0.0), np.float32(0.0), np.float32(0.0), np.float32(1.0), np.float32(1.0), np.float32(1.0), np.float32(0.0), np.float32(0.0), np.float32(0.0), np.float32(1.0), np.float32(1.0), np.float32(0.0), np.float32(1.0), np.float32(1.0), np.float32(1.0), np.float32(1.0)]",-4.0,99675.0,36
2025-08-14_08-18-36,6758,"[np.float32(1.0), np.float32(0.0), np.float32(0.0), np.float32(0.0), np.float32(1.0), np.float32(1.0), np.float32(1.0), np.float32(1.0), np.float32(1.0), np.float32(1.0), np.float32(0.0), np.float32(1.0), np.float32(0.0), np.float32(0.0), np.float32(0.0), np.float32(0.0)]",0.0,99675.0,31
2025-08-14_08-18-36,6759,"[np.float32(1.0), np.float32(1.0), np.float32(0.0), np.float32(0.0), np.float32(1.0), np.float32(0.0), np.float32(1.0), np.float32(0.0), np.float32(0.0), np.float32(0.0), np.float32(0.0), np.float32(1.0), np.float32(1.0), np.float32(0.0), np.float32(1.0), np.float32(0.0)]",-2.0,99673.0,21
2025-08-14_08-18-36,6760,"[np.float32(0.0), np.float32(0.0), np.float32(0.0), np.float32(1.0), np.float32(1.0), np.float32(1.0), np.float32(0.0), np.float32(1.0), np.float32(1.0), np.float32(0.0), np.float32(0.0), np.float32(0.0), np.float32(0.0), np.float32(1.0), np.float32(0.0), np.float32(0.0)]",-1.0,99672.0,2
2025-08-14_08-18-36,6761,"[np.float32(1.0), np.float32(0.0), np.float32(0.0), np.float32(1.0), np.float32(0.0), np.float32(1.0), np.float32(1.0), np.float32(0.0), np.float32(1.0), np.float32(0.0), np.float32(0.0), np.float32(0.0), np.float32(1.0), np.float32(1.0), np.float32(0.0), np.float32(1.0)]",-1.0,99671.0,33
2025-08-14_08-18-36,6762,"[np.float32(0.0), np.float32(1.0), np.float32(1.0), np.float32(1.0), np.float32(0.0), np.float32(0.0), np.float32(1.0), np.float32(0.0), np.float32(0.0), np.float32(1.0), np.float32(1.0), np.float32(0.0), np.float32(0.0), np.float32(0.0), np.float32(1.0), np.float32(0.0)]",0.0,99671.0,24
2025-08-14_08-18-36,6763,"[np.float32(0.0), np.float32(0.0), np.float32(0.0), np.float32(0.0), np.float32(0.0), np.float32(1.0), np.float32(1.0), np.float32(1.0), np.float32(1.0), np.float32(1.0), np.float32(0.0), np.float32(0.0), np.float32(0.0), np.float32(1.0), np.float32(0.0), np.float32(1.0)]",4.0,99675.0,34
2025-08-14_08-18-36,6764,"[np.float32(1.0), np.float32(1.0), np.float32(0.0), np.float32(1.0), np.float32(0.0), np.float32(0.0), np.float32(0.0), np.float32(0.0), np.float32(1.0), np.float32(1.0), np.float32(0.0), np.float32(0.0), np.float32(0.0), np.float32(0.0), np.float32(1.0), np.float32(0.0)]",1.0,99676.0,29
2025-08-14_08-18-36,6765,"[np.float32(1.0), np.float32(1.0), np.float32(0.0), np.float32(1.0), np.float32(0.0), np.float32(1.0), np.float32(1.0), np.float32(0.0), np.float32(0.0), np.float32(1.0), np.float32(1.0), np.float32(1.0), np.float32(1.0), np.float32(1.0), np.float32(1.0), np.float32(1.0)]",0.0,99676.0,27
2025-08-14_08-18-36,6766,"[np.float32(0.0), np.float32(1.0), np.float32(0.0), np.float32(1.0), np.float32(0.0), np.float32(1.0), np.float32(0.0), np.float32(1.0), np.float32(1.0), np.float32(1.0), np.float32(0.0), np.float32(1.0), np.float32(0.0), np.float32(0.0), np.float32(0.0), np.float32(1.0)]",-3.0,99673.0,10
2025-08-14_08-18-36,6767,"[np.float32(1.0), np.float32(0.0), np.float32(1.0), np.float32(0.0), np.float32(0.0), np.float32(1.0), np.float32(1.0), np.float32(1.0), np.float32(0.0), np.float32(1.0), np.float32(0.0), np.float32(1.0), np.float32(1.0), np.float32(1.0), np.float32(1.0), np.float32(0.0)]",37.0,99710.0,7
2025-08-14_08-18-36,6768,"[np.float32(1.0), np.float32(1.0), np.float32(1.0), np.float32(1.0), np.float32(0.0), np.float32(1.0), np.float32(0.0), np.float32(1.0), np.float32(1.0), np.float32(0.0), np.float32(1.0), np.float32(0.0), np.float32(1.0), np.float32(0.0), np.float32(0.0), np.float32(1.0)]",-3.0,99707.0,6
2025-08-14_08-18-36,6769,"[np.float32(0.0), np.float32(1.0), np.float32(0.0), np.float32(1.0), np.float32(0.0), np.float32(1.0), np.float32(1.0), np.float32(1.0), np.float32(1.0), np.float32(0.0), np.float32(0.0), np.float32(0.0), np.float32(1.0), np.float32(1.0), np.float32(0.0), np.float32(0.0)]",-3.0,99704.0,6
2025-08-14_08-18-36,6770,"[np.float32(1.0), np.float32(0.0), np.float32(1.0), np.float32(1.0), np.float32(0.0), np.float32(0.0), np.float32(1.0), np.float32(1.0), np.float32(0.0), np.float32(1.0), np.float32(1.0), np.float32(0.0), np.float32(1.0), np.float32(1.0), np.float32(1.0), np.float32(0.0)]",-5.0,99699.0,0
2025-08-14_08-18-36,6771,"[np.float32(0.0), np.float32(0.0), np.float32(0.0), np.float32(0.0), np.float32(1.0), np.float32(0.0), np.float32(0.0), np.float32(1.0), np.float32(1.0), np.float32(1.0), np.float32(0.0), np.float32(1.0), np.float32(1.0), np.float32(1.0), np.float32(0.0), np.float32(0.0)]",-2.0,99697.0,14
2025-08-14_08-18-36,6772,"[np.float32(1.0), np.float32(0.0), np.float32(1.0), np.float32(1.0), np.float32(1.0), np.float32(1.0), np.float32(1.0), np.float32(0.0), np.float32(1.0), np.float32(1.0), np.float32(1.0), np.float32(0.0), np.float32(1.0), np.float32(0.0), np.float32(1.0), np.float32(0.0)]",1.0,99698.0,27
2025-08-14_08-18-36,6773,"[np.float32(0.0), np.float32(1.0), np.float32(0.0), np.float32(0.0), np.float32(0.0), np.float32(1.0), np.float32(1.0), np.float32(0.0), np.float32(1.0), np.float32(1.0), np.float32(0.0), np.float32(1.0), np.float32(1.0), np.float32(1.0), np.float32(1.0), np.float32(1.0)]",1.0,99699.0,30
2025-08-14_08-18-36,6774,"[np.float32(1.0), np.float32(0.0), np.float32(0.0), np.float32(0.0), np.float32(1.0), np.float32(0.0), np.float32(0.0), np.float32(1.0), np.float32(0.0), np.float32(0.0), np.float32(0.0), np.float32(1.0), np.float32(1.0), np.float32(1.0), np.float32(0.0), np.float32(1.0)]",-2.0,99697.0,30
2025-08-14_08-18-36,6775,"[np.float32(0.0), np.float32(1.0), np.float32(0.0), np.float32(1.0), np.float32(0.0), np.float32(1.0), np.float32(1.0), np.float32(0.0), np.float32(0.0), np.float32(1.0), np.float32(0.0), np.float32(1.0), np.float32(0.0), np.float32(0.0), np.float32(0.0), np.float32(1.0)]",1.0,99698.0,7
2025-08-14_08-18-36,6776,"[np.float32(0.0), np.float32(0.0), np.float32(0.0), np.float32(1.0), np.float32(0.0), np.float32(0.0), np.float32(1.0), np.float32(1.0), np.float32(1.0), np.float32(0.0), np.float32(0.0), np.float32(0.0), np.float32(1.0), np.float32(0.0), np.float32(1.0), np.float32(0.0)]",-3.0,99695.0,18
2025-08-14_08-18-36,6777,"[np.float32(1.0), np.float32(1.0), np.float32(1.0), np.float32(1.0), np.float32(0.0), np.float32(0.0), np.float32(1.0), np.float32(0.0), np.float32(1.0), np.float32(0.0), np.float32(1.0), np.float32(0.0), np.float32(1.0), np.float32(1.0), np.float32(1.0), np.float32(0.0)]",-3.0,99692.0,16
2025-08-14_08-18-36,6778,"[np.float32(1.0), np.float32(0.0), np.float32(0.0), np.float32(1.0), np.float32(0.0), np.float32(0.0), np.float32(0.0), np.float32(1.0), np.float32(1.0), np.float32(1.0), np.float32(0.0), np.float32(0.0), np.float32(0.0), np.float32(1.0), np.float32(0.0), np.float32(1.0)]",-5.0,99687.0,11
2025-08-14_08-18-36,6779,"[np.float32(1.0), np.float32(0.0), np.float32(0.0), np.float32(1.0), np.float32(0.0), np.float32(1.0), np.float32(0.0), np.float32(1.0), np.float32(1.0), np.float32(0.0), np.float32(1.0), np.float32(1.0), np.float32(0.0), np.float32(0.0), np.float32(1.0), np.float32(0.0)]",2.0,99689.0,32
2025-08-14_08-18-36,6780,"[np.float32(1.0), np.float32(1.0), np.float32(0.0), np.float32(1.0), np.float32(1.0), np.float32(0.0), np.float32(0.0), np.float32(0.0), np.float32(1.0), np.float32(0.0), np.float32(1.0), np.float32(1.0), np.float32(0.0), np.float32(0.0), np.float32(0.0), np.float32(0.0)]",0.0,99689.0,21
2025-08-14_08-18-36,6781,"[np.float32(0.0), np.float32(0.0), np.float32(0.0), np.float32(0.0), np.float32(1.0), np.float32(1.0), np.float32(0.0), np.float32(1.0), np.float32(0.0), np.float32(0.0), np.float32(0.0), np.float32(0.0), np.float32(0.0), np.float32(1.0), np.float32(0.0), np.float32(0.0)]",-2.0,99687.0,27
2025-08-14_08-18-36,6782,"[np.float32(0.0), np.float32(1.0), np.float32(1.0), np.float32(1.0), np.float32(0.0), np.float32(1.0), np.float32(1.0), np.float32(1.0), np.float32(0.0), np.float32(0.0), np.float32(0.0), np.float32(0.0), np.float32(1.0), np.float32(0.0), np.float32(0.0), np.float32(1.0)]",-1.0,99686.0,13
2025-08-14_08-18-36,6783,"[np.float32(1.0), np.float32(1.0), np.float32(0.0), np.float32(1.0), np.float32(0.0), np.float32(1.0), np.float32(0.0), np.float32(1.0), np.float32(0.0), np.float32(1.0), np.float32(0.0), np.float32(0.0), np.float32(0.0), np.float32(1.0), np.float32(0.0), np.float32(1.0)]",7.0,99693.0,19
2025-08-14_08-18-36,6784,"[np.float32(0.0), np.float32(0.0), np.float32(1.0), np.float32(1.0), np.float32(1.0), np.float32(1.0), np.float32(1.0), np.float32(0.0), np.float32(1.0), np.float32(0.0), np.float32(0.0), np.float32(1.0), np.float32(1.0), np.float32(0.0), np.float32(1.0), np.float32(0.0)]",-5.0,99688.0,22
2025-08-14_08-18-36,6785,"[np.float32(0.0), np.float32(0.0), np.float32(1.0), np.float32(0.0), np.float32(1.0), np.float32(0.0), np.float32(1.0), np.float32(1.0), np.float32(0.0), np.float32(0.0), np.float32(1.0), np.float32(0.0), np.float32(0.0), np.float32(0.0), np.float32(0.0), np.float32(0.0)]",0.0,99688.0,1
2025-08-14_08-18-36,6786,"[np.float32(1.0), np.float32(0.0), np.float32(0.0), np.float32(1.0), np.float32(0.0), np.float32(1.0), np.float32(1.0), np.float32(1.0), np.float32(0.0), np.float32(1.0), np.float32(1.0), np.float32(0.0), np.float32(1.0), np.float32(0.0), np.float32(1.0), np.float32(1.0)]",-8.0,99680.0,0
2025-08-14_08-18-36,6787,"[np.float32(0.0), np.float32(0.0), np.float32(0.0), np.float32(0.0), np.float32(0.0), np.float32(1.0), np.float32(1.0), np.float32(1.0), np.float32(1.0), np.float32(1.0), np.float32(0.0), np.float32(0.0), np.float32(1.0), np.float32(1.0), np.float32(0.0), np.float32(0.0)]",-1.0,99679.0,2
2025-08-14_08-18-36,6788,"[np.float32(0.0), np.float32(0.0), np.float32(1.0), np.float32(0.0), np.float32(0.0), np.float32(1.0), np.float32(0.0), np.float32(1.0), np.float32(1.0), np.float32(1.0), np.float32(0.0), np.float32(1.0), np.float32(1.0), np.float32(1.0), np.float32(1.0), np.float32(0.0)]",2.0,99681.0,18
2025-08-14_08-18-36,6789,"[np.float32(1.0), np.float32(0.0), np.float32(1.0), np.float32(0.0), np.float32(0.0), np.float32(1.0), np.float32(0.0), np.float32(1.0), np.float32(0.0), np.float32(0.0), np.float32(1.0), np.float32(1.0), np.float32(0.0), np.float32(1.0), np.float32(0.0), np.float32(1.0)]",-1.0,99680.0,16
2025-08-14_08-18-36,6790,"[np.float32(0.0), np.float32(0.0), np.float32(0.0), np.float32(0.0), np.float32(0.0), np.float32(1.0), np.float32(0.0), np.float32(1.0), np.float32(1.0), np.float32(1.0), np.float32(0.0), np.float32(1.0), np.float32(1.0), np.float32(0.0), np.float32(0.0), np.float32(0.0)]",-3.0,99677.0,4
2025-08-14_08-18-36,6791,"[np.float32(0.0), np.float32(0.0), np.float32(0.0), np.float32(0.0), np.float32(0.0), np.float32(1.0), np.float32(0.0), np.float32(1.0), np.float32(0.0), np.float32(0.0), np.float32(0.0), np.float32(0.0), np.float32(1.0), np.float32(0.0), np.float32(0.0), np.float32(0.0)]",33.0,99710.0,7
2025-08-14_08-18-36,6792,"[np.float32(0.0), np.float32(1.0), np.float32(1.0), np.float32(0.0), np.float32(1.0), np.float32(1.0), np.float32(1.0), np.float32(1.0), np.float32(0.0), np.float32(0.0), np.float32(1.0), np.float32(1.0), np.float32(0.0), np.float32(1.0), np.float32(0.0), np.float32(0.0)]",-1.0,99709.0,23
2025-08-14_08-18-36,6793,"[np.float32(1.0), np.float32(0.0), np.float32(0.0), np.float32(0.0), np.float32(1.0), np.float32(1.0), np.float32(0.0), np.float32(1.0), np.float32(0.0), np.float32(1.0), np.float32(1.0), np.float32(0.0), np.float32(0.0), np.float32(1.0), np.float32(1.0), np.float32(0.0)]",-6.0,99703.0,6
2025-08-14_08-18-36,6794,"[np.float32(0.0), np.float32(0.0), np.float32(0.0), np.float32(1.0), np.float32(1.0), np.float32(0.0), np.float32(0.0), np.float32(1.0), np.float32(0.0), np.float32(0.0), np.float32(1.0), np.float32(0.0), np.float32(0.0), np.float32(1.0), np.float32(0.0), np.float32(0.0)]",-3.0,99700.0,10
2025-08-14_08-18-36,6795,"[np.float32(1.0), np.float32(0.0), np.float32(0.0), np.float32(1.0), np.float32(0.0), np.float32(0.0), np.float32(0.0), np.float32(1.0), np.float32(1.0), np.float32(1.0), np.float32(0.0), np.float32(0.0), np.float32(1.0), np.float32(1.0), np.float32(0.0), np.float32(1.0)]",0.0,99700.0,32
2025-08-14_08-18-36,6796,"[np.float32(0.0), np.float32(0.0), np.float32(1.0), np.float32(0.0), np.float32(1.0), np.float32(1.0), np.float32(0.0), np.float32(1.0), np.float32(1.0), np.float32(0.0), np.float32(0.0), np.float32(0.0), np.float32(0.0), np.float32(1.0), np.float32(0.0), np.float32(1.0)]",1.0,99701.0,17
2025-08-14_08-18-36,6797,"[np.float32(1.0), np.float32(0.0), np.float32(1.0), np.float32(0.0), np.float32(1.0), np.float32(1.0), np.float32(0.0), np.float32(1.0), np.float32(1.0), np.float32(0.0), np.float32(0.0), np.float32(1.0), np.float32(0.0), np.float32(0.0), np.float32(0.0), np.float32(0.0)]",-2.0,99699.0,31
2025-08-14_08-18-36,6798,"[np.float32(0.0), np.float32(0.0), np.float32(1.0), np.float32(0.0), np.float32(0.0), np.float32(0.0), np.float32(1.0), np.float32(1.0), np.float32(1.0), np.float32(0.0), np.float32(0.0), np.float32(1.0), np.float32(1.0), np.float32(0.0), np.float32(0.0), np.float32(0.0)]",2.0,99701.0,24
2025-08-14_08-18-36,6799,"[np.float32(0.0), np.float32(1.0), np.float32(0.0), np.float32(1.0), np.float32(0.0), np.float32(1.0), np.float32(0.0), np.float32(0.0), np.float32(1.0), np.float32(0.0), np.float32(1.0), np.float32(1.0), np.float32(1.0), np.float32(1.0), np.float32(1.0), np.float32(0.0)]",-1.0,99700.0,5
2025-08-14_08-18-36,6800,"[np.float32(0.0), np.float32(0.0), np.float32(0.0), np.float32(1.0), np.float32(0.0), np.float32(1.0), np.float32(0.0), np.float32(1.0), np.float32(0.0), np.float32(0.0), np.float32(0.0), np.float32(1.0), np.float32(1.0), np.float32(0.0), np.float32(1.0), np.float32(1.0)]",3.0,99703.0,27
2025-08-14_08-18-36,6801,"[np.float32(1.0), np.float32(1.0), np.float32(0.0), np.float32(0.0), np.float32(1.0), np.float32(0.0), np.float32(1.0), np.float32(1.0), np.float32(0.0), np.float32(1.0), np.float32(1.0), np.float32(1.0), np.float32(1.0), np.float32(0.0), np.float32(0.0), np.float32(1.0)]",0.0,99703.0,8
2025-08-14_08-18-36,6802,"[np.float32(0.0), np.float32(1.0), np.float32(0.0), np.float32(0.0), np.float32(0.0), np.float32(0.0), np.float32(0.0), np.float32(0.0), np.float32(0.0), np.float32(0.0), np.float32(1.0), np.float32(1.0), np.float32(0.0), np.float32(0.0), np.float32(1.0), np.float32(0.0)]",1.0,99704.0,10
2025-08-14_08-18-36,6803,"[np.float32(0.0), np.float32(1.0), np.float32(1.0), np.float32(0.0), np.float32(1.0), np.float32(1.0), np.float32(0.0), np.float32(1.0), np.float32(1.0), np.float32(0.0), np.float32(0.0), np.float32(0.0), np.float32(0.0), np.float32(0.0), np.float32(1.0), np.float32(1.0)]",2.0,99706.0,16
2025-08-14_08-18-36,6804,"[np.float32(1.0), np.float32(0.0), np.float32(1.0), np.float32(1.0), np.float32(0.0), np.float32(0.0), np.float32(1.0), np.float32(1.0), np.float32(0.0), np.float32(0.0), np.float32(0.0), np.float32(0.0), np.float32(0.0), np.float32(0.0), np.float32(1.0), np.float32(1.0)]",0.0,99706.0,36
2025-08-14_08-18-36,6805,"[np.float32(1.0), np.float32(1.0), np.float32(0.0), np.float32(0.0), np.float32(0.0), np.float32(0.0), np.float32(1.0), np.float32(1.0), np.float32(1.0), np.float32(1.0), np.float32(1.0), np.float32(0.0), np.float32(0.0), np.float32(1.0), np.float32(0.0), np.float32(0.0)]",0.0,99706.0,31
2025-08-14_08-18-36,6806,"[np.float32(1.0), np.float32(1.0), np.float32(1.0), np.float32(0.0), np.float32(1.0), np.float32(0.0), np.float32(0.0), np.float32(1.0), np.float32(0.0), np.float32(1.0), np.float32(0.0), np.float32(0.0), np.float32(1.0), np.float32(1.0), np.float32(1.0), np.float32(1.0)]",1.0,99707.0,19
2025-08-14_08-18-36,6807,"[np.float32(1.0), np.float32(1.0), np.float32(1.0), np.float32(0.0), np.float32(1.0), np.float32(0.0), np.float32(0.0), np.float32(1.0), np.float32(1.0), np.float32(0.0), np.float32(1.0), np.float32(1.0), np.float32(0.0), np.float32(1.0), np.float32(1.0), np.float32(1.0)]",2.0,99709.0,24
2025-08-14_08-18-36,6808,"[np.float32(1.0), np.float32(0.0), np.float32(0.0), np.float32(0.0), np.float32(1.0), np.float32(0.0), np.float32(1.0), np.float32(1.0), np.float32(1.0), np.float32(1.0), np.float32(1.0), np.float32(0.0), np.float32(1.0), np.float32(1.0), np.float32(1.0), np.float32(0.0)]",1.0,99710.0,13
2025-08-14_08-18-36,6809,"[np.float32(1.0), np.float32(0.0), np.float32(0.0), np.float32(1.0), np.float32(1.0), np.float32(0.0), np.float32(0.0), np.float32(1.0), np.float32(0.0), np.float32(1.0), np.float32(0.0), np.float32(0.0), np.float32(1.0), np.float32(1.0), np.float32(0.0), np.float32(0.0)]",-2.0,99708.0,35
2025-08-14_08-18-36,6810,"[np.float32(0.0), np.float32(0.0), np.float32(0.0), np.float32(1.0), np.float32(0.0), np.float32(0.0), np.float32(1.0), np.float32(1.0), np.float32(0.0), np.float32(0.0), np.float32(0.0), np.float32(1.0), np.float32(1.0), np.float32(0.0), np.float32(1.0), np.float32(0.0)]",2.0,99710.0,23
2025-08-14_08-18-36,6811,"[np.float32(0.0), np.float32(0.0), np.float32(1.0), np.float32(1.0), np.float32(1.0), np.float32(0.0), np.float32(0.0), np.float32(1.0), np.float32(1.0), np.float32(0.0), np.float32(1.0), np.float32(0.0), np.float32(1.0), np.float32(0.0), np.float32(0.0), np.float32(1.0)]",-3.0,99707.0,19
2025-08-14_08-18-36,6812,"[np.float32(1.0), np.float32(0.0), np.float32(0.0), np.float32(0.0), np.float32(0.0), np.float32(0.0), np.float32(0.0), np.float32(0.0), np.float32(1.0), np.float32(0.0), np.float32(0.0), np.float32(0.0), np.float32(0.0), np.float32(0.0), np.float32(0.0), np.float32(0.0)]",0.0,99707.0,12
2025-08-14_08-18-36,6813,"[np.float32(0.0), np.float32(0.0), np.float32(1.0), np.float32(1.0), np.float32(1.0), np.float32(0.0), np.float32(0.0), np.float32(0.0), np.float32(1.0), np.float32(1.0), np.float32(0.0), np.float32(0.0), np.float32(1.0), np.float32(0.0), np.float32(1.0), np.float32(0.0)]",-5.0,99702.0,0
2025-08-14_08-18-36,6814,"[np.float32(0.0), np.float32(0.0), np.float32(1.0), np.float32(1.0), np.float32(0.0), np.float32(1.0), np.float32(1.0), np.float32(1.0), np.float32(1.0), np.float32(0.0), np.float32(1.0), np.float32(0.0), np.float32(0.0), np.float32(1.0), np.float32(1.0), np.float32(1.0)]",3.0,99705.0,26
2025-08-14_08-18-36,6815,"[np.float32(1.0), np.float32(0.0), np.float32(1.0), np.float32(1.0), np.float32(0.0), np.float32(0.0), np.float32(1.0), np.float32(1.0), np.float32(0.0), np.float32(0.0), np.float32(0.0), np.float32(1.0), np.float32(0.0), np.float32(1.0), np.float32(1.0), np.float32(0.0)]",3.0,99708.0,15
2025-08-14_08-18-36,6816,"[np.float32(0.0), np.float32(0.0), np.float32(0.0), np.float32(1.0), np.float32(0.0), np.float32(0.0), np.float32(1.0), np.float32(0.0), np.float32(1.0), np.float32(1.0), np.float32(0.0), np.float32(1.0), np.float32(0.0), np.float32(1.0), np.float32(0.0), np.float32(1.0)]",1.0,99709.0,33
2025-08-14_08-18-36,6817,"[np.float32(0.0), np.float32(0.0), np.float32(0.0), np.float32(0.0), np.float32(0.0), np.float32(1.0), np.float32(1.0), np.float32(0.0), np.float32(1.0), np.float32(0.0), np.float32(1.0), np.float32(0.0), np.float32(0.0), np.float32(1.0), np.float32(0.0), np.float32(0.0)]",1.0,99710.0,7
2025-08-14_08-18-36,6818,"[np.float32(0.0), np.float32(1.0), np.float32(1.0), np.float32(0.0), np.float32(0.0), np.float32(0.0), np.float32(1.0), np.float32(1.0), np.float32(0.0), np.float32(1.0), np.float32(0.0), np.float32(0.0), np.float32(1.0), np.float32(1.0), np.float32(1.0), np.float32(0.0)]",-2.0,99708.0,21
2025-08-14_08-18-36,6819,"[np.float32(1.0), np.float32(1.0), np.float32(0.0), np.float32(0.0), np.float32(0.0), np.float32(0.0), np.float32(1.0), np.float32(1.0), np.float32(1.0), np.float32(1.0), np.float32(1.0), np.float32(0.0), np.float32(0.0), np.float32(0.0), np.float32(0.0), np.float32(1.0)]",0.0,99708.0,13
2025-08-14_08-18-36,6820,"[np.float32(0.0), np.float32(0.0), np.float32(1.0), np.float32(0.0), np.float32(1.0), np.float32(1.0), np.float32(0.0), np.float32(1.0), np.float32(1.0), np.float32(1.0), np.float32(1.0), np.float32(1.0), np.float32(1.0), np.float32(1.0), np.float32(0.0), np.float32(0.0)]",-3.0,99705.0,0
2025-08-14_08-18-36,6821,"[np.float32(1.0), np.float32(1.0), np.float32(1.0), np.float32(1.0), np.float32(1.0), np.float32(0.0), np.float32(0.0), np.float32(1.0), np.float32(0.0), np.float32(1.0), np.float32(1.0), np.float32(1.0), np.float32(0.0), np.float32(0.0), np.float32(1.0), np.float32(0.0)]",0.0,99705.0,30
2025-08-14_08-18-36,6822,"[np.float32(0.0), np.float32(0.0), np.float32(1.0), np.float32(0.0), np.float32(0.0), np.float32(0.0), np.float32(0.0), np.float32(1.0), np.float32(1.0), np.float32(0.0), np.float32(1.0), np.float32(1.0), np.float32(1.0), np.float32(1.0), np.float32(1.0), np.float32(0.0)]",-5.0,99700.0,31
2025-08-14_08-18-36,6823,"[np.float32(0.0), np.float32(1.0), np.float32(1.0), np.float32(1.0), np.float32(0.0), np.float32(0.0), np.float32(0.0), np.float32(0.0), np.float32(0.0), np.float32(0.0), np.float32(1.0), np.float32(0.0), np.float32(0.0), np.float32(1.0), np.float32(0.0), np.float32(0.0)]",5.0,99705.0,26
2025-08-14_08-18-36,6824,"[np.float32(0.0), np.float32(0.0), np.float32(0.0), np.float32(0.0), np.float32(0.0), np.float32(0.0), np.float32(1.0), np.float32(1.0), np.float32(0.0), np.float32(1.0), np.float32(0.0), np.float32(1.0), np.float32(0.0), np.float32(1.0), np.float32(1.0), np.float32(0.0)]",0.0,99705.0,28
2025-08-14_08-18-36,6825,"[np.float32(0.0), np.float32(0.0), np.float32(0.0), np.float32(1.0), np.float32(1.0), np.float32(0.0), np.float32(1.0), np.float32(0.0), np.float32(0.0), np.float32(1.0), np.float32(1.0), np.float32(1.0), np.float32(0.0), np.float32(1.0), np.float32(0.0), np.float32(1.0)]",3.0,99708.0,4
2025-08-14_08-18-36,6826,"[np.float32(0.0), np.float32(1.0), np.float32(1.0), np.float32(1.0), np.float32(1.0), np.float32(1.0), np.float32(0.0), np.float32(1.0), np.float32(1.0), np.float32(0.0), np.float32(0.0), np.float32(0.0), np.float32(0.0), np.float32(0.0), np.float32(1.0), np.float32(0.0)]",-1.0,99707.0,21
2025-08-14_08-18-36,6827,"[np.float32(0.0), np.float32(0.0), np.float32(0.0), np.float32(0.0), np.float32(1.0), np.float32(0.0), np.float32(0.0), np.float32(1.0), np.float32(1.0), np.float32(1.0), np.float32(1.0), np.float32(0.0), np.float32(0.0), np.float32(0.0), np.float32(1.0), np.float32(1.0)]",-2.0,99705.0,15
2025-08-14_08-18-36,6828,"[np.float32(1.0), np.float32(0.0), np.float32(0.0), np.float32(1.0), np.float32(1.0), np.float32(0.0), np.float32(0.0), np.float32(1.0), np.float32(1.0), np.float32(1.0), np.float32(1.0), np.float32(0.0), np.float32(0.0), np.float32(1.0), np.float32(0.0), np.float32(0.0)]",0.0,99705.0,2
2025-08-14_08-18-36,6829,"[np.float32(1.0), np.float32(0.0), np.float32(1.0), np.float32(1.0), np.float32(0.0), np.float32(0.0), np.float32(1.0), np.float32(0.0), np.float32(1.0), np.float32(0.0), np.float32(1.0), np.float32(0.0), np.float32(1.0), np.float32(0.0), np.float32(1.0), np.float32(0.0)]",-1.0,99704.0,25
2025-08-14_08-18-36,6830,"[np.float32(0.0), np.float32(0.0), np.float32(1.0), np.float32(1.0), np.float32(0.0), np.float32(1.0), np.float32(0.0), np.float32(1.0), np.float32(1.0), np.float32(1.0), np.float32(0.0), np.float32(0.0), np.float32(0.0), np.float32(0.0), np.float32(0.0), np.float32(0.0)]",1.0,99705.0,33
2025-08-14_08-18-36,6831,"[np.float32(1.0), np.float32(1.0), np.float32(0.0), np.float32(1.0), np.float32(0.0), np.float32(1.0), np.float32(1.0), np.float32(0.0), np.float32(1.0), np.float32(1.0), np.float32(1.0), np.float32(0.0), np.float32(1.0), np.float32(1.0), np.float32(0.0), np.float32(0.0)]",-3.0,99702.0,9
2025-08-14_08-18-36,6832,"[np.float32(0.0), np.float32(0.0), np.float32(1.0), np.float32(1.0), np.float32(0.0), np.float32(0.0), np.float32(0.0), np.float32(0.0), np.float32(1.0), np.float32(1.0), np.float32(0.0), np.float32(0.0), np.float32(1.0), np.float32(0.0), np.float32(0.0), np.float32(0.0)]",-3.0,99699.0,21
2025-08-14_08-18-36,6833,"[np.float32(0.0), np.float32(0.0), np.float32(1.0), np.float32(1.0), np.float32(0.0), np.float32(0.0), np.float32(1.0), np.float32(0.0), np.float32(1.0), np.float32(1.0), np.float32(1.0), np.float32(1.0), np.float32(1.0), np.float32(0.0), np.float32(1.0), np.float32(1.0)]",1.0,99700.0,36
2025-08-14_08-18-36,6834,"[np.float32(0.0), np.float32(0.0), np.float32(1.0), np.float32(0.0), np.float32(0.0), np.float32(1.0), np.float32(1.0), np.float32(1.0), np.float32(0.0), np.float32(1.0), np.float32(0.0), np.float32(0.0), np.float32(1.0), np.float32(1.0), np.float32(0.0), np.float32(0.0)]",-1.0,99699.0,15
2025-08-14_08-18-36,6835,"[np.float32(0.0), np.float32(0.0), np.float32(0.0), np.float32(0.0), np.float32(0.0), np.float32(1.0), np.float32(1.0), np.float32(1.0), np.float32(0.0), np.float32(1.0), np.float32(0.0), np.float32(1.0), np.float32(1.0), np.float32(1.0), np.float32(0.0), np.float32(0.0)]",1.0,99700.0,25
2025-08-14_08-18-36,6836,"[np.float32(0.0), np.float32(1.0), np.float32(1.0), np.float32(0.0), np.float32(0.0), np.float32(1.0), np.float32(0.0), np.float32(1.0), np.float32(0.0), np.float32(0.0), np.float32(0.0), np.float32(1.0), np.float32(0.0), np.float32(1.0), np.float32(0.0), np.float32(0.0)]",-3.0,99697.0,7
2025-08-14_08-18-36,6837,"[np.float32(1.0), np.float32(0.0), np.float32(1.0), np.float32(0.0), np.float32(1.0), np.float32(0.0), np.float32(0.0), np.float32(1.0), np.float32(1.0), np.float32(1.0), np.float32(1.0), np.float32(0.0), np.float32(1.0), np.float32(1.0), np.float32(0.0), np.float32(1.0)]",-3.0,99694.0,3
2025-08-14_08-18-36,6838,"[np.float32(1.0), np.float32(0.0), np.float32(1.0), np.float32(1.0), np.float32(1.0), np.float32(1.0), np.float32(1.0), np.float32(0.0), np.float32(1.0), np.float32(0.0), np.float32(0.0), np.float32(0.0), np.float32(0.0), np.float32(0.0), np.float32(0.0), np.float32(0.0)]",-3.0,99691.0,24
2025-08-14_08-18-36,6839,"[np.float32(0.0), np.float32(1.0), np.float32(1.0), np.float32(0.0), np.float32(1.0), np.float32(1.0), np.float32(1.0), np.float32(1.0), np.float32(1.0), np.float32(0.0), np.float32(0.0), np.float32(0.0), np.float32(1.0), np.float32(1.0), np.float32(0.0), np.float32(0.0)]",3.0,99694.0,2
2025-08-14_08-18-36,6840,"[np.float32(0.0), np.float32(1.0), np.float32(1.0), np.float32(1.0), np.float32(0.0), np.float32(0.0), np.float32(1.0), np.float32(1.0), np.float32(0.0), np.float32(0.0), np.float32(0.0), np.float32(0.0), np.float32(0.0), np.float32(1.0), np.float32(1.0), np.float32(1.0)]",0.0,99694.0,21
2025-08-14_08-18-36,6841,"[np.float32(1.0), np.float32(1.0), np.float32(0.0), np.float32(1.0), np.float32(0.0), np.float32(1.0), np.float32(0.0), np.float32(0.0), np.float32(1.0), np.float32(0.0), np.float32(0.0), np.float32(0.0), np.float32(0.0), np.float32(0.0), np.float32(0.0), np.float32(1.0)]",-2.0,99692.0,7
2025-08-14_08-18-36,6842,"[np.float32(1.0), np.float32(1.0), np.float32(0.0), np.float32(1.0), np.float32(1.0), np.float32(1.0), np.float32(0.0), np.float32(0.0), np.float32(1.0), np.float32(0.0), np.float32(1.0), np.float32(1.0), np.float32(0.0), np.float32(0.0), np.float32(0.0), np.float32(0.0)]",-1.0,99691.0,6
2025-08-14_08-18-36,6843,"[np.float32(1.0), np.float32(1.0), np.float32(0.0), np.float32(1.0), np.float32(1.0), np.float32(1.0), np.float32(1.0), np.float32(1.0), np.float32(0.0), np.float32(0.0), np.float32(1.0), np.float32(1.0), np.float32(1.0), np.float32(1.0), np.float32(0.0), np.float32(0.0)]",1.0,99692.0,23
2025-08-14_08-18-36,6844,"[np.float32(0.0), np.float32(1.0), np.float32(1.0), np.float32(1.0), np.float32(0.0), np.float32(1.0), np.float32(1.0), np.float32(1.0), np.float32(0.0), np.float32(1.0), np.float32(0.0), np.float32(1.0), np.float32(1.0), np.float32(0.0), np.float32(1.0), np.float32(1.0)]",4.0,99696.0,24
2025-08-14_08-18-36,6845,"[np.float32(1.0), np.float32(0.0), np.float32(1.0), np.float32(0.0), np.float32(0.0), np.float32(1.0), np.float32(1.0), np.float32(0.0), np.float32(1.0), np.float32(0.0), np.float32(0.0), np.float32(0.0), np.float32(0.0), np.float32(1.0), np.float32(1.0), np.float32(0.0)]",0.0,99696.0,24
2025-08-14_08-18-36,6846,"[np.float32(1.0), np.float32(0.0), np.float32(0.0), np.float32(0.0), np.float32(1.0), np.float32(1.0), np.float32(0.0), np.float32(1.0), np.float32(1.0), np.float32(0.0), np.float32(0.0), np.float32(0.0), np.float32(1.0), np.float32(0.0), np.float32(1.0), np.float32(0.0)]",3.0,99699.0,27
2025-08-14_08-18-36,6847,"[np.float32(0.0), np.float32(0.0), np.float32(1.0), np.float32(1.0), np.float32(0.0), np.float32(1.0), np.float32(1.0), np.float32(1.0), np.float32(1.0), np.float32(0.0), np.float32(0.0), np.float32(1.0), np.float32(1.0), np.float32(0.0), np.float32(0.0), np.float32(0.0)]",-3.0,99696.0,8
2025-08-14_08-18-36,6848,"[np.float32(1.0), np.float32(1.0), np.float32(0.0), np.float32(1.0), np.float32(1.0), np.float32(1.0), np.float32(0.0), np.float32(1.0), np.float32(0.0), np.float32(0.0), np.float32(1.0), np.float32(0.0), np.float32(1.0), np.float32(1.0), np.float32(1.0), np.float32(0.0)]",2.0,99698.0,35
2025-08-14_08-18-36,6849,"[np.float32(0.0), np.float32(0.0), np.float32(1.0), np.float32(1.0), np.float32(1.0), np.float32(0.0), np.float32(0.0), np.float32(1.0), np.float32(1.0), np.float32(1.0), np.float32(0.0), np.float32(0.0), np.float32(0.0), np.float32(0.0), np.float32(1.0), np.float32(1.0)]",0.0,99698.0,27
2025-08-14_08-18-36,6850,"[np.float32(1.0), np.float32(1.0), np.float32(1.0), np.float32(1.0), np.float32(1.0), np.float32(0.0), np.float32(0.0), np.float32(1.0), np.float32(1.0), np.float32(1.0), np.float32(0.0), np.float32(1.0), np.float32(1.0), np.float32(0.0), np.float32(1.0), np.float32(1.0)]",-3.0,99695.0,3
2025-08-14_08-18-36,6851,"[np.float32(1.0), np.float32(1.0), np.float32(0.0), np.float32(0.0), np.float32(1.0), np.float32(1.0), np.float32(1.0), np.float32(1.0), np.float32(1.0), np.float32(0.0), np.float32(0.0), np.float32(0.0), np.float32(0.0), np.float32(1.0), np.float32(1.0), np.float32(0.0)]",-2.0,99693.0,0
2025-08-14_08-18-36,6852,"[np.float32(1.0), np.float32(1.0), np.float32(0.0), np.float32(0.0), np.float32(0.0), np.float32(1.0), np.float32(1.0), np.float32(0.0), np.float32(1.0), np.float32(1.0), np.float32(0.0), np.float32(1.0), np.float32(1.0), np.float32(1.0), np.float32(0.0), np.float32(1.0)]",0.0,99693.0,29
2025-08-14_08-18-36,6853,"[np.float32(1.0), np.float32(0.0), np.float32(0.0), np.float32(1.0), np.float32(0.0), np.float32(0.0), np.float32(0.0), np.float32(0.0), np.float32(0.0), np.float32(0.0), np.float32(0.0), np.float32(1.0), np.float32(1.0), np.float32(0.0), np.float32(1.0), np.float32(0.0)]",0.0,99693.0,15
2025-08-14_08-18-36,6854,"[np.float32(1.0), np.float32(0.0), np.float32(1.0), np.float32(1.0), np.float32(0.0), np.float32(0.0), np.float32(0.0), np.float32(1.0), np.float32(0.0), np.float32(0.0), np.float32(0.0), np.float32(0.0), np.float32(1.0), np.float32(1.0), np.float32(0.0), np.float32(0.0)]",-4.0,99689.0,6
2025-08-14_08-18-36,6855,"[np.float32(1.0), np.float32(0.0), np.float32(0.0), np.float32(1.0), np.float32(0.0), np.float32(0.0), np.float32(0.0), np.float32(0.0), np.float32(1.0), np.float32(0.0), np.float32(0.0), np.float32(1.0), np.float32(1.0), np.float32(1.0), np.float32(0.0), np.float32(1.0)]",1.0,99690.0,34
2025-08-14_08-18-36,6856,"[np.float32(0.0), np.float32(1.0), np.float32(1.0), np.float32(0.0), np.float32(0.0), np.float32(0.0), np.float32(0.0), np.float32(0.0), np.float32(0.0), np.float32(1.0), np.float32(0.0), np.float32(1.0), np.float32(0.0), np.float32(0.0), np.float32(1.0), np.float32(0.0)]",5.0,99695.0,10
2025-08-14_08-18-36,6857,"[np.float32(0.0), np.float32(0.0), np.float32(0.0), np.float32(0.0), np.float32(0.0), np.float32(1.0), np.float32(0.0), np.float32(0.0), np.float32(0.0), np.float32(0.0), np.float32(0.0), np.float32(1.0), np.float32(1.0), np.float32(0.0), np.float32(1.0), np.float32(0.0)]",-1.0,99694.0,12
2025-08-14_08-18-36,6858,"[np.float32(0.0), np.float32(1.0), np.float32(1.0), np.float32(0.0), np.float32(0.0), np.float32(1.0), np.float32(1.0), np.float32(1.0), np.float32(0.0), np.float32(0.0), np.float32(0.0), np.float32(1.0), np.float32(1.0), np.float32(0.0), np.float32(0.0), np.float32(0.0)]",-3.0,99691.0,32
2025-08-14_08-18-36,6859,"[np.float32(1.0), np.float32(1.0), np.float32(1.0), np.float32(0.0), np.float32(0.0), np.float32(0.0), np.float32(1.0), np.float32(1.0), np.float32(0.0), np.float32(0.0), np.float32(1.0), np.float32(0.0), np.float32(1.0), np.float32(0.0), np.float32(0.0), np.float32(0.0)]",0.0,99691.0,32
2025-08-14_08-18-36,6860,"[np.float32(0.0), np.float32(0.0), np.float32(0.0), np.float32(0.0), np.float32(0.0), np.float32(0.0), np.float32(0.0), np.float32(1.0), np.float32(1.0), np.float32(0.0), np.float32(0.0), np.float32(1.0), np.float32(0.0), np.float32(0.0), np.float32(0.0), np.float32(0.0)]",0.0,99691.0,12
2025-08-14_08-18-36,6861,"[np.float32(1.0), np.float32(0.0), np.float32(0.0), np.float32(0.0), np.float32(0.0), np.float32(1.0), np.float32(0.0), np.float32(0.0), np.float32(0.0), np.float32(0.0), np.float32(1.0), np.float32(1.0), np.float32(0.0), np.float32(0.0), np.float32(0.0), np.float32(0.0)]",3.0,99694.0,23
2025-08-14_08-18-36,6862,"[np.float32(1.0), np.float32(1.0), np.float32(0.0), np.float32(0.0), np.float32(1.0), np.float32(1.0), np.float32(0.0), np.float32(1.0), np.float32(1.0), np.float32(1.0), np.float32(0.0), np.float32(0.0), np.float32(1.0), np.float32(1.0), np.float32(0.0), np.float32(0.0)]",1.0,99695.0,32
2025-08-14_08-18-36,6863,"[np.float32(1.0), np.float32(0.0), np.float32(0.0), np.float32(0.0), np.float32(0.0), np.float32(1.0), np.float32(1.0), np.float32(0.0), np.float32(1.0), np.float32(0.0), np.float32(1.0), np.float32(0.0), np.float32(1.0), np.float32(1.0), np.float32(1.0), np.float32(0.0)]",-1.0,99694.0,21
2025-08-14_08-18-36,6864,"[np.float32(1.0), np.float32(0.0), np.float32(1.0), np.float32(0.0), np.float32(1.0), np.float32(1.0), np.float32(0.0), np.float32(1.0), np.float32(0.0), np.float32(0.0), np.float32(1.0), np.float32(1.0), np.float32(0.0), np.float32(1.0), np.float32(0.0), np.float32(0.0)]",-3.0,99691.0,11
2025-08-14_08-18-36,6865,"[np.float32(1.0), np.float32(1.0), np.float32(1.0), np.float32(0.0), np.float32(0.0), np.float32(1.0), np.float32(1.0), np.float32(1.0), np.float32(0.0), np.float32(0.0), np.float32(0.0), np.float32(1.0), np.float32(0.0), np.float32(0.0), np.float32(0.0), np.float32(1.0)]",-2.0,99689.0,0
2025-08-14_08-18-36,6866,"[np.float32(0.0), np.float32(1.0), np.float32(1.0), np.float32(0.0), np.float32(1.0), np.float32(1.0), np.float32(1.0), np.float32(0.0), np.float32(0.0), np.float32(1.0), np.float32(0.0), np.float32(0.0), np.float32(1.0), np.float32(1.0), np.float32(1.0), np.float32(0.0)]",-2.0,99687.0,15
2025-08-14_08-18-36,6867,"[np.float32(1.0), np.float32(1.0), np.float32(0.0), np.float32(0.0), np.float32(0.0), np.float32(1.0), np.float32(1.0), np.float32(1.0), np.float32(0.0), np.float32(1.0), np.float32(0.0), np.float32(0.0), np.float32(1.0), np.float32(0.0), np.float32(0.0), np.float32(0.0)]",-3.0,99684.0,30
2025-08-14_08-18-36,6868,"[np.float32(1.0), np.float32(1.0), np.float32(0.0), np.float32(0.0), np.float32(0.0), np.float32(1.0), np.float32(0.0), np.float32(1.0), np.float32(0.0), np.float32(0.0), np.float32(0.0), np.float32(1.0), np.float32(0.0), np.float32(1.0), np.float32(1.0), np.float32(0.0)]",-2.0,99682.0,10
2025-08-14_08-18-36,6869,"[np.float32(0.0), np.float32(0.0), np.float32(1.0), np.float32(1.0), np.float32(0.0), np.float32(1.0), np.float32(1.0), np.float32(1.0), np.float32(0.0), np.float32(0.0), np.float32(1.0), np.float32(0.0), np.float32(0.0), np.float32(0.0), np.float32(1.0), np.float32(0.0)]",0.0,99682.0,22
2025-08-14_08-18-36,6870,"[np.float32(0.0), np.float32(1.0), np.float32(1.0), np.float32(1.0), np.float32(1.0), np.float32(1.0), np.float32(1.0), np.float32(0.0), np.float32(0.0), np.float32(0.0), np.float32(1.0), np.float32(0.0), np.float32(0.0), np.float32(1.0), np.float32(0.0), np.float32(0.0)]",-1.0,99681.0,23
2025-08-14_08-18-36,6871,"[np.float32(0.0), np.float32(0.0), np.float32(1.0), np.float32(0.0), np.float32(0.0), np.float32(0.0), np.float32(1.0), np.float32(1.0), np.float32(0.0), np.float32(0.0), np.float32(0.0), np.float32(0.0), np.float32(0.0), np.float32(1.0), np.float32(1.0), np.float32(0.0)]",-2.0,99679.0,1
2025-08-14_08-18-36,6872,"[np.float32(0.0), np.float32(1.0), np.float32(0.0), np.float32(0.0), np.float32(0.0), np.float32(1.0), np.float32(1.0), np.float32(0.0), np.float32(0.0), np.float32(1.0), np.float32(0.0), np.float32(0.0), np.float32(1.0), np.float32(1.0), np.float32(0.0), np.float32(0.0)]",-4.0,99675.0,27
2025-08-14_08-18-36,6873,"[np.float32(0.0), np.float32(0.0), np.float32(0.0), np.float32(0.0), np.float32(0.0), np.float32(0.0), np.float32(0.0), np.float32(0.0), np.float32(0.0), np.float32(0.0), np.float32(1.0), np.float32(1.0), np.float32(0.0), np.float32(1.0), np.float32(1.0), np.float32(0.0)]",2.0,99677.0,11
2025-08-14_08-18-36,6874,"[np.float32(1.0), np.float32(0.0), np.float32(0.0), np.float32(1.0), np.float32(1.0), np.float32(0.0), np.float32(0.0), np.float32(1.0), np.float32(1.0), np.float32(1.0), np.float32(1.0), np.float32(0.0), np.float32(1.0), np.float32(0.0), np.float32(0.0), np.float32(0.0)]",-2.0,99675.0,9
2025-08-14_08-18-36,6875,"[np.float32(0.0), np.float32(0.0), np.float32(0.0), np.float32(0.0), np.float32(1.0), np.float32(0.0), np.float32(1.0), np.float32(0.0), np.float32(0.0), np.float32(0.0), np.float32(0.0), np.float32(0.0), np.float32(1.0), np.float32(1.0), np.float32(0.0), np.float32(0.0)]",-4.0,99671.0,31
2025-08-14_08-18-36,6876,"[np.float32(0.0), np.float32(0.0), np.float32(1.0), np.float32(0.0), np.float32(1.0), np.float32(1.0), np.float32(1.0), np.float32(0.0), np.float32(0.0), np.float32(0.0), np.float32(0.0), np.float32(1.0), np.float32(1.0), np.float32(1.0), np.float32(0.0), np.float32(1.0)]",-4.0,99667.0,16
2025-08-14_08-18-36,6877,"[np.float32(0.0), np.float32(1.0), np.float32(0.0), np.float32(0.0), np.float32(1.0), np.float32(0.0), np.float32(0.0), np.float32(0.0), np.float32(1.0), np.float32(1.0), np.float32(1.0), np.float32(0.0), np.float32(0.0), np.float32(0.0), np.float32(1.0), np.float32(1.0)]",3.0,99670.0,10
2025-08-14_08-18-36,6878,"[np.float32(0.0), np.float32(1.0), np.float32(0.0), np.float32(1.0), np.float32(1.0), np.float32(1.0), np.float32(1.0), np.float32(1.0), np.float32(1.0), np.float32(1.0), np.float32(0.0), np.float32(1.0), np.float32(1.0), np.float32(0.0), np.float32(0.0), np.float32(0.0)]",0.0,99670.0,22
2025-08-14_08-18-36,6879,"[np.float32(1.0), np.float32(1.0), np.float32(0.0), np.float32(0.0), np.float32(0.0), np.float32(0.0), np.float32(0.0), np.float32(1.0), np.float32(1.0), np.float32(1.0), np.float32(0.0), np.float32(1.0), np.float32(1.0), np.float32(1.0), np.float32(0.0), np.float32(0.0)]",0.0,99670.0,36
2025-08-14_08-18-36,6880,"[np.float32(0.0), np.float32(0.0), np.float32(1.0), np.float32(0.0), np.float32(1.0), np.float32(1.0), np.float32(0.0), np.float32(1.0), np.float32(1.0), np.float32(0.0), np.float32(0.0), np.float32(0.0), np.float32(0.0), np.float32(0.0), np.float32(0.0), np.float32(1.0)]",1.0,99671.0,26
2025-08-14_08-18-36,6881,"[np.float32(1.0), np.float32(0.0), np.float32(1.0), np.float32(0.0), np.float32(1.0), np.float32(0.0), np.float32(0.0), np.float32(0.0), np.float32(1.0), np.float32(1.0), np.float32(0.0), np.float32(1.0), np.float32(1.0), np.float32(0.0), np.float32(0.0), np.float32(0.0)]",3.0,99674.0,36
2025-08-14_08-18-36,6882,"[np.float32(0.0), np.float32(0.0), np.float32(0.0), np.float32(0.0), np.float32(1.0), np.float32(0.0), np.float32(1.0), np.float32(1.0), np.float32(0.0), np.float32(0.0), np.float32(1.0), np.float32(0.0), np.float32(0.0), np.float32(0.0), np.float32(0.0), np.float32(1.0)]",-5.0,99669.0,30
2025-08-14_08-18-36,6883,"[np.float32(0.0), np.float32(0.0), np.float32(1.0), np.float32(1.0), np.float32(0.0), np.float32(1.0), np.float32(1.0), np.float32(1.0), np.float32(1.0), np.float32(0.0), np.float32(0.0), np.float32(1.0), np.float32(0.0), np.float32(0.0), np.float32(0.0), np.float32(0.0)]",0.0,99669.0,26
2025-08-14_08-18-36,6884,"[np.float32(1.0), np.float32(1.0), np.float32(0.0), np.float32(1.0), np.float32(1.0), np.float32(1.0), np.float32(1.0), np.float32(1.0), np.float32(0.0), np.float32(1.0), np.float32(0.0), np.float32(0.0), np.float32(0.0), np.float32(0.0), np.float32(0.0), np.float32(1.0)]",-5.0,99664.0,26
2025-08-14_08-18-36,6885,"[np.float32(1.0), np.float32(0.0), np.float32(1.0), np.float32(1.0), np.float32(1.0), np.float32(0.0), np.float32(1.0), np.float32(0.0), np.float32(0.0), np.float32(0.0), np.float32(0.0), np.float32(0.0), np.float32(0.0), np.float32(0.0), np.float32(0.0), np.float32(0.0)]",2.0,99666.0,2
2025-08-14_08-18-36,6886,"[np.float32(1.0), np.float32(0.0), np.float32(0.0), np.float32(1.0), np.float32(1.0), np.float32(1.0), np.float32(0.0), np.float32(1.0), np.float32(1.0), np.float32(1.0), np.float32(0.0), np.float32(0.0), np.float32(1.0), np.float32(1.0), np.float32(0.0), np.float32(1.0)]",-2.0,99664.0,26
2025-08-14_08-18-36,6887,"[np.float32(1.0), np.float32(1.0), np.float32(1.0), np.float32(1.0), np.float32(0.0), np.float32(0.0), np.float32(0.0), np.float32(0.0), np.float32(1.0), np.float32(0.0), np.float32(0.0), np.float32(1.0), np.float32(1.0), np.float32(0.0), np.float32(1.0), np.float32(0.0)]",-1.0,99663.0,34
2025-08-14_08-18-36,6888,"[np.float32(0.0), np.float32(1.0), np.float32(1.0), np.float32(0.0), np.float32(0.0), np.float32(0.0), np.float32(1.0), np.float32(1.0), np.float32(1.0), np.float32(0.0), np.float32(1.0), np.float32(0.0), np.float32(1.0), np.float32(0.0), np.float32(0.0), np.float32(0.0)]",-2.0,99661.0,18
2025-08-14_08-18-36,6889,"[np.float32(1.0), np.float32(0.0), np.float32(1.0), np.float32(0.0), np.float32(0.0), np.float32(1.0), np.float32(0.0), np.float32(1.0), np.float32(1.0), np.float32(1.0), np.float32(0.0), np.float32(0.0), np.float32(0.0), np.float32(1.0), np.float32(1.0), np.float32(0.0)]",5.0,99666.0,25
2025-08-14_08-18-36,6890,"[np.float32(1.0), np.float32(0.0), np.float32(0.0), np.float32(0.0), np.float32(0.0), np.float32(1.0), np.float32(1.0), np.float32(1.0), np.float32(1.0), np.float32(0.0), np.float32(1.0), np.float32(0.0), np.float32(1.0), np.float32(0.0), np.float32(1.0), np.float32(1.0)]",-6.0,99660.0,4
2025-08-14_08-18-36,6891,"[np.float32(0.0), np.float32(1.0), np.float32(0.0), np.float32(0.0), np.float32(1.0), np.float32(0.0), np.float32(1.0), np.float32(1.0), np.float32(1.0), np.float32(0.0), np.float32(0.0), np.float32(0.0), np.float32(0.0), np.float32(1.0), np.float32(0.0), np.float32(0.0)]",1.0,99661.0,13
2025-08-14_08-18-36,6892,"[np.float32(1.0), np.float32(0.0), np.float32(0.0), np.float32(0.0), np.float32(0.0), np.float32(0.0), np.float32(1.0), np.float32(1.0), np.float32(1.0), np.float32(1.0), np.float32(1.0), np.float32(0.0), np.float32(1.0), np.float32(1.0), np.float32(1.0), np.float32(1.0)]",-7.0,99654.0,0
2025-08-14_08-18-36,6893,"[np.float32(1.0), np.float32(1.0), np.float32(1.0), np.float32(1.0), np.float32(1.0), np.float32(1.0), np.float32(1.0), np.float32(0.0), np.float32(1.0), np.float32(0.0), np.float32(1.0), np.float32(1.0), np.float32(1.0), np.float32(0.0), np.float32(1.0), np.float32(0.0)]",-6.0,99648.0,22
2025-08-14_08-18-36,6894,"[np.float32(0.0), np.float32(0.0), np.float32(0.0), np.float32(0.0), np.float32(0.0), np.float32(0.0), np.float32(1.0), np.float32(0.0), np.float32(1.0), np.float32(1.0), np.float32(0.0), np.float32(0.0), np.float32(0.0), np.float32(0.0), np.float32(0.0), np.float32(1.0)]",-4.0,99644.0,0
2025-08-14_08-18-36,6895,"[np.float32(0.0), np.float32(0.0), np.float32(0.0), np.float32(0.0), np.float32(0.0), np.float32(1.0), np.float32(0.0), np.float32(1.0), np.float32(0.0), np.float32(1.0), np.float32(0.0), np.float32(0.0), np.float32(0.0), np.float32(0.0), np.float32(0.0), np.float32(0.0)]",-1.0,99643.0,33
2025-08-14_08-18-36,6896,"[np.float32(1.0), np.float32(0.0), np.float32(0.0), np.float32(1.0), np.float32(1.0), np.float32(1.0), np.float32(0.0), np.float32(1.0), np.float32(1.0), np.float32(1.0), np.float32(0.0), np.float32(1.0), np.float32(0.0), np.float32(1.0), np.float32(0.0), np.float32(1.0)]",5.0,99648.0,25
2025-08-14_08-18-36,6897,"[np.float32(0.0), np.float32(1.0), np.float32(1.0), np.float32(0.0), np.float32(0.0), np.float32(0.0), np.float32(1.0), np.float32(0.0), np.float32(1.0), np.float32(0.0), np.float32(0.0), np.float32(0.0), np.float32(0.0), np.float32(0.0), np.float32(0.0), np.float32(0.0)]",1.0,99649.0,34
2025-08-14_08-18-36,6898,"[np.float32(1.0), np.float32(1.0), np.float32(1.0), np.float32(0.0), np.float32(1.0), np.float32(0.0), np.float32(1.0), np.float32(1.0), np.float32(1.0), np.float32(0.0), np.float32(1.0), np.float32(1.0), np.float32(0.0), np.float32(0.0), np.float32(0.0), np.float32(0.0)]",-1.0,99648.0,27
2025-08-14_08-18-36,6899,"[np.float32(1.0), np.float32(0.0), np.float32(1.0), np.float32(0.0), np.float32(0.0), np.float32(0.0), np.float32(0.0), np.float32(0.0), np.float32(0.0), np.float32(1.0), np.float32(0.0), np.float32(0.0), np.float32(1.0), np.float32(0.0), np.float32(1.0), np.float32(0.0)]",-3.0,99645.0,20
2025-08-14_08-18-36,6900,"[np.float32(1.0), np.float32(1.0), np.float32(0.0), np.float32(1.0), np.float32(1.0), np.float32(0.0), np.float32(0.0), np.float32(1.0), np.float32(1.0), np.float32(0.0), np.float32(0.0), np.float32(0.0), np.float32(0.0), np.float32(0.0), np.float32(0.0), np.float32(0.0)]",3.0,99648.0,13
2025-08-14_08-18-36,6901,"[np.float32(0.0), np.float32(0.0), np.float32(1.0), np.float32(0.0), np.float32(0.0), np.float32(1.0), np.float32(0.0), np.float32(1.0), np.float32(1.0), np.float32(1.0), np.float32(0.0), np.float32(1.0), np.float32(1.0), np.float32(1.0), np.float32(1.0), np.float32(0.0)]",2.0,99650.0,33
2025-08-14_08-18-36,6902,"[np.float32(1.0), np.float32(0.0), np.float32(0.0), np.float32(0.0), np.float32(1.0), np.float32(0.0), np.float32(1.0), np.float32(1.0), np.float32(0.0), np.float32(1.0), np.float32(1.0), np.float32(0.0), np.float32(0.0), np.float32(0.0), np.float32(0.0), np.float32(1.0)]",3.0,99653.0,16
2025-08-14_08-18-36,6903,"[np.float32(1.0), np.float32(0.0), np.float32(1.0), np.float32(1.0), np.float32(1.0), np.float32(0.0), np.float32(1.0), np.float32(0.0), np.float32(1.0), np.float32(0.0), np.float32(0.0), np.float32(0.0), np.float32(1.0), np.float32(0.0), np.float32(1.0), np.float32(0.0)]",-2.0,99651.0,18
2025-08-14_08-18-36,6904,"[np.float32(0.0), np.float32(0.0), np.float32(1.0), np.float32(0.0), np.float32(1.0), np.float32(1.0), np.float32(0.0), np.float32(0.0), np.float32(0.0), np.float32(1.0), np.float32(1.0), np.float32(0.0), np.float32(1.0), np.float32(0.0), np.float32(0.0), np.float32(1.0)]",34.0,99685.0,7
2025-08-14_08-18-36,6905,"[np.float32(0.0), np.float32(1.0), np.float32(0.0), np.float32(0.0), np.float32(0.0), np.float32(1.0), np.float32(1.0), np.float32(0.0), np.float32(0.0), np.float32(0.0), np.float32(0.0), np.float32(0.0), np.float32(0.0), np.float32(0.0), np.float32(0.0), np.float32(1.0)]",0.0,99685.0,29
2025-08-14_08-18-36,6906,"[np.float32(1.0), np.float32(1.0), np.float32(1.0), np.float32(0.0), np.float32(0.0), np.float32(1.0), np.float32(0.0), np.float32(1.0), np.float32(0.0), np.float32(1.0), np.float32(1.0), np.float32(1.0), np.float32(1.0), np.float32(1.0), np.float32(0.0), np.float32(0.0)]",0.0,99685.0,35
2025-08-14_08-18-36,6907,"[np.float32(0.0), np.float32(0.0), np.float32(1.0), np.float32(0.0), np.float32(0.0), np.float32(1.0), np.float32(0.0), np.float32(0.0), np.float32(1.0), np.float32(0.0), np.float32(1.0), np.float32(0.0), np.float32(1.0), np.float32(1.0), np.float32(0.0), np.float32(0.0)]",-1.0,99684.0,23
2025-08-14_08-18-36,6908,"[np.float32(0.0), np.float32(1.0), np.float32(0.0), np.float32(0.0), np.float32(1.0), np.float32(0.0), np.float32(0.0), np.float32(0.0), np.float32(1.0), np.float32(1.0), np.float32(0.0), np.float32(0.0), np.float32(1.0), np.float32(0.0), np.float32(0.0), np.float32(0.0)]",2.0,99686.0,4
2025-08-14_08-18-36,6909,"[np.float32(0.0), np.float32(0.0), np.float32(0.0), np.float32(1.0), np.float32(0.0), np.float32(1.0), np.float32(0.0), np.float32(1.0), np.float32(1.0), np.float32(1.0), np.float32(0.0), np.float32(0.0), np.float32(0.0), np.float32(1.0), np.float32(0.0), np.float32(1.0)]",-2.0,99684.0,24
2025-08-14_08-18-36,6910,"[np.float32(1.0), np.float32(0.0), np.float32(1.0), np.float32(0.0), np.float32(0.0), np.float32(0.0), np.float32(0.0), np.float32(0.0), np.float32(0.0), np.float32(1.0), np.float32(1.0), np.float32(1.0), np.float32(1.0), np.float32(0.0), np.float32(0.0), np.float32(0.0)]",-3.0,99681.0,35
2025-08-14_08-18-36,6911,"[np.float32(1.0), np.float32(1.0), np.float32(0.0), np.float32(1.0), np.float32(1.0), np.float32(1.0), np.float32(1.0), np.float32(1.0), np.float32(0.0), np.float32(1.0), np.float32(0.0), np.float32(0.0), np.float32(1.0), np.float32(1.0), np.float32(0.0), np.float32(1.0)]",-2.0,99679.0,11
2025-08-14_08-18-36,6912,"[np.float32(0.0), np.float32(1.0), np.float32(1.0), np.float32(1.0), np.float32(1.0), np.float32(1.0), np.float32(1.0), np.float32(1.0), np.float32(0.0), np.float32(0.0), np.float32(0.0), np.float32(0.0), np.float32(0.0), np.float32(0.0), np.float32(1.0), np.float32(1.0)]",-5.0,99674.0,32
2025-08-14_08-18-36,6913,"[np.float32(0.0), np.float32(0.0), np.float32(1.0), np.float32(1.0), np.float32(0.0), np.float32(0.0), np.float32(1.0), np.float32(0.0), np.float32(0.0), np.float32(1.0), np.float32(0.0), np.float32(1.0), np.float32(1.0), np.float32(1.0), np.float32(1.0), np.float32(0.0)]",0.0,99674.0,9
2025-08-14_08-18-36,6914,"[np.float32(0.0), np.float32(1.0), np.float32(1.0), np.float32(1.0), np.float32(1.0), np.float32(0.0), np.float32(0.0), np.float32(1.0), np.float32(0.0), np.float32(0.0), np.float32(0.0), np.float32(0.0), np.float32(1.0), np.float32(0.0), np.float32(0.0), np.float32(1.0)]",5.0,99679.0,17
2025-08-14_08-18-36,6915,"[np.float32(1.0), np.float32(0.0), np.float32(0.0), np.float32(1.0), np.float32(0.0), np.float32(1.0), np.float32(0.0), np.float32(1.0), np.float32(0.0), np.float32(0.0), np.float32(0.0), np.float32(0.0), np.float32(1.0), np.float32(1.0), np.float32(0.0), np.float32(1.0)]",-4.0,99675.0,4
2025-08-14_08-18-36,6916,"[np.float32(0.0), np.float32(0.0), np.float32(0.0), np.float32(0.0), np.float32(1.0), np.float32(1.0), np.float32(0.0), np.float32(0.0), np.float32(1.0), np.float32(1.0), np.float32(1.0), np.float32(1.0), np.float32(0.0), np.float32(1.0), np.float32(1.0), np.float32(1.0)]",-1.0,99674.0,12
2025-08-14_08-18-36,6917,"[np.float32(1.0), np.float32(0.0), np.float32(1.0), np.float32(0.0), np.float32(0.0), np.float32(1.0), np.float32(0.0), np.float32(0.0), np.float32(1.0), np.float32(1.0), np.float32(1.0), np.float32(0.0), np.float32(0.0), np.float32(1.0), np.float32(0.0), np.float32(1.0)]",-3.0,99671.0,6
2025-08-14_08-18-36,6918,"[np.float32(0.0), np.float32(1.0), np.float32(0.0), np.float32(1.0), np.float32(0.0), np.float32(0.0), np.float32(0.0), np.float32(1.0), np.float32(1.0), np.float32(0.0), np.float32(0.0), np.float32(0.0), np.float32(1.0), np.float32(0.0), np.float32(0.0), np.float32(0.0)]",-3.0,99668.0,3
2025-08-14_08-18-36,6919,"[np.float32(0.0), np.float32(1.0), np.float32(0.0), np.float32(1.0), np.float32(1.0), np.float32(0.0), np.float32(0.0), np.float32(1.0), np.float32(0.0), np.float32(1.0), np.float32(0.0), np.float32(0.0), np.float32(0.0), np.float32(0.0), np.float32(0.0), np.float32(0.0)]",-1.0,99667.0,2
2025-08-14_08-18-36,6920,"[np.float32(0.0), np.float32(0.0), np.float32(1.0), np.float32(0.0), np.float32(1.0), np.float32(0.0), np.float32(0.0), np.float32(0.0), np.float32(0.0), np.float32(0.0), np.float32(0.0), np.float32(1.0), np.float32(1.0), np.float32(1.0), np.float32(1.0), np.float32(1.0)]",1.0,99668.0,36
2025-08-14_08-18-36,6921,"[np.float32(1.0), np.float32(0.0), np.float32(1.0), np.float32(1.0), np.float32(0.0), np.float32(0.0), np.float32(1.0), np.float32(1.0), np.float32(0.0), np.float32(1.0), np.float32(1.0), np.float32(1.0), np.float32(1.0), np.float32(1.0), np.float32(0.0), np.float32(0.0)]",-2.0,99666.0,24
2025-08-14_08-18-36,6922,"[np.float32(0.0), np.float32(0.0), np.float32(1.0), np.float32(0.0), np.float32(0.0), np.float32(1.0), np.float32(0.0), np.float32(1.0), np.float32(0.0), np.float32(1.0), np.float32(0.0), np.float32(1.0), np.float32(0.0), np.float32(1.0), np.float32(1.0), np.float32(0.0)]",-4.0,99662.0,17
2025-08-14_08-18-36,6923,"[np.float32(0.0), np.float32(0.0), np.float32(0.0), np.float32(0.0), np.float32(0.0), np.float32(0.0), np.float32(0.0), np.float32(1.0), np.float32(1.0), np.float32(0.0), np.float32(0.0), np.float32(1.0), np.float32(0.0), np.float32(0.0), np.float32(0.0), np.float32(0.0)]",-3.0,99659.0,2
2025-08-14_08-18-36,6924,"[np.float32(0.0), np.float32(0.0), np.float32(0.0), np.float32(0.0), np.float32(0.0), np.float32(1.0), np.float32(1.0), np.float32(1.0), np.float32(0.0), np.float32(0.0), np.float32(0.0), np.float32(0.0), np.float32(0.0), np.float32(0.0), np.float32(0.0), np.float32(0.0)]",-1.0,99658.0,33
2025-08-14_08-18-36,6925,"[np.float32(0.0), np.float32(0.0), np.float32(0.0), np.float32(1.0), np.float32(0.0), np.float32(0.0), np.float32(1.0), np.float32(1.0), np.float32(0.0), np.float32(0.0), np.float32(0.0), np.float32(0.0), np.float32(1.0), np.float32(1.0), np.float32(0.0), np.float32(0.0)]",-2.0,99656.0,26
2025-08-14_08-18-36,6926,"[np.float32(0.0), np.float32(1.0), np.float32(0.0), np.float32(1.0), np.float32(0.0), np.float32(1.0), np.float32(1.0), np.float32(1.0), np.float32(1.0), np.float32(1.0), np.float32(1.0), np.float32(0.0), np.float32(1.0), np.float32(0.0), np.float32(0.0), np.float32(0.0)]",-3.0,99653.0,14
2025-08-14_08-18-36,6927,"[np.float32(0.0), np.float32(0.0), np.float32(1.0), np.float32(1.0), np.float32(0.0), np.float32(0.0), np.float32(0.0), np.float32(1.0), np.float32(1.0), np.float32(1.0), np.float32(0.0), np.float32(0.0), np.float32(1.0), np.float32(1.0), np.float32(1.0), np.float32(0.0)]",3.0,99656.0,16
2025-08-14_08-18-36,6928,"[np.float32(1.0), np.float32(0.0), np.float32(1.0), np.float32(0.0), np.float32(0.0), np.float32(1.0), np.float32(1.0), np.float32(1.0), np.float32(1.0), np.float32(0.0), np.float32(0.0), np.float32(1.0), np.float32(1.0), np.float32(1.0), np.float32(0.0), np.float32(0.0)]",-1.0,99655.0,33
2025-08-14_08-18-36,6929,"[np.float32(1.0), np.float32(0.0), np.float32(1.0), np.float32(1.0), np.float32(0.0), np.float32(0.0), np.float32(0.0), np.float32(1.0), np.float32(1.0), np.float32(0.0), np.float32(0.0), np.float32(0.0), np.float32(1.0), np.float32(1.0), np.float32(0.0), np.float32(1.0)]",2.0,99657.0,25
2025-08-14_08-18-36,6930,"[np.float32(1.0), np.float32(1.0), np.float32(1.0), np.float32(1.0), np.float32(0.0), np.float32(0.0), np.float32(0.0), np.float32(1.0), np.float32(1.0), np.float32(1.0), np.float32(1.0), np.float32(1.0), np.float32(0.0), np.float32(1.0), np.float32(0.0), np.float32(1.0)]",2.0,99659.0,20
2025-08-14_08-18-36,6931,"[np.float32(0.0), np.float32(0.0), np.float32(0.0), np.float32(0.0), np.float32(0.0), np.float32(1.0), np.float32(0.0), np.float32(1.0), np.float32(1.0), np.float32(0.0), np.float32(0.0), np.float32(0.0), np.float32(0.0), np.float32(0.0), np.float32(1.0), np.float32(1.0)]",0.0,99659.0,19
2025-08-14_08-18-36,6932,"[np.float32(0.0), np.float32(0.0), np.float32(0.0), np.float32(0.0), np.float32(1.0), np.float32(1.0), np.float32(0.0), np.float32(1.0), np.float32(1.0), np.float32(1.0), np.float32(1.0), np.float32(1.0), np.float32(1.0), np.float32(0.0), np.float32(0.0), np.float32(1.0)]",-4.0,99655.0,8
2025-08-14_08-18-36,6933,"[np.float32(1.0), np.float32(1.0), np.float32(1.0), np.float32(0.0), np.float32(0.0), np.float32(0.0), np.float32(1.0), np.float32(0.0), np.float32(0.0), np.float32(0.0), np.float32(0.0), np.float32(1.0), np.float32(0.0), np.float32(0.0), np.float32(1.0), np.float32(0.0)]",-2.0,99653.0,0
2025-08-14_08-18-36,6934,"[np.float32(0.0), np.float32(1.0), np.float32(0.0), np.float32(1.0), np.float32(1.0), np.float32(1.0), np.float32(1.0), np.float32(1.0), np.float32(0.0), np.float32(0.0), np.float32(1.0), np.float32(0.0), np.float32(0.0), np.float32(0.0), np.float32(1.0), np.float32(0.0)]",-2.0,99651.0,31
2025-08-14_08-18-36,6935,"[np.float32(1.0), np.float32(0.0), np.float32(0.0), np.float32(0.0), np.float32(0.0), np.float32(1.0), np.float32(1.0), np.float32(1.0), np.float32(0.0), np.float32(1.0), np.float32(0.0), np.float32(0.0), np.float32(1.0), np.float32(1.0), np.float32(1.0), np.float32(1.0)]",-3.0,99648.0,2
2025-08-14_08-18-36,6936,"[np.float32(0.0), np.float32(1.0), np.float32(1.0), np.float32(0.0), np.float32(0.0), np.float32(1.0), np.float32(0.0), np.float32(0.0), np.float32(0.0), np.float32(0.0), np.float32(1.0), np.float32(0.0), np.float32(1.0), np.float32(0.0), np.float32(1.0), np.float32(0.0)]",-1.0,99647.0,27
2025-08-14_08-18-36,6937,"[np.float32(1.0), np.float32(1.0), np.float32(0.0), np.float32(1.0), np.float32(1.0), np.float32(0.0), np.float32(1.0), np.float32(1.0), np.float32(1.0), np.float32(1.0), np.float32(1.0), np.float32(0.0), np.float32(0.0), np.float32(1.0), np.float32(0.0), np.float32(0.0)]",-5.0,99642.0,30
2025-08-14_08-18-36,6938,"[np.float32(1.0), np.float32(1.0), np.float32(0.0), np.float32(0.0), np.float32(1.0), np.float32(1.0), np.float32(0.0), np.float32(1.0), np.float32(0.0), np.float32(0.0), np.float32(1.0), np.float32(1.0), np.float32(1.0), np.float32(1.0), np.float32(1.0), np.float32(0.0)]",0.0,99642.0,5
2025-08-14_08-18-36,6939,"[np.float32(0.0), np.float32(0.0), np.float32(0.0), np.float32(0.0), np.float32(1.0), np.float32(0.0), np.float32(0.0), np.float32(1.0), np.float32(0.0), np.float32(0.0), np.float32(0.0), np.float32(1.0), np.float32(0.0), np.float32(0.0), np.float32(0.0), np.float32(0.0)]",-3.0,99639.0,26
2025-08-14_08-18-36,6940,"[np.float32(1.0), np.float32(1.0), np.float32(1.0), np.float32(0.0), np.float32(0.0), np.float32(1.0), np.float32(1.0), np.float32(0.0), np.float32(0.0), np.float32(0.0), np.float32(0.0), np.float32(1.0), np.float32(0.0), np.float32(1.0), np.float32(0.0), np.float32(1.0)]",0.0,99639.0,1
2025-08-14_08-18-36,6941,"[np.float32(0.0), np.float32(1.0), np.float32(1.0), np.float32(0.0), np.float32(0.0), np.float32(1.0), np.float32(1.0), np.float32(0.0), np.float32(0.0), np.float32(0.0), np.float32(1.0), np.float32(1.0), np.float32(1.0), np.float32(1.0), np.float32(1.0), np.float32(1.0)]",-1.0,99638.0,3
2025-08-14_08-18-36,6942,"[np.float32(1.0), np.float32(1.0), np.float32(1.0), np.float32(1.0), np.float32(0.0), np.float32(0.0), np.float32(1.0), np.float32(1.0), np.float32(0.0), np.float32(0.0), np.float32(0.0), np.float32(1.0), np.float32(1.0), np.float32(1.0), np.float32(1.0), np.float32(0.0)]",0.0,99638.0,13
2025-08-14_08-18-36,6943,"[np.float32(1.0), np.float32(1.0), np.float32(0.0), np.float32(1.0), np.float32(0.0), np.float32(1.0), np.float32(1.0), np.float32(0.0), np.float32(0.0), np.float32(0.0), np.float32(0.0), np.float32(1.0), np.float32(1.0), np.float32(1.0), np.float32(0.0), np.float32(1.0)]",-2.0,99636.0,5
2025-08-14_08-18-36,6944,"[np.float32(0.0), np.float32(0.0), np.float32(1.0), np.float32(0.0), np.float32(1.0), np.float32(1.0), np.float32(1.0), np.float32(0.0), np.float32(0.0), np.float32(1.0), np.float32(0.0), np.float32(0.0), np.float32(1.0), np.float32(1.0), np.float32(0.0), np.float32(0.0)]",-2.0,99634.0,11
2025-08-14_08-18-36,6945,"[np.float32(0.0), np.float32(1.0), np.float32(1.0), np.float32(1.0), np.float32(1.0), np.float32(1.0), np.float32(1.0), np.float32(1.0), np.float32(1.0), np.float32(1.0), np.float32(1.0), np.float32(0.0), np.float32(0.0), np.float32(1.0), np.float32(1.0), np.float32(0.0)]",0.0,99634.0,24
2025-08-14_08-18-36,6946,"[np.float32(0.0), np.float32(0.0), np.float32(1.0), np.float32(0.0), np.float32(0.0), np.float32(0.0), np.float32(1.0), np.float32(0.0), np.float32(1.0), np.float32(1.0), np.float32(1.0), np.float32(1.0), np.float32(1.0), np.float32(1.0), np.float32(1.0), np.float32(1.0)]",1.0,99635.0,32
2025-08-14_08-18-36,6947,"[np.float32(1.0), np.float32(1.0), np.float32(1.0), np.float32(0.0), np.float32(0.0), np.float32(1.0), np.float32(0.0), np.float32(1.0), np.float32(1.0), np.float32(0.0), np.float32(0.0), np.float32(1.0), np.float32(1.0), np.float32(1.0), np.float32(1.0), np.float32(0.0)]",-3.0,99632.0,31
2025-08-14_08-18-36,6948,"[np.float32(0.0), np.float32(1.0), np.float32(0.0), np.float32(1.0), np.float32(0.0), np.float32(1.0), np.float32(0.0), np.float32(1.0), np.float32(0.0), np.float32(1.0), np.float32(1.0), np.float32(1.0), np.float32(1.0), np.float32(1.0), np.float32(1.0), np.float32(0.0)]",34.0,99666.0,7
2025-08-14_08-18-36,6949,"[np.float32(1.0), np.float32(1.0), np.float32(1.0), np.float32(0.0), np.float32(1.0), np.float32(0.0), np.float32(0.0), np.float32(1.0), np.float32(1.0), np.float32(1.0), np.float32(0.0), np.float32(0.0), np.float32(0.0), np.float32(0.0), np.float32(1.0), np.float32(0.0)]",2.0,99668.0,28
2025-08-14_08-18-36,6950,"[np.float32(1.0), np.float32(0.0), np.float32(1.0), np.float32(0.0), np.float32(0.0), np.float32(1.0), np.float32(0.0), np.float32(1.0), np.float32(1.0), np.float32(1.0), np.float32(1.0), np.float32(0.0), np.float32(1.0), np.float32(0.0), np.float32(0.0), np.float32(0.0)]",-5.0,99663.0,11
2025-08-14_08-18-36,6951,"[np.float32(0.0), np.float32(1.0), np.float32(1.0), np.float32(0.0), np.float32(0.0), np.float32(0.0), np.float32(1.0), np.float32(1.0), np.float32(1.0), np.float32(0.0), np.float32(0.0), np.float32(0.0), np.float32(1.0), np.float32(0.0), np.float32(0.0), np.float32(0.0)]",-3.0,99660.0,3
2025-08-14_08-18-36,6952,"[np.float32(1.0), np.float32(1.0), np.float32(1.0), np.float32(0.0), np.float32(1.0), np.float32(0.0), np.float32(1.0), np.float32(0.0), np.float32(1.0), np.float32(1.0), np.float32(0.0), np.float32(0.0), np.float32(0.0), np.float32(1.0), np.float32(1.0), np.float32(0.0)]",2.0,99662.0,25
2025-08-14_08-18-36,6953,"[np.float32(1.0), np.float32(1.0), np.float32(0.0), np.float32(0.0), np.float32(1.0), np.float32(0.0), np.float32(0.0), np.float32(0.0), np.float32(1.0), np.float32(1.0), np.float32(1.0), np.float32(0.0), np.float32(0.0), np.float32(1.0), np.float32(0.0), np.float32(1.0)]",-1.0,99661.0,10
2025-08-14_08-18-36,6954,"[np.float32(0.0), np.float32(1.0), np.float32(1.0), np.float32(1.0), np.float32(0.0), np.float32(1.0), np.float32(0.0), np.float32(1.0), np.float32(0.0), np.float32(0.0), np.float32(1.0), np.float32(1.0), np.float32(0.0), np.float32(1.0), np.float32(1.0), np.float32(0.0)]",1.0,99662.0,8
2025-08-14_08-18-36,6955,"[np.float32(0.0), np.float32(1.0), np.float32(1.0), np.float32(0.0), np.float32(1.0), np.float32(0.0), np.float32(0.0), np.float32(1.0), np.float32(0.0), np.float32(0.0), np.float32(0.0), np.float32(0.0), np.float32(1.0), np.float32(1.0), np.float32(1.0), np.float32(0.0)]",-5.0,99657.0,34
2025-08-14_08-18-36,6956,"[np.float32(0.0), np.float32(1.0), np.float32(1.0), np.float32(1.0), np.float32(1.0), np.float32(0.0), np.float32(0.0), np.float32(1.0), np.float32(0.0), np.float32(0.0), np.float32(0.0), np.float32(0.0), np.float32(0.0), np.float32(1.0), np.float32(1.0), np.float32(0.0)]",2.0,99659.0,10
2025-08-14_08-18-36,6957,"[np.float32(1.0), np.float32(1.0), np.float32(1.0), np.float32(0.0), np.float32(0.0), np.float32(1.0), np.float32(1.0), np.float32(0.0), np.float32(1.0), np.float32(0.0), np.float32(0.0), np.float32(1.0), np.float32(1.0), np.float32(1.0), np.float32(0.0), np.float32(0.0)]",1.0,99660.0,18
2025-08-14_08-18-36,6958,"[np.float32(1.0), np.float32(0.0), np.float32(0.0), np.float32(0.0), np.float32(1.0), np.float32(0.0), np.float32(0.0), np.float32(0.0), np.float32(0.0), np.float32(0.0), np.float32(0.0), np.float32(0.0), np.float32(0.0), np.float32(1.0), np.float32(0.0), np.float32(0.0)]",-1.0,99659.0,34
2025-08-14_08-18-36,6959,"[np.float32(0.0), np.float32(0.0), np.float32(0.0), np.float32(0.0), np.float32(0.0), np.float32(1.0), np.float32(1.0), np.float32(0.0), np.float32(0.0), np.float32(1.0), np.float32(1.0), np.float32(1.0), np.float32(0.0), np.float32(0.0), np.float32(0.0), np.float32(0.0)]",1.0,99660.0,7
2025-08-14_08-18-36,6960,"[np.float32(1.0), np.float32(1.0), np.float32(0.0), np.float32(0.0), np.float32(1.0), np.float32(0.0), np.float32(1.0), np.float32(1.0), np.float32(0.0), np.float32(1.0), np.float32(0.0), np.float32(0.0), np.float32(1.0), np.float32(0.0), np.float32(0.0), np.float32(0.0)]",0.0,99660.0,15
2025-08-14_08-18-36,6961,"[np.float32(1.0), np.float32(0.0), np.float32(0.0), np.float32(1.0), np.float32(0.0), np.float32(1.0), np.float32(1.0), np.float32(1.0), np.float32(1.0), np.float32(0.0), np.float32(0.0), np.float32(1.0), np.float32(0.0), np.float32(1.0), np.float32(0.0), np.float32(1.0)]",1.0,99661.0,29
2025-08-14_08-18-36,6962,"[np.float32(0.0), np.float32(1.0), np.float32(0.0), np.float32(0.0), np.float32(0.0), np.float32(1.0), np.float32(1.0), np.float32(1.0), np.float32(1.0), np.float32(1.0), np.float32(0.0), np.float32(1.0), np.float32(1.0), np.float32(1.0), np.float32(0.0), np.float32(1.0)]",-2.0,99659.0,10
2025-08-14_08-18-36,6963,"[np.float32(1.0), np.float32(1.0), np.float32(1.0), np.float32(0.0), np.float32(0.0), np.float32(0.0), np.float32(0.0), np.float32(0.0), np.float32(0.0), np.float32(0.0), np.float32(1.0), np.float32(1.0), np.float32(0.0), np.float32(0.0), np.float32(1.0), np.float32(1.0)]",0.0,99659.0,34
2025-08-14_08-18-36,6964,"[np.float32(1.0), np.float32(0.0), np.float32(1.0), np.float32(1.0), np.float32(1.0), np.float32(1.0), np.float32(1.0), np.float32(0.0), np.float32(0.0), np.float32(0.0), np.float32(1.0), np.float32(0.0), np.float32(0.0), np.float32(0.0), np.float32(0.0), np.float32(0.0)]",-1.0,99658.0,27
2025-08-14_08-18-36,6965,"[np.float32(0.0), np.float32(0.0), np.float32(1.0), np.float32(1.0), np.float32(0.0), np.float32(1.0), np.float32(0.0), np.float32(0.0), np.float32(1.0), np.float32(0.0), np.float32(0.0), np.float32(0.0), np.float32(0.0), np.float32(0.0), np.float32(0.0), np.float32(1.0)]",-3.0,99655.0,3
2025-08-14_08-18-36,6966,"[np.float32(0.0), np.float32(0.0), np.float32(0.0), np.float32(1.0), np.float32(1.0), np.float32(1.0), np.float32(1.0), np.float32(1.0), np.float32(0.0), np.float32(0.0), np.float32(0.0), np.float32(1.0), np.float32(1.0), np.float32(0.0), np.float32(0.0), np.float32(0.0)]",0.0,99655.0,33
2025-08-14_08-18-36,6967,"[np.float32(1.0), np.float32(1.0), np.float32(1.0), np.float32(0.0), np.float32(1.0), np.float32(0.0), np.float32(0.0), np.float32(0.0), np.float32(1.0), np.float32(0.0), np.float32(0.0), np.float32(1.0), np.float32(0.0), np.float32(1.0), np.float32(1.0), np.float32(0.0)]",3.0,99658.0,33
2025-08-14_08-18-36,6968,"[np.float32(0.0), np.float32(0.0), np.float32(1.0), np.float32(0.0), np.float32(0.0), np.float32(1.0), np.float32(1.0), np.float32(1.0), np.float32(1.0), np.float32(0.0), np.float32(0.0), np.float32(1.0), np.float32(1.0), np.float32(0.0), np.float32(1.0), np.float32(1.0)]",-2.0,99656.0,22
2025-08-14_08-18-36,6969,"[np.float32(0.0), np.float32(1.0), np.float32(1.0), np.float32(1.0), np.float32(1.0), np.float32(1.0), np.float32(1.0), np.float32(0.0), np.float32(0.0), np.float32(1.0), np.float32(1.0), np.float32(0.0), np.float32(1.0), np.float32(1.0), np.float32(1.0), np.float32(0.0)]",-1.0,99655.0,1
2025-08-14_08-18-36,6970,"[np.float32(0.0), np.float32(1.0), np.float32(0.0), np.float32(0.0), np.float32(0.0), np.float32(1.0), np.float32(0.0), np.float32(1.0), np.float32(0.0), np.float32(1.0), np.float32(1.0), np.float32(1.0), np.float32(0.0), np.float32(0.0), np.float32(0.0), np.float32(1.0)]",-2.0,99653.0,30
2025-08-14_08-18-36,6971,"[np.float32(1.0), np.float32(0.0), np.float32(1.0), np.float32(0.0), np.float32(0.0), np.float32(1.0), np.float32(0.0), np.float32(1.0), np.float32(1.0), np.float32(1.0), np.float32(1.0), np.float32(1.0), np.float32(0.0), np.float32(0.0), np.float32(0.0), np.float32(1.0)]",-4.0,99649.0,8
2025-08-14_08-18-36,6972,"[np.float32(1.0), np.float32(0.0), np.float32(0.0), np.float32(1.0), np.float32(1.0), np.float32(1.0), np.float32(0.0), np.float32(1.0), np.float32(1.0), np.float32(1.0), np.float32(1.0), np.float32(0.0), np.float32(1.0), np.float32(1.0), np.float32(0.0), np.float32(0.0)]",0.0,99649.0,14
2025-08-14_08-18-36,6973,"[np.float32(1.0), np.float32(1.0), np.float32(1.0), np.float32(1.0), np.float32(1.0), np.float32(1.0), np.float32(1.0), np.float32(1.0), np.float32(1.0), np.float32(0.0), np.float32(1.0), np.float32(1.0), np.float32(1.0), np.float32(1.0), np.float32(0.0), np.float32(1.0)]",-2.0,99647.0,19
2025-08-14_08-18-36,6974,"[np.float32(0.0), np.float32(1.0), np.float32(1.0), np.float32(0.0), np.float32(1.0), np.float32(0.0), np.float32(1.0), np.float32(0.0), np.float32(1.0), np.float32(1.0), np.float32(1.0), np.float32(0.0), np.float32(1.0), np.float32(0.0), np.float32(1.0), np.float32(1.0)]",1.0,99648.0,31
2025-08-14_08-18-36,6975,"[np.float32(0.0), np.float32(0.0), np.float32(1.0), np.float32(1.0), np.float32(0.0), np.float32(1.0), np.float32(1.0), np.float32(0.0), np.float32(0.0), np.float32(1.0), np.float32(1.0), np.float32(0.0), np.float32(1.0), np.float32(1.0), np.float32(1.0), np.float32(0.0)]",1.0,99649.0,35
2025-08-14_08-18-36,6976,"[np.float32(1.0), np.float32(0.0), np.float32(0.0), np.float32(1.0), np.float32(1.0), np.float32(0.0), np.float32(1.0), np.float32(0.0), np.float32(0.0), np.float32(1.0), np.float32(0.0), np.float32(0.0), np.float32(1.0), np.float32(0.0), np.float32(0.0), np.float32(1.0)]",-5.0,99644.0,29
2025-08-14_08-18-36,6977,"[np.float32(1.0), np.float32(0.0), np.float32(1.0), np.float32(1.0), np.float32(1.0), np.float32(1.0), np.float32(1.0), np.float32(1.0), np.float32(1.0), np.float32(0.0), np.float32(1.0), np.float32(1.0), np.float32(1.0), np.float32(0.0), np.float32(0.0), np.float32(1.0)]",1.0,99645.0,17
2025-08-14_08-18-36,6978,"[np.float32(1.0), np.float32(1.0), np.float32(0.0), np.float32(0.0), np.float32(0.0), np.float32(1.0), np.float32(1.0), np.float32(0.0), np.float32(0.0), np.float32(0.0), np.float32(0.0), np.float32(0.0), np.float32(1.0), np.float32(1.0), np.float32(0.0), np.float32(1.0)]",0.0,99645.0,0
2025-08-14_08-18-36,6979,"[np.float32(1.0), np.float32(1.0), np.float32(1.0), np.float32(1.0), np.float32(1.0), np.float32(0.0), np.float32(0.0), np.float32(0.0), np.float32(1.0), np.float32(1.0), np.float32(1.0), np.float32(1.0), np.float32(1.0), np.float32(0.0), np.float32(0.0), np.float32(0.0)]",0.0,99645.0,36
2025-08-14_08-18-36,6980,"[np.float32(0.0), np.float32(0.0), np.float32(1.0), np.float32(1.0), np.float32(0.0), np.float32(1.0), np.float32(0.0), np.float32(1.0), np.float32(0.0), np.float32(1.0), np.float32(0.0), np.float32(0.0), np.float32(1.0), np.float32(0.0), np.float32(0.0), np.float32(0.0)]",-4.0,99641.0,12
2025-08-14_08-18-36,6981,"[np.float32(0.0), np.float32(1.0), np.float32(0.0), np.float32(0.0), np.float32(0.0), np.float32(0.0), np.float32(0.0), np.float32(1.0), np.float32(1.0), np.float32(1.0), np.float32(1.0), np.float32(1.0), np.float32(1.0), np.float32(1.0), np.float32(0.0), np.float32(0.0)]",0.0,99641.0,17
2025-08-14_08-18-36,6982,"[np.float32(1.0), np.float32(1.0), np.float32(0.0), np.float32(0.0), np.float32(0.0), np.float32(1.0), np.float32(1.0), np.float32(1.0), np.float32(0.0), np.float32(0.0), np.float32(0.0), np.float32(0.0), np.float32(1.0), np.float32(1.0), np.float32(0.0), np.float32(0.0)]",-3.0,99638.0,36
2025-08-14_08-18-36,6983,"[np.float32(0.0), np.float32(1.0), np.float32(0.0), np.float32(1.0), np.float32(0.0), np.float32(1.0), np.float32(1.0), np.float32(1.0), np.float32(1.0), np.float32(1.0), np.float32(0.0), np.float32(0.0), np.float32(1.0), np.float32(0.0), np.float32(1.0), np.float32(0.0)]",-1.0,99637.0,4
2025-08-14_08-18-36,6984,"[np.float32(1.0), np.float32(1.0), np.float32(1.0), np.float32(1.0), np.float32(1.0), np.float32(1.0), np.float32(1.0), np.float32(1.0), np.float32(0.0), np.float32(0.0), np.float32(1.0), np.float32(1.0), np.float32(0.0), np.float32(1.0), np.float32(0.0), np.float32(0.0)]",-2.0,99635.0,36
2025-08-14_08-18-36,6985,"[np.float32(1.0), np.float32(1.0), np.float32(1.0), np.float32(1.0), np.float32(0.0), np.float32(1.0), np.float32(1.0), np.float32(1.0), np.float32(1.0), np.float32(0.0), np.float32(0.0), np.float32(0.0), np.float32(0.0), np.float32(1.0), np.float32(0.0), np.float32(0.0)]",1.0,99636.0,12
2025-08-14_08-18-36,6986,"[np.float32(0.0), np.float32(0.0), np.float32(1.0), np.float32(0.0), np.float32(0.0), np.float32(1.0), np.float32(1.0), np.float32(1.0), np.float32(0.0), np.float32(0.0), np.float32(0.0), np.float32(0.0), np.float32(1.0), np.float32(0.0), np.float32(0.0), np.float32(1.0)]",-4.0,99632.0,29
2025-08-14_08-18-36,6987,"[np.float32(1.0), np.float32(1.0), np.float32(0.0), np.float32(1.0), np.float32(0.0), np.float32(0.0), np.float32(0.0), np.float32(1.0), np.float32(0.0), np.float32(0.0), np.float32(1.0), np.float32(1.0), np.float32(0.0), np.float32(1.0), np.float32(1.0), np.float32(1.0)]",-1.0,99631.0,36
2025-08-14_08-18-36,6988,"[np.float32(0.0), np.float32(1.0), np.float32(0.0), np.float32(0.0), np.float32(1.0), np.float32(1.0), np.float32(1.0), np.float32(1.0), np.float32(1.0), np.float32(0.0), np.float32(1.0), np.float32(1.0), np.float32(1.0), np.float32(1.0), np.float32(0.0), np.float32(0.0)]",0.0,99631.0,11
2025-08-14_08-18-36,6989,"[np.float32(0.0), np.float32(0.0), np.float32(1.0), np.float32(0.0), np.float32(0.0), np.float32(0.0), np.float32(1.0), np.float32(1.0), np.float32(1.0), np.float32(1.0), np.float32(0.0), np.float32(1.0), np.float32(1.0), np.float32(0.0), np.float32(0.0), np.float32(1.0)]",-3.0,99628.0,2
2025-08-14_08-18-36,6990,"[np.float32(1.0), np.float32(1.0), np.float32(1.0), np.float32(1.0), np.float32(1.0), np.float32(0.0), np.float32(0.0), np.float32(0.0), np.float32(1.0), np.float32(0.0), np.float32(1.0), np.float32(1.0), np.float32(1.0), np.float32(1.0), np.float32(0.0), np.float32(1.0)]",-1.0,99627.0,31
2025-08-14_08-18-36,6991,"[np.float32(1.0), np.float32(1.0), np.float32(1.0), np.float32(0.0), np.float32(0.0), np.float32(0.0), np.float32(0.0), np.float32(0.0), np.float32(1.0), np.float32(0.0), np.float32(0.0), np.float32(0.0), np.float32(0.0), np.float32(1.0), np.float32(0.0), np.float32(0.0)]",-1.0,99626.0,6
2025-08-14_08-18-36,6992,"[np.float32(0.0), np.float32(1.0), np.float32(0.0), np.float32(0.0), np.float32(1.0), np.float32(1.0), np.float32(0.0), np.float32(0.0), np.float32(0.0), np.float32(1.0), np.float32(0.0), np.float32(0.0), np.float32(0.0), np.float32(1.0), np.float32(0.0), np.float32(1.0)]",-4.0,99622.0,23
2025-08-14_08-18-36,6993,"[np.float32(0.0), np.float32(1.0), np.float32(1.0), np.float32(0.0), np.float32(0.0), np.float32(0.0), np.float32(1.0), np.float32(1.0), np.float32(0.0), np.float32(0.0), np.float32(1.0), np.float32(0.0), np.float32(0.0), np.float32(0.0), np.float32(0.0), np.float32(0.0)]",-2.0,99620.0,21
2025-08-14_08-18-36,6994,"[np.float32(1.0), np.float32(1.0), np.float32(1.0), np.float32(0.0), np.float32(1.0), np.float32(0.0), np.float32(0.0), np.float32(1.0), np.float32(1.0), np.float32(0.0), np.float32(0.0), np.float32(0.0), np.float32(1.0), np.float32(1.0), np.float32(0.0), np.float32(1.0)]",-4.0,99616.0,27
2025-08-14_08-18-36,6995,"[np.float32(1.0), np.float32(0.0), np.float32(1.0), np.float32(0.0), np.float32(1.0), np.float32(0.0), np.float32(1.0), np.float32(1.0), np.float32(1.0), np.float32(1.0), np.float32(1.0), np.float32(0.0), np.float32(0.0), np.float32(0.0), np.float32(0.0), np.float32(1.0)]",1.0,99617.0,2
2025-08-14_08-18-36,6996,"[np.float32(1.0), np.float32(0.0), np.float32(0.0), np.float32(0.0), np.float32(1.0), np.float32(1.0), np.float32(1.0), np.float32(0.0), np.float32(0.0), np.float32(0.0), np.float32(0.0), np.float32(0.0), np.float32(1.0), np.float32(1.0), np.float32(0.0), np.float32(1.0)]",-2.0,99615.0,8
2025-08-14_08-18-36,6997,"[np.float32(1.0), np.float32(0.0), np.float32(1.0), np.float32(0.0), np.float32(1.0), np.float32(1.0), np.float32(1.0), np.float32(1.0), np.float32(1.0), np.float32(1.0), np.float32(1.0), np.float32(0.0), np.float32(1.0), np.float32(0.0), np.float32(0.0), np.float32(0.0)]",-3.0,99612.0,9
2025-08-14_08-18-36,6998,"[np.float32(0.0), np.float32(0.0), np.float32(1.0), np.float32(1.0), np.float32(1.0), np.float32(1.0), np.float32(1.0), np.float32(1.0), np.float32(0.0), np.float32(0.0), np.float32(0.0), np.float32(0.0), np.float32(0.0), np.float32(0.0), np.float32(1.0), np.float32(0.0)]",0.0,99612.0,2
2025-08-14_08-18-36,6999,"[np.float32(0.0), np.float32(0.0), np.float32(0.0), np.float32(1.0), np.float32(0.0), np.float32(0.0), np.float32(0.0), np.float32(1.0), np.float32(1.0), np.float32(0.0), np.float32(0.0), np.float32(0.0), np.float32(0.0), np.float32(0.0), np.float32(1.0), np.float32(0.0)]",1.0,99613.0,15
2025-08-14_08-18-36,7000,"[np.float32(0.0), np.float32(0.0), np.float32(1.0), np.float32(0.0), np.float32(1.0), np.float32(1.0), np.float32(0.0), np.float32(1.0), np.float32(1.0), np.float32(1.0), np.float32(0.0), np.float32(1.0), np.float32(1.0), np.float32(0.0), np.float32(0.0), np.float32(1.0)]",1.0,99614.0,24
2025-08-14_08-18-36,7001,"[np.float32(1.0), np.float32(1.0), np.float32(1.0), np.float32(1.0), np.float32(1.0), np.float32(1.0), np.float32(1.0), np.float32(1.0), np.float32(1.0), np.float32(1.0), np.float32(0.0), np.float32(1.0), np.float32(0.0), np.float32(0.0), np.float32(1.0), np.float32(0.0)]",0.0,99754.0,11
2025-08-14_08-18-36,7002,"[np.float32(0.0), np.float32(1.0), np.float32(1.0), np.float32(1.0), np.float32(0.0), np.float32(1.0), np.float32(0.0), np.float32(1.0), np.float32(1.0), np.float32(0.0), np.float32(1.0), np.float32(0.0), np.float32(1.0), np.float32(0.0), np.float32(1.0), np.float32(0.0)]",-2.0,99752.0,34
2025-08-14_08-18-36,7003,"[np.float32(0.0), np.float32(0.0), np.float32(1.0), np.float32(0.0), np.float32(0.0), np.float32(1.0), np.float32(0.0), np.float32(1.0), np.float32(0.0), np.float32(1.0), np.float32(1.0), np.float32(1.0), np.float32(1.0), np.float32(0.0), np.float32(1.0), np.float32(1.0)]",-1.0,99751.0,6
2025-08-14_08-18-36,7004,"[np.float32(0.0), np.float32(1.0), np.float32(1.0), np.float32(0.0), np.float32(0.0), np.float32(0.0), np.float32(1.0), np.float32(1.0), np.float32(1.0), np.float32(0.0), np.float32(0.0), np.float32(1.0), np.float32(1.0), np.float32(1.0), np.float32(0.0), np.float32(0.0)]",2.0,99753.0,28
2025-08-14_08-18-36,7005,"[np.float32(0.0), np.float32(0.0), np.float32(0.0), np.float32(1.0), np.float32(0.0), np.float32(0.0), np.float32(0.0), np.float32(1.0), np.float32(0.0), np.float32(1.0), np.float32(0.0), np.float32(1.0), np.float32(1.0), np.float32(0.0), np.float32(0.0), np.float32(0.0)]",0.0,99753.0,25
2025-08-14_08-18-36,7006,"[np.float32(1.0), np.float32(0.0), np.float32(0.0), np.float32(1.0), np.float32(0.0), np.float32(1.0), np.float32(0.0), np.float32(0.0), np.float32(1.0), np.float32(0.0), np.float32(0.0), np.float32(1.0), np.float32(0.0), np.float32(0.0), np.float32(1.0), np.float32(0.0)]",1.0,99754.0,35
2025-08-14_08-18-36,7007,"[np.float32(0.0), np.float32(0.0), np.float32(0.0), np.float32(0.0), np.float32(0.0), np.float32(0.0), np.float32(0.0), np.float32(0.0), np.float32(0.0), np.float32(1.0), np.float32(0.0), np.float32(0.0), np.float32(1.0), np.float32(0.0), np.float32(0.0), np.float32(0.0)]",-2.0,99752.0,36
2025-08-14_08-18-36,7008,"[np.float32(1.0), np.float32(1.0), np.float32(1.0), np.float32(1.0), np.float32(0.0), np.float32(1.0), np.float32(1.0), np.float32(1.0), np.float32(0.0), np.float32(0.0), np.float32(1.0), np.float32(1.0), np.float32(1.0), np.float32(0.0), np.float32(1.0), np.float32(0.0)]",-2.0,99750.0,29
2025-08-14_08-18-36,7009,"[np.float32(1.0), np.float32(1.0), np.float32(0.0), np.float32(1.0), np.float32(0.0), np.float32(1.0), np.float32(0.0), np.float32(1.0), np.float32(0.0), np.float32(1.0), np.float32(1.0), np.float32(0.0), np.float32(0.0), np.float32(0.0), np.float32(1.0), np.float32(0.0)]",-1.0,99749.0,26
2025-08-14_08-18-36,7010,"[np.float32(0.0), np.float32(0.0), np.float32(1.0), np.float32(1.0), np.float32(0.0), np.float32(0.0), np.float32(1.0), np.float32(0.0), np.float32(1.0), np.float32(1.0), np.float32(0.0), np.float32(1.0), np.float32(1.0), np.float32(0.0), np.float32(1.0), np.float32(0.0)]",-3.0,99746.0,35
2025-08-14_08-18-36,7011,"[np.float32(1.0), np.float32(0.0), np.float32(1.0), np.float32(1.0), np.float32(1.0), np.float32(1.0), np.float32(0.0), np.float32(0.0), np.float32(0.0), np.float32(1.0), np.float32(1.0), np.float32(0.0), np.float32(0.0), np.float32(0.0), np.float32(1.0), np.float32(0.0)]",-2.0,99744.0,3
2025-08-14_08-18-36,7012,"[np.float32(0.0), np.float32(0.0), np.float32(1.0), np.float32(1.0), np.float32(1.0), np.float32(1.0), np.float32(1.0), np.float32(1.0), np.float32(1.0), np.float32(1.0), np.float32(0.0), np.float32(0.0), np.float32(0.0), np.float32(0.0), np.float32(0.0), np.float32(1.0)]",1.0,99745.0,6
2025-08-14_08-18-36,7013,"[np.float32(0.0), np.float32(1.0), np.float32(1.0), np.float32(0.0), np.float32(1.0), np.float32(1.0), np.float32(0.0), np.float32(0.0), np.float32(1.0), np.float32(0.0), np.float32(1.0), np.float32(1.0), np.float32(1.0), np.float32(1.0), np.float32(0.0), np.float32(0.0)]",-5.0,99740.0,16
2025-08-14_08-18-36,7014,"[np.float32(0.0), np.float32(1.0), np.float32(0.0), np.float32(0.0), np.float32(0.0), np.float32(1.0), np.float32(0.0), np.float32(0.0), np.float32(0.0), np.float32(1.0), np.float32(0.0), np.float32(0.0), np.float32(0.0), np.float32(0.0), np.float32(0.0), np.float32(0.0)]",4.0,99744.0,22
2025-08-14_08-18-36,7015,"[np.float32(0.0), np.float32(0.0), np.float32(0.0), np.float32(1.0), np.float32(1.0), np.float32(0.0), np.float32(0.0), np.float32(1.0), np.float32(1.0), np.float32(0.0), np.float32(0.0), np.float32(1.0), np.float32(1.0), np.float32(1.0), np.float32(0.0), np.float32(1.0)]",-3.0,99741.0,16
2025-08-14_08-18-36,7016,"[np.float32(1.0), np.float32(1.0), np.float32(1.0), np.float32(1.0), np.float32(1.0), np.float32(1.0), np.float32(0.0), np.float32(1.0), np.float32(1.0), np.float32(1.0), np.float32(0.0), np.float32(1.0), np.float32(0.0), np.float32(1.0), np.float32(0.0), np.float32(0.0)]",-5.0,99736.0,5
2025-08-14_08-18-36,7017,"[np.float32(0.0), np.float32(1.0), np.float32(1.0), np.float32(0.0), np.float32(1.0), np.float32(1.0), np.float32(0.0), np.float32(0.0), np.float32(0.0), np.float32(0.0), np.float32(0.0), np.float32(1.0), np.float32(0.0), np.float32(0.0), np.float32(0.0), np.float32(0.0)]",0.0,99736.0,3
2025-08-14_08-18-36,7018,"[np.float32(1.0), np.float32(0.0), np.float32(0.0), np.float32(1.0), np.float32(1.0), np.float32(0.0), np.float32(0.0), np.float32(0.0), np.float32(0.0), np.float32(0.0), np.float32(1.0), np.float32(0.0), np.float32(1.0), np.float32(1.0), np.float32(0.0), np.float32(0.0)]",2.0,99738.0,35
2025-08-14_08-18-36,7019,"[np.float32(0.0), np.float32(1.0), np.float32(1.0), np.float32(1.0), np.float32(0.0), np.float32(1.0), np.float32(1.0), np.float32(0.0), np.float32(0.0), np.float32(0.0), np.float32(1.0), np.float32(0.0), np.float32(1.0), np.float32(0.0), np.float32(0.0), np.float32(0.0)]",-5.0,99733.0,18
2025-08-14_08-18-36,7020,"[np.float32(0.0), np.float32(0.0), np.float32(0.0), np.float32(0.0), np.float32(1.0), np.float32(0.0), np.float32(1.0), np.float32(1.0), np.float32(0.0), np.float32(0.0), np.float32(1.0), np.float32(0.0), np.float32(0.0), np.float32(1.0), np.float32(0.0), np.float32(1.0)]",-6.0,99727.0,30
2025-08-14_08-18-36,7021,"[np.float32(0.0), np.float32(1.0), np.float32(1.0), np.float32(1.0), np.float32(0.0), np.float32(0.0), np.float32(1.0), np.float32(0.0), np.float32(0.0), np.float32(1.0), np.float32(1.0), np.float32(0.0), np.float32(0.0), np.float32(1.0), np.float32(1.0), np.float32(1.0)]",1.0,99728.0,31
2025-08-14_08-18-36,7022,"[np.float32(0.0), np.float32(1.0), np.float32(1.0), np.float32(0.0), np.float32(0.0), np.float32(1.0), np.float32(1.0), np.float32(1.0), np.float32(0.0), np.float32(1.0), np.float32(0.0), np.float32(0.0), np.float32(0.0), np.float32(0.0), np.float32(0.0), np.float32(0.0)]",1.0,99729.0,6
2025-08-14_08-18-36,7023,"[np.float32(0.0), np.float32(0.0), np.float32(0.0), np.float32(1.0), np.float32(0.0), np.float32(0.0), np.float32(0.0), np.float32(1.0), np.float32(0.0), np.float32(1.0), np.float32(1.0), np.float32(0.0), np.float32(1.0), np.float32(1.0), np.float32(1.0), np.float32(0.0)]",-4.0,99725.0,34
2025-08-14_08-18-36,7024,"[np.float32(0.0), np.float32(1.0), np.float32(1.0), np.float32(1.0), np.float32(1.0), np.float32(0.0), np.float32(0.0), np.float32(0.0), np.float32(0.0), np.float32(1.0), np.float32(1.0), np.float32(1.0), np.float32(0.0), np.float32(0.0), np.float32(1.0), np.float32(0.0)]",-1.0,99724.0,9
2025-08-14_08-18-36,7025,"[np.float32(1.0), np.float32(0.0), np.float32(0.0), np.float32(0.0), np.float32(1.0), np.float32(1.0), np.float32(1.0), np.float32(1.0), np.float32(1.0), np.float32(1.0), np.float32(1.0), np.float32(1.0), np.float32(1.0), np.float32(0.0), np.float32(0.0), np.float32(1.0)]",-9.0,99715.0,0
2025-08-14_08-18-36,7026,"[np.float32(0.0), np.float32(1.0), np.float32(1.0), np.float32(0.0), np.float32(0.0), np.float32(1.0), np.float32(1.0), np.float32(1.0), np.float32(0.0), np.float32(0.0), np.float32(1.0), np.float32(0.0), np.float32(1.0), np.float32(0.0), np.float32(0.0), np.float32(0.0)]",-4.0,99711.0,3
2025-08-14_08-18-36,7027,"[np.float32(1.0), np.float32(1.0), np.float32(1.0), np.float32(1.0), np.float32(0.0), np.float32(1.0), np.float32(1.0), np.float32(1.0), np.float32(1.0), np.float32(0.0), np.float32(0.0), np.float32(0.0), np.float32(1.0), np.float32(0.0), np.float32(1.0), np.float32(1.0)]",1.0,99712.0,34
2025-08-14_08-18-36,7028,"[np.float32(0.0), np.float32(0.0), np.float32(0.0), np.float32(1.0), np.float32(0.0), np.float32(1.0), np.float32(1.0), np.float32(1.0), np.float32(1.0), np.float32(0.0), np.float32(0.0), np.float32(0.0), np.float32(1.0), np.float32(0.0), np.float32(0.0), np.float32(0.0)]",-1.0,99711.0,32
2025-08-14_08-18-36,7029,"[np.float32(1.0), np.float32(0.0), np.float32(0.0), np.float32(0.0), np.float32(0.0), np.float32(0.0), np.float32(0.0), np.float32(1.0), np.float32(0.0), np.float32(0.0), np.float32(0.0), np.float32(1.0), np.float32(1.0), np.float32(0.0), np.float32(0.0), np.float32(0.0)]",-1.0,99710.0,6
2025-08-14_08-18-36,7030,"[np.float32(0.0), np.float32(1.0), np.float32(0.0), np.float32(1.0), np.float32(1.0), np.float32(0.0), np.float32(0.0), np.float32(1.0), np.float32(1.0), np.float32(0.0), np.float32(1.0), np.float32(0.0), np.float32(1.0), np.float32(0.0), np.float32(1.0), np.float32(1.0)]",-4.0,99706.0,28
2025-08-14_08-18-36,7031,"[np.float32(0.0), np.float32(1.0), np.float32(0.0), np.float32(0.0), np.float32(1.0), np.float32(1.0), np.float32(1.0), np.float32(1.0), np.float32(0.0), np.float32(0.0), np.float32(0.0), np.float32(1.0), np.float32(1.0), np.float32(1.0), np.float32(1.0), np.float32(1.0)]",-2.0,99704.0,14
2025-08-14_08-18-36,7032,"[np.float32(1.0), np.float32(0.0), np.float32(0.0), np.float32(1.0), np.float32(0.0), np.float32(0.0), np.float32(1.0), np.float32(0.0), np.float32(1.0), np.float32(0.0), np.float32(1.0), np.float32(0.0), np.float32(1.0), np.float32(0.0), np.float32(1.0), np.float32(0.0)]",-2.0,99702.0,14
2025-08-14_08-18-36,7033,"[np.float32(1.0), np.float32(1.0), np.float32(0.0), np.float32(1.0), np.float32(0.0), np.float32(1.0), np.float32(0.0), np.float32(1.0), np.float32(1.0), np.float32(1.0), np.float32(0.0), np.float32(1.0), np.float32(0.0), np.float32(1.0), np.float32(0.0), np.float32(0.0)]",3.0,99705.0,29
2025-08-14_08-18-36,7034,"[np.float32(1.0), np.float32(0.0), np.float32(1.0), np.float32(1.0), np.float32(0.0), np.float32(1.0), np.float32(1.0), np.float32(1.0), np.float32(0.0), np.float32(1.0), np.float32(1.0), np.float32(1.0), np.float32(0.0), np.float32(0.0), np.float32(1.0), np.float32(0.0)]",3.0,99708.0,16
2025-08-14_08-18-36,7035,"[np.float32(0.0), np.float32(0.0), np.float32(0.0), np.float32(1.0), np.float32(0.0), np.float32(1.0), np.float32(0.0), np.float32(1.0), np.float32(0.0), np.float32(1.0), np.float32(0.0), np.float32(0.0), np.float32(1.0), np.float32(0.0), np.float32(1.0), np.float32(0.0)]",1.0,99709.0,21
2025-08-14_08-18-36,7036,"[np.float32(1.0), np.float32(0.0), np.float32(0.0), np.float32(0.0), np.float32(0.0), np.float32(1.0), np.float32(0.0), np.float32(1.0), np.float32(1.0), np.float32(0.0), np.float32(0.0), np.float32(1.0), np.float32(1.0), np.float32(1.0), np.float32(0.0), np.float32(1.0)]",-5.0,99704.0,2
2025-08-14_08-18-36,7037,"[np.float32(1.0), np.float32(1.0), np.float32(1.0), np.float32(0.0), np.float32(1.0), np.float32(1.0), np.float32(1.0), np.float32(1.0), np.float32(1.0), np.float32(1.0), np.float32(1.0), np.float32(1.0), np.float32(0.0), np.float32(1.0), np.float32(0.0), np.float32(0.0)]",-2.0,99702.0,13
2025-08-14_08-18-36,7038,"[np.float32(0.0), np.float32(1.0), np.float32(0.0), np.float32(1.0), np.float32(1.0), np.float32(0.0), np.float32(0.0), np.float32(1.0), np.float32(1.0), np.float32(1.0), np.float32(1.0), np.float32(1.0), np.float32(0.0), np.float32(1.0), np.float32(0.0), np.float32(0.0)]",1.0,99703.0,31
2025-08-14_08-18-36,7039,"[np.float32(0.0), np.float32(1.0), np.float32(0.0), np.float32(1.0), np.float32(0.0), np.float32(0.0), np.float32(1.0), np.float32(1.0), np.float32(1.0), np.float32(1.0), np.float32(1.0), np.float32(1.0), np.float32(1.0), np.float32(1.0), np.float32(1.0), np.float32(0.0)]",0.0,99703.0,24
2025-08-14_08-18-36,7040,"[np.float32(1.0), np.float32(1.0), np.float32(0.0), np.float32(0.0), np.float32(0.0), np.float32(1.0), np.float32(0.0), np.float32(1.0), np.float32(0.0), np.float32(0.0), np.float32(0.0), np.float32(1.0), np.float32(1.0), np.float32(0.0), np.float32(0.0), np.float32(0.0)]",-1.0,99702.0,6
2025-08-14_08-18-36,7041,"[np.float32(0.0), np.float32(1.0), np.float32(1.0), np.float32(1.0), np.float32(0.0), np.float32(0.0), np.float32(0.0), np.float32(0.0), np.float32(1.0), np.float32(0.0), np.float32(1.0), np.float32(0.0), np.float32(1.0), np.float32(0.0), np.float32(0.0), np.float32(0.0)]",-4.0,99698.0,9
2025-08-14_08-18-36,7042,"[np.float32(0.0), np.float32(0.0), np.float32(0.0), np.float32(1.0), np.float32(1.0), np.float32(0.0), np.float32(0.0), np.float32(0.0), np.float32(0.0), np.float32(1.0), np.float32(1.0), np.float32(0.0), np.float32(0.0), np.float32(1.0), np.float32(1.0), np.float32(0.0)]",2.0,99700.0,16
2025-08-14_08-18-36,7043,"[np.float32(0.0), np.float32(0.0), np.float32(0.0), np.float32(1.0), np.float32(1.0), np.float32(1.0), np.float32(1.0), np.float32(1.0), np.float32(0.0), np.float32(0.0), np.float32(1.0), np.float32(1.0), np.float32(1.0), np.float32(0.0), np.float32(1.0), np.float32(1.0)]",3.0,99703.0,23
2025-08-14_08-18-36,7044,"[np.float32(1.0), np.float32(0.0), np.float32(0.0), np.float32(1.0), np.float32(1.0), np.float32(0.0), np.float32(0.0), np.float32(1.0), np.float32(1.0), np.float32(1.0), np.float32(1.0), np.float32(0.0), np.float32(0.0), np.float32(0.0), np.float32(0.0), np.float32(1.0)]",-8.0,99695.0,0
2025-08-14_08-18-36,7045,"[np.float32(1.0), np.float32(0.0), np.float32(0.0), np.float32(1.0), np.float32(1.0), np.float32(0.0), np.float32(0.0), np.float32(1.0), np.float32(0.0), np.float32(0.0), np.float32(0.0), np.float32(0.0), np.float32(0.0), np.float32(1.0), np.float32(0.0), np.float32(0.0)]",5.0,99700.0,18
2025-08-14_08-18-36,7046,"[np.float32(1.0), np.float32(1.0), np.float32(0.0), np.float32(1.0), np.float32(0.0), np.float32(0.0), np.float32(1.0), np.float32(1.0), np.float32(1.0), np.float32(0.0), np.float32(1.0), np.float32(1.0), np.float32(1.0), np.float32(0.0), np.float32(1.0), np.float32(0.0)]",0.0,99700.0,35
2025-08-14_08-18-36,7047,"[np.float32(1.0), np.float32(0.0), np.float32(0.0), np.float32(0.0), np.float32(0.0), np.float32(0.0), np.float32(1.0), np.float32(1.0), np.float32(1.0), np.float32(0.0), np.float32(0.0), np.float32(0.0), np.float32(0.0), np.float32(1.0), np.float32(0.0), np.float32(1.0)]",2.0,99702.0,21
2025-08-14_08-18-36,7048,"[np.float32(0.0), np.float32(1.0), np.float32(0.0), np.float32(1.0), np.float32(0.0), np.float32(0.0), np.float32(1.0), np.float32(0.0), np.float32(1.0), np.float32(0.0), np.float32(1.0), np.float32(1.0), np.float32(1.0), np.float32(0.0), np.float32(1.0), np.float32(1.0)]",-7.0,99695.0,0
2025-08-14_08-18-36,7049,"[np.float32(0.0), np.float32(1.0), np.float32(0.0), np.float32(1.0), np.float32(0.0), np.float32(1.0), np.float32(1.0), np.float32(1.0), np.float32(1.0), np.float32(1.0), np.float32(0.0), np.float32(0.0), np.float32(0.0), np.float32(0.0), np.float32(0.0), np.float32(0.0)]",3.0,99698.0,13
2025-08-14_08-18-36,7050,"[np.float32(1.0), np.float32(0.0), np.float32(1.0), np.float32(0.0), np.float32(1.0), np.float32(1.0), np.float32(1.0), np.float32(1.0), np.float32(0.0), np.float32(0.0), np.float32(1.0), np.float32(1.0), np.float32(0.0), np.float32(0.0), np.float32(1.0), np.float32(1.0)]",3.0,99701.0,9
2025-08-14_08-18-36,7051,"[np.float32(1.0), np.float32(1.0), np.float32(1.0), np.float32(1.0), np.float32(0.0), np.float32(0.0), np.float32(0.0), np.float32(1.0), np.float32(0.0), np.float32(1.0), np.float32(1.0), np.float32(0.0), np.float32(0.0), np.float32(0.0), np.float32(0.0), np.float32(1.0)]",-1.0,99700.0,6
2025-08-14_08-18-36,7052,"[np.float32(0.0), np.float32(1.0), np.float32(1.0), np.float32(1.0), np.float32(1.0), np.float32(0.0), np.float32(1.0), np.float32(0.0), np.float32(1.0), np.float32(0.0), np.float32(1.0), np.float32(1.0), np.float32(0.0), np.float32(0.0), np.float32(1.0), np.float32(1.0)]",-1.0,99699.0,13
2025-08-14_08-18-36,7053,"[np.float32(1.0), np.float32(1.0), np.float32(0.0), np.float32(0.0), np.float32(1.0), np.float32(1.0), np.float32(1.0), np.float32(1.0), np.float32(1.0), np.float32(1.0), np.float32(0.0), np.float32(1.0), np.float32(1.0), np.float32(1.0), np.float32(0.0), np.float32(0.0)]",-4.0,99695.0,14
2025-08-14_08-18-36,7054,"[np.float32(1.0), np.float32(1.0), np.float32(0.0), np.float32(0.0), np.float32(0.0), np.float32(0.0), np.float32(1.0), np.float32(1.0), np.float32(1.0), np.float32(1.0), np.float32(0.0), np.float32(0.0), np.float32(1.0), np.float32(1.0), np.float32(1.0), np.float32(0.0)]",-1.0,99694.0,5
2025-08-14_08-18-36,7055,"[np.float32(0.0), np.float32(0.0), np.float32(0.0), np.float32(0.0), np.float32(1.0), np.float32(1.0), np.float32(1.0), np.float32(1.0), np.float32(1.0), np.float32(0.0), np.float32(0.0), np.float32(0.0), np.float32(1.0), np.float32(0.0), np.float32(0.0), np.float32(0.0)]",-1.0,99693.0,36
2025-08-14_08-18-36,7056,"[np.float32(0.0), np.float32(0.0), np.float32(1.0), np.float32(1.0), np.float32(1.0), np.float32(1.0), np.float32(1.0), np.float32(1.0), np.float32(0.0), np.float32(0.0), np.float32(1.0), np.float32(1.0), np.float32(0.0), np.float32(0.0), np.float32(1.0), np.float32(0.0)]",-2.0,99691.0,26
2025-08-14_08-18-36,7057,"[np.float32(0.0), np.float32(0.0), np.float32(0.0), np.float32(0.0), np.float32(1.0), np.float32(1.0), np.float32(1.0), np.float32(1.0), np.float32(1.0), np.float32(0.0), np.float32(1.0), np.float32(1.0), np.float32(0.0), np.float32(0.0), np.float32(1.0), np.float32(0.0)]",0.0,99691.0,21
2025-08-14_08-18-36,7058,"[np.float32(0.0), np.float32(0.0), np.float32(0.0), np.float32(0.0), np.float32(1.0), np.float32(1.0), np.float32(0.0), np.float32(1.0), np.float32(0.0), np.float32(0.0), np.float32(1.0), np.float32(0.0), np.float32(0.0), np.float32(0.0), np.float32(0.0), np.float32(0.0)]",-2.0,99689.0,28
2025-08-14_08-18-36,7059,"[np.float32(1.0), np.float32(1.0), np.float32(1.0), np.float32(0.0), np.float32(0.0), np.float32(1.0), np.float32(1.0), np.float32(0.0), np.float32(0.0), np.float32(1.0), np.float32(1.0), np.float32(0.0), np.float32(0.0), np.float32(1.0), np.float32(0.0), np.float32(0.0)]",-3.0,99686.0,9
2025-08-14_08-18-36,7060,"[np.float32(0.0), np.float32(0.0), np.float32(1.0), np.float32(0.0), np.float32(1.0), np.float32(0.0), np.float32(1.0), np.float32(1.0), np.float32(0.0), np.float32(0.0), np.float32(1.0), np.float32(0.0), np.float32(1.0), np.float32(1.0), np.float32(1.0), np.float32(0.0)]",-3.0,99683.0,0
2025-08-14_08-18-36,7061,"[np.float32(0.0), np.float32(1.0), np.float32(0.0), np.float32(0.0), np.float32(1.0), np.float32(0.0), np.float32(0.0), np.float32(1.0), np.float32(1.0), np.float32(0.0), np.float32(0.0), np.float32(0.0), np.float32(1.0), np.float32(1.0), np.float32(0.0), np.float32(1.0)]",-3.0,99680.0,8
2025-08-14_08-18-36,7062,"[np.float32(1.0), np.float32(1.0), np.float32(1.0), np.float32(0.0), np.float32(1.0), np.float32(0.0), np.float32(1.0), np.float32(1.0), np.float32(1.0), np.float32(1.0), np.float32(1.0), np.float32(0.0), np.float32(1.0), np.float32(1.0), np.float32(0.0), np.float32(0.0)]",-1.0,99679.0,1
2025-08-14_08-18-36,7063,"[np.float32(0.0), np.float32(1.0), np.float32(1.0), np.float32(0.0), np.float32(0.0), np.float32(0.0), np.float32(1.0), np.float32(1.0), np.float32(1.0), np.float32(0.0), np.float32(1.0), np.float32(0.0), np.float32(0.0), np.float32(0.0), np.float32(0.0), np.float32(0.0)]",-1.0,99678.0,34
2025-08-14_08-18-36,7064,"[np.float32(1.0), np.float32(1.0), np.float32(1.0), np.float32(0.0), np.float32(0.0), np.float32(0.0), np.float32(0.0), np.float32(1.0), np.float32(0.0), np.float32(0.0), np.float32(0.0), np.float32(1.0), np.float32(1.0), np.float32(0.0), np.float32(1.0), np.float32(0.0)]",0.0,99678.0,20
2025-08-14_08-18-36,7065,"[np.float32(1.0), np.float32(0.0), np.float32(1.0), np.float32(1.0), np.float32(0.0), np.float32(0.0), np.float32(0.0), np.float32(0.0), np.float32(0.0), np.float32(0.0), np.float32(0.0), np.float32(0.0), np.float32(0.0), np.float32(0.0), np.float32(1.0), np.float32(1.0)]",0.0,99678.0,33
2025-08-14_08-18-36,7066,"[np.float32(1.0), np.float32(0.0), np.float32(0.0), np.float32(0.0), np.float32(0.0), np.float32(1.0), np.float32(0.0), np.float32(1.0), np.float32(0.0), np.float32(1.0), np.float32(0.0), np.float32(0.0), np.float32(0.0), np.float32(1.0), np.float32(0.0), np.float32(0.0)]",-3.0,99675.0,9
2025-08-14_08-18-36,7067,"[np.float32(1.0), np.float32(1.0), np.float32(0.0), np.float32(0.0), np.float32(1.0), np.float32(1.0), np.float32(1.0), np.float32(0.0), np.float32(0.0), np.float32(0.0), np.float32(1.0), np.float32(0.0), np.float32(1.0), np.float32(1.0), np.float32(1.0), np.float32(0.0)]",-5.0,99670.0,34
2025-08-14_08-18-36,7068,"[np.float32(1.0), np.float32(0.0), np.float32(1.0), np.float32(1.0), np.float32(0.0), np.float32(1.0), np.float32(1.0), np.float32(1.0), np.float32(0.0), np.float32(0.0), np.float32(0.0), np.float32(0.0), np.float32(0.0), np.float32(1.0), np.float32(0.0), np.float32(0.0)]",0.0,99670.0,16
2025-08-14_08-18-36,7069,"[np.float32(1.0), np.float32(1.0), np.float32(1.0), np.float32(0.0), np.float32(1.0), np.float32(1.0), np.float32(0.0), np.float32(0.0), np.float32(0.0), np.float32(1.0), np.float32(0.0), np.float32(1.0), np.float32(0.0), np.float32(0.0), np.float32(1.0), np.float32(0.0)]",4.0,99674.0,10
2025-08-14_08-18-36,7070,"[np.float32(0.0), np.float32(0.0), np.float32(1.0), np.float32(0.0), np.float32(0.0), np.float32(1.0), np.float32(1.0), np.float32(1.0), np.float32(1.0), np.float32(1.0), np.float32(0.0), np.float32(0.0), np.float32(1.0), np.float32(1.0), np.float32(1.0), np.float32(0.0)]",-3.0,99671.0,11
2025-08-14_08-18-36,7071,"[np.float32(0.0), np.float32(0.0), np.float32(1.0), np.float32(1.0), np.float32(1.0), np.float32(1.0), np.float32(1.0), np.float32(0.0), np.float32(1.0), np.float32(1.0), np.float32(1.0), np.float32(1.0), np.float32(1.0), np.float32(1.0), np.float32(1.0), np.float32(1.0)]",0.0,99671.0,2
2025-08-14_08-18-36,7072,"[np.float32(0.0), np.float32(1.0), np.float32(0.0), np.float32(1.0), np.float32(0.0), np.float32(1.0), np.float32(0.0), np.float32(0.0), np.float32(1.0), np.float32(0.0), np.float32(0.0), np.float32(0.0), np.float32(0.0), np.float32(1.0), np.float32(0.0), np.float32(0.0)]",4.0,99675.0,31
2025-08-14_08-18-36,7073,"[np.float32(0.0), np.float32(1.0), np.float32(1.0), np.float32(0.0), np.float32(0.0), np.float32(1.0), np.float32(0.0), np.float32(1.0), np.float32(0.0), np.float32(1.0), np.float32(1.0), np.float32(0.0), np.float32(1.0), np.float32(1.0), np.float32(0.0), np.float32(0.0)]",0.0,99675.0,15
2025-08-14_08-18-36,7074,"[np.float32(0.0), np.float32(0.0), np.float32(0.0), np.float32(0.0), np.float32(1.0), np.float32(1.0), np.float32(0.0), np.float32(0.0), np.float32(0.0), np.float32(0.0), np.float32(0.0), np.float32(1.0), np.float32(0.0), np.float32(1.0), np.float32(1.0), np.float32(0.0)]",3.0,99678.0,15
2025-08-14_08-18-36,7075,"[np.float32(0.0), np.float32(0.0), np.float32(1.0), np.float32(1.0), np.float32(0.0), np.float32(0.0), np.float32(1.0), np.float32(0.0), np.float32(0.0), np.float32(1.0), np.float32(1.0), np.float32(0.0), np.float32(1.0), np.float32(0.0), np.float32(1.0), np.float32(0.0)]",-2.0,99676.0,19
2025-08-14_08-18-36,7076,"[np.float32(0.0), np.float32(1.0), np.float32(0.0), np.float32(0.0), np.float32(0.0), np.float32(1.0), np.float32(0.0), np.float32(1.0), np.float32(0.0), np.float32(1.0), np.float32(0.0), np.float32(1.0), np.float32(1.0), np.float32(1.0), np.float32(0.0), np.float32(0.0)]",-2.0,99674.0,30
2025-08-14_08-18-36,7077,"[np.float32(1.0), np.float32(1.0), np.float32(1.0), np.float32(1.0), np.float32(0.0), np.float32(0.0), np.float32(0.0), np.float32(1.0), np.float32(1.0), np.float32(0.0), np.float32(1.0), np.float32(1.0), np.float32(0.0), np.float32(0.0), np.float32(0.0), np.float32(0.0)]",-1.0,99673.0,3
2025-08-14_08-18-36,7078,"[np.float32(1.0), np.float32(1.0), np.float32(0.0), np.float32(0.0), np.float32(1.0), np.float32(1.0), np.float32(1.0), np.float32(0.0), np.float32(1.0), np.float32(1.0), np.float32(1.0), np.float32(0.0), np.float32(0.0), np.float32(1.0), np.float32(0.0), np.float32(1.0)]",-3.0,99670.0,36
2025-08-14_08-18-36,7079,"[np.float32(1.0), np.float32(0.0), np.float32(0.0), np.float32(1.0), np.float32(1.0), np.float32(0.0), np.float32(1.0), np.float32(1.0), np.float32(0.0), np.float32(1.0), np.float32(1.0), np.float32(0.0), np.float32(1.0), np.float32(0.0), np.float32(0.0), np.float32(0.0)]",2.0,99672.0,16
2025-08-14_08-18-36,7080,"[np.float32(1.0), np.float32(0.0), np.float32(1.0), np.float32(1.0), np.float32(1.0), np.float32(0.0), np.float32(0.0), np.float32(0.0), np.float32(1.0), np.float32(0.0), np.float32(1.0), np.float32(0.0), np.float32(0.0), np.float32(0.0), np.float32(0.0), np.float32(0.0)]",4.0,99676.0,32
2025-08-14_08-18-36,7081,"[np.float32(1.0), np.float32(1.0), np.float32(0.0), np.float32(0.0), np.float32(0.0), np.float32(0.0), np.float32(0.0), np.float32(1.0), np.float32(0.0), np.float32(1.0), np.float32(1.0), np.float32(0.0), np.float32(1.0), np.float32(1.0), np.float32(0.0), np.float32(0.0)]",1.0,99677.0,15
2025-08-14_08-18-36,7082,"[np.float32(0.0), np.float32(0.0), np.float32(1.0), np.float32(1.0), np.float32(1.0), np.float32(0.0), np.float32(1.0), np.float32(0.0), np.float32(0.0), np.float32(1.0), np.float32(1.0), np.float32(1.0), np.float32(0.0), np.float32(0.0), np.float32(0.0), np.float32(0.0)]",-2.0,99675.0,29
2025-08-14_08-18-36,7083,"[np.float32(0.0), np.float32(0.0), np.float32(0.0), np.float32(1.0), np.float32(0.0), np.float32(0.0), np.float32(0.0), np.float32(0.0), np.float32(1.0), np.float32(1.0), np.float32(0.0), np.float32(1.0), np.float32(0.0), np.float32(1.0), np.float32(0.0), np.float32(1.0)]",3.0,99678.0,28
2025-08-14_08-18-36,7084,"[np.float32(1.0), np.float32(0.0), np.float32(1.0), np.float32(1.0), np.float32(1.0), np.float32(1.0), np.float32(1.0), np.float32(1.0), np.float32(1.0), np.float32(1.0), np.float32(0.0), np.float32(1.0), np.float32(1.0), np.float32(1.0), np.float32(0.0), np.float32(0.0)]",0.0,99678.0,16
2025-08-14_08-18-36,7085,"[np.float32(0.0), np.float32(0.0), np.float32(1.0), np.float32(1.0), np.float32(1.0), np.float32(1.0), np.float32(0.0), np.float32(0.0), np.float32(1.0), np.float32(0.0), np.float32(0.0), np.float32(1.0), np.float32(0.0), np.float32(0.0), np.float32(1.0), np.float32(0.0)]",-3.0,99675.0,20
2025-08-14_08-18-36,7086,"[np.float32(0.0), np.float32(0.0), np.float32(1.0), np.float32(1.0), np.float32(1.0), np.float32(0.0), np.float32(1.0), np.float32(0.0), np.float32(1.0), np.float32(0.0), np.float32(1.0), np.float32(0.0), np.float32(1.0), np.float32(0.0), np.float32(0.0), np.float32(0.0)]",-2.0,99673.0,34
2025-08-14_08-18-36,7087,"[np.float32(1.0), np.float32(0.0), np.float32(0.0), np.float32(1.0), np.float32(0.0), np.float32(1.0), np.float32(0.0), np.float32(1.0), np.float32(0.0), np.float32(1.0), np.float32(0.0), np.float32(1.0), np.float32(0.0), np.float32(0.0), np.float32(0.0), np.float32(1.0)]",1.0,99674.0,18
2025-08-14_08-18-36,7088,"[np.float32(1.0), np.float32(0.0), np.float32(1.0), np.float32(1.0), np.float32(0.0), np.float32(1.0), np.float32(0.0), np.float32(1.0), np.float32(0.0), np.float32(0.0), np.float32(1.0), np.float32(0.0), np.float32(1.0), np.float32(1.0), np.float32(0.0), np.float32(0.0)]",0.0,99674.0,17
2025-08-14_08-18-36,7089,"[np.float32(1.0), np.float32(1.0), np.float32(1.0), np.float32(0.0), np.float32(0.0), np.float32(0.0), np.float32(0.0), np.float32(1.0), np.float32(1.0), np.float32(1.0), np.float32(1.0), np.float32(0.0), np.float32(1.0), np.float32(1.0), np.float32(0.0), np.float32(0.0)]",1.0,99675.0,4
2025-08-14_08-18-36,7090,"[np.float32(0.0), np.float32(0.0), np.float32(1.0), np.float32(0.0), np.float32(1.0), np.float32(1.0), np.float32(1.0), np.float32(0.0), np.float32(0.0), np.float32(1.0), np.float32(1.0), np.float32(1.0), np.float32(1.0), np.float32(1.0), np.float32(0.0), np.float32(0.0)]",-2.0,99673.0,34
2025-08-14_08-18-36,7091,"[np.float32(1.0), np.float32(0.0), np.float32(1.0), np.float32(0.0), np.float32(0.0), np.float32(0.0), np.float32(1.0), np.float32(1.0), np.float32(1.0), np.float32(0.0), np.float32(0.0), np.float32(1.0), np.float32(1.0), np.float32(0.0), np.float32(0.0), np.float32(0.0)]",-4.0,99669.0,13
2025-08-14_08-18-36,7092,"[np.float32(0.0), np.float32(1.0), np.float32(1.0), np.float32(1.0), np.float32(1.0), np.float32(0.0), np.float32(1.0), np.float32(0.0), np.float32(0.0), np.float32(0.0), np.float32(0.0), np.float32(0.0), np.float32(0.0), np.float32(0.0), np.float32(0.0), np.float32(0.0)]",4.0,99673.0,4
2025-08-14_08-18-36,7093,"[np.float32(0.0), np.float32(0.0), np.float32(0.0), np.float32(1.0), np.float32(0.0), np.float32(0.0), np.float32(0.0), np.float32(1.0), np.float32(0.0), np.float32(0.0), np.float32(0.0), np.float32(0.0), np.float32(0.0), np.float32(1.0), np.float32(1.0), np.float32(1.0)]",0.0,99673.0,7
2025-08-14_08-18-36,7094,"[np.float32(1.0), np.float32(1.0), np.float32(1.0), np.float32(0.0), np.float32(1.0), np.float32(1.0), np.float32(0.0), np.float32(1.0), np.float32(1.0), np.float32(1.0), np.float32(0.0), np.float32(1.0), np.float32(1.0), np.float32(1.0), np.float32(1.0), np.float32(1.0)]",0.0,99673.0,19
2025-08-14_08-18-36,7095,"[np.float32(1.0), np.float32(0.0), np.float32(0.0), np.float32(0.0), np.float32(1.0), np.float32(0.0), np.float32(1.0), np.float32(0.0), np.float32(1.0), np.float32(1.0), np.float32(0.0), np.float32(0.0), np.float32(1.0), np.float32(1.0), np.float32(0.0), np.float32(0.0)]",-1.0,99672.0,26
2025-08-14_08-18-36,7096,"[np.float32(0.0), np.float32(1.0), np.float32(0.0), np.float32(0.0), np.float32(1.0), np.float32(0.0), np.float32(1.0), np.float32(0.0), np.float32(0.0), np.float32(0.0), np.float32(0.0), np.float32(0.0), np.float32(0.0), np.float32(1.0), np.float32(0.0), np.float32(1.0)]",2.0,99674.0,10
2025-08-14_08-18-36,7097,"[np.float32(0.0), np.float32(0.0), np.float32(1.0), np.float32(1.0), np.float32(1.0), np.float32(1.0), np.float32(0.0), np.float32(1.0), np.float32(1.0), np.float32(0.0), np.float32(1.0), np.float32(0.0), np.float32(0.0), np.float32(0.0), np.float32(0.0), np.float32(1.0)]",-4.0,99670.0,10
2025-08-14_08-18-36,7098,"[np.float32(1.0), np.float32(1.0), np.float32(0.0), np.float32(1.0), np.float32(1.0), np.float32(0.0), np.float32(0.0), np.float32(1.0), np.float32(0.0), np.float32(1.0), np.float32(1.0), np.float32(0.0), np.float32(1.0), np.float32(1.0), np.float32(0.0), np.float32(0.0)]",3.0,99673.0,17
2025-08-14_08-18-36,7099,"[np.float32(1.0), np.float32(0.0), np.float32(1.0), np.float32(0.0), np.float32(0.0), np.float32(1.0), np.float32(0.0), np.float32(1.0), np.float32(0.0), np.float32(0.0), np.float32(1.0), np.float32(0.0), np.float32(0.0), np.float32(1.0), np.float32(1.0), np.float32(0.0)]",0.0,99673.0,0
2025-08-14_08-18-36,7100,"[np.float32(0.0), np.float32(0.0), np.float32(0.0), np.float32(0.0), np.float32(1.0), np.float32(0.0), np.float32(0.0), np.float32(1.0), np.float32(0.0), np.float32(1.0), np.float32(1.0), np.float32(0.0), np.float32(0.0), np.float32(1.0), np.float32(0.0), np.float32(0.0)]",1.0,99674.0,29
2025-08-14_08-18-36,7101,"[np.float32(0.0), np.float32(0.0), np.float32(1.0), np.float32(0.0), np.float32(0.0), np.float32(0.0), np.float32(1.0), np.float32(1.0), np.float32(1.0), np.float32(1.0), np.float32(1.0), np.float32(0.0), np.float32(1.0), np.float32(1.0), np.float32(0.0), np.float32(0.0)]",-5.0,99669.0,33
2025-08-14_08-18-36,7102,"[np.float32(1.0), np.float32(0.0), np.float32(1.0), np.float32(1.0), np.float32(1.0), np.float32(1.0), np.float32(1.0), np.float32(1.0), np.float32(0.0), np.float32(1.0), np.float32(1.0), np.float32(1.0), np.float32(0.0), np.float32(0.0), np.float32(0.0), np.float32(0.0)]",0.0,99669.0,4
2025-08-14_08-18-36,7103,"[np.float32(0.0), np.float32(0.0), np.float32(1.0), np.float32(0.0), np.float32(0.0), np.float32(1.0), np.float32(0.0), np.float32(0.0), np.float32(1.0), np.float32(0.0), np.float32(0.0), np.float32(1.0), np.float32(1.0), np.float32(1.0), np.float32(0.0), np.float32(1.0)]",-2.0,99667.0,4
2025-08-14_08-18-36,7104,"[np.float32(0.0), np.float32(1.0), np.float32(0.0), np.float32(0.0), np.float32(0.0), np.float32(0.0), np.float32(0.0), np.float32(1.0), np.float32(1.0), np.float32(0.0), np.float32(0.0), np.float32(1.0), np.float32(1.0), np.float32(1.0), np.float32(1.0), np.float32(1.0)]",-3.0,99664.0,11
2025-08-14_08-18-36,7105,"[np.float32(0.0), np.float32(1.0), np.float32(1.0), np.float32(0.0), np.float32(0.0), np.float32(0.0), np.float32(1.0), np.float32(1.0), np.float32(1.0), np.float32(0.0), np.float32(0.0), np.float32(0.0), np.float32(0.0), np.float32(1.0), np.float32(1.0), np.float32(0.0)]",0.0,99664.0,20
2025-08-14_08-18-36,7106,"[np.float32(1.0), np.float32(1.0), np.float32(1.0), np.float32(0.0), np.float32(1.0), np.float32(0.0), np.float32(1.0), np.float32(1.0), np.float32(1.0), np.float32(1.0), np.float32(1.0), np.float32(1.0), np.float32(1.0), np.float32(0.0), np.float32(0.0), np.float32(1.0)]",-2.0,99662.0,26
2025-08-14_08-18-36,7107,"[np.float32(0.0), np.float32(0.0), np.float32(0.0), np.float32(1.0), np.float32(0.0), np.float32(1.0), np.float32(1.0), np.float32(0.0), np.float32(1.0), np.float32(1.0), np.float32(0.0), np.float32(0.0), np.float32(1.0), np.float32(0.0), np.float32(1.0), np.float32(1.0)]",-1.0,99661.0,35
2025-08-14_08-18-36,7108,"[np.float32(0.0), np.float32(0.0), np.float32(1.0), np.float32(1.0), np.float32(0.0), np.float32(1.0), np.float32(1.0), np.float32(1.0), np.float32(1.0), np.float32(0.0), np.float32(0.0), np.float32(1.0), np.float32(0.0), np.float32(1.0), np.float32(0.0), np.float32(0.0)]",0.0,99661.0,2
2025-08-14_08-18-36,7109,"[np.float32(1.0), np.float32(0.0), np.float32(1.0), np.float32(0.0), np.float32(0.0), np.float32(1.0), np.float32(0.0), np.float32(1.0), np.float32(0.0), np.float32(1.0), np.float32(1.0), np.float32(0.0), np.float32(1.0), np.float32(1.0), np.float32(1.0), np.float32(0.0)]",0.0,99661.0,13
2025-08-14_08-18-36,7110,"[np.float32(1.0), np.float32(1.0), np.float32(1.0), np.float32(0.0), np.float32(1.0), np.float32(0.0), np.float32(0.0), np.float32(1.0), np.float32(1.0), np.float32(0.0), np.float32(1.0), np.float32(0.0), np.float32(0.0), np.float32(0.0), np.float32(0.0), np.float32(1.0)]",-1.0,99660.0,11
2025-08-14_08-18-36,7111,"[np.float32(0.0), np.float32(0.0), np.float32(1.0), np.float32(1.0), np.float32(0.0), np.float32(1.0), np.float32(0.0), np.float32(1.0), np.float32(1.0), np.float32(1.0), np.float32(1.0), np.float32(0.0), np.float32(1.0), np.float32(1.0), np.float32(0.0), np.float32(1.0)]",-2.0,99658.0,2
2025-08-14_08-18-36,7112,"[np.float32(0.0), np.float32(1.0), np.float32(0.0), np.float32(0.0), np.float32(1.0), np.float32(1.0), np.float32(1.0), np.float32(0.0), np.float32(1.0), np.float32(0.0), np.float32(0.0), np.float32(0.0), np.float32(1.0), np.float32(1.0), np.float32(0.0), np.float32(0.0)]",3.0,99661.0,4
2025-08-14_08-18-36,7113,"[np.float32(0.0), np.float32(1.0), np.float32(1.0), np.float32(0.0), np.float32(1.0), np.float32(0.0), np.float32(1.0), np.float32(0.0), np.float32(1.0), np.float32(1.0), np.float32(0.0), np.float32(0.0), np.float32(0.0), np.float32(1.0), np.float32(0.0), np.float32(1.0)]",4.0,99665.0,2
2025-08-14_08-18-36,7114,"[np.float32(1.0), np.float32(0.0), np.float32(1.0), np.float32(1.0), np.float32(0.0), np.float32(1.0), np.float32(1.0), np.float32(0.0), np.float32(0.0), np.float32(0.0), np.float32(0.0), np.float32(1.0), np.float32(1.0), np.float32(0.0), np.float32(1.0), np.float32(1.0)]",3.0,99668.0,30
2025-08-14_08-18-36,7115,"[np.float32(1.0), np.float32(1.0), np.float32(1.0), np.float32(0.0), np.float32(0.0), np.float32(0.0), np.float32(0.0), np.float32(0.0), np.float32(0.0), np.float32(1.0), np.float32(1.0), np.float32(0.0), np.float32(1.0), np.float32(0.0), np.float32(0.0), np.float32(0.0)]",-1.0,99667.0,17
2025-08-14_08-18-36,7116,"[np.float32(1.0), np.float32(1.0), np.float32(0.0), np.float32(0.0), np.float32(0.0), np.float32(0.0), np.float32(0.0), np.float32(0.0), np.float32(1.0), np.float32(0.0), np.float32(0.0), np.float32(0.0), np.float32(1.0), np.float32(1.0), np.float32(0.0), np.float32(0.0)]",0.0,99667.0,22
2025-08-14_08-18-36,7117,"[np.float32(1.0), np.float32(0.0), np.float32(0.0), np.float32(1.0), np.float32(1.0), np.float32(1.0), np.float32(0.0), np.float32(1.0), np.float32(0.0), np.float32(1.0), np.float32(0.0), np.float32(0.0), np.float32(1.0), np.float32(0.0), np.float32(0.0), np.float32(0.0)]",-5.0,99662.0,0
2025-08-14_08-18-36,7118,"[np.float32(1.0), np.float32(0.0), np.float32(0.0), np.float32(1.0), np.float32(0.0), np.float32(1.0), np.float32(0.0), np.float32(0.0), np.float32(0.0), np.float32(0.0), np.float32(1.0), np.float32(0.0), np.float32(1.0), np.float32(1.0), np.float32(1.0), np.float32(0.0)]",2.0,99664.0,21
2025-08-14_08-18-36,7119,"[np.float32(1.0), np.float32(1.0), np.float32(1.0), np.float32(1.0), np.float32(1.0), np.float32(1.0), np.float32(0.0), np.float32(1.0), np.float32(1.0), np.float32(1.0), np.float32(1.0), np.float32(1.0), np.float32(1.0), np.float32(1.0), np.float32(0.0), np.float32(0.0)]",2.0,99666.0,22
2025-08-14_08-18-36,7120,"[np.float32(0.0), np.float32(0.0), np.float32(0.0), np.float32(0.0), np.float32(1.0), np.float32(0.0), np.float32(1.0), np.float32(1.0), np.float32(1.0), np.float32(0.0), np.float32(1.0), np.float32(0.0), np.float32(0.0), np.float32(1.0), np.float32(0.0), np.float32(1.0)]",2.0,99668.0,20
2025-08-14_08-18-36,7121,"[np.float32(1.0), np.float32(0.0), np.float32(0.0), np.float32(0.0), np.float32(1.0), np.float32(1.0), np.float32(0.0), np.float32(1.0), np.float32(1.0), np.float32(1.0), np.float32(1.0), np.float32(0.0), np.float32(1.0), np.float32(1.0), np.float32(0.0), np.float32(1.0)]",1.0,99669.0,31
2025-08-14_08-18-36,7122,"[np.float32(1.0), np.float32(0.0), np.float32(0.0), np.float32(0.0), np.float32(0.0), np.float32(0.0), np.float32(1.0), np.float32(1.0), np.float32(1.0), np.float32(0.0), np.float32(1.0), np.float32(1.0), np.float32(0.0), np.float32(1.0), np.float32(1.0), np.float32(0.0)]",-2.0,99667.0,13
2025-08-14_08-18-36,7123,"[np.float32(1.0), np.float32(0.0), np.float32(0.0), np.float32(0.0), np.float32(0.0), np.float32(0.0), np.float32(0.0), np.float32(1.0), np.float32(0.0), np.float32(0.0), np.float32(1.0), np.float32(1.0), np.float32(0.0), np.float32(1.0), np.float32(0.0), np.float32(0.0)]",1.0,99668.0,24
2025-08-14_08-18-36,7124,"[np.float32(0.0), np.float32(0.0), np.float32(1.0), np.float32(0.0), np.float32(0.0), np.float32(0.0), np.float32(1.0), np.float32(1.0), np.float32(0.0), np.float32(0.0), np.float32(1.0), np.float32(1.0), np.float32(1.0), np.float32(1.0), np.float32(1.0), np.float32(0.0)]",0.0,99668.0,4
2025-08-14_08-18-36,7125,"[np.float32(0.0), np.float32(0.0), np.float32(1.0), np.float32(0.0), np.float32(0.0), np.float32(0.0), np.float32(0.0), np.float32(1.0), np.float32(1.0), np.float32(1.0), np.float32(0.0), np.float32(1.0), np.float32(1.0), np.float32(0.0), np.float32(0.0), np.float32(0.0)]",-1.0,99667.0,32
2025-08-14_08-18-36,7126,"[np.float32(1.0), np.float32(0.0), np.float32(1.0), np.float32(1.0), np.float32(1.0), np.float32(0.0), np.float32(0.0), np.float32(1.0), np.float32(1.0), np.float32(1.0), np.float32(1.0), np.float32(0.0), np.float32(0.0), np.float32(0.0), np.float32(0.0), np.float32(0.0)]",-2.0,99665.0,9
2025-08-14_08-18-36,7127,"[np.float32(0.0), np.float32(1.0), np.float32(0.0), np.float32(1.0), np.float32(0.0), np.float32(0.0), np.float32(1.0), np.float32(1.0), np.float32(1.0), np.float32(1.0), np.float32(1.0), np.float32(1.0), np.float32(1.0), np.float32(0.0), np.float32(1.0), np.float32(1.0)]",-3.0,99662.0,26
2025-08-14_08-18-36,7128,"[np.float32(1.0), np.float32(0.0), np.float32(0.0), np.float32(0.0), np.float32(0.0), np.float32(0.0), np.float32(0.0), np.float32(1.0), np.float32(1.0), np.float32(0.0), np.float32(1.0), np.float32(1.0), np.float32(1.0), np.float32(1.0), np.float32(1.0), np.float32(0.0)]",0.0,99662.0,25
2025-08-14_08-18-36,7129,"[np.float32(0.0), np.float32(0.0), np.float32(0.0), np.float32(1.0), np.float32(0.0), np.float32(1.0), np.float32(1.0), np.float32(1.0), np.float32(0.0), np.float32(0.0), np.float32(1.0), np.float32(1.0), np.float32(1.0), np.float32(0.0), np.float32(1.0), np.float32(0.0)]",0.0,99662.0,15
2025-08-14_08-18-36,7130,"[np.float32(0.0), np.float32(1.0), np.float32(0.0), np.float32(1.0), np.float32(0.0), np.float32(0.0), np.float32(0.0), np.float32(1.0), np.float32(0.0), np.float32(0.0), np.float32(1.0), np.float32(1.0), np.float32(1.0), np.float32(0.0), np.float32(1.0), np.float32(1.0)]",-1.0,99661.0,29
2025-08-14_08-18-36,7131,"[np.float32(0.0), np.float32(0.0), np.float32(1.0), np.float32(0.0), np.float32(0.0), np.float32(1.0), np.float32(0.0), np.float32(1.0), np.float32(0.0), np.float32(1.0), np.float32(1.0), np.float32(0.0), np.float32(0.0), np.float32(1.0), np.float32(1.0), np.float32(0.0)]",-7.0,99654.0,9
2025-08-14_08-18-36,7132,"[np.float32(0.0), np.float32(0.0), np.float32(1.0), np.float32(0.0), np.float32(1.0), np.float32(0.0), np.float32(1.0), np.float32(0.0), np.float32(0.0), np.float32(0.0), np.float32(0.0), np.float32(1.0), np.float32(0.0), np.float32(1.0), np.float32(1.0), np.float32(0.0)]",-2.0,99652.0,14
2025-08-14_08-18-36,7133,"[np.float32(0.0), np.float32(1.0), np.float32(0.0), np.float32(0.0), np.float32(1.0), np.float32(1.0), np.float32(1.0), np.float32(0.0), np.float32(0.0), np.float32(1.0), np.float32(1.0), np.float32(0.0), np.float32(1.0), np.float32(0.0), np.float32(0.0), np.float32(1.0)]",-6.0,99646.0,30
2025-08-14_08-18-36,7134,"[np.float32(0.0), np.float32(0.0), np.float32(0.0), np.float32(1.0), np.float32(1.0), np.float32(0.0), np.float32(0.0), np.float32(0.0), np.float32(0.0), np.float32(0.0), np.float32(1.0), np.float32(1.0), np.float32(1.0), np.float32(0.0), np.float32(1.0), np.float32(0.0)]",2.0,99648.0,8
2025-08-14_08-18-36,7135,"[np.float32(1.0), np.float32(1.0), np.float32(0.0), np.float32(1.0), np.float32(1.0), np.float32(0.0), np.float32(1.0), np.float32(0.0), np.float32(1.0), np.float32(0.0), np.float32(0.0), np.float32(0.0), np.float32(0.0), np.float32(0.0), np.float32(1.0), np.float32(1.0)]",2.0,99650.0,8
2025-08-14_08-18-36,7136,"[np.float32(0.0), np.float32(1.0), np.float32(1.0), np.float32(0.0), np.float32(0.0), np.float32(1.0), np.float32(0.0), np.float32(0.0), np.float32(1.0), np.float32(1.0), np.float32(0.0), np.float32(0.0), np.float32(0.0), np.float32(0.0), np.float32(0.0), np.float32(0.0)]",-5.0,99645.0,3
2025-08-14_08-18-36,7137,"[np.float32(0.0), np.float32(1.0), np.float32(1.0), np.float32(1.0), np.float32(0.0), np.float32(0.0), np.float32(1.0), np.float32(1.0), np.float32(1.0), np.float32(1.0), np.float32(1.0), np.float32(0.0), np.float32(1.0), np.float32(1.0), np.float32(0.0), np.float32(0.0)]",0.0,99645.0,17
2025-08-14_08-18-36,7138,"[np.float32(1.0), np.float32(0.0), np.float32(1.0), np.float32(0.0), np.float32(1.0), np.float32(0.0), np.float32(1.0), np.float32(1.0), np.float32(0.0), np.float32(1.0), np.float32(1.0), np.float32(0.0), np.float32(1.0), np.float32(1.0), np.float32(0.0), np.float32(1.0)]",-4.0,99641.0,35
2025-08-14_08-18-36,7139,"[np.float32(1.0), np.float32(1.0), np.float32(1.0), np.float32(0.0), np.float32(0.0), np.float32(1.0), np.float32(1.0), np.float32(1.0), np.float32(0.0), np.float32(0.0), np.float32(0.0), np.float32(1.0), np.float32(1.0), np.float32(1.0), np.float32(0.0), np.float32(0.0)]",0.0,99641.0,30
2025-08-14_08-18-36,7140,"[np.float32(0.0), np.float32(1.0), np.float32(0.0), np.float32(1.0), np.float32(0.0), np.float32(0.0), np.float32(1.0), np.float32(0.0), np.float32(1.0), np.float32(0.0), np.float32(1.0), np.float32(0.0), np.float32(0.0), np.float32(1.0), np.float32(1.0), np.float32(1.0)]",3.0,99644.0,5
2025-08-14_08-18-36,7141,"[np.float32(0.0), np.float32(1.0), np.float32(0.0), np.float32(1.0), np.float32(0.0), np.float32(0.0), np.float32(1.0), np.float32(0.0), np.float32(0.0), np.float32(0.0), np.float32(1.0), np.float32(1.0), np.float32(0.0), np.float32(0.0), np.float32(1.0), np.float32(0.0)]",-1.0,99643.0,20
2025-08-14_08-18-36,7142,"[np.float32(0.0), np.float32(1.0), np.float32(0.0), np.float32(0.0), np.float32(1.0), np.float32(0.0), np.float32(0.0), np.float32(1.0), np.float32(1.0), np.float32(0.0), np.float32(1.0), np.float32(1.0), np.float32(0.0), np.float32(1.0), np.float32(1.0), np.float32(0.0)]",0.0,99643.0,3
2025-08-14_08-18-36,7143,"[np.float32(0.0), np.float32(1.0), np.float32(1.0), np.float32(1.0), np.float32(1.0), np.float32(0.0), np.float32(0.0), np.float32(0.0), np.float32(0.0), np.float32(1.0), np.float32(1.0), np.float32(0.0), np.float32(1.0), np.float32(1.0), np.float32(0.0), np.float32(0.0)]",4.0,99647.0,2
2025-08-14_08-18-36,7144,"[np.float32(0.0), np.float32(0.0), np.float32(0.0), np.float32(0.0), np.float32(0.0), np.float32(1.0), np.float32(1.0), np.float32(1.0), np.float32(0.0), np.float32(0.0), np.float32(0.0), np.float32(1.0), np.float32(0.0), np.float32(0.0), np.float32(0.0), np.float32(1.0)]",-2.0,99645.0,13
2025-08-14_08-18-36,7145,"[np.float32(1.0), np.float32(0.0), np.float32(1.0), np.float32(0.0), np.float32(0.0), np.float32(1.0), np.float32(0.0), np.float32(1.0), np.float32(1.0), np.float32(0.0), np.float32(1.0), np.float32(0.0), np.float32(0.0), np.float32(0.0), np.float32(1.0), np.float32(0.0)]",1.0,99646.0,33
2025-08-14_08-18-36,7146,"[np.float32(1.0), np.float32(0.0), np.float32(0.0), np.float32(1.0), np.float32(0.0), np.float32(0.0), np.float32(0.0), np.float32(1.0), np.float32(0.0), np.float32(1.0), np.float32(0.0), np.float32(1.0), np.float32(1.0), np.float32(0.0), np.float32(1.0), np.float32(0.0)]",-4.0,99642.0,8
2025-08-14_08-18-36,7147,"[np.float32(0.0), np.float32(0.0), np.float32(0.0), np.float32(1.0), np.float32(1.0), np.float32(1.0), np.float32(0.0), np.float32(1.0), np.float32(0.0), np.float32(1.0), np.float32(1.0), np.float32(0.0), np.float32(1.0), np.float32(0.0), np.float32(0.0), np.float32(0.0)]",-2.0,99640.0,4
2025-08-14_08-18-36,7148,"[np.float32(1.0), np.float32(0.0), np.float32(1.0), np.float32(0.0), np.float32(1.0), np.float32(1.0), np.float32(0.0), np.float32(1.0), np.float32(1.0), np.float32(1.0), np.float32(0.0), np.float32(0.0), np.float32(0.0), np.float32(1.0), np.float32(0.0), np.float32(0.0)]",-4.0,99636.0,9
2025-08-14_08-18-36,7149,"[np.float32(1.0), np.float32(1.0), np.float32(1.0), np.float32(1.0), np.float32(1.0), np.float32(1.0), np.float32(1.0), np.float32(1.0), np.float32(1.0), np.float32(0.0), np.float32(1.0), np.float32(0.0), np.float32(0.0), np.float32(0.0), np.float32(0.0), np.float32(0.0)]",-1.0,99635.0,24
2025-08-14_08-18-36,7150,"[np.float32(1.0), np.float32(1.0), np.float32(0.0), np.float32(0.0), np.float32(0.0), np.float32(0.0), np.float32(1.0), np.float32(1.0), np.float32(1.0), np.float32(0.0), np.float32(0.0), np.float32(0.0), np.float32(1.0), np.float32(0.0), np.float32(0.0), np.float32(0.0)]",-1.0,99634.0,28
2025-08-14_08-18-36,7151,"[np.float32(0.0), np.float32(0.0), np.float32(1.0), np.float32(0.0), np.float32(1.0), np.float32(1.0), np.float32(0.0), np.float32(1.0), np.float32(0.0), np.float32(1.0), np.float32(0.0), np.float32(0.0), np.float32(0.0), np.float32(1.0), np.float32(0.0), np.float32(0.0)]",-1.0,99633.0,3
2025-08-14_08-18-36,7152,"[np.float32(0.0), np.float32(0.0), np.float32(0.0), np.float32(1.0), np.float32(0.0), np.float32(1.0), np.float32(0.0), np.float32(0.0), np.float32(1.0), np.float32(0.0), np.float32(0.0), np.float32(0.0), np.float32(1.0), np.float32(0.0), np.float32(1.0), np.float32(0.0)]",0.0,99633.0,5
2025-08-14_08-18-36,7153,"[np.float32(1.0), np.float32(0.0), np.float32(0.0), np.float32(1.0), np.float32(0.0), np.float32(1.0), np.float32(0.0), np.float32(0.0), np.float32(1.0), np.float32(0.0), np.float32(0.0), np.float32(0.0), np.float32(0.0), np.float32(1.0), np.float32(0.0), np.float32(0.0)]",4.0,99637.0,27
2025-08-14_08-18-36,7154,"[np.float32(0.0), np.float32(0.0), np.float32(1.0), np.float32(1.0), np.float32(1.0), np.float32(1.0), np.float32(0.0), np.float32(1.0), np.float32(1.0), np.float32(0.0), np.float32(0.0), np.float32(0.0), np.float32(0.0), np.float32(0.0), np.float32(0.0), np.float32(1.0)]",3.0,99640.0,20
2025-08-14_08-18-36,7155,"[np.float32(0.0), np.float32(1.0), np.float32(0.0), np.float32(0.0), np.float32(0.0), np.float32(1.0), np.float32(0.0), np.float32(1.0), np.float32(1.0), np.float32(0.0), np.float32(0.0), np.float32(1.0), np.float32(1.0), np.float32(1.0), np.float32(1.0), np.float32(0.0)]",-3.0,99637.0,6
2025-08-14_08-18-36,7156,"[np.float32(0.0), np.float32(1.0), np.float32(0.0), np.float32(0.0), np.float32(0.0), np.float32(0.0), np.float32(1.0), np.float32(0.0), np.float32(0.0), np.float32(0.0), np.float32(0.0), np.float32(1.0), np.float32(1.0), np.float32(0.0), np.float32(1.0), np.float32(0.0)]",-5.0,99632.0,14
2025-08-14_08-18-36,7157,"[np.float32(0.0), np.float32(1.0), np.float32(0.0), np.float32(0.0), np.float32(0.0), np.float32(0.0), np.float32(1.0), np.float32(1.0), np.float32(1.0), np.float32(1.0), np.float32(1.0), np.float32(1.0), np.float32(1.0), np.float32(0.0), np.float32(1.0), np.float32(0.0)]",-3.0,99629.0,1
2025-08-14_08-18-36,7158,"[np.float32(0.0), np.float32(1.0), np.float32(0.0), np.float32(0.0), np.float32(0.0), np.float32(0.0), np.float32(1.0), np.float32(1.0), np.float32(1.0), np.float32(1.0), np.float32(1.0), np.float32(0.0), np.float32(1.0), np.float32(0.0), np.float32(0.0), np.float32(0.0)]",-4.0,99625.0,30
2025-08-14_08-18-36,7159,"[np.float32(1.0), np.float32(1.0), np.float32(0.0), np.float32(1.0), np.float32(1.0), np.float32(0.0), np.float32(1.0), np.float32(0.0), np.float32(1.0), np.float32(1.0), np.float32(0.0), np.float32(0.0), np.float32(1.0), np.float32(1.0), np.float32(1.0), np.float32(0.0)]",0.0,99625.0,33
2025-08-14_08-18-36,7160,"[np.float32(0.0), np.float32(0.0), np.float32(1.0), np.float32(0.0), np.float32(1.0), np.float32(0.0), np.float32(1.0), np.float32(0.0), np.float32(1.0), np.float32(1.0), np.float32(1.0), np.float32(0.0), np.float32(1.0), np.float32(1.0), np.float32(0.0), np.float32(0.0)]",3.0,99628.0,28
2025-08-14_08-18-36,7161,"[np.float32(0.0), np.float32(1.0), np.float32(0.0), np.float32(0.0), np.float32(1.0), np.float32(1.0), np.float32(0.0), np.float32(1.0), np.float32(0.0), np.float32(1.0), np.float32(1.0), np.float32(0.0), np.float32(0.0), np.float32(1.0), np.float32(1.0), np.float32(0.0)]",2.0,99630.0,8
2025-08-14_08-18-36,7162,"[np.float32(1.0), np.float32(1.0), np.float32(0.0), np.float32(1.0), np.float32(1.0), np.float32(1.0), np.float32(1.0), np.float32(1.0), np.float32(1.0), np.float32(1.0), np.float32(1.0), np.float32(1.0), np.float32(0.0), np.float32(1.0), np.float32(1.0), np.float32(0.0)]",2.0,99632.0,21
2025-08-14_08-18-36,7163,"[np.float32(1.0), np.float32(0.0), np.float32(0.0), np.float32(1.0), np.float32(1.0), np.float32(1.0), np.float32(1.0), np.float32(0.0), np.float32(1.0), np.float32(1.0), np.float32(1.0), np.float32(0.0), np.float32(0.0), np.float32(1.0), np.float32(1.0), np.float32(0.0)]",0.0,99632.0,13
2025-08-14_08-18-36,7164,"[np.float32(0.0), np.float32(0.0), np.float32(0.0), np.float32(1.0), np.float32(0.0), np.float32(0.0), np.float32(0.0), np.float32(0.0), np.float32(0.0), np.float32(1.0), np.float32(0.0), np.float32(1.0), np.float32(1.0), np.float32(0.0), np.float32(1.0), np.float32(1.0)]",-6.0,99626.0,0
2025-08-14_08-18-36,7165,"[np.float32(1.0), np.float32(1.0), np.float32(1.0), np.float32(0.0), np.float32(1.0), np.float32(1.0), np.float32(0.0), np.float32(0.0), np.float32(1.0), np.float32(1.0), np.float32(1.0), np.float32(0.0), np.float32(0.0), np.float32(0.0), np.float32(1.0), np.float32(0.0)]",-5.0,99621.0,15
2025-08-14_08-18-36,7166,"[np.float32(0.0), np.float32(1.0), np.float32(0.0), np.float32(0.0), np.float32(0.0), np.float32(1.0), np.float32(0.0), np.float32(0.0), np.float32(0.0), np.float32(0.0), np.float32(0.0), np.float32(0.0), np.float32(1.0), np.float32(1.0), np.float32(0.0), np.float32(0.0)]",-4.0,99617.0,16
2025-08-14_08-18-36,7167,"[np.float32(1.0), np.float32(0.0), np.float32(0.0), np.float32(0.0), np.float32(0.0), np.float32(0.0), np.float32(0.0), np.float32(1.0), np.float32(0.0), np.float32(0.0), np.float32(1.0), np.float32(0.0), np.float32(0.0), np.float32(1.0), np.float32(0.0), np.float32(0.0)]",2.0,99619.0,15
2025-08-14_08-18-36,7168,"[np.float32(1.0), np.float32(1.0), np.float32(0.0), np.float32(1.0), np.float32(0.0), np.float32(0.0), np.float32(0.0), np.float32(1.0), np.float32(0.0), np.float32(1.0), np.float32(0.0), np.float32(0.0), np.float32(1.0), np.float32(0.0), np.float32(0.0), np.float32(1.0)]",0.0,99619.0,25
2025-08-14_08-18-36,7169,"[np.float32(1.0), np.float32(1.0), np.float32(1.0), np.float32(0.0), np.float32(1.0), np.float32(0.0), np.float32(1.0), np.float32(1.0), np.float32(1.0), np.float32(1.0), np.float32(1.0), np.float32(1.0), np.float32(0.0), np.float32(0.0), np.float32(0.0), np.float32(0.0)]",-2.0,99617.0,29
2025-08-14_08-18-36,7170,"[np.float32(0.0), np.float32(1.0), np.float32(1.0), np.float32(0.0), np.float32(1.0), np.float32(1.0), np.float32(1.0), np.float32(1.0), np.float32(1.0), np.float32(1.0), np.float32(0.0), np.float32(0.0), np.float32(1.0), np.float32(1.0), np.float32(1.0), np.float32(1.0)]",-2.0,99615.0,29
2025-08-14_08-18-36,7171,"[np.float32(0.0), np.float32(1.0), np.float32(1.0), np.float32(1.0), np.float32(1.0), np.float32(0.0), np.float32(1.0), np.float32(1.0), np.float32(1.0), np.float32(0.0), np.float32(1.0), np.float32(0.0), np.float32(1.0), np.float32(1.0), np.float32(0.0), np.float32(0.0)]",2.0,99617.0,15
2025-08-14_08-18-36,7172,"[np.float32(1.0), np.float32(0.0), np.float32(0.0), np.float32(1.0), np.float32(1.0), np.float32(1.0), np.float32(0.0), np.float32(1.0), np.float32(1.0), np.float32(0.0), np.float32(1.0), np.float32(0.0), np.float32(1.0), np.float32(0.0), np.float32(0.0), np.float32(0.0)]",0.0,99617.0,20
2025-08-14_08-18-36,7173,"[np.float32(1.0), np.float32(1.0), np.float32(0.0), np.float32(1.0), np.float32(1.0), np.float32(0.0), np.float32(1.0), np.float32(1.0), np.float32(1.0), np.float32(1.0), np.float32(1.0), np.float32(0.0), np.float32(1.0), np.float32(0.0), np.float32(1.0), np.float32(1.0)]",-5.0,99612.0,12
2025-08-14_08-18-36,7174,"[np.float32(0.0), np.float32(1.0), np.float32(0.0), np.float32(0.0), np.float32(1.0), np.float32(1.0), np.float32(1.0), np.float32(0.0), np.float32(1.0), np.float32(0.0), np.float32(0.0), np.float32(0.0), np.float32(1.0), np.float32(0.0), np.float32(1.0), np.float32(1.0)]",-6.0,99606.0,18
2025-08-14_08-18-36,7175,"[np.float32(0.0), np.float32(0.0), np.float32(1.0), np.float32(1.0), np.float32(0.0), np.float32(1.0), np.float32(1.0), np.float32(0.0), np.float32(1.0), np.float32(0.0), np.float32(1.0), np.float32(0.0), np.float32(1.0), np.float32(1.0), np.float32(0.0), np.float32(1.0)]",-4.0,99602.0,18
2025-08-14_08-18-36,7176,"[np.float32(0.0), np.float32(1.0), np.float32(1.0), np.float32(0.0), np.float32(1.0), np.float32(1.0), np.float32(1.0), np.float32(1.0), np.float32(1.0), np.float32(0.0), np.float32(1.0), np.float32(0.0), np.float32(1.0), np.float32(1.0), np.float32(1.0), np.float32(1.0)]",-4.0,99598.0,1
2025-08-14_08-18-36,7177,"[np.float32(1.0), np.float32(1.0), np.float32(0.0), np.float32(0.0), np.float32(0.0), np.float32(0.0), np.float32(0.0), np.float32(1.0), np.float32(1.0), np.float32(1.0), np.float32(1.0), np.float32(0.0), np.float32(1.0), np.float32(1.0), np.float32(1.0), np.float32(0.0)]",2.0,99600.0,32
2025-08-14_08-18-36,7178,"[np.float32(0.0), np.float32(0.0), np.float32(0.0), np.float32(1.0), np.float32(0.0), np.float32(1.0), np.float32(0.0), np.float32(0.0), np.float32(0.0), np.float32(1.0), np.float32(1.0), np.float32(0.0), np.float32(1.0), np.float32(1.0), np.float32(1.0), np.float32(0.0)]",0.0,99600.0,31
2025-08-14_08-18-36,7179,"[np.float32(0.0), np.float32(1.0), np.float32(0.0), np.float32(0.0), np.float32(1.0), np.float32(1.0), np.float32(0.0), np.float32(0.0), np.float32(1.0), np.float32(0.0), np.float32(1.0), np.float32(0.0), np.float32(0.0), np.float32(0.0), np.float32(1.0), np.float32(1.0)]",0.0,99600.0,2
2025-08-14_08-18-36,7180,"[np.float32(0.0), np.float32(1.0), np.float32(0.0), np.float32(1.0), np.float32(1.0), np.float32(0.0), np.float32(0.0), np.float32(0.0), np.float32(1.0), np.float32(1.0), np.float32(0.0), np.float32(1.0), np.float32(1.0), np.float32(0.0), np.float32(0.0), np.float32(0.0)]",0.0,99600.0,29
2025-08-14_08-18-36,7181,"[np.float32(0.0), np.float32(1.0), np.float32(1.0), np.float32(1.0), np.float32(1.0), np.float32(1.0), np.float32(0.0), np.float32(1.0), np.float32(0.0), np.float32(0.0), np.float32(0.0), np.float32(0.0), np.float32(0.0), np.float32(1.0), np.float32(1.0), np.float32(1.0)]",1.0,99601.0,19
2025-08-14_08-18-36,7182,"[np.float32(0.0), np.float32(0.0), np.float32(1.0), np.float32(0.0), np.float32(1.0), np.float32(1.0), np.float32(1.0), np.float32(0.0), np.float32(1.0), np.float32(0.0), np.float32(0.0), np.float32(1.0), np.float32(0.0), np.float32(1.0), np.float32(0.0), np.float32(0.0)]",0.0,99601.0,24
2025-08-14_08-18-36,7183,"[np.float32(1.0), np.float32(1.0), np.float32(0.0), np.float32(1.0), np.float32(0.0), np.float32(1.0), np.float32(1.0), np.float32(1.0), np.float32(0.0), np.float32(0.0), np.float32(0.0), np.float32(0.0), np.float32(1.0), np.float32(0.0), np.float32(1.0), np.float32(0.0)]",-3.0,99598.0,18
2025-08-14_08-18-36,7184,"[np.float32(0.0), np.float32(0.0), np.float32(0.0), np.float32(0.0), np.float32(0.0), np.float32(1.0), np.float32(1.0), np.float32(1.0), np.float32(1.0), np.float32(1.0), np.float32(0.0), np.float32(1.0), np.float32(0.0), np.float32(0.0), np.float32(1.0), np.float32(1.0)]",0.0,99598.0,20
2025-08-14_08-18-36,7185,"[np.float32(1.0), np.float32(1.0), np.float32(1.0), np.float32(0.0), np.float32(0.0), np.float32(1.0), np.float32(0.0), np.float32(1.0), np.float32(1.0), np.float32(1.0), np.float32(1.0), np.float32(0.0), np.float32(1.0), np.float32(1.0), np.float32(1.0), np.float32(0.0)]",-3.0,99595.0,17
2025-08-14_08-18-36,7186,"[np.float32(1.0), np.float32(0.0), np.float32(1.0), np.float32(1.0), np.float32(0.0), np.float32(0.0), np.float32(1.0), np.float32(1.0), np.float32(0.0), np.float32(1.0), np.float32(0.0), np.float32(0.0), np.float32(0.0), np.float32(0.0), np.float32(0.0), np.float32(0.0)]",-4.0,99591.0,0
2025-08-14_08-18-36,7187,"[np.float32(0.0), np.float32(1.0), np.float32(0.0), np.float32(1.0), np.float32(1.0), np.float32(0.0), np.float32(1.0), np.float32(1.0), np.float32(1.0), np.float32(0.0), np.float32(0.0), np.float32(1.0), np.float32(0.0), np.float32(1.0), np.float32(1.0), np.float32(0.0)]",1.0,99592.0,35
2025-08-14_08-18-36,7188,"[np.float32(0.0), np.float32(0.0), np.float32(0.0), np.float32(1.0), np.float32(1.0), np.float32(1.0), np.float32(0.0), np.float32(1.0), np.float32(1.0), np.float32(1.0), np.float32(0.0), np.float32(0.0), np.float32(0.0), np.float32(0.0), np.float32(1.0), np.float32(0.0)]",1.0,99593.0,24
2025-08-14_08-18-36,7189,"[np.float32(0.0), np.float32(1.0), np.float32(0.0), np.float32(0.0), np.float32(0.0), np.float32(0.0), np.float32(0.0), np.float32(1.0), np.float32(1.0), np.float32(0.0), np.float32(0.0), np.float32(1.0), np.float32(0.0), np.float32(1.0), np.float32(1.0), np.float32(0.0)]",-3.0,99590.0,14
2025-08-14_08-18-36,7190,"[np.float32(1.0), np.float32(1.0), np.float32(0.0), np.float32(1.0), np.float32(1.0), np.float32(1.0), np.float32(1.0), np.float32(1.0), np.float32(1.0), np.float32(0.0), np.float32(1.0), np.float32(1.0), np.float32(1.0), np.float32(1.0), np.float32(1.0), np.float32(0.0)]",2.0,99592.0,5
2025-08-14_08-18-36,7191,"[np.float32(0.0), np.float32(1.0), np.float32(1.0), np.float32(0.0), np.float32(0.0), np.float32(1.0), np.float32(1.0), np.float32(0.0), np.float32(1.0), np.float32(1.0), np.float32(0.0), np.float32(1.0), np.float32(0.0), np.float32(1.0), np.float32(1.0), np.float32(0.0)]",1.0,99593.0,8
2025-08-14_08-18-36,7192,"[np.float32(1.0), np.float32(0.0), np.float32(0.0), np.float32(1.0), np.float32(1.0), np.float32(1.0), np.float32(1.0), np.float32(0.0), np.float32(0.0), np.float32(1.0), np.float32(1.0), np.float32(0.0), np.float32(0.0), np.float32(0.0), np.float32(0.0), np.float32(1.0)]",0.0,99593.0,10
2025-08-14_08-18-36,7193,"[np.float32(1.0), np.float32(1.0), np.float32(1.0), np.float32(1.0), np.float32(0.0), np.float32(0.0), np.float32(1.0), np.float32(0.0), np.float32(0.0), np.float32(0.0), np.float32(1.0), np.float32(0.0), np.float32(0.0), np.float32(0.0), np.float32(0.0), np.float32(0.0)]",-2.0,99591.0,22
2025-08-14_08-18-36,7194,"[np.float32(1.0), np.float32(0.0), np.float32(1.0), np.float32(1.0), np.float32(0.0), np.float32(1.0), np.float32(1.0), np.float32(1.0), np.float32(0.0), np.float32(1.0), np.float32(0.0), np.float32(1.0), np.float32(0.0), np.float32(0.0), np.float32(1.0), np.float32(1.0)]",0.0,99591.0,18
2025-08-14_08-18-36,7195,"[np.float32(0.0), np.float32(1.0), np.float32(0.0), np.float32(0.0), np.float32(1.0), np.float32(1.0), np.float32(0.0), np.float32(1.0), np.float32(0.0), np.float32(0.0), np.float32(0.0), np.float32(0.0), np.float32(0.0), np.float32(0.0), np.float32(0.0), np.float32(1.0)]",0.0,99591.0,23
2025-08-14_08-18-36,7196,"[np.float32(1.0), np.float32(1.0), np.float32(0.0), np.float32(1.0), np.float32(1.0), np.float32(1.0), np.float32(1.0), np.float32(0.0), np.float32(1.0), np.float32(1.0), np.float32(1.0), np.float32(0.0), np.float32(0.0), np.float32(0.0), np.float32(1.0), np.float32(1.0)]",1.0,99592.0,9
2025-08-14_08-18-36,7197,"[np.float32(0.0), np.float32(0.0), np.float32(0.0), np.float32(1.0), np.float32(0.0), np.float32(1.0), np.float32(0.0), np.float32(1.0), np.float32(1.0), np.float32(0.0), np.float32(0.0), np.float32(1.0), np.float32(1.0), np.float32(1.0), np.float32(0.0), np.float32(0.0)]",-5.0,99587.0,5
2025-08-14_08-18-36,7198,"[np.float32(0.0), np.float32(1.0), np.float32(1.0), np.float32(0.0), np.float32(1.0), np.float32(0.0), np.float32(1.0), np.float32(0.0), np.float32(1.0), np.float32(0.0), np.float32(0.0), np.float32(0.0), np.float32(1.0), np.float32(1.0), np.float32(1.0), np.float32(0.0)]",-5.0,99582.0,23
2025-08-14_08-18-36,7199,"[np.float32(0.0), np.float32(0.0), np.float32(1.0), np.float32(0.0), np.float32(0.0), np.float32(1.0), np.float32(1.0), np.float32(0.0), np.float32(1.0), np.float32(1.0), np.float32(0.0), np.float32(1.0), np.float32(0.0), np.float32(0.0), np.float32(0.0), np.float32(0.0)]",2.0,99584.0,6
2025-08-14_08-18-36,7200,"[np.float32(1.0), np.float32(1.0), np.float32(1.0), np.float32(0.0), np.float32(1.0), np.float32(1.0), np.float32(1.0), np.float32(0.0), np.float32(0.0), np.float32(0.0), np.float32(0.0), np.float32(1.0), np.float32(0.0), np.float32(0.0), np.float32(0.0), np.float32(1.0)]",-2.0,99582.0,32
2025-08-14_08-18-36,7201,"[np.float32(0.0), np.float32(0.0), np.float32(0.0), np.float32(1.0), np.float32(0.0), np.float32(0.0), np.float32(1.0), np.float32(0.0), np.float32(1.0), np.float32(1.0), np.float32(0.0), np.float32(0.0), np.float32(0.0), np.float32(0.0), np.float32(0.0), np.float32(1.0)]",0.0,99582.0,3
2025-08-14_08-18-36,7202,"[np.float32(0.0), np.float32(1.0), np.float32(0.0), np.float32(0.0), np.float32(0.0), np.float32(1.0), np.float32(0.0), np.float32(1.0), np.float32(1.0), np.float32(0.0), np.float32(1.0), np.float32(0.0), np.float32(1.0), np.float32(1.0), np.float32(0.0), np.float32(0.0)]",-7.0,99575.0,9
2025-08-14_08-18-36,7203,"[np.float32(0.0), np.float32(0.0), np.float32(1.0), np.float32(1.0), np.float32(1.0), np.float32(1.0), np.float32(0.0), np.float32(0.0), np.float32(0.0), np.float32(0.0), np.float32(0.0), np.float32(0.0), np.float32(0.0), np.float32(1.0), np.float32(1.0), np.float32(0.0)]",1.0,99576.0,30
2025-08-14_08-18-36,7204,"[np.float32(0.0), np.float32(0.0), np.float32(0.0), np.float32(0.0), np.float32(1.0), np.float32(1.0), np.float32(1.0), np.float32(0.0), np.float32(0.0), np.float32(1.0), np.float32(0.0), np.float32(1.0), np.float32(1.0), np.float32(0.0), np.float32(1.0), np.float32(0.0)]",1.0,99577.0,24
2025-08-14_08-18-36,7205,"[np.float32(0.0), np.float32(0.0), np.float32(1.0), np.float32(0.0), np.float32(0.0), np.float32(1.0), np.float32(1.0), np.float32(1.0), np.float32(1.0), np.float32(0.0), np.float32(0.0), np.float32(0.0), np.float32(0.0), np.float32(1.0), np.float32(0.0), np.float32(0.0)]",1.0,99578.0,0
2025-08-14_08-18-36,7206,"[np.float32(0.0), np.float32(0.0), np.float32(0.0), np.float32(0.0), np.float32(1.0), np.float32(0.0), np.float32(1.0), np.float32(0.0), np.float32(1.0), np.float32(0.0), np.float32(1.0), np.float32(0.0), np.float32(0.0), np.float32(1.0), np.float32(1.0), np.float32(0.0)]",3.0,99581.0,32
2025-08-14_08-18-36,7207,"[np.float32(1.0), np.float32(0.0), np.float32(0.0), np.float32(0.0), np.float32(1.0), np.float32(0.0), np.float32(0.0), np.float32(1.0), np.float32(1.0), np.float32(0.0), np.float32(1.0), np.float32(1.0), np.float32(0.0), np.float32(1.0), np.float32(1.0), np.float32(1.0)]",-1.0,99580.0,2
2025-08-14_08-18-36,7208,"[np.float32(0.0), np.float32(0.0), np.float32(0.0), np.float32(0.0), np.float32(0.0), np.float32(0.0), np.float32(0.0), np.float32(1.0), np.float32(1.0), np.float32(1.0), np.float32(1.0), np.float32(0.0), np.float32(1.0), np.float32(1.0), np.float32(0.0), np.float32(0.0)]",0.0,99580.0,31
2025-08-14_08-18-36,7209,"[np.float32(1.0), np.float32(1.0), np.float32(1.0), np.float32(0.0), np.float32(0.0), np.float32(1.0), np.float32(0.0), np.float32(1.0), np.float32(0.0), np.float32(1.0), np.float32(0.0), np.float32(0.0), np.float32(0.0), np.float32(1.0), np.float32(0.0), np.float32(1.0)]",-1.0,99579.0,12
2025-08-14_08-18-36,7210,"[np.float32(1.0), np.float32(0.0), np.float32(0.0), np.float32(0.0), np.float32(0.0), np.float32(1.0), np.float32(1.0), np.float32(0.0), np.float32(1.0), np.float32(0.0), np.float32(1.0), np.float32(1.0), np.float32(1.0), np.float32(1.0), np.float32(0.0), np.float32(0.0)]",-3.0,99576.0,22
2025-08-14_08-18-36,7211,"[np.float32(0.0), np.float32(0.0), np.float32(1.0), np.float32(1.0), np.float32(0.0), np.float32(0.0), np.float32(0.0), np.float32(1.0), np.float32(0.0), np.float32(1.0), np.float32(1.0), np.float32(0.0), np.float32(0.0), np.float32(1.0), np.float32(0.0), np.float32(0.0)]",-1.0,99575.0,34
2025-08-14_08-18-36,7212,"[np.float32(0.0), np.float32(0.0), np.float32(0.0), np.float32(1.0), np.float32(1.0), np.float32(0.0), np.float32(0.0), np.float32(1.0), np.float32(1.0), np.float32(0.0), np.float32(0.0), np.float32(0.0), np.float32(1.0), np.float32(0.0), np.float32(0.0), np.float32(1.0)]",-3.0,99572.0,24
2025-08-14_08-18-36,7213,"[np.float32(1.0), np.float32(1.0), np.float32(1.0), np.float32(1.0), np.float32(0.0), np.float32(0.0), np.float32(0.0), np.float32(0.0), np.float32(1.0), np.float32(1.0), np.float32(1.0), np.float32(1.0), np.float32(0.0), np.float32(1.0), np.float32(1.0), np.float32(0.0)]",0.0,99572.0,22
2025-08-14_08-18-36,7214,"[np.float32(1.0), np.float32(0.0), np.float32(0.0), np.float32(0.0), np.float32(1.0), np.float32(0.0), np.float32(1.0), np.float32(1.0), np.float32(1.0), np.float32(0.0), np.float32(0.0), np.float32(0.0), np.float32(0.0), np.float32(1.0), np.float32(1.0), np.float32(0.0)]",-4.0,99568.0,31
2025-08-14_08-18-36,7215,"[np.float32(1.0), np.float32(0.0), np.float32(0.0), np.float32(1.0), np.float32(1.0), np.float32(0.0), np.float32(0.0), np.float32(0.0), np.float32(0.0), np.float32(1.0), np.float32(0.0), np.float32(0.0), np.float32(1.0), np.float32(1.0), np.float32(0.0), np.float32(0.0)]",-4.0,99564.0,33
2025-08-14_08-18-36,7216,"[np.float32(1.0), np.float32(1.0), np.float32(1.0), np.float32(0.0), np.float32(0.0), np.float32(1.0), np.float32(1.0), np.float32(0.0), np.float32(1.0), np.float32(1.0), np.float32(0.0), np.float32(1.0), np.float32(0.0), np.float32(0.0), np.float32(1.0), np.float32(0.0)]",-1.0,99563.0,11
2025-08-14_08-18-36,7217,"[np.float32(0.0), np.float32(1.0), np.float32(1.0), np.float32(1.0), np.float32(1.0), np.float32(0.0), np.float32(0.0), np.float32(1.0), np.float32(1.0), np.float32(1.0), np.float32(1.0), np.float32(0.0), np.float32(0.0), np.float32(1.0), np.float32(0.0), np.float32(0.0)]",-1.0,99562.0,34
2025-08-14_08-18-36,7218,"[np.float32(1.0), np.float32(1.0), np.float32(0.0), np.float32(0.0), np.float32(0.0), np.float32(0.0), np.float32(1.0), np.float32(1.0), np.float32(1.0), np.float32(1.0), np.float32(1.0), np.float32(0.0), np.float32(1.0), np.float32(1.0), np.float32(0.0), np.float32(1.0)]",1.0,99563.0,19
2025-08-14_08-18-36,7219,"[np.float32(1.0), np.float32(0.0), np.float32(1.0), np.float32(1.0), np.float32(1.0), np.float32(0.0), np.float32(0.0), np.float32(1.0), np.float32(0.0), np.float32(0.0), np.float32(0.0), np.float32(0.0), np.float32(0.0), np.float32(1.0), np.float32(0.0), np.float32(1.0)]",-3.0,99560.0,30
2025-08-14_08-18-36,7220,"[np.float32(1.0), np.float32(0.0), np.float32(1.0), np.float32(1.0), np.float32(0.0), np.float32(0.0), np.float32(0.0), np.float32(0.0), np.float32(0.0), np.float32(0.0), np.float32(1.0), np.float32(0.0), np.float32(1.0), np.float32(1.0), np.float32(0.0), np.float32(0.0)]",-1.0,99559.0,17
2025-08-14_08-18-36,7221,"[np.float32(0.0), np.float32(1.0), np.float32(1.0), np.float32(0.0), np.float32(0.0), np.float32(0.0), np.float32(0.0), np.float32(0.0), np.float32(1.0), np.float32(1.0), np.float32(0.0), np.float32(0.0), np.float32(1.0), np.float32(1.0), np.float32(0.0), np.float32(0.0)]",4.0,99563.0,4
2025-08-14_08-18-36,7222,"[np.float32(1.0), np.float32(1.0), np.float32(0.0), np.float32(1.0), np.float32(0.0), np.float32(0.0), np.float32(1.0), np.float32(1.0), np.float32(1.0), np.float32(0.0), np.float32(1.0), np.float32(0.0), np.float32(1.0), np.float32(0.0), np.float32(1.0), np.float32(0.0)]",4.0,99567.0,11
2025-08-14_08-18-36,7223,"[np.float32(1.0), np.float32(0.0), np.float32(0.0), np.float32(1.0), np.float32(0.0), np.float32(1.0), np.float32(0.0), np.float32(0.0), np.float32(0.0), np.float32(1.0), np.float32(1.0), np.float32(0.0), np.float32(1.0), np.float32(1.0), np.float32(0.0), np.float32(0.0)]",-2.0,99565.0,15
2025-08-14_08-18-36,7224,"[np.float32(0.0), np.float32(0.0), np.float32(0.0), np.float32(0.0), np.float32(0.0), np.float32(0.0), np.float32(1.0), np.float32(1.0), np.float32(1.0), np.float32(1.0), np.float32(1.0), np.float32(0.0), np.float32(1.0), np.float32(1.0), np.float32(0.0), np.float32(0.0)]",-4.0,99561.0,24
2025-08-14_08-18-36,7225,"[np.float32(1.0), np.float32(1.0), np.float32(0.0), np.float32(0.0), np.float32(0.0), np.float32(1.0), np.float32(1.0), np.float32(1.0), np.float32(0.0), np.float32(0.0), np.float32(0.0), np.float32(1.0), np.float32(1.0), np.float32(1.0), np.float32(0.0), np.float32(0.0)]",-3.0,99558.0,5
2025-08-14_08-18-36,7226,"[np.float32(1.0), np.float32(0.0), np.float32(0.0), np.float32(1.0), np.float32(0.0), np.float32(1.0), np.float32(1.0), np.float32(1.0), np.float32(0.0), np.float32(0.0), np.float32(1.0), np.float32(1.0), np.float32(0.0), np.float32(0.0), np.float32(1.0), np.float32(0.0)]",0.0,99558.0,12
2025-08-14_08-18-36,7227,"[np.float32(1.0), np.float32(0.0), np.float32(1.0), np.float32(0.0), np.float32(1.0), np.float32(0.0), np.float32(1.0), np.float32(0.0), np.float32(0.0), np.float32(0.0), np.float32(1.0), np.float32(1.0), np.float32(1.0), np.float32(1.0), np.float32(1.0), np.float32(1.0)]",-2.0,99556.0,24
2025-08-14_08-18-36,7228,"[np.float32(0.0), np.float32(0.0), np.float32(0.0), np.float32(1.0), np.float32(1.0), np.float32(1.0), np.float32(1.0), np.float32(1.0), np.float32(0.0), np.float32(0.0), np.float32(0.0), np.float32(1.0), np.float32(1.0), np.float32(0.0), np.float32(0.0), np.float32(1.0)]",35.0,99591.0,7
2025-08-14_08-18-36,7229,"[np.float32(0.0), np.float32(1.0), np.float32(1.0), np.float32(1.0), np.float32(1.0), np.float32(1.0), np.float32(1.0), np.float32(1.0), np.float32(1.0), np.float32(0.0), np.float32(0.0), np.float32(1.0), np.float32(1.0), np.float32(1.0), np.float32(1.0), np.float32(0.0)]",-3.0,99588.0,17
2025-08-14_08-18-36,7230,"[np.float32(0.0), np.float32(1.0), np.float32(1.0), np.float32(0.0), np.float32(0.0), np.float32(0.0), np.float32(1.0), np.float32(1.0), np.float32(1.0), np.float32(0.0), np.float32(0.0), np.float32(0.0), np.float32(0.0), np.float32(0.0), np.float32(1.0), np.float32(0.0)]",-1.0,99587.0,15
2025-08-14_08-18-36,7231,"[np.float32(0.0), np.float32(0.0), np.float32(1.0), np.float32(0.0), np.float32(0.0), np.float32(1.0), np.float32(0.0), np.float32(1.0), np.float32(0.0), np.float32(1.0), np.float32(1.0), np.float32(1.0), np.float32(1.0), np.float32(0.0), np.float32(0.0), np.float32(1.0)]",31.0,99618.0,7
2025-08-14_08-18-36,7232,"[np.float32(0.0), np.float32(0.0), np.float32(0.0), np.float32(1.0), np.float32(0.0), np.float32(0.0), np.float32(1.0), np.float32(0.0), np.float32(1.0), np.float32(1.0), np.float32(0.0), np.float32(0.0), np.float32(0.0), np.float32(1.0), np.float32(1.0), np.float32(1.0)]",-4.0,99614.0,20
2025-08-14_08-18-36,7233,"[np.float32(0.0), np.float32(0.0), np.float32(1.0), np.float32(1.0), np.float32(0.0), np.float32(0.0), np.float32(0.0), np.float32(1.0), np.float32(1.0), np.float32(1.0), np.float32(0.0), np.float32(0.0), np.float32(1.0), np.float32(0.0), np.float32(0.0), np.float32(0.0)]",2.0,99616.0,13
2025-08-14_08-18-36,7234,"[np.float32(1.0), np.float32(1.0), np.float32(0.0), np.float32(1.0), np.float32(0.0), np.float32(0.0), np.float32(1.0), np.float32(0.0), np.float32(1.0), np.float32(0.0), np.float32(1.0), np.float32(0.0), np.float32(1.0), np.float32(0.0), np.float32(1.0), np.float32(0.0)]",2.0,99618.0,29
2025-08-14_08-18-36,7235,"[np.float32(0.0), np.float32(0.0), np.float32(1.0), np.float32(1.0), np.float32(0.0), np.float32(0.0), np.float32(0.0), np.float32(1.0), np.float32(1.0), np.float32(1.0), np.float32(1.0), np.float32(1.0), np.float32(1.0), np.float32(0.0), np.float32(1.0), np.float32(0.0)]",-4.0,99614.0,2
2025-08-14_08-18-36,7236,"[np.float32(1.0), np.float32(1.0), np.float32(1.0), np.float32(1.0), np.float32(0.0), np.float32(0.0), np.float32(1.0), np.float32(1.0), np.float32(0.0), np.float32(1.0), np.float32(0.0), np.float32(0.0), np.float32(0.0), np.float32(1.0), np.float32(0.0), np.float32(1.0)]",1.0,99615.0,28
2025-08-14_08-18-36,7237,"[np.float32(0.0), np.float32(1.0), np.float32(1.0), np.float32(0.0), np.float32(0.0), np.float32(1.0), np.float32(1.0), np.float32(0.0), np.float32(1.0), np.float32(0.0), np.float32(0.0), np.float32(1.0), np.float32(1.0), np.float32(0.0), np.float32(1.0), np.float32(0.0)]",2.0,99617.0,6
2025-08-14_08-18-36,7238,"[np.float32(0.0), np.float32(1.0), np.float32(1.0), np.float32(0.0), np.float32(0.0), np.float32(0.0), np.float32(1.0), np.float32(0.0), np.float32(1.0), np.float32(1.0), np.float32(0.0), np.float32(0.0), np.float32(0.0), np.float32(0.0), np.float32(0.0), np.float32(1.0)]",-4.0,99613.0,15
2025-08-14_08-18-36,7239,"[np.float32(1.0), np.float32(0.0), np.float32(0.0), np.float32(0.0), np.float32(0.0), np.float32(1.0), np.float32(1.0), np.float32(0.0), np.float32(0.0), np.float32(0.0), np.float32(1.0), np.float32(1.0), np.float32(0.0), np.float32(1.0), np.float32(0.0), np.float32(1.0)]",3.0,99616.0,21
2025-08-14_08-18-36,7240,"[np.float32(0.0), np.float32(0.0), np.float32(1.0), np.float32(0.0), np.float32(0.0), np.float32(0.0), np.float32(0.0), np.float32(1.0), np.float32(0.0), np.float32(1.0), np.float32(1.0), np.float32(1.0), np.float32(0.0), np.float32(0.0), np.float32(0.0), np.float32(1.0)]",-1.0,99615.0,8
2025-08-14_08-18-36,7241,"[np.float32(1.0), np.float32(0.0), np.float32(0.0), np.float32(0.0), np.float32(0.0), np.float32(1.0), np.float32(1.0), np.float32(1.0), np.float32(0.0), np.float32(1.0), np.float32(0.0), np.float32(0.0), np.float32(0.0), np.float32(1.0), np.float32(0.0), np.float32(0.0)]",-3.0,99612.0,8
2025-08-14_08-18-36,7242,"[np.float32(1.0), np.float32(0.0), np.float32(1.0), np.float32(0.0), np.float32(1.0), np.float32(1.0), np.float32(0.0), np.float32(1.0), np.float32(1.0), np.float32(0.0), np.float32(1.0), np.float32(0.0), np.float32(0.0), np.float32(1.0), np.float32(0.0), np.float32(0.0)]",-1.0,99611.0,8
2025-08-14_08-18-36,7243,"[np.float32(1.0), np.float32(1.0), np.float32(1.0), np.float32(1.0), np.float32(0.0), np.float32(0.0), np.float32(0.0), np.float32(0.0), np.float32(0.0), np.float32(0.0), np.float32(0.0), np.float32(1.0), np.float32(1.0), np.float32(1.0), np.float32(0.0), np.float32(1.0)]",-4.0,99607.0,16
2025-08-14_08-18-36,7244,"[np.float32(1.0), np.float32(0.0), np.float32(1.0), np.float32(1.0), np.float32(0.0), np.float32(0.0), np.float32(1.0), np.float32(1.0), np.float32(1.0), np.float32(0.0), np.float32(0.0), np.float32(0.0), np.float32(1.0), np.float32(0.0), np.float32(1.0), np.float32(0.0)]",0.0,99607.0,33
2025-08-14_08-18-36,7245,"[np.float32(0.0), np.float32(1.0), np.float32(0.0), np.float32(0.0), np.float32(0.0), np.float32(1.0), np.float32(0.0), np.float32(1.0), np.float32(0.0), np.float32(0.0), np.float32(1.0), np.float32(0.0), np.float32(1.0), np.float32(1.0), np.float32(0.0), np.float32(1.0)]",3.0,99610.0,26
2025-08-14_08-18-36,7246,"[np.float32(0.0), np.float32(1.0), np.float32(0.0), np.float32(0.0), np.float32(0.0), np.float32(1.0), np.float32(0.0), np.float32(1.0), np.float32(0.0), np.float32(1.0), np.float32(0.0), np.float32(0.0), np.float32(0.0), np.float32(0.0), np.float32(1.0), np.float32(1.0)]",-1.0,99609.0,30
2025-08-14_08-18-36,7247,"[np.float32(1.0), np.float32(1.0), np.float32(1.0), np.float32(0.0), np.float32(1.0), np.float32(0.0), np.float32(1.0), np.float32(0.0), np.float32(0.0), np.float32(0.0), np.float32(0.0), np.float32(1.0), np.float32(0.0), np.float32(1.0), np.float32(0.0), np.float32(0.0)]",0.0,99609.0,30
2025-08-14_08-18-36,7248,"[np.float32(1.0), np.float32(1.0), np.float32(1.0), np.float32(1.0), np.float32(0.0), np.float32(1.0), np.float32(1.0), np.float32(0.0), np.float32(1.0), np.float32(1.0), np.float32(0.0), np.float32(1.0), np.float32(1.0), np.float32(0.0), np.float32(0.0), np.float32(1.0)]",-4.0,99605.0,14
2025-08-14_08-18-36,7249,"[np.float32(1.0), np.float32(1.0), np.float32(1.0), np.float32(1.0), np.float32(1.0), np.float32(0.0), np.float32(0.0), np.float32(0.0), np.float32(0.0), np.float32(0.0), np.float32(0.0), np.float32(1.0), np.float32(0.0), np.float32(1.0), np.float32(0.0), np.float32(0.0)]",-1.0,99604.0,1
2025-08-14_08-18-36,7250,"[np.float32(0.0), np.float32(1.0), np.float32(0.0), np.float32(0.0), np.float32(0.0), np.float32(0.0), np.float32(0.0), np.float32(1.0), np.float32(1.0), np.float32(0.0), np.float32(0.0), np.float32(0.0), np.float32(1.0), np.float32(0.0), np.float32(0.0), np.float32(0.0)]",1.0,99605.0,20
2025-08-14_08-18-36,7251,"[np.float32(0.0), np.float32(1.0), np.float32(1.0), np.float32(0.0), np.float32(0.0), np.float32(1.0), np.float32(0.0), np.float32(1.0), np.float32(1.0), np.float32(0.0), np.float32(1.0), np.float32(0.0), np.float32(0.0), np.float32(1.0), np.float32(1.0), np.float32(0.0)]",0.0,99605.0,15
2025-08-14_08-18-36,7252,"[np.float32(0.0), np.float32(1.0), np.float32(0.0), np.float32(0.0), np.float32(0.0), np.float32(0.0), np.float32(1.0), np.float32(0.0), np.float32(0.0), np.float32(1.0), np.float32(0.0), np.float32(0.0), np.float32(1.0), np.float32(0.0), np.float32(0.0), np.float32(1.0)]",-3.0,99602.0,35
2025-08-14_08-18-36,7253,"[np.float32(1.0), np.float32(0.0), np.float32(0.0), np.float32(0.0), np.float32(0.0), np.float32(1.0), np.float32(1.0), np.float32(0.0), np.float32(1.0), np.float32(0.0), np.float32(1.0), np.float32(1.0), np.float32(1.0), np.float32(0.0), np.float32(1.0), np.float32(1.0)]",-6.0,99596.0,15
2025-08-14_08-18-36,7254,"[np.float32(0.0), np.float32(1.0), np.float32(0.0), np.float32(1.0), np.float32(1.0), np.float32(0.0), np.float32(0.0), np.float32(1.0), np.float32(1.0), np.float32(1.0), np.float32(0.0), np.float32(0.0), np.float32(0.0), np.float32(0.0), np.float32(0.0), np.float32(0.0)]",3.0,99599.0,17
2025-08-14_08-18-36,7255,"[np.float32(0.0), np.float32(1.0), np.float32(1.0), np.float32(0.0), np.float32(0.0), np.float32(1.0), np.float32(0.0), np.float32(1.0), np.float32(0.0), np.float32(1.0), np.float32(1.0), np.float32(0.0), np.float32(0.0), np.float32(0.0), np.float32(0.0), np.float32(0.0)]",6.0,99605.0,22
2025-08-14_08-18-36,7256,"[np.float32(1.0), np.float32(1.0), np.float32(0.0), np.float32(0.0), np.float32(0.0), np.float32(1.0), np.float32(1.0), np.float32(1.0), np.float32(0.0), np.float32(0.0), np.float32(1.0), np.float32(0.0), np.float32(0.0), np.float32(0.0), np.float32(1.0), np.float32(1.0)]",-1.0,99604.0,33
2025-08-14_08-18-36,7257,"[np.float32(1.0), np.float32(1.0), np.float32(0.0), np.float32(0.0), np.float32(0.0), np.float32(0.0), np.float32(1.0), np.float32(1.0), np.float32(1.0), np.float32(1.0), np.float32(1.0), np.float32(1.0), np.float32(0.0), np.float32(1.0), np.float32(1.0), np.float32(0.0)]",1.0,99605.0,36
2025-08-14_08-18-36,7258,"[np.float32(1.0), np.float32(1.0), np.float32(0.0), np.float32(1.0), np.float32(1.0), np.float32(1.0), np.float32(0.0), np.float32(0.0), np.float32(1.0), np.float32(1.0), np.float32(1.0), np.float32(0.0), np.float32(1.0), np.float32(1.0), np.float32(0.0), np.float32(0.0)]",2.0,99607.0,31
2025-08-14_08-18-36,7259,"[np.float32(0.0), np.float32(0.0), np.float32(1.0), np.float32(0.0), np.float32(0.0), np.float32(0.0), np.float32(0.0), np.float32(1.0), np.float32(0.0), np.float32(0.0), np.float32(1.0), np.float32(0.0), np.float32(0.0), np.float32(1.0), np.float32(1.0), np.float32(0.0)]",0.0,99607.0,0
2025-08-14_08-18-36,7260,"[np.float32(0.0), np.float32(1.0), np.float32(1.0), np.float32(0.0), np.float32(0.0), np.float32(0.0), np.float32(1.0), np.float32(1.0), np.float32(1.0), np.float32(1.0), np.float32(0.0), np.float32(0.0), np.float32(1.0), np.float32(1.0), np.float32(0.0), np.float32(1.0)]",2.0,99609.0,34
2025-08-14_08-18-36,7261,"[np.float32(1.0), np.float32(1.0), np.float32(0.0), np.float32(0.0), np.float32(0.0), np.float32(1.0), np.float32(0.0), np.float32(1.0), np.float32(1.0), np.float32(1.0), np.float32(0.0), np.float32(0.0), np.float32(1.0), np.float32(1.0), np.float32(0.0), np.float32(0.0)]",-1.0,99608.0,24
2025-08-14_08-18-36,7262,"[np.float32(0.0), np.float32(1.0), np.float32(1.0), np.float32(0.0), np.float32(1.0), np.float32(1.0), np.float32(1.0), np.float32(1.0), np.float32(0.0), np.float32(0.0), np.float32(1.0), np.float32(1.0), np.float32(0.0), np.float32(1.0), np.float32(1.0), np.float32(1.0)]",-6.0,99602.0,25
2025-08-14_08-18-36,7263,"[np.float32(1.0), np.float32(1.0), np.float32(0.0), np.float32(1.0), np.float32(1.0), np.float32(0.0), np.float32(1.0), np.float32(1.0), np.float32(1.0), np.float32(0.0), np.float32(0.0), np.float32(1.0), np.float32(0.0), np.float32(0.0), np.float32(0.0), np.float32(0.0)]",2.0,99604.0,18
2025-08-14_08-18-36,7264,"[np.float32(1.0), np.float32(1.0), np.float32(0.0), np.float32(0.0), np.float32(0.0), np.float32(1.0), np.float32(1.0), np.float32(1.0), np.float32(0.0), np.float32(0.0), np.float32(0.0), np.float32(0.0), np.float32(1.0), np.float32(0.0), np.float32(1.0), np.float32(1.0)]",-4.0,99600.0,28
2025-08-14_08-18-36,7265,"[np.float32(0.0), np.float32(1.0), np.float32(1.0), np.float32(0.0), np.float32(1.0), np.float32(1.0), np.float32(0.0), np.float32(0.0), np.float32(1.0), np.float32(0.0), np.float32(1.0), np.float32(0.0), np.float32(1.0), np.float32(1.0), np.float32(0.0), np.float32(0.0)]",5.0,99605.0,35
2025-08-14_08-18-36,7266,"[np.float32(0.0), np.float32(1.0), np.float32(1.0), np.float32(1.0), np.float32(1.0), np.float32(1.0), np.float32(1.0), np.float32(1.0), np.float32(0.0), np.float32(0.0), np.float32(1.0), np.float32(1.0), np.float32(0.0), np.float32(1.0), np.float32(1.0), np.float32(0.0)]",4.0,99609.0,24
2025-08-14_08-18-36,7267,"[np.float32(1.0), np.float32(0.0), np.float32(1.0), np.float32(0.0), np.float32(1.0), np.float32(0.0), np.float32(1.0), np.float32(0.0), np.float32(0.0), np.float32(0.0), np.float32(1.0), np.float32(1.0), np.float32(0.0), np.float32(1.0), np.float32(0.0), np.float32(0.0)]",3.0,99612.0,6
2025-08-14_08-18-36,7268,"[np.float32(1.0), np.float32(0.0), np.float32(1.0), np.float32(0.0), np.float32(0.0), np.float32(1.0), np.float32(0.0), np.float32(1.0), np.float32(0.0), np.float32(0.0), np.float32(1.0), np.float32(0.0), np.float32(1.0), np.float32(0.0), np.float32(1.0), np.float32(1.0)]",-3.0,99609.0,10
2025-08-14_08-18-36,7269,"[np.float32(1.0), np.float32(1.0), np.float32(1.0), np.float32(1.0), np.float32(0.0), np.float32(0.0), np.float32(0.0), np.float32(1.0), np.float32(0.0), np.float32(0.0), np.float32(0.0), np.float32(0.0), np.float32(1.0), np.float32(1.0), np.float32(1.0), np.float32(1.0)]",1.0,99610.0,21
2025-08-14_08-18-36,7270,"[np.float32(1.0), np.float32(0.0), np.float32(1.0), np.float32(1.0), np.float32(0.0), np.float32(0.0), np.float32(1.0), np.float32(1.0), np.float32(1.0), np.float32(0.0), np.float32(1.0), np.float32(0.0), np.float32(1.0), np.float32(1.0), np.float32(0.0), np.float32(0.0)]",1.0,99611.0,5
2025-08-14_08-18-36,7271,"[np.float32(0.0), np.float32(0.0), np.float32(1.0), np.float32(1.0), np.float32(0.0), np.float32(0.0), np.float32(1.0), np.float32(1.0), np.float32(1.0), np.float32(1.0), np.float32(1.0), np.float32(0.0), np.float32(1.0), np.float32(0.0), np.float32(0.0), np.float32(0.0)]",0.0,99611.0,28
2025-08-14_08-18-36,7272,"[np.float32(1.0), np.float32(1.0), np.float32(0.0), np.float32(0.0), np.float32(0.0), np.float32(0.0), np.float32(0.0), np.float32(1.0), np.float32(1.0), np.float32(1.0), np.float32(0.0), np.float32(0.0), np.float32(0.0), np.float32(1.0), np.float32(1.0), np.float32(0.0)]",4.0,99615.0,19
2025-08-14_08-18-36,7273,"[np.float32(0.0), np.float32(1.0), np.float32(1.0), np.float32(0.0), np.float32(0.0), np.float32(1.0), np.float32(1.0), np.float32(1.0), np.float32(0.0), np.float32(0.0), np.float32(1.0), np.float32(0.0), np.float32(0.0), np.float32(1.0), np.float32(1.0), np.float32(0.0)]",0.0,99615.0,16
2025-08-14_08-18-36,7274,"[np.float32(0.0), np.float32(1.0), np.float32(1.0), np.float32(0.0), np.float32(1.0), np.float32(0.0), np.float32(1.0), np.float32(1.0), np.float32(1.0), np.float32(0.0), np.float32(1.0), np.float32(0.0), np.float32(0.0), np.float32(1.0), np.float32(1.0), np.float32(1.0)]",0.0,99615.0,15
2025-08-14_08-18-36,7275,"[np.float32(0.0), np.float32(0.0), np.float32(0.0), np.float32(0.0), np.float32(1.0), np.float32(0.0), np.float32(1.0), np.float32(0.0), np.float32(1.0), np.float32(0.0), np.float32(0.0), np.float32(0.0), np.float32(1.0), np.float32(1.0), np.float32(0.0), np.float32(1.0)]",0.0,99615.0,28
2025-08-14_08-18-36,7276,"[np.float32(0.0), np.float32(1.0), np.float32(1.0), np.float32(0.0), np.float32(1.0), np.float32(1.0), np.float32(0.0), np.float32(1.0), np.float32(1.0), np.float32(0.0), np.float32(1.0), np.float32(1.0), np.float32(1.0), np.float32(1.0), np.float32(1.0), np.float32(0.0)]",4.0,99619.0,26
2025-08-14_08-18-36,7277,"[np.float32(0.0), np.float32(0.0), np.float32(1.0), np.float32(0.0), np.float32(1.0), np.float32(1.0), np.float32(1.0), np.float32(1.0), np.float32(1.0), np.float32(1.0), np.float32(0.0), np.float32(0.0), np.float32(1.0), np.float32(0.0), np.float32(0.0), np.float32(0.0)]",0.0,99619.0,25
2025-08-14_08-18-36,7278,"[np.float32(0.0), np.float32(1.0), np.float32(0.0), np.float32(0.0), np.float32(0.0), np.float32(1.0), np.float32(1.0), np.float32(0.0), np.float32(1.0), np.float32(1.0), np.float32(0.0), np.float32(1.0), np.float32(1.0), np.float32(0.0), np.float32(0.0), np.float32(0.0)]",-2.0,99617.0,19
2025-08-14_08-18-36,7279,"[np.float32(0.0), np.float32(1.0), np.float32(0.0), np.float32(0.0), np.float32(1.0), np.float32(1.0), np.float32(1.0), np.float32(0.0), np.float32(0.0), np.float32(0.0), np.float32(0.0), np.float32(0.0), np.float32(0.0), np.float32(0.0), np.float32(1.0), np.float32(0.0)]",-3.0,99614.0,34
2025-08-14_08-18-36,7280,"[np.float32(0.0), np.float32(1.0), np.float32(0.0), np.float32(1.0), np.float32(0.0), np.float32(0.0), np.float32(0.0), np.float32(0.0), np.float32(0.0), np.float32(1.0), np.float32(0.0), np.float32(1.0), np.float32(1.0), np.float32(0.0), np.float32(0.0), np.float32(0.0)]",-1.0,99613.0,35
2025-08-14_08-18-36,7281,"[np.float32(1.0), np.float32(1.0), np.float32(0.0), np.float32(1.0), np.float32(0.0), np.float32(1.0), np.float32(1.0), np.float32(0.0), np.float32(0.0), np.float32(0.0), np.float32(0.0), np.float32(1.0), np.float32(1.0), np.float32(0.0), np.float32(0.0), np.float32(1.0)]",2.0,99615.0,1
2025-08-14_08-18-36,7282,"[np.float32(0.0), np.float32(1.0), np.float32(0.0), np.float32(1.0), np.float32(1.0), np.float32(0.0), np.float32(0.0), np.float32(0.0), np.float32(1.0), np.float32(1.0), np.float32(0.0), np.float32(0.0), np.float32(0.0), np.float32(0.0), np.float32(0.0), np.float32(0.0)]",-1.0,99614.0,5
2025-08-14_08-18-36,7283,"[np.float32(0.0), np.float32(0.0), np.float32(0.0), np.float32(0.0), np.float32(1.0), np.float32(1.0), np.float32(0.0), np.float32(1.0), np.float32(1.0), np.float32(1.0), np.float32(0.0), np.float32(1.0), np.float32(1.0), np.float32(0.0), np.float32(0.0), np.float32(0.0)]",-2.0,99612.0,35
2025-08-14_08-18-36,7284,"[np.float32(0.0), np.float32(1.0), np.float32(1.0), np.float32(0.0), np.float32(0.0), np.float32(0.0), np.float32(0.0), np.float32(1.0), np.float32(0.0), np.float32(0.0), np.float32(1.0), np.float32(0.0), np.float32(0.0), np.float32(1.0), np.float32(0.0), np.float32(0.0)]",-2.0,99610.0,3
2025-08-14_08-18-36,7285,"[np.float32(0.0), np.float32(1.0), np.float32(1.0), np.float32(0.0), np.float32(1.0), np.float32(1.0), np.float32(1.0), np.float32(0.0), np.float32(0.0), np.float32(1.0), np.float32(1.0), np.float32(0.0), np.float32(0.0), np.float32(1.0), np.float32(1.0), np.float32(1.0)]",1.0,99611.0,7
2025-08-14_08-18-36,7286,"[np.float32(0.0), np.float32(1.0), np.float32(1.0), np.float32(0.0), np.float32(0.0), np.float32(0.0), np.float32(1.0), np.float32(1.0), np.float32(0.0), np.float32(1.0), np.float32(0.0), np.float32(1.0), np.float32(1.0), np.float32(0.0), np.float32(1.0), np.float32(1.0)]",-7.0,99604.0,35
2025-08-14_08-18-36,7287,"[np.float32(1.0), np.float32(1.0), np.float32(1.0), np.float32(0.0), np.float32(1.0), np.float32(0.0), np.float32(1.0), np.float32(1.0), np.float32(1.0), np.float32(0.0), np.float32(0.0), np.float32(0.0), np.float32(1.0), np.float32(1.0), np.float32(0.0), np.float32(0.0)]",3.0,99607.0,2
2025-08-14_08-18-36,7288,"[np.float32(1.0), np.float32(0.0), np.float32(1.0), np.float32(1.0), np.float32(1.0), np.float32(1.0), np.float32(0.0), np.float32(1.0), np.float32(0.0), np.float32(0.0), np.float32(1.0), np.float32(0.0), np.float32(0.0), np.float32(0.0), np.float32(1.0), np.float32(1.0)]",-2.0,99605.0,2
2025-08-14_08-18-36,7289,"[np.float32(0.0), np.float32(0.0), np.float32(1.0), np.float32(1.0), np.float32(0.0), np.float32(0.0), np.float32(1.0), np.float32(1.0), np.float32(1.0), np.float32(0.0), np.float32(1.0), np.float32(1.0), np.float32(1.0), np.float32(0.0), np.float32(1.0), np.float32(1.0)]",-2.0,99603.0,15
2025-08-14_08-18-36,7290,"[np.float32(1.0), np.float32(1.0), np.float32(0.0), np.float32(0.0), np.float32(0.0), np.float32(1.0), np.float32(1.0), np.float32(1.0), np.float32(0.0), np.float32(1.0), np.float32(1.0), np.float32(0.0), np.float32(0.0), np.float32(1.0), np.float32(1.0), np.float32(0.0)]",2.0,99605.0,2
2025-08-14_08-18-36,7291,"[np.float32(0.0), np.float32(1.0), np.float32(1.0), np.float32(0.0), np.float32(0.0), np.float32(1.0), np.float32(0.0), np.float32(1.0), np.float32(1.0), np.float32(0.0), np.float32(1.0), np.float32(1.0), np.float32(1.0), np.float32(1.0), np.float32(1.0), np.float32(0.0)]",-2.0,99603.0,19
2025-08-14_08-18-36,7292,"[np.float32(0.0), np.float32(1.0), np.float32(0.0), np.float32(0.0), np.float32(1.0), np.float32(0.0), np.float32(1.0), np.float32(1.0), np.float32(0.0), np.float32(0.0), np.float32(0.0), np.float32(1.0), np.float32(0.0), np.float32(0.0), np.float32(1.0), np.float32(1.0)]",3.0,99606.0,17
2025-08-14_08-18-36,7293,"[np.float32(1.0), np.float32(0.0), np.float32(1.0), np.float32(1.0), np.float32(0.0), np.float32(1.0), np.float32(0.0), np.float32(0.0), np.float32(0.0), np.float32(1.0), np.float32(1.0), np.float32(0.0), np.float32(1.0), np.float32(1.0), np.float32(1.0), np.float32(1.0)]",-2.0,99604.0,11
2025-08-14_08-18-36,7294,"[np.float32(0.0), np.float32(1.0), np.float32(0.0), np.float32(1.0), np.float32(1.0), np.float32(0.0), np.float32(1.0), np.float32(1.0), np.float32(0.0), np.float32(0.0), np.float32(0.0), np.float32(0.0), np.float32(0.0), np.float32(0.0), np.float32(1.0), np.float32(0.0)]",3.0,99607.0,15
2025-08-14_08-18-36,7295,"[np.float32(1.0), np.float32(1.0), np.float32(1.0), np.float32(1.0), np.float32(1.0), np.float32(1.0), np.float32(1.0), np.float32(1.0), np.float32(1.0), np.float32(0.0), np.float32(0.0), np.float32(1.0), np.float32(0.0), np.float32(0.0), np.float32(0.0), np.float32(1.0)]",1.0,99608.0,33
2025-08-14_08-18-36,7296,"[np.float32(1.0), np.float32(1.0), np.float32(1.0), np.float32(0.0), np.float32(0.0), np.float32(1.0), np.float32(0.0), np.float32(1.0), np.float32(1.0), np.float32(1.0), np.float32(0.0), np.float32(0.0), np.float32(1.0), np.float32(1.0), np.float32(1.0), np.float32(0.0)]",0.0,99608.0,18
2025-08-14_08-18-36,7297,"[np.float32(1.0), np.float32(0.0), np.float32(1.0), np.float32(0.0), np.float32(0.0), np.float32(1.0), np.float32(0.0), np.float32(1.0), np.float32(1.0), np.float32(0.0), np.float32(1.0), np.float32(1.0), np.float32(0.0), np.float32(1.0), np.float32(1.0), np.float32(1.0)]",1.0,99609.0,35
2025-08-14_08-18-36,7298,"[np.float32(1.0), np.float32(1.0), np.float32(0.0), np.float32(0.0), np.float32(0.0), np.float32(1.0), np.float32(1.0), np.float32(1.0), np.float32(1.0), np.float32(1.0), np.float32(0.0), np.float32(0.0), np.float32(0.0), np.float32(0.0), np.float32(0.0), np.float32(1.0)]",5.0,99614.0,34
2025-08-14_08-18-36,7299,"[np.float32(0.0), np.float32(1.0), np.float32(1.0), np.float32(0.0), np.float32(0.0), np.float32(0.0), np.float32(0.0), np.float32(1.0), np.float32(0.0), np.float32(0.0), np.float32(1.0), np.float32(0.0), np.float32(0.0), np.float32(1.0), np.float32(0.0), np.float32(0.0)]",0.0,99614.0,13
2025-08-14_08-18-36,7300,"[np.float32(1.0), np.float32(0.0), np.float32(0.0), np.float32(1.0), np.float32(0.0), np.float32(1.0), np.float32(1.0), np.float32(0.0), np.float32(0.0), np.float32(0.0), np.float32(0.0), np.float32(1.0), np.float32(1.0), np.float32(0.0), np.float32(0.0), np.float32(1.0)]",0.0,99614.0,5
2025-08-14_08-18-36,7301,"[np.float32(1.0), np.float32(0.0), np.float32(0.0), np.float32(1.0), np.float32(1.0), np.float32(0.0), np.float32(1.0), np.float32(0.0), np.float32(0.0), np.float32(1.0), np.float32(1.0), np.float32(1.0), np.float32(0.0), np.float32(0.0), np.float32(1.0), np.float32(1.0)]",1.0,99615.0,23
2025-08-14_08-18-36,7302,"[np.float32(0.0), np.float32(0.0), np.float32(0.0), np.float32(0.0), np.float32(1.0), np.float32(1.0), np.float32(0.0), np.float32(0.0), np.float32(1.0), np.float32(0.0), np.float32(0.0), np.float32(1.0), np.float32(1.0), np.float32(1.0), np.float32(0.0), np.float32(1.0)]",-2.0,99613.0,19
2025-08-14_08-18-36,7303,"[np.float32(0.0), np.float32(0.0), np.float32(0.0), np.float32(1.0), np.float32(0.0), np.float32(1.0), np.float32(0.0), np.float32(1.0), np.float32(1.0), np.float32(0.0), np.float32(0.0), np.float32(0.0), np.float32(0.0), np.float32(1.0), np.float32(1.0), np.float32(1.0)]",-2.0,99611.0,1
2025-08-14_08-18-36,7304,"[np.float32(1.0), np.float32(1.0), np.float32(0.0), np.float32(0.0), np.float32(1.0), np.float32(0.0), np.float32(1.0), np.float32(1.0), np.float32(1.0), np.float32(0.0), np.float32(1.0), np.float32(0.0), np.float32(0.0), np.float32(0.0), np.float32(1.0), np.float32(1.0)]",-4.0,99607.0,22
2025-08-14_08-18-36,7305,"[np.float32(0.0), np.float32(1.0), np.float32(0.0), np.float32(0.0), np.float32(1.0), np.float32(1.0), np.float32(0.0), np.float32(1.0), np.float32(0.0), np.float32(1.0), np.float32(0.0), np.float32(0.0), np.float32(0.0), np.float32(0.0), np.float32(0.0), np.float32(1.0)]",-4.0,99603.0,5
2025-08-14_08-18-36,7306,"[np.float32(0.0), np.float32(0.0), np.float32(1.0), np.float32(0.0), np.float32(1.0), np.float32(1.0), np.float32(1.0), np.float32(0.0), np.float32(1.0), np.float32(0.0), np.float32(1.0), np.float32(1.0), np.float32(1.0), np.float32(0.0), np.float32(0.0), np.float32(0.0)]",-1.0,99602.0,10
2025-08-14_08-18-36,7307,"[np.float32(0.0), np.float32(0.0), np.float32(1.0), np.float32(0.0), np.float32(0.0), np.float32(1.0), np.float32(1.0), np.float32(1.0), np.float32(0.0), np.float32(0.0), np.float32(0.0), np.float32(0.0), np.float32(1.0), np.float32(0.0), np.float32(0.0), np.float32(0.0)]",0.0,99602.0,19
2025-08-14_08-18-36,7308,"[np.float32(0.0), np.float32(1.0), np.float32(0.0), np.float32(1.0), np.float32(1.0), np.float32(0.0), np.float32(1.0), np.float32(0.0), np.float32(0.0), np.float32(1.0), np.float32(1.0), np.float32(0.0), np.float32(0.0), np.float32(1.0), np.float32(0.0), np.float32(0.0)]",2.0,99604.0,15
2025-08-14_08-18-36,7309,"[np.float32(1.0), np.float32(0.0), np.float32(1.0), np.float32(0.0), np.float32(0.0), np.float32(0.0), np.float32(0.0), np.float32(1.0), np.float32(1.0), np.float32(1.0), np.float32(1.0), np.float32(0.0), np.float32(1.0), np.float32(1.0), np.float32(1.0), np.float32(1.0)]",1.0,99605.0,23
2025-08-14_08-18-36,7310,"[np.float32(1.0), np.float32(1.0), np.float32(1.0), np.float32(1.0), np.float32(0.0), np.float32(1.0), np.float32(0.0), np.float32(1.0), np.float32(0.0), np.float32(1.0), np.float32(0.0), np.float32(1.0), np.float32(0.0), np.float32(1.0), np.float32(1.0), np.float32(0.0)]",5.0,99610.0,19
2025-08-14_08-18-36,7311,"[np.float32(1.0), np.float32(0.0), np.float32(1.0), np.float32(1.0), np.float32(1.0), np.float32(1.0), np.float32(1.0), np.float32(0.0), np.float32(1.0), np.float32(0.0), np.float32(0.0), np.float32(1.0), np.float32(0.0), np.float32(1.0), np.float32(1.0), np.float32(0.0)]",5.0,99615.0,30
2025-08-14_08-18-36,7312,"[np.float32(0.0), np.float32(0.0), np.float32(1.0), np.float32(0.0), np.float32(0.0), np.float32(1.0), np.float32(1.0), np.float32(1.0), np.float32(1.0), np.float32(1.0), np.float32(0.0), np.float32(1.0), np.float32(1.0), np.float32(0.0), np.float32(0.0), np.float32(0.0)]",-5.0,99610.0,5
2025-08-14_08-18-36,7313,"[np.float32(0.0), np.float32(1.0), np.float32(1.0), np.float32(0.0), np.float32(1.0), np.float32(1.0), np.float32(1.0), np.float32(1.0), np.float32(1.0), np.float32(1.0), np.float32(0.0), np.float32(1.0), np.float32(0.0), np.float32(1.0), np.float32(0.0), np.float32(0.0)]",0.0,99610.0,29
2025-08-14_08-18-36,7314,"[np.float32(0.0), np.float32(1.0), np.float32(1.0), np.float32(0.0), np.float32(0.0), np.float32(1.0), np.float32(1.0), np.float32(1.0), np.float32(1.0), np.float32(0.0), np.float32(1.0), np.float32(1.0), np.float32(0.0), np.float32(1.0), np.float32(0.0), np.float32(0.0)]",1.0,99611.0,4
2025-08-14_08-18-36,7315,"[np.float32(0.0), np.float32(1.0), np.float32(0.0), np.float32(0.0), np.float32(1.0), np.float32(1.0), np.float32(0.0), np.float32(1.0), np.float32(0.0), np.float32(1.0), np.float32(1.0), np.float32(1.0), np.float32(0.0), np.float32(1.0), np.float32(0.0), np.float32(1.0)]",1.0,99612.0,2
2025-08-14_08-18-36,7316,"[np.float32(1.0), np.float32(0.0), np.float32(0.0), np.float32(1.0), np.float32(1.0), np.float32(1.0), np.float32(0.0), np.float32(1.0), np.float32(1.0), np.float32(0.0), np.float32(0.0), np.float32(0.0), np.float32(1.0), np.float32(1.0), np.float32(0.0), np.float32(0.0)]",1.0,99613.0,3
2025-08-14_08-18-36,7317,"[np.float32(0.0), np.float32(0.0), np.float32(0.0), np.float32(1.0), np.float32(0.0), np.float32(1.0), np.float32(1.0), np.float32(1.0), np.float32(0.0), np.float32(0.0), np.float32(0.0), np.float32(0.0), np.float32(1.0), np.float32(1.0), np.float32(1.0), np.float32(1.0)]",0.0,99613.0,3
2025-08-14_08-18-36,7318,"[np.float32(0.0), np.float32(0.0), np.float32(1.0), np.float32(0.0), np.float32(0.0), np.float32(1.0), np.float32(1.0), np.float32(1.0), np.float32(0.0), np.float32(0.0), np.float32(1.0), np.float32(1.0), np.float32(0.0), np.float32(0.0), np.float32(1.0), np.float32(0.0)]",-1.0,99612.0,17
2025-08-14_08-18-36,7319,"[np.float32(0.0), np.float32(0.0), np.float32(0.0), np.float32(1.0), np.float32(0.0), np.float32(1.0), np.float32(1.0), np.float32(1.0), np.float32(0.0), np.float32(0.0), np.float32(1.0), np.float32(1.0), np.float32(0.0), np.float32(0.0), np.float32(0.0), np.float32(1.0)]",-4.0,99608.0,16
2025-08-14_08-18-36,7320,"[np.float32(1.0), np.float32(0.0), np.float32(0.0), np.float32(1.0), np.float32(1.0), np.float32(0.0), np.float32(0.0), np.float32(1.0), np.float32(1.0), np.float32(1.0), np.float32(0.0), np.float32(0.0), np.float32(1.0), np.float32(1.0), np.float32(0.0), np.float32(1.0)]",0.0,99608.0,28
2025-08-14_08-18-36,7321,"[np.float32(1.0), np.float32(0.0), np.float32(0.0), np.float32(1.0), np.float32(0.0), np.float32(1.0), np.float32(0.0), np.float32(1.0), np.float32(0.0), np.float32(0.0), np.float32(0.0), np.float32(0.0), np.float32(0.0), np.float32(0.0), np.float32(0.0), np.float32(1.0)]",4.0,99612.0,21
2025-08-14_08-18-36,7322,"[np.float32(1.0), np.float32(1.0), np.float32(1.0), np.float32(0.0), np.float32(0.0), np.float32(0.0), np.float32(1.0), np.float32(1.0), np.float32(0.0), np.float32(0.0), np.float32(1.0), np.float32(1.0), np.float32(0.0), np.float32(1.0), np.float32(0.0), np.float32(0.0)]",0.0,99612.0,29
2025-08-14_08-18-36,7323,"[np.float32(1.0), np.float32(1.0), np.float32(1.0), np.float32(0.0), np.float32(0.0), np.float32(0.0), np.float32(1.0), np.float32(1.0), np.float32(1.0), np.float32(1.0), np.float32(0.0), np.float32(0.0), np.float32(0.0), np.float32(1.0), np.float32(0.0), np.float32(1.0)]",1.0,99613.0,10
2025-08-14_08-18-36,7324,"[np.float32(0.0), np.float32(0.0), np.float32(1.0), np.float32(0.0), np.float32(1.0), np.float32(1.0), np.float32(1.0), np.float32(1.0), np.float32(0.0), np.float32(1.0), np.float32(0.0), np.float32(0.0), np.float32(1.0), np.float32(1.0), np.float32(1.0), np.float32(0.0)]",-2.0,99611.0,14
2025-08-14_08-18-36,7325,"[np.float32(0.0), np.float32(1.0), np.float32(1.0), np.float32(0.0), np.float32(1.0), np.float32(0.0), np.float32(0.0), np.float32(0.0), np.float32(1.0), np.float32(1.0), np.float32(0.0), np.float32(1.0), np.float32(0.0), np.float32(0.0), np.float32(1.0), np.float32(0.0)]",2.0,99613.0,6
2025-08-14_08-18-36,7326,"[np.float32(1.0), np.float32(1.0), np.float32(0.0), np.float32(1.0), np.float32(0.0), np.float32(0.0), np.float32(0.0), np.float32(0.0), np.float32(0.0), np.float32(0.0), np.float32(1.0), np.float32(1.0), np.float32(0.0), np.float32(1.0), np.float32(1.0), np.float32(0.0)]",1.0,99614.0,12
2025-08-14_08-18-36,7327,"[np.float32(0.0), np.float32(1.0), np.float32(0.0), np.float32(0.0), np.float32(1.0), np.float32(0.0), np.float32(0.0), np.float32(1.0), np.float32(1.0), np.float32(1.0), np.float32(0.0), np.float32(1.0), np.float32(0.0), np.float32(0.0), np.float32(1.0), np.float32(0.0)]",0.0,99614.0,6
2025-08-14_08-18-36,7328,"[np.float32(0.0), np.float32(0.0), np.float32(1.0), np.float32(0.0), np.float32(0.0), np.float32(0.0), np.float32(0.0), np.float32(0.0), np.float32(1.0), np.float32(1.0), np.float32(0.0), np.float32(0.0), np.float32(1.0), np.float32(1.0), np.float32(1.0), np.float32(1.0)]",4.0,99618.0,34
2025-08-14_08-18-36,7329,"[np.float32(1.0), np.float32(0.0), np.float32(0.0), np.float32(1.0), np.float32(1.0), np.float32(0.0), np.float32(0.0), np.float32(0.0), np.float32(1.0), np.float32(1.0), np.float32(1.0), np.float32(0.0), np.float32(1.0), np.float32(0.0), np.float32(0.0), np.float32(1.0)]",-1.0,99617.0,19
2025-08-14_08-18-36,7330,"[np.float32(0.0), np.float32(0.0), np.float32(0.0), np.float32(0.0), np.float32(0.0), np.float32(0.0), np.float32(0.0), np.float32(0.0), np.float32(1.0), np.float32(0.0), np.float32(1.0), np.float32(0.0), np.float32(1.0), np.float32(1.0), np.float32(0.0), np.float32(1.0)]",-2.0,99615.0,8
2025-08-14_08-18-36,7331,"[np.float32(0.0), np.float32(1.0), np.float32(0.0), np.float32(1.0), np.float32(0.0), np.float32(0.0), np.float32(1.0), np.float32(1.0), np.float32(0.0), np.float32(0.0), np.float32(0.0), np.float32(0.0), np.float32(0.0), np.float32(1.0), np.float32(0.0), np.float32(0.0)]",0.0,99615.0,5
2025-08-14_08-18-36,7332,"[np.float32(1.0), np.float32(0.0), np.float32(0.0), np.float32(0.0), np.float32(0.0), np.float32(0.0), np.float32(0.0), np.float32(0.0), np.float32(0.0), np.float32(0.0), np.float32(0.0), np.float32(1.0), np.float32(1.0), np.float32(1.0), np.float32(0.0), np.float32(0.0)]",2.0,99617.0,15
2025-08-14_08-18-36,7333,"[np.float32(0.0), np.float32(1.0), np.float32(0.0), np.float32(1.0), np.float32(1.0), np.float32(1.0), np.float32(0.0), np.float32(1.0), np.float32(1.0), np.float32(1.0), np.float32(1.0), np.float32(0.0), np.float32(0.0), np.float32(1.0), np.float32(0.0), np.float32(0.0)]",-1.0,99616.0,14
2025-08-14_08-18-36,7334,"[np.float32(1.0), np.float32(1.0), np.float32(1.0), np.float32(0.0), np.float32(0.0), np.float32(0.0), np.float32(0.0), np.float32(1.0), np.float32(1.0), np.float32(1.0), np.float32(0.0), np.float32(1.0), np.float32(0.0), np.float32(1.0), np.float32(1.0), np.float32(0.0)]",2.0,99618.0,21
2025-08-14_08-18-36,7335,"[np.float32(0.0), np.float32(1.0), np.float32(1.0), np.float32(1.0), np.float32(1.0), np.float32(1.0), np.float32(1.0), np.float32(0.0), np.float32(0.0), np.float32(0.0), np.float32(1.0), np.float32(1.0), np.float32(0.0), np.float32(1.0), np.float32(0.0), np.float32(0.0)]",-2.0,99616.0,27
2025-08-14_08-18-36,7336,"[np.float32(0.0), np.float32(1.0), np.float32(0.0), np.float32(0.0), np.float32(0.0), np.float32(0.0), np.float32(1.0), np.float32(0.0), np.float32(1.0), np.float32(0.0), np.float32(1.0), np.float32(0.0), np.float32(1.0), np.float32(1.0), np.float32(0.0), np.float32(0.0)]",-1.0,99615.0,22
2025-08-14_08-18-36,7337,"[np.float32(1.0), np.float32(1.0), np.float32(0.0), np.float32(0.0), np.float32(0.0), np.float32(0.0), np.float32(1.0), np.float32(1.0), np.float32(1.0), np.float32(1.0), np.float32(0.0), np.float32(0.0), np.float32(1.0), np.float32(1.0), np.float32(1.0), np.float32(1.0)]",-2.0,99613.0,26
2025-08-14_08-18-36,7338,"[np.float32(1.0), np.float32(1.0), np.float32(1.0), np.float32(1.0), np.float32(0.0), np.float32(0.0), np.float32(1.0), np.float32(1.0), np.float32(0.0), np.float32(0.0), np.float32(0.0), np.float32(1.0), np.float32(1.0), np.float32(1.0), np.float32(0.0), np.float32(1.0)]",-3.0,99610.0,10
2025-08-14_08-18-36,7339,"[np.float32(0.0), np.float32(0.0), np.float32(0.0), np.float32(0.0), np.float32(1.0), np.float32(0.0), np.float32(1.0), np.float32(1.0), np.float32(1.0), np.float32(1.0), np.float32(1.0), np.float32(1.0), np.float32(1.0), np.float32(1.0), np.float32(0.0), np.float32(0.0)]",2.0,99612.0,3
2025-08-14_08-18-36,7340,"[np.float32(0.0), np.float32(0.0), np.float32(0.0), np.float32(0.0), np.float32(0.0), np.float32(0.0), np.float32(1.0), np.float32(1.0), np.float32(1.0), np.float32(0.0), np.float32(1.0), np.float32(1.0), np.float32(1.0), np.float32(1.0), np.float32(0.0), np.float32(0.0)]",-1.0,99611.0,20
2025-08-14_08-18-36,7341,"[np.float32(0.0), np.float32(0.0), np.float32(1.0), np.float32(1.0), np.float32(0.0), np.float32(1.0), np.float32(1.0), np.float32(1.0), np.float32(1.0), np.float32(0.0), np.float32(0.0), np.float32(1.0), np.float32(1.0), np.float32(1.0), np.float32(1.0), np.float32(0.0)]",0.0,99611.0,28
2025-08-14_08-18-36,7342,"[np.float32(0.0), np.float32(1.0), np.float32(0.0), np.float32(0.0), np.float32(0.0), np.float32(1.0), np.float32(1.0), np.float32(1.0), np.float32(1.0), np.float32(1.0), np.float32(1.0), np.float32(1.0), np.float32(1.0), np.float32(0.0), np.float32(0.0), np.float32(1.0)]",1.0,99612.0,34
2025-08-14_08-18-36,7343,"[np.float32(0.0), np.float32(1.0), np.float32(1.0), np.float32(0.0), np.float32(0.0), np.float32(0.0), np.float32(0.0), np.float32(1.0), np.float32(1.0), np.float32(0.0), np.float32(1.0), np.float32(0.0), np.float32(1.0), np.float32(1.0), np.float32(1.0), np.float32(0.0)]",3.0,99615.0,29
2025-08-14_08-18-36,7344,"[np.float32(0.0), np.float32(1.0), np.float32(0.0), np.float32(1.0), np.float32(1.0), np.float32(1.0), np.float32(0.0), np.float32(1.0), np.float32(1.0), np.float32(1.0), np.float32(0.0), np.float32(1.0), np.float32(1.0), np.float32(1.0), np.float32(0.0), np.float32(0.0)]",-2.0,99613.0,36
2025-08-14_08-18-36,7345,"[np.float32(1.0), np.float32(0.0), np.float32(1.0), np.float32(0.0), np.float32(1.0), np.float32(1.0), np.float32(1.0), np.float32(1.0), np.float32(1.0), np.float32(0.0), np.float32(1.0), np.float32(0.0), np.float32(0.0), np.float32(0.0), np.float32(1.0), np.float32(0.0)]",-2.0,99611.0,7
2025-08-14_08-18-36,7346,"[np.float32(1.0), np.float32(0.0), np.float32(1.0), np.float32(0.0), np.float32(0.0), np.float32(1.0), np.float32(1.0), np.float32(1.0), np.float32(1.0), np.float32(0.0), np.float32(0.0), np.float32(1.0), np.float32(1.0), np.float32(1.0), np.float32(0.0), np.float32(0.0)]",4.0,99615.0,12
2025-08-14_08-18-36,7347,"[np.float32(1.0), np.float32(0.0), np.float32(0.0), np.float32(0.0), np.float32(1.0), np.float32(1.0), np.float32(1.0), np.float32(0.0), np.float32(1.0), np.float32(1.0), np.float32(0.0), np.float32(0.0), np.float32(0.0), np.float32(1.0), np.float32(0.0), np.float32(1.0)]",-3.0,99612.0,15
2025-08-14_08-18-36,7348,"[np.float32(0.0), np.float32(1.0), np.float32(1.0), np.float32(1.0), np.float32(1.0), np.float32(0.0), np.float32(0.0), np.float32(1.0), np.float32(1.0), np.float32(0.0), np.float32(0.0), np.float32(1.0), np.float32(1.0), np.float32(1.0), np.float32(0.0), np.float32(0.0)]",1.0,99613.0,3
2025-08-14_08-18-36,7349,"[np.float32(0.0), np.float32(0.0), np.float32(1.0), np.float32(1.0), np.float32(0.0), np.float32(1.0), np.float32(1.0), np.float32(1.0), np.float32(0.0), np.float32(0.0), np.float32(1.0), np.float32(0.0), np.float32(1.0), np.float32(1.0), np.float32(1.0), np.float32(1.0)]",0.0,99613.0,22
2025-08-14_08-18-36,7350,"[np.float32(1.0), np.float32(0.0), np.float32(0.0), np.float32(0.0), np.float32(0.0), np.float32(0.0), np.float32(1.0), np.float32(1.0), np.float32(0.0), np.float32(1.0), np.float32(0.0), np.float32(0.0), np.float32(1.0), np.float32(1.0), np.float32(1.0), np.float32(1.0)]",0.0,99613.0,18
2025-08-14_08-18-36,7351,"[np.float32(0.0), np.float32(1.0), np.float32(0.0), np.float32(0.0), np.float32(0.0), np.float32(1.0), np.float32(0.0), np.float32(0.0), np.float32(0.0), np.float32(1.0), np.float32(0.0), np.float32(0.0), np.float32(1.0), np.float32(0.0), np.float32(0.0), np.float32(0.0)]",-2.0,99611.0,23
2025-08-14_08-18-36,7352,"[np.float32(0.0), np.float32(1.0), np.float32(0.0), np.float32(0.0), np.float32(0.0), np.float32(0.0), np.float32(0.0), np.float32(1.0), np.float32(1.0), np.float32(1.0), np.float32(1.0), np.float32(0.0), np.float32(0.0), np.float32(0.0), np.float32(1.0), np.float32(1.0)]",-1.0,99610.0,32
2025-08-14_08-18-36,7353,"[np.float32(1.0), np.float32(0.0), np.float32(0.0), np.float32(0.0), np.float32(0.0), np.float32(1.0), np.float32(0.0), np.float32(1.0), np.float32(1.0), np.float32(0.0), np.float32(1.0), np.float32(0.0), np.float32(0.0), np.float32(1.0), np.float32(1.0), np.float32(0.0)]",3.0,99613.0,30
2025-08-14_08-18-36,7354,"[np.float32(1.0), np.float32(1.0), np.float32(0.0), np.float32(0.0), np.float32(1.0), np.float32(1.0), np.float32(0.0), np.float32(0.0), np.float32(1.0), np.float32(0.0), np.float32(0.0), np.float32(0.0), np.float32(1.0), np.float32(1.0), np.float32(0.0), np.float32(0.0)]",-3.0,99610.0,13
2025-08-14_08-18-36,7355,"[np.float32(1.0), np.float32(1.0), np.float32(1.0), np.float32(1.0), np.float32(0.0), np.float32(1.0), np.float32(1.0), np.float32(1.0), np.float32(1.0), np.float32(1.0), np.float32(0.0), np.float32(0.0), np.float32(0.0), np.float32(0.0), np.float32(0.0), np.float32(1.0)]",-1.0,99609.0,30
2025-08-14_08-18-36,7356,"[np.float32(1.0), np.float32(0.0), np.float32(0.0), np.float32(1.0), np.float32(1.0), np.float32(1.0), np.float32(1.0), np.float32(0.0), np.float32(1.0), np.float32(1.0), np.float32(0.0), np.float32(0.0), np.float32(0.0), np.float32(1.0), np.float32(1.0), np.float32(0.0)]",6.0,99615.0,7
2025-08-14_08-18-36,7357,"[np.float32(1.0), np.float32(1.0), np.float32(0.0), np.float32(0.0), np.float32(1.0), np.float32(0.0), np.float32(1.0), np.float32(1.0), np.float32(1.0), np.float32(0.0), np.float32(0.0), np.float32(1.0), np.float32(1.0), np.float32(1.0), np.float32(1.0), np.float32(1.0)]",-3.0,99612.0,23
2025-08-14_08-18-36,7358,"[np.float32(0.0), np.float32(1.0), np.float32(0.0), np.float32(1.0), np.float32(0.0), np.float32(1.0), np.float32(1.0), np.float32(0.0), np.float32(1.0), np.float32(1.0), np.float32(0.0), np.float32(0.0), np.float32(0.0), np.float32(0.0), np.float32(0.0), np.float32(0.0)]",-1.0,99611.0,2
2025-08-14_08-18-36,7359,"[np.float32(1.0), np.float32(0.0), np.float32(0.0), np.float32(0.0), np.float32(0.0), np.float32(1.0), np.float32(1.0), np.float32(1.0), np.float32(1.0), np.float32(1.0), np.float32(0.0), np.float32(1.0), np.float32(1.0), np.float32(1.0), np.float32(1.0), np.float32(0.0)]",-2.0,99609.0,31
2025-08-14_08-18-36,7360,"[np.float32(1.0), np.float32(0.0), np.float32(1.0), np.float32(0.0), np.float32(0.0), np.float32(0.0), np.float32(1.0), np.float32(1.0), np.float32(1.0), np.float32(0.0), np.float32(0.0), np.float32(1.0), np.float32(1.0), np.float32(1.0), np.float32(1.0), np.float32(1.0)]",-4.0,99605.0,11
2025-08-14_08-18-36,7361,"[np.float32(1.0), np.float32(1.0), np.float32(0.0), np.float32(0.0), np.float32(1.0), np.float32(0.0), np.float32(1.0), np.float32(1.0), np.float32(1.0), np.float32(0.0), np.float32(0.0), np.float32(1.0), np.float32(0.0), np.float32(1.0), np.float32(0.0), np.float32(1.0)]",-4.0,99601.0,0
2025-08-14_08-18-36,7362,"[np.float32(1.0), np.float32(0.0), np.float32(1.0), np.float32(1.0), np.float32(1.0), np.float32(1.0), np.float32(1.0), np.float32(1.0), np.float32(0.0), np.float32(1.0), np.float32(1.0), np.float32(0.0), np.float32(0.0), np.float32(1.0), np.float32(0.0), np.float32(0.0)]",2.0,99603.0,25
2025-08-14_08-18-36,7363,"[np.float32(0.0), np.float32(0.0), np.float32(1.0), np.float32(0.0), np.float32(0.0), np.float32(1.0), np.float32(1.0), np.float32(1.0), np.float32(1.0), np.float32(0.0), np.float32(0.0), np.float32(0.0), np.float32(0.0), np.float32(1.0), np.float32(1.0), np.float32(0.0)]",-4.0,99599.0,17
2025-08-14_08-18-36,7364,"[np.float32(0.0), np.float32(1.0), np.float32(1.0), np.float32(0.0), np.float32(0.0), np.float32(0.0), np.float32(0.0), np.float32(1.0), np.float32(1.0), np.float32(0.0), np.float32(0.0), np.float32(1.0), np.float32(1.0), np.float32(1.0), np.float32(1.0), np.float32(0.0)]",0.0,99599.0,12
2025-08-14_08-18-36,7365,"[np.float32(1.0), np.float32(0.0), np.float32(0.0), np.float32(0.0), np.float32(1.0), np.float32(0.0), np.float32(0.0), np.float32(0.0), np.float32(0.0), np.float32(1.0), np.float32(1.0), np.float32(1.0), np.float32(0.0), np.float32(1.0), np.float32(1.0), np.float32(0.0)]",1.0,99600.0,23
2025-08-14_08-18-36,7366,"[np.float32(0.0), np.float32(0.0), np.float32(1.0), np.float32(0.0), np.float32(0.0), np.float32(0.0), np.float32(1.0), np.float32(1.0), np.float32(0.0), np.float32(1.0), np.float32(1.0), np.float32(0.0), np.float32(0.0), np.float32(0.0), np.float32(0.0), np.float32(0.0)]",3.0,99603.0,8
2025-08-14_08-18-36,7367,"[np.float32(0.0), np.float32(1.0), np.float32(0.0), np.float32(1.0), np.float32(0.0), np.float32(0.0), np.float32(0.0), np.float32(0.0), np.float32(0.0), np.float32(1.0), np.float32(0.0), np.float32(1.0), np.float32(0.0), np.float32(1.0), np.float32(0.0), np.float32(0.0)]",1.0,99604.0,12
2025-08-14_08-18-36,7368,"[np.float32(0.0), np.float32(0.0), np.float32(1.0), np.float32(1.0), np.float32(0.0), np.float32(1.0), np.float32(0.0), np.float32(0.0), np.float32(1.0), np.float32(1.0), np.float32(0.0), np.float32(0.0), np.float32(1.0), np.float32(0.0), np.float32(0.0), np.float32(0.0)]",-1.0,99603.0,10
2025-08-14_08-18-36,7369,"[np.float32(0.0), np.float32(0.0), np.float32(1.0), np.float32(1.0), np.float32(0.0), np.float32(0.0), np.float32(0.0), np.float32(1.0), np.float32(1.0), np.float32(1.0), np.float32(1.0), np.float32(1.0), np.float32(1.0), np.float32(0.0), np.float32(1.0), np.float32(1.0)]",-2.0,99601.0,22
2025-08-14_08-18-36,7370,"[np.float32(1.0), np.float32(0.0), np.float32(1.0), np.float32(0.0), np.float32(1.0), np.float32(1.0), np.float32(0.0), np.float32(1.0), np.float32(1.0), np.float32(0.0), np.float32(0.0), np.float32(0.0), np.float32(0.0), np.float32(1.0), np.float32(0.0), np.float32(0.0)]",3.0,99604.0,28
2025-08-14_08-18-36,7371,"[np.float32(1.0), np.float32(1.0), np.float32(1.0), np.float32(0.0), np.float32(0.0), np.float32(1.0), np.float32(1.0), np.float32(0.0), np.float32(0.0), np.float32(0.0), np.float32(1.0), np.float32(1.0), np.float32(0.0), np.float32(1.0), np.float32(0.0), np.float32(1.0)]",-1.0,99603.0,5
2025-08-14_08-18-36,7372,"[np.float32(0.0), np.float32(0.0), np.float32(0.0), np.float32(1.0), np.float32(0.0), np.float32(0.0), np.float32(0.0), np.float32(1.0), np.float32(0.0), np.float32(0.0), np.float32(0.0), np.float32(1.0), np.float32(0.0), np.float32(0.0), np.float32(0.0), np.float32(0.0)]",-1.0,99602.0,5
2025-08-14_08-18-36,7373,"[np.float32(0.0), np.float32(1.0), np.float32(1.0), np.float32(0.0), np.float32(0.0), np.float32(1.0), np.float32(0.0), np.float32(0.0), np.float32(1.0), np.float32(1.0), np.float32(1.0), np.float32(1.0), np.float32(1.0), np.float32(1.0), np.float32(0.0), np.float32(0.0)]",6.0,99608.0,28
2025-08-14_08-18-36,7374,"[np.float32(1.0), np.float32(1.0), np.float32(1.0), np.float32(1.0), np.float32(0.0), np.float32(1.0), np.float32(0.0), np.float32(0.0), np.float32(1.0), np.float32(0.0), np.float32(1.0), np.float32(1.0), np.float32(1.0), np.float32(0.0), np.float32(0.0), np.float32(0.0)]",-2.0,99606.0,3
2025-08-14_08-18-36,7375,"[np.float32(1.0), np.float32(1.0), np.float32(1.0), np.float32(1.0), np.float32(0.0), np.float32(0.0), np.float32(1.0), np.float32(0.0), np.float32(1.0), np.float32(1.0), np.float32(0.0), np.float32(1.0), np.float32(0.0), np.float32(1.0), np.float32(1.0), np.float32(1.0)]",-4.0,99602.0,14
2025-08-14_08-18-36,7376,"[np.float32(0.0), np.float32(0.0), np.float32(1.0), np.float32(0.0), np.float32(0.0), np.float32(0.0), np.float32(0.0), np.float32(1.0), np.float32(0.0), np.float32(1.0), np.float32(0.0), np.float32(1.0), np.float32(0.0), np.float32(0.0), np.float32(0.0), np.float32(0.0)]",-2.0,99600.0,32
2025-08-14_08-18-36,7377,"[np.float32(0.0), np.float32(0.0), np.float32(0.0), np.float32(1.0), np.float32(1.0), np.float32(1.0), np.float32(0.0), np.float32(1.0), np.float32(0.0), np.float32(1.0), np.float32(0.0), np.float32(0.0), np.float32(1.0), np.float32(0.0), np.float32(0.0), np.float32(0.0)]",1.0,99601.0,21
2025-08-14_08-18-36,7378,"[np.float32(1.0), np.float32(1.0), np.float32(0.0), np.float32(1.0), np.float32(1.0), np.float32(1.0), np.float32(0.0), np.float32(0.0), np.float32(0.0), np.float32(1.0), np.float32(0.0), np.float32(0.0), np.float32(1.0), np.float32(0.0), np.float32(0.0), np.float32(0.0)]",-3.0,99598.0,20
2025-08-14_08-18-36,7379,"[np.float32(1.0), np.float32(1.0), np.float32(1.0), np.float32(0.0), np.float32(0.0), np.float32(0.0), np.float32(1.0), np.float32(0.0), np.float32(0.0), np.float32(0.0), np.float32(1.0), np.float32(0.0), np.float32(0.0), np.float32(0.0), np.float32(1.0), np.float32(0.0)]",1.0,99599.0,12
2025-08-14_08-18-36,7380,"[np.float32(0.0), np.float32(0.0), np.float32(1.0), np.float32(0.0), np.float32(1.0), np.float32(1.0), np.float32(1.0), np.float32(1.0), np.float32(0.0), np.float32(1.0), np.float32(0.0), np.float32(0.0), np.float32(1.0), np.float32(1.0), np.float32(0.0), np.float32(0.0)]",-3.0,99596.0,31
2025-08-14_08-18-36,7381,"[np.float32(0.0), np.float32(0.0), np.float32(1.0), np.float32(1.0), np.float32(0.0), np.float32(0.0), np.float32(0.0), np.float32(1.0), np.float32(0.0), np.float32(0.0), np.float32(1.0), np.float32(0.0), np.float32(1.0), np.float32(0.0), np.float32(1.0), np.float32(0.0)]",-1.0,99595.0,22
2025-08-14_08-18-36,7382,"[np.float32(0.0), np.float32(1.0), np.float32(0.0), np.float32(1.0), np.float32(0.0), np.float32(1.0), np.float32(0.0), np.float32(0.0), np.float32(0.0), np.float32(1.0), np.float32(1.0), np.float32(0.0), np.float32(0.0), np.float32(1.0), np.float32(0.0), np.float32(0.0)]",6.0,99601.0,29
2025-08-14_08-18-36,7383,"[np.float32(0.0), np.float32(1.0), np.float32(1.0), np.float32(1.0), np.float32(0.0), np.float32(0.0), np.float32(0.0), np.float32(1.0), np.float32(0.0), np.float32(1.0), np.float32(0.0), np.float32(0.0), np.float32(0.0), np.float32(1.0), np.float32(1.0), np.float32(1.0)]",5.0,99606.0,13
2025-08-14_08-18-36,7384,"[np.float32(0.0), np.float32(0.0), np.float32(1.0), np.float32(0.0), np.float32(0.0), np.float32(0.0), np.float32(1.0), np.float32(0.0), np.float32(1.0), np.float32(1.0), np.float32(0.0), np.float32(1.0), np.float32(0.0), np.float32(1.0), np.float32(1.0), np.float32(0.0)]",4.0,99610.0,36
2025-08-14_08-18-36,7385,"[np.float32(0.0), np.float32(1.0), np.float32(0.0), np.float32(0.0), np.float32(0.0), np.float32(0.0), np.float32(0.0), np.float32(1.0), np.float32(1.0), np.float32(1.0), np.float32(0.0), np.float32(0.0), np.float32(0.0), np.float32(1.0), np.float32(1.0), np.float32(1.0)]",1.0,99611.0,35
2025-08-14_08-18-36,7386,"[np.float32(0.0), np.float32(0.0), np.float32(1.0), np.float32(0.0), np.float32(1.0), np.float32(0.0), np.float32(0.0), np.float32(1.0), np.float32(1.0), np.float32(0.0), np.float32(1.0), np.float32(1.0), np.float32(0.0), np.float32(1.0), np.float32(0.0), np.float32(1.0)]",1.0,99612.0,35
2025-08-14_08-18-36,7387,"[np.float32(0.0), np.float32(1.0), np.float32(0.0), np.float32(1.0), np.float32(1.0), np.float32(1.0), np.float32(1.0), np.float32(0.0), np.float32(0.0), np.float32(1.0), np.float32(0.0), np.float32(1.0), np.float32(0.0), np.float32(1.0), np.float32(0.0), np.float32(0.0)]",5.0,99617.0,3
2025-08-14_08-18-36,7388,"[np.float32(0.0), np.float32(1.0), np.float32(0.0), np.float32(0.0), np.float32(0.0), np.float32(0.0), np.float32(1.0), np.float32(1.0), np.float32(0.0), np.float32(1.0), np.float32(0.0), np.float32(0.0), np.float32(0.0), np.float32(1.0), np.float32(1.0), np.float32(0.0)]",2.0,99619.0,11
2025-08-14_08-18-36,7389,"[np.float32(0.0), np.float32(1.0), np.float32(1.0), np.float32(1.0), np.float32(1.0), np.float32(0.0), np.float32(1.0), np.float32(1.0), np.float32(1.0), np.float32(0.0), np.float32(1.0), np.float32(0.0), np.float32(0.0), np.float32(0.0), np.float32(0.0), np.float32(1.0)]",4.0,99623.0,14
2025-08-14_08-18-36,7390,"[np.float32(1.0), np.float32(0.0), np.float32(0.0), np.float32(0.0), np.float32(0.0), np.float32(1.0), np.float32(0.0), np.float32(1.0), np.float32(0.0), np.float32(0.0), np.float32(0.0), np.float32(0.0), np.float32(0.0), np.float32(0.0), np.float32(0.0), np.float32(1.0)]",-1.0,99622.0,13
2025-08-14_08-18-36,7391,"[np.float32(0.0), np.float32(1.0), np.float32(0.0), np.float32(0.0), np.float32(0.0), np.float32(0.0), np.float32(0.0), np.float32(1.0), np.float32(1.0), np.float32(0.0), np.float32(0.0), np.float32(0.0), np.float32(0.0), np.float32(1.0), np.float32(0.0), np.float32(1.0)]",-2.0,99620.0,30
2025-08-14_08-18-36,7392,"[np.float32(1.0), np.float32(0.0), np.float32(0.0), np.float32(0.0), np.float32(0.0), np.float32(1.0), np.float32(0.0), np.float32(0.0), np.float32(0.0), np.float32(1.0), np.float32(1.0), np.float32(0.0), np.float32(0.0), np.float32(1.0), np.float32(1.0), np.float32(0.0)]",-1.0,99619.0,18
2025-08-14_08-18-36,7393,"[np.float32(0.0), np.float32(1.0), np.float32(0.0), np.float32(0.0), np.float32(1.0), np.float32(0.0), np.float32(0.0), np.float32(1.0), np.float32(1.0), np.float32(1.0), np.float32(0.0), np.float32(1.0), np.float32(1.0), np.float32(0.0), np.float32(0.0), np.float32(1.0)]",-4.0,99615.0,11
2025-08-14_08-18-36,7394,"[np.float32(0.0), np.float32(0.0), np.float32(1.0), np.float32(1.0), np.float32(1.0), np.float32(0.0), np.float32(0.0), np.float32(1.0), np.float32(1.0), np.float32(0.0), np.float32(0.0), np.float32(1.0), np.float32(1.0), np.float32(1.0), np.float32(1.0), np.float32(0.0)]",-2.0,99613.0,11
2025-08-14_08-18-36,7395,"[np.float32(1.0), np.float32(1.0), np.float32(1.0), np.float32(0.0), np.float32(0.0), np.float32(1.0), np.float32(1.0), np.float32(1.0), np.float32(0.0), np.float32(1.0), np.float32(1.0), np.float32(0.0), np.float32(1.0), np.float32(0.0), np.float32(0.0), np.float32(1.0)]",-2.0,99611.0,11
2025-08-14_08-18-36,7396,"[np.float32(1.0), np.float32(1.0), np.float32(1.0), np.float32(0.0), np.float32(1.0), np.float32(1.0), np.float32(1.0), np.float32(1.0), np.float32(1.0), np.float32(0.0), np.float32(1.0), np.float32(1.0), np.float32(0.0), np.float32(0.0), np.float32(0.0), np.float32(0.0)]",2.0,99613.0,12
2025-08-14_08-18-36,7397,"[np.float32(1.0), np.float32(1.0), np.float32(0.0), np.float32(0.0), np.float32(1.0), np.float32(0.0), np.float32(1.0), np.float32(1.0), np.float32(1.0), np.float32(0.0), np.float32(1.0), np.float32(1.0), np.float32(1.0), np.float32(0.0), np.float32(1.0), np.float32(0.0)]",-5.0,99608.0,31
2025-08-14_08-18-36,7398,"[np.float32(1.0), np.float32(0.0), np.float32(1.0), np.float32(1.0), np.float32(1.0), np.float32(1.0), np.float32(1.0), np.float32(1.0), np.float32(0.0), np.float32(1.0), np.float32(0.0), np.float32(0.0), np.float32(0.0), np.float32(1.0), np.float32(0.0), np.float32(1.0)]",0.0,99608.0,15
2025-08-14_08-18-36,7399,"[np.float32(1.0), np.float32(1.0), np.float32(0.0), np.float32(1.0), np.float32(0.0), np.float32(1.0), np.float32(0.0), np.float32(1.0), np.float32(1.0), np.float32(1.0), np.float32(0.0), np.float32(1.0), np.float32(1.0), np.float32(1.0), np.float32(1.0), np.float32(0.0)]",-1.0,99607.0,32
2025-08-14_08-18-36,7400,"[np.float32(0.0), np.float32(1.0), np.float32(1.0), np.float32(0.0), np.float32(1.0), np.float32(1.0), np.float32(1.0), np.float32(1.0), np.float32(0.0), np.float32(1.0), np.float32(0.0), np.float32(0.0), np.float32(1.0), np.float32(0.0), np.float32(1.0), np.float32(0.0)]",-1.0,99606.0,19
2025-08-14_08-18-36,7401,"[np.float32(0.0), np.float32(1.0), np.float32(0.0), np.float32(0.0), np.float32(0.0), np.float32(1.0), np.float32(1.0), np.float32(1.0), np.float32(1.0), np.float32(0.0), np.float32(1.0), np.float32(0.0), np.float32(1.0), np.float32(0.0), np.float32(1.0), np.float32(1.0)]",1.0,99607.0,24
2025-08-14_08-18-36,7402,"[np.float32(1.0), np.float32(0.0), np.float32(1.0), np.float32(0.0), np.float32(1.0), np.float32(1.0), np.float32(1.0), np.float32(0.0), np.float32(1.0), np.float32(1.0), np.float32(1.0), np.float32(0.0), np.float32(1.0), np.float32(1.0), np.float32(1.0), np.float32(1.0)]",-3.0,99604.0,18
2025-08-14_08-18-36,7403,"[np.float32(1.0), np.float32(0.0), np.float32(1.0), np.float32(0.0), np.float32(0.0), np.float32(0.0), np.float32(1.0), np.float32(0.0), np.float32(1.0), np.float32(0.0), np.float32(0.0), np.float32(0.0), np.float32(1.0), np.float32(0.0), np.float32(0.0), np.float32(1.0)]",-1.0,99603.0,20
2025-08-14_08-18-36,7404,"[np.float32(1.0), np.float32(0.0), np.float32(0.0), np.float32(0.0), np.float32(1.0), np.float32(1.0), np.float32(1.0), np.float32(1.0), np.float32(0.0), np.float32(1.0), np.float32(1.0), np.float32(0.0), np.float32(1.0), np.float32(1.0), np.float32(1.0), np.float32(0.0)]",-5.0,99598.0,33
2025-08-14_08-18-36,7405,"[np.float32(1.0), np.float32(1.0), np.float32(1.0), np.float32(1.0), np.float32(0.0), np.float32(1.0), np.float32(1.0), np.float32(1.0), np.float32(0.0), np.float32(1.0), np.float32(0.0), np.float32(1.0), np.float32(0.0), np.float32(0.0), np.float32(0.0), np.float32(1.0)]",0.0,99598.0,14
2025-08-14_08-18-36,7406,"[np.float32(0.0), np.float32(0.0), np.float32(1.0), np.float32(1.0), np.float32(0.0), np.float32(0.0), np.float32(1.0), np.float32(0.0), np.float32(0.0), np.float32(1.0), np.float32(1.0), np.float32(0.0), np.float32(1.0), np.float32(0.0), np.float32(1.0), np.float32(0.0)]",-5.0,99593.0,0
2025-08-14_08-18-36,7407,"[np.float32(1.0), np.float32(1.0), np.float32(1.0), np.float32(1.0), np.float32(1.0), np.float32(0.0), np.float32(0.0), np.float32(0.0), np.float32(1.0), np.float32(1.0), np.float32(0.0), np.float32(1.0), np.float32(0.0), np.float32(1.0), np.float32(1.0), np.float32(0.0)]",3.0,99596.0,33
2025-08-14_08-18-36,7408,"[np.float32(0.0), np.float32(0.0), np.float32(0.0), np.float32(1.0), np.float32(1.0), np.float32(1.0), np.float32(1.0), np.float32(1.0), np.float32(1.0), np.float32(1.0), np.float32(1.0), np.float32(0.0), np.float32(0.0), np.float32(1.0), np.float32(0.0), np.float32(1.0)]",-2.0,99594.0,6
2025-08-14_08-18-36,7409,"[np.float32(0.0), np.float32(0.0), np.float32(0.0), np.float32(1.0), np.float32(0.0), np.float32(1.0), np.float32(1.0), np.float32(1.0), np.float32(0.0), np.float32(0.0), np.float32(0.0), np.float32(0.0), np.float32(0.0), np.float32(0.0), np.float32(0.0), np.float32(0.0)]",0.0,99594.0,27
2025-08-14_08-18-36,7410,"[np.float32(1.0), np.float32(1.0), np.float32(0.0), np.float32(1.0), np.float32(1.0), np.float32(1.0), np.float32(0.0), np.float32(0.0), np.float32(1.0), np.float32(1.0), np.float32(1.0), np.float32(0.0), np.float32(1.0), np.float32(1.0), np.float32(0.0), np.float32(0.0)]",-1.0,99593.0,23
2025-08-14_08-18-36,7411,"[np.float32(1.0), np.float32(0.0), np.float32(1.0), np.float32(0.0), np.float32(1.0), np.float32(0.0), np.float32(1.0), np.float32(1.0), np.float32(0.0), np.float32(0.0), np.float32(1.0), np.float32(1.0), np.float32(0.0), np.float32(1.0), np.float32(0.0), np.float32(0.0)]",0.0,99593.0,26
2025-08-14_08-18-36,7412,"[np.float32(1.0), np.float32(0.0), np.float32(1.0), np.float32(1.0), np.float32(0.0), np.float32(1.0), np.float32(1.0), np.float32(1.0), np.float32(0.0), np.float32(1.0), np.float32(1.0), np.float32(1.0), np.float32(1.0), np.float32(0.0), np.float32(0.0), np.float32(0.0)]",-1.0,99592.0,32
2025-08-14_08-18-36,7413,"[np.float32(1.0), np.float32(1.0), np.float32(1.0), np.float32(0.0), np.float32(0.0), np.float32(0.0), np.float32(1.0), np.float32(1.0), np.float32(1.0), np.float32(0.0), np.float32(1.0), np.float32(1.0), np.float32(1.0), np.float32(0.0), np.float32(0.0), np.float32(0.0)]",-2.0,99590.0,28
2025-08-14_08-18-36,7414,"[np.float32(0.0), np.float32(0.0), np.float32(0.0), np.float32(1.0), np.float32(1.0), np.float32(0.0), np.float32(1.0), np.float32(1.0), np.float32(0.0), np.float32(1.0), np.float32(0.0), np.float32(1.0), np.float32(1.0), np.float32(1.0), np.float32(0.0), np.float32(0.0)]",0.0,99590.0,2
2025-08-14_08-18-36,7415,"[np.float32(0.0), np.float32(1.0), np.float32(1.0), np.float32(0.0), np.float32(0.0), np.float32(0.0), np.float32(0.0), np.float32(1.0), np.float32(1.0), np.float32(0.0), np.float32(1.0), np.float32(0.0), np.float32(0.0), np.float32(0.0), np.float32(1.0), np.float32(1.0)]",-1.0,99589.0,5
2025-08-14_08-18-36,7416,"[np.float32(0.0), np.float32(0.0), np.float32(1.0), np.float32(0.0), np.float32(1.0), np.float32(0.0), np.float32(1.0), np.float32(0.0), np.float32(1.0), np.float32(0.0), np.float32(0.0), np.float32(0.0), np.float32(0.0), np.float32(0.0), np.float32(0.0), np.float32(0.0)]",3.0,99592.0,2
2025-08-14_08-18-36,7417,"[np.float32(1.0), np.float32(0.0), np.float32(0.0), np.float32(0.0), np.float32(1.0), np.float32(0.0), np.float32(1.0), np.float32(1.0), np.float32(1.0), np.float32(1.0), np.float32(0.0), np.float32(0.0), np.float32(0.0), np.float32(1.0), np.float32(1.0), np.float32(1.0)]",-1.0,99591.0,11
2025-08-14_08-18-36,7418,"[np.float32(0.0), np.float32(0.0), np.float32(1.0), np.float32(0.0), np.float32(1.0), np.float32(0.0), np.float32(0.0), np.float32(1.0), np.float32(0.0), np.float32(0.0), np.float32(1.0), np.float32(0.0), np.float32(1.0), np.float32(1.0), np.float32(1.0), np.float32(0.0)]",-1.0,99590.0,29
2025-08-14_08-18-36,7419,"[np.float32(1.0), np.float32(0.0), np.float32(0.0), np.float32(1.0), np.float32(0.0), np.float32(0.0), np.float32(1.0), np.float32(1.0), np.float32(1.0), np.float32(0.0), np.float32(1.0), np.float32(1.0), np.float32(0.0), np.float32(1.0), np.float32(0.0), np.float32(1.0)]",-4.0,99586.0,13
2025-08-14_08-18-36,7420,"[np.float32(0.0), np.float32(0.0), np.float32(1.0), np.float32(0.0), np.float32(0.0), np.float32(0.0), np.float32(1.0), np.float32(0.0), np.float32(1.0), np.float32(1.0), np.float32(0.0), np.float32(0.0), np.float32(0.0), np.float32(1.0), np.float32(0.0), np.float32(0.0)]",-2.0,99584.0,15
2025-08-14_08-18-36,7421,"[np.float32(0.0), np.float32(0.0), np.float32(1.0), np.float32(1.0), np.float32(1.0), np.float32(1.0), np.float32(1.0), np.float32(1.0), np.float32(1.0), np.float32(0.0), np.float32(1.0), np.float32(0.0), np.float32(0.0), np.float32(1.0), np.float32(0.0), np.float32(0.0)]",1.0,99585.0,15
2025-08-14_08-18-36,7422,"[np.float32(1.0), np.float32(1.0), np.float32(1.0), np.float32(1.0), np.float32(1.0), np.float32(1.0), np.float32(0.0), np.float32(1.0), np.float32(1.0), np.float32(1.0), np.float32(0.0), np.float32(0.0), np.float32(0.0), np.float32(1.0), np.float32(1.0), np.float32(1.0)]",0.0,99585.0,30
2025-08-14_08-18-36,7423,"[np.float32(0.0), np.float32(1.0), np.float32(0.0), np.float32(1.0), np.float32(1.0), np.float32(1.0), np.float32(1.0), np.float32(0.0), np.float32(0.0), np.float32(0.0), np.float32(1.0), np.float32(1.0), np.float32(0.0), np.float32(0.0), np.float32(0.0), np.float32(0.0)]",-5.0,99580.0,34
2025-08-14_08-18-36,7424,"[np.float32(1.0), np.float32(1.0), np.float32(1.0), np.float32(1.0), np.float32(1.0), np.float32(1.0), np.float32(0.0), np.float32(0.0), np.float32(1.0), np.float32(1.0), np.float32(0.0), np.float32(1.0), np.float32(1.0), np.float32(1.0), np.float32(1.0), np.float32(0.0)]",0.0,99580.0,13
2025-08-14_08-18-36,7425,"[np.float32(1.0), np.float32(0.0), np.float32(0.0), np.float32(0.0), np.float32(0.0), np.float32(0.0), np.float32(0.0), np.float32(1.0), np.float32(0.0), np.float32(0.0), np.float32(0.0), np.float32(0.0), np.float32(1.0), np.float32(1.0), np.float32(1.0), np.float32(1.0)]",-3.0,99577.0,11
2025-08-14_08-18-36,7426,"[np.float32(1.0), np.float32(1.0), np.float32(1.0), np.float32(0.0), np.float32(0.0), np.float32(1.0), np.float32(0.0), np.float32(1.0), np.float32(1.0), np.float32(0.0), np.float32(1.0), np.float32(0.0), np.float32(0.0), np.float32(1.0), np.float32(0.0), np.float32(1.0)]",6.0,99583.0,26
2025-08-14_08-18-36,7427,"[np.float32(0.0), np.float32(0.0), np.float32(1.0), np.float32(0.0), np.float32(1.0), np.float32(0.0), np.float32(1.0), np.float32(0.0), np.float32(0.0), np.float32(1.0), np.float32(1.0), np.float32(0.0), np.float32(0.0), np.float32(1.0), np.float32(0.0), np.float32(0.0)]",-1.0,99582.0,9
2025-08-14_08-18-36,7428,"[np.float32(1.0), np.float32(0.0), np.float32(0.0), np.float32(0.0), np.float32(1.0), np.float32(1.0), np.float32(0.0), np.float32(1.0), np.float32(0.0), np.float32(0.0), np.float32(1.0), np.float32(1.0), np.float32(1.0), np.float32(0.0), np.float32(0.0), np.float32(1.0)]",-3.0,99579.0,11
2025-08-14_08-18-36,7429,"[np.float32(0.0), np.float32(1.0), np.float32(1.0), np.float32(0.0), np.float32(0.0), np.float32(0.0), np.float32(1.0), np.float32(0.0), np.float32(0.0), np.float32(0.0), np.float32(0.0), np.float32(1.0), np.float32(0.0), np.float32(1.0), np.float32(1.0), np.float32(1.0)]",-1.0,99578.0,1
2025-08-14_08-18-36,7430,"[np.float32(1.0), np.float32(0.0), np.float32(0.0), np.float32(1.0), np.float32(1.0), np.float32(0.0), np.float32(0.0), np.float32(0.0), np.float32(0.0), np.float32(1.0), np.float32(1.0), np.float32(1.0), np.float32(0.0), np.float32(0.0), np.float32(1.0), np.float32(0.0)]",-1.0,99577.0,24
2025-08-14_08-18-36,7431,"[np.float32(0.0), np.float32(0.0), np.float32(1.0), np.float32(1.0), np.float32(0.0), np.float32(1.0), np.float32(1.0), np.float32(0.0), np.float32(1.0), np.float32(1.0), np.float32(0.0), np.float32(0.0), np.float32(0.0), np.float32(1.0), np.float32(0.0), np.float32(0.0)]",3.0,99580.0,34
2025-08-14_08-18-36,7432,"[np.float32(1.0), np.float32(0.0), np.float32(1.0), np.float32(1.0), np.float32(1.0), np.float32(1.0), np.float32(1.0), np.float32(1.0), np.float32(0.0), np.float32(1.0), np.float32(0.0), np.float32(0.0), np.float32(1.0), np.float32(1.0), np.float32(1.0), np.float32(0.0)]",2.0,99582.0,10
2025-08-14_08-18-36,7433,"[np.float32(1.0), np.float32(0.0), np.float32(1.0), np.float32(0.0), np.float32(0.0), np.float32(1.0), np.float32(1.0), np.float32(1.0), np.float32(1.0), np.float32(1.0), np.float32(0.0), np.float32(0.0), np.float32(1.0), np.float32(0.0), np.float32(1.0), np.float32(1.0)]",-6.0,99576.0,0
2025-08-14_08-18-36,7434,"[np.float32(0.0), np.float32(0.0), np.float32(1.0), np.float32(1.0), np.float32(1.0), np.float32(0.0), np.float32(1.0), np.float32(1.0), np.float32(1.0), np.float32(0.0), np.float32(1.0), np.float32(0.0), np.float32(0.0), np.float32(1.0), np.float32(1.0), np.float32(0.0)]",2.0,99578.0,32
2025-08-14_08-18-36,7435,"[np.float32(1.0), np.float32(0.0), np.float32(0.0), np.float32(1.0), np.float32(0.0), np.float32(0.0), np.float32(1.0), np.float32(1.0), np.float32(1.0), np.float32(0.0), np.float32(1.0), np.float32(1.0), np.float32(0.0), np.float32(0.0), np.float32(0.0), np.float32(1.0)]",-3.0,99575.0,13
2025-08-14_08-18-36,7436,"[np.float32(1.0), np.float32(0.0), np.float32(0.0), np.float32(1.0), np.float32(0.0), np.float32(0.0), np.float32(0.0), np.float32(1.0), np.float32(0.0), np.float32(0.0), np.float32(1.0), np.float32(0.0), np.float32(0.0), np.float32(1.0), np.float32(1.0), np.float32(0.0)]",0.0,99575.0,2
2025-08-14_08-18-36,7437,"[np.float32(0.0), np.float32(1.0), np.float32(1.0), np.float32(0.0), np.float32(0.0), np.float32(1.0), np.float32(0.0), np.float32(1.0), np.float32(1.0), np.float32(0.0), np.float32(1.0), np.float32(1.0), np.float32(0.0), np.float32(1.0), np.float32(1.0), np.float32(0.0)]",-2.0,99573.0,31
2025-08-14_08-18-36,7438,"[np.float32(0.0), np.float32(0.0), np.float32(1.0), np.float32(0.0), np.float32(0.0), np.float32(1.0), np.float32(0.0), np.float32(0.0), np.float32(0.0), np.float32(0.0), np.float32(0.0), np.float32(1.0), np.float32(0.0), np.float32(0.0), np.float32(1.0), np.float32(1.0)]",-2.0,99571.0,15
2025-08-14_08-18-36,7439,"[np.float32(0.0), np.float32(0.0), np.float32(1.0), np.float32(0.0), np.float32(1.0), np.float32(1.0), np.float32(1.0), np.float32(1.0), np.float32(1.0), np.float32(0.0), np.float32(0.0), np.float32(0.0), np.float32(1.0), np.float32(0.0), np.float32(0.0), np.float32(0.0)]",0.0,99571.0,30
2025-08-14_08-18-36,7440,"[np.float32(0.0), np.float32(0.0), np.float32(0.0), np.float32(0.0), np.float32(1.0), np.float32(1.0), np.float32(1.0), np.float32(1.0), np.float32(1.0), np.float32(1.0), np.float32(0.0), np.float32(1.0), np.float32(0.0), np.float32(1.0), np.float32(1.0), np.float32(1.0)]",-2.0,99569.0,23
2025-08-14_08-18-36,7441,"[np.float32(1.0), np.float32(0.0), np.float32(1.0), np.float32(0.0), np.float32(0.0), np.float32(0.0), np.float32(1.0), np.float32(0.0), np.float32(1.0), np.float32(1.0), np.float32(1.0), np.float32(1.0), np.float32(1.0), np.float32(1.0), np.float32(0.0), np.float32(0.0)]",1.0,99570.0,18
2025-08-14_08-18-36,7442,"[np.float32(1.0), np.float32(0.0), np.float32(0.0), np.float32(0.0), np.float32(0.0), np.float32(0.0), np.float32(0.0), np.float32(1.0), np.float32(1.0), np.float32(0.0), np.float32(0.0), np.float32(1.0), np.float32(0.0), np.float32(1.0), np.float32(1.0), np.float32(0.0)]",-4.0,99566.0,1
2025-08-14_08-18-36,7443,"[np.float32(1.0), np.float32(1.0), np.float32(0.0), np.float32(0.0), np.float32(1.0), np.float32(0.0), np.float32(0.0), np.float32(0.0), np.float32(0.0), np.float32(0.0), np.float32(0.0), np.float32(0.0), np.float32(0.0), np.float32(0.0), np.float32(0.0), np.float32(1.0)]",-2.0,99564.0,33
2025-08-14_08-18-36,7444,"[np.float32(1.0), np.float32(0.0), np.float32(0.0), np.float32(1.0), np.float32(0.0), np.float32(0.0), np.float32(1.0), np.float32(1.0), np.float32(1.0), np.float32(1.0), np.float32(0.0), np.float32(1.0), np.float32(1.0), np.float32(1.0), np.float32(0.0), np.float32(0.0)]",-6.0,99558.0,8
2025-08-14_08-18-36,7445,"[np.float32(1.0), np.float32(1.0), np.float32(1.0), np.float32(1.0), np.float32(0.0), np.float32(0.0), np.float32(1.0), np.float32(1.0), np.float32(0.0), np.float32(0.0), np.float32(1.0), np.float32(1.0), np.float32(1.0), np.float32(0.0), np.float32(0.0), np.float32(0.0)]",1.0,99559.0,18
2025-08-14_08-18-36,7446,"[np.float32(1.0), np.float32(1.0), np.float32(1.0), np.float32(1.0), np.float32(1.0), np.float32(1.0), np.float32(0.0), np.float32(0.0), np.float32(1.0), np.float32(1.0), np.float32(0.0), np.float32(0.0), np.float32(0.0), np.float32(0.0), np.float32(1.0), np.float32(1.0)]",-1.0,99558.0,19
2025-08-14_08-18-36,7447,"[np.float32(1.0), np.float32(1.0), np.float32(1.0), np.float32(1.0), np.float32(1.0), np.float32(0.0), np.float32(0.0), np.float32(1.0), np.float32(0.0), np.float32(1.0), np.float32(0.0), np.float32(1.0), np.float32(1.0), np.float32(1.0), np.float32(0.0), np.float32(0.0)]",-1.0,99557.0,10
2025-08-14_08-18-36,7448,"[np.float32(0.0), np.float32(0.0), np.float32(1.0), np.float32(1.0), np.float32(1.0), np.float32(1.0), np.float32(1.0), np.float32(1.0), np.float32(0.0), np.float32(0.0), np.float32(1.0), np.float32(0.0), np.float32(1.0), np.float32(1.0), np.float32(0.0), np.float32(0.0)]",-5.0,99552.0,36
2025-08-14_08-18-36,7449,"[np.float32(1.0), np.float32(0.0), np.float32(0.0), np.float32(0.0), np.float32(1.0), np.float32(1.0), np.float32(0.0), np.float32(1.0), np.float32(0.0), np.float32(1.0), np.float32(1.0), np.float32(0.0), np.float32(1.0), np.float32(0.0), np.float32(0.0), np.float32(1.0)]",0.0,99552.0,13
2025-08-14_08-18-36,7450,"[np.float32(0.0), np.float32(1.0), np.float32(1.0), np.float32(0.0), np.float32(1.0), np.float32(1.0), np.float32(1.0), np.float32(0.0), np.float32(0.0), np.float32(1.0), np.float32(1.0), np.float32(1.0), np.float32(0.0), np.float32(1.0), np.float32(1.0), np.float32(0.0)]",-2.0,99550.0,23
2025-08-14_08-18-36,7451,"[np.float32(1.0), np.float32(1.0), np.float32(1.0), np.float32(1.0), np.float32(1.0), np.float32(0.0), np.float32(1.0), np.float32(0.0), np.float32(0.0), np.float32(0.0), np.float32(1.0), np.float32(0.0), np.float32(0.0), np.float32(1.0), np.float32(1.0), np.float32(0.0)]",0.0,99550.0,18
2025-08-14_08-18-36,7452,"[np.float32(0.0), np.float32(1.0), np.float32(0.0), np.float32(0.0), np.float32(0.0), np.float32(1.0), np.float32(1.0), np.float32(1.0), np.float32(0.0), np.float32(1.0), np.float32(0.0), np.float32(0.0), np.float32(0.0), np.float32(1.0), np.float32(0.0), np.float32(0.0)]",-1.0,99549.0,6
2025-08-14_08-18-36,7453,"[np.float32(1.0), np.float32(1.0), np.float32(1.0), np.float32(0.0), np.float32(0.0), np.float32(1.0), np.float32(1.0), np.float32(0.0), np.float32(1.0), np.float32(1.0), np.float32(1.0), np.float32(0.0), np.float32(1.0), np.float32(0.0), np.float32(0.0), np.float32(0.0)]",-7.0,99542.0,15
2025-08-14_08-18-36,7454,"[np.float32(1.0), np.float32(1.0), np.float32(1.0), np.float32(0.0), np.float32(1.0), np.float32(1.0), np.float32(0.0), np.float32(1.0), np.float32(1.0), np.float32(0.0), np.float32(0.0), np.float32(0.0), np.float32(1.0), np.float32(1.0), np.float32(0.0), np.float32(0.0)]",1.0,99543.0,29
2025-08-14_08-18-36,7455,"[np.float32(1.0), np.float32(0.0), np.float32(0.0), np.float32(0.0), np.float32(1.0), np.float32(0.0), np.float32(1.0), np.float32(1.0), np.float32(1.0), np.float32(0.0), np.float32(0.0), np.float32(0.0), np.float32(0.0), np.float32(0.0), np.float32(0.0), np.float32(0.0)]",0.0,99543.0,13
2025-08-14_08-18-36,7456,"[np.float32(1.0), np.float32(0.0), np.float32(1.0), np.float32(1.0), np.float32(1.0), np.float32(1.0), np.float32(0.0), np.float32(1.0), np.float32(0.0), np.float32(0.0), np.float32(0.0), np.float32(1.0), np.float32(0.0), np.float32(1.0), np.float32(1.0), np.float32(0.0)]",3.0,99546.0,3
2025-08-14_08-18-36,7457,"[np.float32(1.0), np.float32(1.0), np.float32(0.0), np.float32(0.0), np.float32(0.0), np.float32(0.0), np.float32(1.0), np.float32(1.0), np.float32(1.0), np.float32(1.0), np.float32(1.0), np.float32(0.0), np.float32(0.0), np.float32(1.0), np.float32(0.0), np.float32(1.0)]",-4.0,99542.0,30
2025-08-14_08-18-36,7458,"[np.float32(0.0), np.float32(0.0), np.float32(0.0), np.float32(0.0), np.float32(1.0), np.float32(1.0), np.float32(1.0), np.float32(1.0), np.float32(1.0), np.float32(0.0), np.float32(0.0), np.float32(0.0), np.float32(0.0), np.float32(1.0), np.float32(1.0), np.float32(1.0)]",0.0,99542.0,35
2025-08-14_08-18-36,7459,"[np.float32(0.0), np.float32(0.0), np.float32(0.0), np.float32(1.0), np.float32(0.0), np.float32(1.0), np.float32(0.0), np.float32(1.0), np.float32(0.0), np.float32(0.0), np.float32(1.0), np.float32(0.0), np.float32(0.0), np.float32(1.0), np.float32(0.0), np.float32(0.0)]",3.0,99545.0,15
2025-08-14_08-18-36,7460,"[np.float32(1.0), np.float32(0.0), np.float32(0.0), np.float32(1.0), np.float32(1.0), np.float32(0.0), np.float32(1.0), np.float32(1.0), np.float32(0.0), np.float32(0.0), np.float32(1.0), np.float32(1.0), np.float32(0.0), np.float32(0.0), np.float32(1.0), np.float32(0.0)]",3.0,99548.0,8
2025-08-14_08-18-36,7461,"[np.float32(0.0), np.float32(0.0), np.float32(0.0), np.float32(1.0), np.float32(0.0), np.float32(0.0), np.float32(1.0), np.float32(1.0), np.float32(0.0), np.float32(0.0), np.float32(1.0), np.float32(0.0), np.float32(1.0), np.float32(0.0), np.float32(0.0), np.float32(1.0)]",-3.0,99545.0,18
2025-08-14_08-18-36,7462,"[np.float32(0.0), np.float32(1.0), np.float32(1.0), np.float32(0.0), np.float32(0.0), np.float32(0.0), np.float32(1.0), np.float32(1.0), np.float32(0.0), np.float32(1.0), np.float32(1.0), np.float32(0.0), np.float32(1.0), np.float32(0.0), np.float32(0.0), np.float32(0.0)]",-2.0,99543.0,32
2025-08-14_08-18-36,7463,"[np.float32(0.0), np.float32(0.0), np.float32(0.0), np.float32(0.0), np.float32(0.0), np.float32(1.0), np.float32(0.0), np.float32(1.0), np.float32(0.0), np.float32(1.0), np.float32(0.0), np.float32(1.0), np.float32(0.0), np.float32(0.0), np.float32(1.0), np.float32(1.0)]",0.0,99543.0,6
2025-08-14_08-18-36,7464,"[np.float32(1.0), np.float32(0.0), np.float32(1.0), np.float32(1.0), np.float32(0.0), np.float32(0.0), np.float32(0.0), np.float32(0.0), np.float32(0.0), np.float32(1.0), np.float32(1.0), np.float32(0.0), np.float32(1.0), np.float32(1.0), np.float32(1.0), np.float32(0.0)]",0.0,99543.0,29
2025-08-14_08-18-36,7465,"[np.float32(1.0), np.float32(0.0), np.float32(0.0), np.float32(1.0), np.float32(0.0), np.float32(1.0), np.float32(0.0), np.float32(1.0), np.float32(0.0), np.float32(1.0), np.float32(1.0), np.float32(1.0), np.float32(0.0), np.float32(0.0), np.float32(0.0), np.float32(0.0)]",2.0,99545.0,25
2025-08-14_08-18-36,7466,"[np.float32(0.0), np.float32(0.0), np.float32(0.0), np.float32(1.0), np.float32(0.0), np.float32(1.0), np.float32(0.0), np.float32(1.0), np.float32(1.0), np.float32(1.0), np.float32(1.0), np.float32(0.0), np.float32(1.0), np.float32(0.0), np.float32(0.0), np.float32(0.0)]",1.0,99546.0,13
2025-08-14_08-18-36,7467,"[np.float32(0.0), np.float32(0.0), np.float32(1.0), np.float32(1.0), np.float32(0.0), np.float32(1.0), np.float32(0.0), np.float32(0.0), np.float32(0.0), np.float32(0.0), np.float32(0.0), np.float32(0.0), np.float32(0.0), np.float32(1.0), np.float32(1.0), np.float32(1.0)]",1.0,99547.0,25
2025-08-14_08-18-36,7468,"[np.float32(0.0), np.float32(1.0), np.float32(0.0), np.float32(1.0), np.float32(0.0), np.float32(1.0), np.float32(0.0), np.float32(1.0), np.float32(1.0), np.float32(1.0), np.float32(0.0), np.float32(1.0), np.float32(0.0), np.float32(1.0), np.float32(1.0), np.float32(1.0)]",-2.0,99545.0,10
2025-08-14_08-18-36,7469,"[np.float32(1.0), np.float32(1.0), np.float32(1.0), np.float32(0.0), np.float32(0.0), np.float32(1.0), np.float32(0.0), np.float32(0.0), np.float32(1.0), np.float32(1.0), np.float32(0.0), np.float32(1.0), np.float32(0.0), np.float32(0.0), np.float32(1.0), np.float32(1.0)]",-2.0,99543.0,19
2025-08-14_08-18-36,7470,"[np.float32(1.0), np.float32(0.0), np.float32(1.0), np.float32(1.0), np.float32(1.0), np.float32(1.0), np.float32(1.0), np.float32(1.0), np.float32(1.0), np.float32(0.0), np.float32(0.0), np.float32(1.0), np.float32(1.0), np.float32(1.0), np.float32(0.0), np.float32(0.0)]",-4.0,99539.0,17
2025-08-14_08-18-36,7471,"[np.float32(0.0), np.float32(0.0), np.float32(0.0), np.float32(1.0), np.float32(0.0), np.float32(1.0), np.float32(1.0), np.float32(0.0), np.float32(1.0), np.float32(0.0), np.float32(1.0), np.float32(0.0), np.float32(0.0), np.float32(1.0), np.float32(1.0), np.float32(0.0)]",1.0,99540.0,28
2025-08-14_08-18-36,7472,"[np.float32(0.0), np.float32(0.0), np.float32(0.0), np.float32(1.0), np.float32(0.0), np.float32(0.0), np.float32(1.0), np.float32(1.0), np.float32(0.0), np.float32(1.0), np.float32(1.0), np.float32(1.0), np.float32(1.0), np.float32(0.0), np.float32(1.0), np.float32(0.0)]",3.0,99543.0,13
2025-08-14_08-18-36,7473,"[np.float32(1.0), np.float32(1.0), np.float32(0.0), np.float32(0.0), np.float32(0.0), np.float32(1.0), np.float32(1.0), np.float32(1.0), np.float32(1.0), np.float32(1.0), np.float32(1.0), np.float32(0.0), np.float32(0.0), np.float32(1.0), np.float32(1.0), np.float32(0.0)]",3.0,99546.0,29
2025-08-14_08-18-36,7474,"[np.float32(0.0), np.float32(1.0), np.float32(1.0), np.float32(0.0), np.float32(1.0), np.float32(0.0), np.float32(1.0), np.float32(0.0), np.float32(0.0), np.float32(0.0), np.float32(0.0), np.float32(0.0), np.float32(1.0), np.float32(1.0), np.float32(0.0), np.float32(0.0)]",-6.0,99540.0,23
2025-08-14_08-18-36,7475,"[np.float32(1.0), np.float32(1.0), np.float32(1.0), np.float32(1.0), np.float32(1.0), np.float32(1.0), np.float32(0.0), np.float32(1.0), np.float32(0.0), np.float32(1.0), np.float32(0.0), np.float32(0.0), np.float32(0.0), np.float32(0.0), np.float32(0.0), np.float32(1.0)]",-3.0,99537.0,33
2025-08-14_08-18-36,7476,"[np.float32(0.0), np.float32(1.0), np.float32(0.0), np.float32(1.0), np.float32(1.0), np.float32(1.0), np.float32(0.0), np.float32(1.0), np.float32(1.0), np.float32(1.0), np.float32(1.0), np.float32(1.0), np.float32(0.0), np.float32(0.0), np.float32(1.0), np.float32(0.0)]",-3.0,99534.0,4
2025-08-14_08-18-36,7477,"[np.float32(1.0), np.float32(0.0), np.float32(0.0), np.float32(1.0), np.float32(1.0), np.float32(1.0), np.float32(0.0), np.float32(1.0), np.float32(1.0), np.float32(1.0), np.float32(0.0), np.float32(0.0), np.float32(0.0), np.float32(0.0), np.float32(0.0), np.float32(0.0)]",2.0,99536.0,7
2025-08-14_08-18-36,7478,"[np.float32(0.0), np.float32(0.0), np.float32(0.0), np.float32(1.0), np.float32(0.0), np.float32(1.0), np.float32(1.0), np.float32(1.0), np.float32(0.0), np.float32(1.0), np.float32(0.0), np.float32(0.0), np.float32(1.0), np.float32(1.0), np.float32(0.0), np.float32(1.0)]",-2.0,99534.0,14
2025-08-14_08-18-36,7479,"[np.float32(1.0), np.float32(1.0), np.float32(0.0), np.float32(1.0), np.float32(1.0), np.float32(1.0), np.float32(0.0), np.float32(1.0), np.float32(1.0), np.float32(1.0), np.float32(1.0), np.float32(1.0), np.float32(0.0), np.float32(0.0), np.float32(1.0), np.float32(1.0)]",3.0,99537.0,17
2025-08-14_08-18-36,7480,"[np.float32(1.0), np.float32(1.0), np.float32(0.0), np.float32(1.0), np.float32(0.0), np.float32(1.0), np.float32(1.0), np.float32(1.0), np.float32(0.0), np.float32(1.0), np.float32(1.0), np.float32(0.0), np.float32(1.0), np.float32(0.0), np.float32(1.0), np.float32(1.0)]",2.0,99539.0,11
2025-08-14_08-18-36,7481,"[np.float32(1.0), np.float32(1.0), np.float32(1.0), np.float32(1.0), np.float32(1.0), np.float32(0.0), np.float32(1.0), np.float32(1.0), np.float32(1.0), np.float32(1.0), np.float32(1.0), np.float32(0.0), np.float32(0.0), np.float32(1.0), np.float32(1.0), np.float32(0.0)]",3.0,99542.0,10
2025-08-14_08-18-36,7482,"[np.float32(0.0), np.float32(1.0), np.float32(0.0), np.float32(1.0), np.float32(0.0), np.float32(1.0), np.float32(1.0), np.float32(0.0), np.float32(0.0), np.float32(0.0), np.float32(0.0), np.float32(0.0), np.float32(1.0), np.float32(1.0), np.float32(0.0), np.float32(1.0)]",0.0,99542.0,26
2025-08-14_08-18-36,7483,"[np.float32(0.0), np.float32(1.0), np.float32(1.0), np.float32(1.0), np.float32(1.0), np.float32(0.0), np.float32(0.0), np.float32(0.0), np.float32(1.0), np.float32(1.0), np.float32(1.0), np.float32(1.0), np.float32(1.0), np.float32(1.0), np.float32(0.0), np.float32(0.0)]",-3.0,99539.0,0
2025-08-14_08-18-36,7484,"[np.float32(1.0), np.float32(0.0), np.float32(0.0), np.float32(0.0), np.float32(0.0), np.float32(0.0), np.float32(1.0), np.float32(1.0), np.float32(0.0), np.float32(0.0), np.float32(0.0), np.float32(1.0), np.float32(1.0), np.float32(1.0), np.float32(1.0), np.float32(1.0)]",-2.0,99537.0,10
2025-08-14_08-18-36,7485,"[np.float32(0.0), np.float32(1.0), np.float32(1.0), np.float32(1.0), np.float32(0.0), np.float32(0.0), np.float32(0.0), np.float32(1.0), np.float32(1.0), np.float32(1.0), np.float32(0.0), np.float32(0.0), np.float32(1.0), np.float32(1.0), np.float32(1.0), np.float32(0.0)]",-1.0,99536.0,30
2025-08-14_08-18-36,7486,"[np.float32(0.0), np.float32(1.0), np.float32(1.0), np.float32(0.0), np.float32(1.0), np.float32(1.0), np.float32(0.0), np.float32(1.0), np.float32(1.0), np.float32(1.0), np.float32(0.0), np.float32(0.0), np.float32(0.0), np.float32(0.0), np.float32(1.0), np.float32(0.0)]",-6.0,99530.0,9
2025-08-14_08-18-36,7487,"[np.float32(0.0), np.float32(0.0), np.float32(0.0), np.float32(1.0), np.float32(0.0), np.float32(0.0), np.float32(0.0), np.float32(0.0), np.float32(0.0), np.float32(0.0), np.float32(0.0), np.float32(1.0), np.float32(0.0), np.float32(1.0), np.float32(0.0), np.float32(1.0)]",2.0,99532.0,6
2025-08-14_08-18-36,7488,"[np.float32(1.0), np.float32(0.0), np.float32(1.0), np.float32(1.0), np.float32(0.0), np.float32(0.0), np.float32(0.0), np.float32(0.0), np.float32(0.0), np.float32(1.0), np.float32(0.0), np.float32(0.0), np.float32(0.0), np.float32(1.0), np.float32(0.0), np.float32(0.0)]",2.0,99534.0,21
2025-08-14_08-18-36,7489,"[np.float32(1.0), np.float32(0.0), np.float32(0.0), np.float32(0.0), np.float32(0.0), np.float32(0.0), np.float32(0.0), np.float32(1.0), np.float32(1.0), np.float32(1.0), np.float32(1.0), np.float32(0.0), np.float32(0.0), np.float32(1.0), np.float32(1.0), np.float32(0.0)]",-5.0,99529.0,9
2025-08-14_08-18-36,7490,"[np.float32(0.0), np.float32(1.0), np.float32(1.0), np.float32(0.0), np.float32(0.0), np.float32(1.0), np.float32(0.0), np.float32(1.0), np.float32(0.0), np.float32(0.0), np.float32(1.0), np.float32(1.0), np.float32(0.0), np.float32(0.0), np.float32(0.0), np.float32(0.0)]",1.0,99530.0,30
2025-08-14_08-18-36,7491,"[np.float32(0.0), np.float32(0.0), np.float32(1.0), np.float32(0.0), np.float32(0.0), np.float32(0.0), np.float32(1.0), np.float32(0.0), np.float32(1.0), np.float32(0.0), np.float32(1.0), np.float32(0.0), np.float32(0.0), np.float32(1.0), np.float32(1.0), np.float32(0.0)]",0.0,99530.0,27
2025-08-14_08-18-36,7492,"[np.float32(0.0), np.float32(0.0), np.float32(0.0), np.float32(0.0), np.float32(0.0), np.float32(1.0), np.float32(1.0), np.float32(1.0), np.float32(1.0), np.float32(1.0), np.float32(0.0), np.float32(1.0), np.float32(0.0), np.float32(0.0), np.float32(0.0), np.float32(1.0)]",-4.0,99526.0,8
2025-08-14_08-18-36,7493,"[np.float32(1.0), np.float32(0.0), np.float32(0.0), np.float32(1.0), np.float32(0.0), np.float32(1.0), np.float32(1.0), np.float32(1.0), np.float32(0.0), np.float32(0.0), np.float32(0.0), np.float32(0.0), np.float32(1.0), np.float32(1.0), np.float32(0.0), np.float32(0.0)]",-2.0,99524.0,24
2025-08-14_08-18-36,7494,"[np.float32(1.0), np.float32(1.0), np.float32(1.0), np.float32(0.0), np.float32(0.0), np.float32(1.0), np.float32(0.0), np.float32(1.0), np.float32(0.0), np.float32(1.0), np.float32(1.0), np.float32(0.0), np.float32(0.0), np.float32(1.0), np.float32(0.0), np.float32(1.0)]",-2.0,99522.0,10
2025-08-14_08-18-36,7495,"[np.float32(0.0), np.float32(1.0), np.float32(0.0), np.float32(0.0), np.float32(1.0), np.float32(1.0), np.float32(1.0), np.float32(1.0), np.float32(0.0), np.float32(0.0), np.float32(1.0), np.float32(0.0), np.float32(0.0), np.float32(1.0), np.float32(0.0), np.float32(0.0)]",-5.0,99517.0,27
2025-08-14_08-18-36,7496,"[np.float32(1.0), np.float32(1.0), np.float32(1.0), np.float32(1.0), np.float32(0.0), np.float32(1.0), np.float32(1.0), np.float32(0.0), np.float32(0.0), np.float32(1.0), np.float32(1.0), np.float32(0.0), np.float32(1.0), np.float32(0.0), np.float32(0.0), np.float32(1.0)]",-4.0,99513.0,36
2025-08-14_08-18-36,7497,"[np.float32(1.0), np.float32(1.0), np.float32(1.0), np.float32(0.0), np.float32(0.0), np.float32(1.0), np.float32(1.0), np.float32(1.0), np.float32(0.0), np.float32(1.0), np.float32(1.0), np.float32(0.0), np.float32(0.0), np.float32(0.0), np.float32(0.0), np.float32(0.0)]",2.0,99515.0,8
2025-08-14_08-18-36,7498,"[np.float32(0.0), np.float32(0.0), np.float32(1.0), np.float32(0.0), np.float32(1.0), np.float32(0.0), np.float32(1.0), np.float32(1.0), np.float32(0.0), np.float32(0.0), np.float32(1.0), np.float32(0.0), np.float32(1.0), np.float32(0.0), np.float32(1.0), np.float32(0.0)]",-7.0,99508.0,31
2025-08-14_08-18-36,7499,"[np.float32(0.0), np.float32(0.0), np.float32(0.0), np.float32(0.0), np.float32(0.0), np.float32(1.0), np.float32(1.0), np.float32(1.0), np.float32(0.0), np.float32(0.0), np.float32(0.0), np.float32(1.0), np.float32(0.0), np.float32(1.0), np.float32(0.0), np.float32(1.0)]",0.0,99508.0,17
2025-08-14_08-18-36,7500,"[np.float32(1.0), np.float32(0.0), np.float32(1.0), np.float32(1.0), np.float32(0.0), np.float32(1.0), np.float32(0.0), np.float32(0.0), np.float32(0.0), np.float32(1.0), np.float32(1.0), np.float32(0.0), np.float32(0.0), np.float32(1.0), np.float32(0.0), np.float32(0.0)]",0.0,99508.0,20
2025-08-14_08-18-36,7501,"[np.float32(0.0), np.float32(1.0), np.float32(0.0), np.float32(1.0), np.float32(1.0), np.float32(1.0), np.float32(0.0), np.float32(1.0), np.float32(0.0), np.float32(1.0), np.float32(1.0), np.float32(0.0), np.float32(0.0), np.float32(0.0), np.float32(1.0), np.float32(0.0)]",2.0,99510.0,22
2025-08-14_08-18-36,7502,"[np.float32(0.0), np.float32(0.0), np.float32(0.0), np.float32(0.0), np.float32(1.0), np.float32(1.0), np.float32(0.0), np.float32(1.0), np.float32(0.0), np.float32(1.0), np.float32(0.0), np.float32(1.0), np.float32(1.0), np.float32(1.0), np.float32(1.0), np.float32(0.0)]",-3.0,99507.0,2
2025-08-14_08-18-36,7503,"[np.float32(0.0), np.float32(0.0), np.float32(0.0), np.float32(1.0), np.float32(0.0), np.float32(1.0), np.float32(1.0), np.float32(1.0), np.float32(1.0), np.float32(0.0), np.float32(0.0), np.float32(0.0), np.float32(0.0), np.float32(0.0), np.float32(1.0), np.float32(0.0)]",-1.0,99506.0,26
2025-08-14_08-18-36,7504,"[np.float32(1.0), np.float32(0.0), np.float32(1.0), np.float32(1.0), np.float32(1.0), np.float32(1.0), np.float32(0.0), np.float32(0.0), np.float32(1.0), np.float32(0.0), np.float32(1.0), np.float32(1.0), np.float32(0.0), np.float32(0.0), np.float32(0.0), np.float32(0.0)]",-4.0,99502.0,0
2025-08-14_08-18-36,7505,"[np.float32(1.0), np.float32(1.0), np.float32(1.0), np.float32(1.0), np.float32(0.0), np.float32(0.0), np.float32(0.0), np.float32(1.0), np.float32(0.0), np.float32(0.0), np.float32(1.0), np.float32(0.0), np.float32(1.0), np.float32(1.0), np.float32(0.0), np.float32(1.0)]",1.0,99503.0,19
2025-08-14_08-18-36,7506,"[np.float32(1.0), np.float32(1.0), np.float32(1.0), np.float32(0.0), np.float32(0.0), np.float32(0.0), np.float32(0.0), np.float32(0.0), np.float32(1.0), np.float32(1.0), np.float32(1.0), np.float32(0.0), np.float32(0.0), np.float32(0.0), np.float32(1.0), np.float32(0.0)]",-2.0,99501.0,17
2025-08-14_08-18-36,7507,"[np.float32(1.0), np.float32(1.0), np.float32(0.0), np.float32(0.0), np.float32(0.0), np.float32(1.0), np.float32(1.0), np.float32(0.0), np.float32(1.0), np.float32(1.0), np.float32(0.0), np.float32(0.0), np.float32(0.0), np.float32(1.0), np.float32(0.0), np.float32(0.0)]",-2.0,99499.0,18
2025-08-14_08-18-36,7508,"[np.float32(0.0), np.float32(1.0), np.float32(1.0), np.float32(1.0), np.float32(0.0), np.float32(1.0), np.float32(1.0), np.float32(1.0), np.float32(1.0), np.float32(0.0), np.float32(0.0), np.float32(1.0), np.float32(0.0), np.float32(1.0), np.float32(0.0), np.float32(0.0)]",3.0,99502.0,35
2025-08-14_08-18-36,7509,"[np.float32(1.0), np.float32(0.0), np.float32(0.0), np.float32(1.0), np.float32(1.0), np.float32(1.0), np.float32(1.0), np.float32(1.0), np.float32(0.0), np.float32(0.0), np.float32(1.0), np.float32(1.0), np.float32(1.0), np.float32(1.0), np.float32(1.0), np.float32(0.0)]",2.0,99504.0,15
2025-08-14_08-18-36,7510,"[np.float32(0.0), np.float32(0.0), np.float32(1.0), np.float32(1.0), np.float32(0.0), np.float32(1.0), np.float32(0.0), np.float32(1.0), np.float32(1.0), np.float32(0.0), np.float32(1.0), np.float32(1.0), np.float32(1.0), np.float32(0.0), np.float32(1.0), np.float32(0.0)]",-7.0,99497.0,1
2025-08-14_08-18-36,7511,"[np.float32(0.0), np.float32(1.0), np.float32(0.0), np.float32(1.0), np.float32(1.0), np.float32(1.0), np.float32(1.0), np.float32(1.0), np.float32(1.0), np.float32(1.0), np.float32(0.0), np.float32(1.0), np.float32(0.0), np.float32(0.0), np.float32(0.0), np.float32(0.0)]",-1.0,99496.0,18
2025-08-14_08-18-36,7512,"[np.float32(0.0), np.float32(0.0), np.float32(0.0), np.float32(0.0), np.float32(1.0), np.float32(1.0), np.float32(0.0), np.float32(1.0), np.float32(1.0), np.float32(1.0), np.float32(1.0), np.float32(0.0), np.float32(0.0), np.float32(0.0), np.float32(1.0), np.float32(1.0)]",0.0,99496.0,19
2025-08-14_08-18-36,7513,"[np.float32(0.0), np.float32(1.0), np.float32(0.0), np.float32(1.0), np.float32(0.0), np.float32(1.0), np.float32(1.0), np.float32(1.0), np.float32(1.0), np.float32(0.0), np.float32(1.0), np.float32(1.0), np.float32(1.0), np.float32(1.0), np.float32(0.0), np.float32(1.0)]",0.0,99496.0,6
2025-08-14_08-18-36,7514,"[np.float32(0.0), np.float32(1.0), np.float32(1.0), np.float32(0.0), np.float32(0.0), np.float32(1.0), np.float32(1.0), np.float32(0.0), np.float32(0.0), np.float32(0.0), np.float32(1.0), np.float32(0.0), np.float32(1.0), np.float32(1.0), np.float32(0.0), np.float32(0.0)]",-5.0,99491.0,13
2025-08-14_08-18-36,7515,"[np.float32(0.0), np.float32(1.0), np.float32(1.0), np.float32(0.0), np.float32(0.0), np.float32(0.0), np.float32(1.0), np.float32(1.0), np.float32(1.0), np.float32(1.0), np.float32(1.0), np.float32(0.0), np.float32(0.0), np.float32(0.0), np.float32(1.0), np.float32(0.0)]",1.0,99492.0,23
2025-08-14_08-18-36,7516,"[np.float32(1.0), np.float32(1.0), np.float32(1.0), np.float32(1.0), np.float32(0.0), np.float32(1.0), np.float32(1.0), np.float32(1.0), np.float32(0.0), np.float32(0.0), np.float32(0.0), np.float32(1.0), np.float32(0.0), np.float32(1.0), np.float32(1.0), np.float32(0.0)]",0.0,99492.0,6
2025-08-14_08-18-36,7517,"[np.float32(0.0), np.float32(1.0), np.float32(0.0), np.float32(0.0), np.float32(0.0), np.float32(1.0), np.float32(1.0), np.float32(1.0), np.float32(1.0), np.float32(0.0), np.float32(0.0), np.float32(0.0), np.float32(1.0), np.float32(1.0), np.float32(0.0), np.float32(0.0)]",-4.0,99488.0,1
2025-08-14_08-18-36,7518,"[np.float32(0.0), np.float32(0.0), np.float32(0.0), np.float32(1.0), np.float32(0.0), np.float32(1.0), np.float32(0.0), np.float32(1.0), np.float32(0.0), np.float32(1.0), np.float32(0.0), np.float32(1.0), np.float32(0.0), np.float32(0.0), np.float32(0.0), np.float32(1.0)]",-6.0,99482.0,2
2025-08-14_08-18-36,7519,"[np.float32(1.0), np.float32(0.0), np.float32(0.0), np.float32(1.0), np.float32(0.0), np.float32(0.0), np.float32(1.0), np.float32(0.0), np.float32(1.0), np.float32(0.0), np.float32(1.0), np.float32(1.0), np.float32(0.0), np.float32(0.0), np.float32(0.0), np.float32(0.0)]",-1.0,99481.0,15
2025-08-14_08-18-36,7520,"[np.float32(0.0), np.float32(0.0), np.float32(0.0), np.float32(1.0), np.float32(1.0), np.float32(1.0), np.float32(1.0), np.float32(0.0), np.float32(0.0), np.float32(0.0), np.float32(1.0), np.float32(0.0), np.float32(1.0), np.float32(1.0), np.float32(0.0), np.float32(1.0)]",0.0,99481.0,32
2025-08-14_08-18-36,7521,"[np.float32(1.0), np.float32(0.0), np.float32(0.0), np.float32(0.0), np.float32(1.0), np.float32(0.0), np.float32(1.0), np.float32(0.0), np.float32(0.0), np.float32(0.0), np.float32(1.0), np.float32(0.0), np.float32(1.0), np.float32(0.0), np.float32(1.0), np.float32(0.0)]",1.0,99482.0,3
2025-08-14_08-18-36,7522,"[np.float32(1.0), np.float32(0.0), np.float32(0.0), np.float32(1.0), np.float32(0.0), np.float32(1.0), np.float32(0.0), np.float32(1.0), np.float32(1.0), np.float32(1.0), np.float32(0.0), np.float32(1.0), np.float32(1.0), np.float32(0.0), np.float32(1.0), np.float32(1.0)]",1.0,99483.0,16
2025-08-14_08-18-36,7523,"[np.float32(0.0), np.float32(1.0), np.float32(0.0), np.float32(0.0), np.float32(0.0), np.float32(1.0), np.float32(0.0), np.float32(0.0), np.float32(1.0), np.float32(0.0), np.float32(1.0), np.float32(1.0), np.float32(1.0), np.float32(1.0), np.float32(0.0), np.float32(0.0)]",-5.0,99478.0,10
2025-08-14_08-18-36,7524,"[np.float32(0.0), np.float32(0.0), np.float32(1.0), np.float32(0.0), np.float32(1.0), np.float32(1.0), np.float32(1.0), np.float32(1.0), np.float32(0.0), np.float32(1.0), np.float32(0.0), np.float32(0.0), np.float32(1.0), np.float32(0.0), np.float32(1.0), np.float32(0.0)]",-3.0,99475.0,3
2025-08-14_08-18-36,7525,"[np.float32(0.0), np.float32(0.0), np.float32(1.0), np.float32(0.0), np.float32(1.0), np.float32(1.0), np.float32(1.0), np.float32(1.0), np.float32(1.0), np.float32(1.0), np.float32(1.0), np.float32(1.0), np.float32(0.0), np.float32(0.0), np.float32(0.0), np.float32(0.0)]",-1.0,99474.0,17
2025-08-14_08-18-36,7526,"[np.float32(1.0), np.float32(1.0), np.float32(1.0), np.float32(0.0), np.float32(0.0), np.float32(0.0), np.float32(0.0), np.float32(1.0), np.float32(1.0), np.float32(1.0), np.float32(0.0), np.float32(0.0), np.float32(0.0), np.float32(0.0), np.float32(0.0), np.float32(1.0)]",-2.0,99472.0,23
2025-08-14_08-18-36,7527,"[np.float32(1.0), np.float32(0.0), np.float32(1.0), np.float32(1.0), np.float32(1.0), np.float32(0.0), np.float32(1.0), np.float32(1.0), np.float32(0.0), np.float32(0.0), np.float32(0.0), np.float32(0.0), np.float32(0.0), np.float32(1.0), np.float32(1.0), np.float32(0.0)]",1.0,99473.0,1
2025-08-14_08-18-36,7528,"[np.float32(0.0), np.float32(0.0), np.float32(0.0), np.float32(0.0), np.float32(0.0), np.float32(1.0), np.float32(0.0), np.float32(1.0), np.float32(0.0), np.float32(0.0), np.float32(1.0), np.float32(1.0), np.float32(0.0), np.float32(1.0), np.float32(0.0), np.float32(0.0)]",-2.0,99471.0,8
2025-08-14_08-18-36,7529,"[np.float32(1.0), np.float32(1.0), np.float32(0.0), np.float32(1.0), np.float32(0.0), np.float32(1.0), np.float32(1.0), np.float32(1.0), np.float32(0.0), np.float32(0.0), np.float32(0.0), np.float32(0.0), np.float32(1.0), np.float32(0.0), np.float32(1.0), np.float32(0.0)]",-1.0,99470.0,30
2025-08-14_08-18-36,7530,"[np.float32(1.0), np.float32(1.0), np.float32(1.0), np.float32(0.0), np.float32(0.0), np.float32(1.0), np.float32(1.0), np.float32(1.0), np.float32(0.0), np.float32(1.0), np.float32(0.0), np.float32(1.0), np.float32(0.0), np.float32(0.0), np.float32(1.0), np.float32(1.0)]",2.0,99472.0,36
2025-08-14_08-18-36,7531,"[np.float32(0.0), np.float32(1.0), np.float32(0.0), np.float32(0.0), np.float32(0.0), np.float32(0.0), np.float32(1.0), np.float32(1.0), np.float32(0.0), np.float32(0.0), np.float32(0.0), np.float32(1.0), np.float32(0.0), np.float32(0.0), np.float32(0.0), np.float32(1.0)]",-3.0,99469.0,28
2025-08-14_08-18-36,7532,"[np.float32(0.0), np.float32(1.0), np.float32(0.0), np.float32(0.0), np.float32(0.0), np.float32(0.0), np.float32(1.0), np.float32(1.0), np.float32(1.0), np.float32(0.0), np.float32(1.0), np.float32(0.0), np.float32(0.0), np.float32(1.0), np.float32(0.0), np.float32(1.0)]",-4.0,99465.0,16
2025-08-14_08-18-36,7533,"[np.float32(0.0), np.float32(0.0), np.float32(0.0), np.float32(0.0), np.float32(1.0), np.float32(0.0), np.float32(1.0), np.float32(0.0), np.float32(1.0), np.float32(0.0), np.float32(0.0), np.float32(0.0), np.float32(1.0), np.float32(1.0), np.float32(1.0), np.float32(0.0)]",-1.0,99464.0,18
2025-08-14_08-18-36,7534,"[np.float32(0.0), np.float32(1.0), np.float32(0.0), np.float32(0.0), np.float32(0.0), np.float32(0.0), np.float32(1.0), np.float32(0.0), np.float32(0.0), np.float32(1.0), np.float32(1.0), np.float32(0.0), np.float32(1.0), np.float32(0.0), np.float32(1.0), np.float32(0.0)]",-3.0,99461.0,14
2025-08-14_08-18-36,7535,"[np.float32(1.0), np.float32(0.0), np.float32(0.0), np.float32(1.0), np.float32(0.0), np.float32(1.0), np.float32(1.0), np.float32(1.0), np.float32(1.0), np.float32(0.0), np.float32(1.0), np.float32(0.0), np.float32(1.0), np.float32(1.0), np.float32(0.0), np.float32(0.0)]",2.0,99463.0,26
2025-08-14_08-18-36,7536,"[np.float32(1.0), np.float32(1.0), np.float32(1.0), np.float32(0.0), np.float32(0.0), np.float32(0.0), np.float32(1.0), np.float32(1.0), np.float32(1.0), np.float32(0.0), np.float32(0.0), np.float32(0.0), np.float32(1.0), np.float32(1.0), np.float32(0.0), np.float32(0.0)]",-1.0,99462.0,0
2025-08-14_08-18-36,7537,"[np.float32(0.0), np.float32(0.0), np.float32(1.0), np.float32(0.0), np.float32(0.0), np.float32(1.0), np.float32(0.0), np.float32(1.0), np.float32(0.0), np.float32(0.0), np.float32(0.0), np.float32(0.0), np.float32(0.0), np.float32(1.0), np.float32(1.0), np.float32(1.0)]",-1.0,99461.0,2
2025-08-14_08-18-36,7538,"[np.float32(0.0), np.float32(1.0), np.float32(0.0), np.float32(0.0), np.float32(1.0), np.float32(0.0), np.float32(0.0), np.float32(0.0), np.float32(1.0), np.float32(0.0), np.float32(0.0), np.float32(0.0), np.float32(0.0), np.float32(1.0), np.float32(1.0), np.float32(1.0)]",2.0,99463.0,28
2025-08-14_08-18-36,7539,"[np.float32(1.0), np.float32(1.0), np.float32(0.0), np.float32(1.0), np.float32(0.0), np.float32(1.0), np.float32(1.0), np.float32(0.0), np.float32(1.0), np.float32(0.0), np.float32(1.0), np.float32(0.0), np.float32(0.0), np.float32(1.0), np.float32(0.0), np.float32(0.0)]",-1.0,99462.0,1
2025-08-14_08-18-36,7540,"[np.float32(0.0), np.float32(0.0), np.float32(0.0), np.float32(1.0), np.float32(0.0), np.float32(1.0), np.float32(0.0), np.float32(1.0), np.float32(1.0), np.float32(0.0), np.float32(1.0), np.float32(0.0), np.float32(0.0), np.float32(0.0), np.float32(1.0), np.float32(0.0)]",2.0,99464.0,5
2025-08-14_08-18-36,7541,"[np.float32(1.0), np.float32(0.0), np.float32(0.0), np.float32(0.0), np.float32(0.0), np.float32(1.0), np.float32(1.0), np.float32(1.0), np.float32(0.0), np.float32(1.0), np.float32(1.0), np.float32(0.0), np.float32(0.0), np.float32(1.0), np.float32(1.0), np.float32(0.0)]",3.0,99467.0,7
2025-08-14_08-18-36,7542,"[np.float32(1.0), np.float32(0.0), np.float32(0.0), np.float32(1.0), np.float32(0.0), np.float32(0.0), np.float32(1.0), np.float32(1.0), np.float32(0.0), np.float32(0.0), np.float32(0.0), np.float32(0.0), np.float32(1.0), np.float32(1.0), np.float32(1.0), np.float32(0.0)]",3.0,99470.0,21
2025-08-14_08-18-36,7543,"[np.float32(1.0), np.float32(0.0), np.float32(0.0), np.float32(1.0), np.float32(1.0), np.float32(1.0), np.float32(0.0), np.float32(0.0), np.float32(0.0), np.float32(0.0), np.float32(0.0), np.float32(0.0), np.float32(1.0), np.float32(0.0), np.float32(1.0), np.float32(0.0)]",-2.0,99468.0,15
2025-08-14_08-18-36,7544,"[np.float32(0.0), np.float32(0.0), np.float32(0.0), np.float32(0.0), np.float32(0.0), np.float32(0.0), np.float32(1.0), np.float32(0.0), np.float32(0.0), np.float32(0.0), np.float32(1.0), np.float32(0.0), np.float32(0.0), np.float32(1.0), np.float32(0.0), np.float32(0.0)]",0.0,99468.0,14
2025-08-14_08-18-36,7545,"[np.float32(1.0), np.float32(0.0), np.float32(1.0), np.float32(1.0), np.float32(0.0), np.float32(1.0), np.float32(1.0), np.float32(1.0), np.float32(1.0), np.float32(1.0), np.float32(0.0), np.float32(0.0), np.float32(1.0), np.float32(1.0), np.float32(1.0), np.float32(0.0)]",1.0,99469.0,34
2025-08-14_08-18-36,7546,"[np.float32(1.0), np.float32(0.0), np.float32(0.0), np.float32(0.0), np.float32(0.0), np.float32(0.0), np.float32(1.0), np.float32(1.0), np.float32(0.0), np.float32(1.0), np.float32(0.0), np.float32(0.0), np.float32(1.0), np.float32(1.0), np.float32(0.0), np.float32(0.0)]",2.0,99471.0,21
2025-08-14_08-18-36,7547,"[np.float32(1.0), np.float32(1.0), np.float32(1.0), np.float32(1.0), np.float32(0.0), np.float32(1.0), np.float32(1.0), np.float32(0.0), np.float32(1.0), np.float32(1.0), np.float32(0.0), np.float32(1.0), np.float32(1.0), np.float32(0.0), np.float32(0.0), np.float32(1.0)]",-4.0,99467.0,18
2025-08-14_08-18-36,7548,"[np.float32(0.0), np.float32(1.0), np.float32(1.0), np.float32(0.0), np.float32(0.0), np.float32(1.0), np.float32(1.0), np.float32(1.0), np.float32(1.0), np.float32(1.0), np.float32(0.0), np.float32(1.0), np.float32(1.0), np.float32(1.0), np.float32(1.0), np.float32(1.0)]",-1.0,99466.0,12
2025-08-14_08-18-36,7549,"[np.float32(1.0), np.float32(0.0), np.float32(1.0), np.float32(1.0), np.float32(0.0), np.float32(1.0), np.float32(0.0), np.float32(1.0), np.float32(0.0), np.float32(0.0), np.float32(1.0), np.float32(0.0), np.float32(0.0), np.float32(0.0), np.float32(0.0), np.float32(0.0)]",1.0,99467.0,24
2025-08-14_08-18-36,7550,"[np.float32(1.0), np.float32(1.0), np.float32(1.0), np.float32(1.0), np.float32(1.0), np.float32(0.0), np.float32(0.0), np.float32(1.0), np.float32(1.0), np.float32(1.0), np.float32(0.0), np.float32(1.0), np.float32(1.0), np.float32(0.0), np.float32(1.0), np.float32(0.0)]",-2.0,99465.0,14
2025-08-14_08-18-36,7551,"[np.float32(1.0), np.float32(0.0), np.float32(1.0), np.float32(1.0), np.float32(0.0), np.float32(1.0), np.float32(0.0), np.float32(0.0), np.float32(1.0), np.float32(0.0), np.float32(1.0), np.float32(0.0), np.float32(1.0), np.float32(0.0), np.float32(0.0), np.float32(0.0)]",2.0,99467.0,25
2025-08-14_08-18-36,7552,"[np.float32(1.0), np.float32(0.0), np.float32(1.0), np.float32(1.0), np.float32(0.0), np.float32(1.0), np.float32(1.0), np.float32(1.0), np.float32(1.0), np.float32(0.0), np.float32(0.0), np.float32(0.0), np.float32(1.0), np.float32(1.0), np.float32(0.0), np.float32(1.0)]",-3.0,99464.0,33
2025-08-14_08-18-36,7553,"[np.float32(1.0), np.float32(1.0), np.float32(1.0), np.float32(0.0), np.float32(1.0), np.float32(1.0), np.float32(0.0), np.float32(1.0), np.float32(1.0), np.float32(1.0), np.float32(1.0), np.float32(0.0), np.float32(0.0), np.float32(1.0), np.float32(0.0), np.float32(0.0)]",0.0,99464.0,21
2025-08-14_08-18-36,7554,"[np.float32(1.0), np.float32(0.0), np.float32(1.0), np.float32(0.0), np.float32(0.0), np.float32(0.0), np.float32(1.0), np.float32(1.0), np.float32(1.0), np.float32(1.0), np.float32(0.0), np.float32(1.0), np.float32(0.0), np.float32(1.0), np.float32(1.0), np.float32(0.0)]",4.0,99468.0,30
2025-08-14_08-18-36,7555,"[np.float32(0.0), np.float32(1.0), np.float32(0.0), np.float32(1.0), np.float32(0.0), np.float32(1.0), np.float32(1.0), np.float32(1.0), np.float32(1.0), np.float32(1.0), np.float32(0.0), np.float32(0.0), np.float32(1.0), np.float32(0.0), np.float32(1.0), np.float32(1.0)]",-4.0,99464.0,14
2025-08-14_08-18-36,7556,"[np.float32(0.0), np.float32(0.0), np.float32(0.0), np.float32(1.0), np.float32(1.0), np.float32(1.0), np.float32(0.0), np.float32(1.0), np.float32(1.0), np.float32(0.0), np.float32(0.0), np.float32(1.0), np.float32(1.0), np.float32(1.0), np.float32(0.0), np.float32(1.0)]",1.0,99465.0,19
2025-08-14_08-18-36,7557,"[np.float32(0.0), np.float32(1.0), np.float32(1.0), np.float32(1.0), np.float32(0.0), np.float32(0.0), np.float32(0.0), np.float32(1.0), np.float32(0.0), np.float32(0.0), np.float32(1.0), np.float32(0.0), np.float32(1.0), np.float32(1.0), np.float32(1.0), np.float32(0.0)]",3.0,99468.0,23
2025-08-14_08-18-36,7558,"[np.float32(1.0), np.float32(0.0), np.float32(1.0), np.float32(0.0), np.float32(0.0), np.float32(0.0), np.float32(1.0), np.float32(1.0), np.float32(1.0), np.float32(0.0), np.float32(1.0), np.float32(1.0), np.float32(1.0), np.float32(0.0), np.float32(0.0), np.float32(1.0)]",-1.0,99467.0,27
2025-08-14_08-18-36,7559,"[np.float32(1.0), np.float32(1.0), np.float32(1.0), np.float32(1.0), np.float32(0.0), np.float32(1.0), np.float32(1.0), np.float32(1.0), np.float32(1.0), np.float32(1.0), np.float32(1.0), np.float32(1.0), np.float32(1.0), np.float32(1.0), np.float32(0.0), np.float32(1.0)]",-1.0,99466.0,4
2025-08-14_08-18-36,7560,"[np.float32(0.0), np.float32(0.0), np.float32(0.0), np.float32(1.0), np.float32(0.0), np.float32(0.0), np.float32(0.0), np.float32(1.0), np.float32(0.0), np.float32(1.0), np.float32(0.0), np.float32(0.0), np.float32(0.0), np.float32(0.0), np.float32(0.0), np.float32(1.0)]",-2.0,99464.0,5
2025-08-14_08-18-36,7561,"[np.float32(1.0), np.float32(1.0), np.float32(0.0), np.float32(0.0), np.float32(0.0), np.float32(1.0), np.float32(0.0), np.float32(1.0), np.float32(0.0), np.float32(1.0), np.float32(1.0), np.float32(0.0), np.float32(0.0), np.float32(1.0), np.float32(1.0), np.float32(0.0)]",-1.0,99463.0,31
2025-08-14_08-18-36,7562,"[np.float32(1.0), np.float32(1.0), np.float32(0.0), np.float32(0.0), np.float32(0.0), np.float32(0.0), np.float32(0.0), np.float32(0.0), np.float32(1.0), np.float32(0.0), np.float32(1.0), np.float32(1.0), np.float32(1.0), np.float32(0.0), np.float32(0.0), np.float32(1.0)]",1.0,99464.0,27
2025-08-14_08-18-36,7563,"[np.float32(0.0), np.float32(1.0), np.float32(0.0), np.float32(0.0), np.float32(0.0), np.float32(0.0), np.float32(1.0), np.float32(0.0), np.float32(0.0), np.float32(0.0), np.float32(0.0), np.float32(0.0), np.float32(1.0), np.float32(0.0), np.float32(1.0), np.float32(0.0)]",-4.0,99460.0,25
2025-08-14_08-18-36,7564,"[np.float32(1.0), np.float32(1.0), np.float32(1.0), np.float32(0.0), np.float32(0.0), np.float32(1.0), np.float32(0.0), np.float32(0.0), np.float32(0.0), np.float32(1.0), np.float32(1.0), np.float32(1.0), np.float32(1.0), np.float32(1.0), np.float32(1.0), np.float32(0.0)]",34.0,99494.0,7
2025-08-14_08-18-36,7565,"[np.float32(1.0), np.float32(1.0), np.float32(0.0), np.float32(0.0), np.float32(0.0), np.float32(0.0), np.float32(1.0), np.float32(1.0), np.float32(0.0), np.float32(1.0), np.float32(0.0), np.float32(1.0), np.float32(0.0), np.float32(0.0), np.float32(0.0), np.float32(1.0)]",1.0,99495.0,18
2025-08-14_08-18-36,7566,"[np.float32(0.0), np.float32(1.0), np.float32(0.0), np.float32(0.0), np.float32(0.0), np.float32(0.0), np.float32(0.0), np.float32(0.0), np.float32(1.0), np.float32(1.0), np.float32(1.0), np.float32(1.0), np.float32(0.0), np.float32(1.0), np.float32(0.0), np.float32(0.0)]",2.0,99497.0,2
2025-08-14_08-18-36,7567,"[np.float32(0.0), np.float32(0.0), np.float32(0.0), np.float32(1.0), np.float32(1.0), np.float32(0.0), np.float32(1.0), np.float32(1.0), np.float32(0.0), np.float32(0.0), np.float32(0.0), np.float32(1.0), np.float32(0.0), np.float32(0.0), np.float32(1.0), np.float32(1.0)]",6.0,99503.0,9
2025-08-14_08-18-36,7568,"[np.float32(0.0), np.float32(0.0), np.float32(1.0), np.float32(0.0), np.float32(0.0), np.float32(0.0), np.float32(0.0), np.float32(0.0), np.float32(1.0), np.float32(0.0), np.float32(0.0), np.float32(0.0), np.float32(0.0), np.float32(1.0), np.float32(0.0), np.float32(0.0)]",0.0,99503.0,31
2025-08-14_08-18-36,7569,"[np.float32(0.0), np.float32(1.0), np.float32(1.0), np.float32(1.0), np.float32(0.0), np.float32(1.0), np.float32(1.0), np.float32(1.0), np.float32(1.0), np.float32(0.0), np.float32(0.0), np.float32(0.0), np.float32(1.0), np.float32(0.0), np.float32(0.0), np.float32(0.0)]",33.0,99536.0,7
2025-08-14_08-18-36,7570,"[np.float32(0.0), np.float32(0.0), np.float32(1.0), np.float32(0.0), np.float32(1.0), np.float32(0.0), np.float32(1.0), np.float32(1.0), np.float32(1.0), np.float32(0.0), np.float32(1.0), np.float32(0.0), np.float32(0.0), np.float32(0.0), np.float32(1.0), np.float32(1.0)]",-5.0,99531.0,19
2025-08-14_08-18-36,7571,"[np.float32(0.0), np.float32(1.0), np.float32(1.0), np.float32(1.0), np.float32(1.0), np.float32(0.0), np.float32(1.0), np.float32(1.0), np.float32(1.0), np.float32(0.0), np.float32(0.0), np.float32(1.0), np.float32(0.0), np.float32(0.0), np.float32(1.0), np.float32(1.0)]",-3.0,99528.0,28
2025-08-14_08-18-36,7572,"[np.float32(0.0), np.float32(0.0), np.float32(1.0), np.float32(0.0), np.float32(0.0), np.float32(1.0), np.float32(0.0), np.float32(1.0), np.float32(0.0), np.float32(1.0), np.float32(1.0), np.float32(0.0), np.float32(0.0), np.float32(1.0), np.float32(1.0), np.float32(1.0)]",2.0,99530.0,34
2025-08-14_08-18-36,7573,"[np.float32(0.0), np.float32(1.0), np.float32(1.0), np.float32(0.0), np.float32(0.0), np.float32(1.0), np.float32(1.0), np.float32(1.0), np.float32(1.0), np.float32(1.0), np.float32(0.0), np.float32(0.0), np.float32(0.0), np.float32(0.0), np.float32(0.0), np.float32(1.0)]",-2.0,99528.0,7
2025-08-14_08-18-36,7574,"[np.float32(0.0), np.float32(0.0), np.float32(0.0), np.float32(1.0), np.float32(1.0), np.float32(1.0), np.float32(1.0), np.float32(0.0), np.float32(0.0), np.float32(1.0), np.float32(1.0), np.float32(0.0), np.float32(1.0), np.float32(1.0), np.float32(0.0), np.float32(1.0)]",2.0,99530.0,2
2025-08-14_08-18-36,7575,"[np.float32(0.0), np.float32(1.0), np.float32(0.0), np.float32(0.0), np.float32(0.0), np.float32(0.0), np.float32(1.0), np.float32(0.0), np.float32(0.0), np.float32(1.0), np.float32(0.0), np.float32(0.0), np.float32(0.0), np.float32(1.0), np.float32(0.0), np.float32(0.0)]",-2.0,99528.0,33
2025-08-14_08-18-36,7576,"[np.float32(0.0), np.float32(1.0), np.float32(1.0), np.float32(0.0), np.float32(0.0), np.float32(0.0), np.float32(1.0), np.float32(0.0), np.float32(1.0), np.float32(0.0), np.float32(0.0), np.float32(1.0), np.float32(0.0), np.float32(1.0), np.float32(0.0), np.float32(0.0)]",2.0,99530.0,36
2025-08-14_08-18-36,7577,"[np.float32(0.0), np.float32(0.0), np.float32(0.0), np.float32(0.0), np.float32(0.0), np.float32(0.0), np.float32(1.0), np.float32(0.0), np.float32(0.0), np.float32(0.0), np.float32(0.0), np.float32(1.0), np.float32(0.0), np.float32(1.0), np.float32(1.0), np.float32(0.0)]",2.0,99532.0,4
2025-08-14_08-18-36,7578,"[np.float32(0.0), np.float32(0.0), np.float32(0.0), np.float32(1.0), np.float32(1.0), np.float32(1.0), np.float32(0.0), np.float32(0.0), np.float32(0.0), np.float32(1.0), np.float32(1.0), np.float32(1.0), np.float32(1.0), np.float32(1.0), np.float32(1.0), np.float32(0.0)]",-2.0,99530.0,1
2025-08-14_08-18-36,7579,"[np.float32(0.0), np.float32(1.0), np.float32(0.0), np.float32(1.0), np.float32(0.0), np.float32(0.0), np.float32(0.0), np.float32(0.0), np.float32(0.0), np.float32(1.0), np.float32(1.0), np.float32(0.0), np.float32(0.0), np.float32(0.0), np.float32(0.0), np.float32(1.0)]",0.0,99530.0,25
2025-08-14_08-18-36,7580,"[np.float32(0.0), np.float32(0.0), np.float32(1.0), np.float32(0.0), np.float32(0.0), np.float32(1.0), np.float32(0.0), np.float32(0.0), np.float32(0.0), np.float32(0.0), np.float32(0.0), np.float32(1.0), np.float32(1.0), np.float32(1.0), np.float32(0.0), np.float32(0.0)]",3.0,99533.0,21
2025-08-14_08-18-36,7581,"[np.float32(1.0), np.float32(0.0), np.float32(1.0), np.float32(1.0), np.float32(0.0), np.float32(1.0), np.float32(0.0), np.float32(0.0), np.float32(1.0), np.float32(0.0), np.float32(0.0), np.float32(0.0), np.float32(1.0), np.float32(1.0), np.float32(1.0), np.float32(0.0)]",1.0,99534.0,34
2025-08-14_08-18-36,7582,"[np.float32(0.0), np.float32(0.0), np.float32(1.0), np.float32(0.0), np.float32(1.0), np.float32(1.0), np.float32(0.0), np.float32(1.0), np.float32(0.0), np.float32(0.0), np.float32(0.0), np.float32(0.0), np.float32(0.0), np.float32(0.0), np.float32(1.0), np.float32(0.0)]",2.0,99536.0,14
2025-08-14_08-18-36,7583,"[np.float32(0.0), np.float32(0.0), np.float32(1.0), np.float32(0.0), np.float32(0.0), np.float32(1.0), np.float32(0.0), np.float32(0.0), np.float32(0.0), np.float32(1.0), np.float32(0.0), np.float32(0.0), np.float32(0.0), np.float32(1.0), np.float32(0.0), np.float32(0.0)]",-2.0,99534.0,27
2025-08-14_08-18-36,7584,"[np.float32(1.0), np.float32(0.0), np.float32(1.0), np.float32(0.0), np.float32(0.0), np.float32(0.0), np.float32(1.0), np.float32(1.0), np.float32(0.0), np.float32(0.0), np.float32(0.0), np.float32(0.0), np.float32(1.0), np.float32(1.0), np.float32(0.0), np.float32(0.0)]",4.0,99538.0,12
2025-08-14_08-18-36,7585,"[np.float32(0.0), np.float32(1.0), np.float32(1.0), np.float32(0.0), np.float32(0.0), np.float32(0.0), np.float32(0.0), np.float32(1.0), np.float32(1.0), np.float32(1.0), np.float32(0.0), np.float32(1.0), np.float32(1.0), np.float32(0.0), np.float32(0.0), np.float32(0.0)]",0.0,99538.0,10
2025-08-14_08-18-36,7586,"[np.float32(1.0), np.float32(0.0), np.float32(1.0), np.float32(0.0), np.float32(0.0), np.float32(1.0), np.float32(1.0), np.float32(0.0), np.float32(1.0), np.float32(0.0), np.float32(1.0), np.float32(0.0), np.float32(0.0), np.float32(1.0), np.float32(0.0), np.float32(1.0)]",-1.0,99537.0,22
2025-08-14_08-18-36,7587,"[np.float32(0.0), np.float32(1.0), np.float32(1.0), np.float32(0.0), np.float32(1.0), np.float32(1.0), np.float32(1.0), np.float32(1.0), np.float32(1.0), np.float32(0.0), np.float32(1.0), np.float32(0.0), np.float32(0.0), np.float32(1.0), np.float32(1.0), np.float32(1.0)]",2.0,99539.0,17
2025-08-14_08-18-36,7588,"[np.float32(0.0), np.float32(0.0), np.float32(1.0), np.float32(1.0), np.float32(1.0), np.float32(0.0), np.float32(1.0), np.float32(1.0), np.float32(1.0), np.float32(0.0), np.float32(0.0), np.float32(0.0), np.float32(0.0), np.float32(1.0), np.float32(0.0), np.float32(0.0)]",-2.0,99537.0,0
2025-08-14_08-18-36,7589,"[np.float32(1.0), np.float32(0.0), np.float32(1.0), np.float32(0.0), np.float32(0.0), np.float32(0.0), np.float32(1.0), np.float32(0.0), np.float32(1.0), np.float32(0.0), np.float32(1.0), np.float32(1.0), np.float32(1.0), np.float32(1.0), np.float32(0.0), np.float32(0.0)]",-3.0,99534.0,22
2025-08-14_08-18-36,7590,"[np.float32(0.0), np.float32(0.0), np.float32(0.0), np.float32(1.0), np.float32(0.0), np.float32(1.0), np.float32(1.0), np.float32(1.0), np.float32(1.0), np.float32(1.0), np.float32(0.0), np.float32(0.0), np.float32(0.0), np.float32(1.0), np.float32(1.0), np.float32(0.0)]",2.0,99536.0,31
2025-08-14_08-18-36,7591,"[np.float32(0.0), np.float32(0.0), np.float32(1.0), np.float32(1.0), np.float32(0.0), np.float32(1.0), np.float32(0.0), np.float32(1.0), np.float32(1.0), np.float32(0.0), np.float32(0.0), np.float32(0.0), np.float32(1.0), np.float32(1.0), np.float32(0.0), np.float32(0.0)]",0.0,99536.0,20
2025-08-14_08-18-36,7592,"[np.float32(1.0), np.float32(1.0), np.float32(0.0), np.float32(0.0), np.float32(0.0), np.float32(1.0), np.float32(0.0), np.float32(0.0), np.float32(0.0), np.float32(0.0), np.float32(0.0), np.float32(1.0), np.float32(1.0), np.float32(1.0), np.float32(0.0), np.float32(1.0)]",0.0,99536.0,32
2025-08-14_08-18-36,7593,"[np.float32(0.0), np.float32(1.0), np.float32(0.0), np.float32(0.0), np.float32(0.0), np.float32(0.0), np.float32(1.0), np.float32(0.0), np.float32(0.0), np.float32(1.0), np.float32(1.0), np.float32(1.0), np.float32(0.0), np.float32(1.0), np.float32(0.0), np.float32(0.0)]",-3.0,99533.0,27
2025-08-14_08-18-36,7594,"[np.float32(1.0), np.float32(1.0), np.float32(0.0), np.float32(0.0), np.float32(0.0), np.float32(1.0), np.float32(0.0), np.float32(1.0), np.float32(1.0), np.float32(1.0), np.float32(1.0), np.float32(0.0), np.float32(0.0), np.float32(0.0), np.float32(1.0), np.float32(1.0)]",-5.0,99528.0,0
2025-08-14_08-18-36,7595,"[np.float32(0.0), np.float32(1.0), np.float32(1.0), np.float32(1.0), np.float32(0.0), np.float32(1.0), np.float32(0.0), np.float32(1.0), np.float32(1.0), np.float32(0.0), np.float32(0.0), np.float32(0.0), np.float32(1.0), np.float32(0.0), np.float32(0.0), np.float32(1.0)]",0.0,99528.0,14
2025-08-14_08-18-36,7596,"[np.float32(1.0), np.float32(1.0), np.float32(0.0), np.float32(0.0), np.float32(0.0), np.float32(1.0), np.float32(1.0), np.float32(1.0), np.float32(1.0), np.float32(1.0), np.float32(1.0), np.float32(0.0), np.float32(1.0), np.float32(0.0), np.float32(0.0), np.float32(0.0)]",1.0,99529.0,22
2025-08-14_08-18-36,7597,"[np.float32(0.0), np.float32(1.0), np.float32(1.0), np.float32(1.0), np.float32(1.0), np.float32(1.0), np.float32(0.0), np.float32(0.0), np.float32(1.0), np.float32(0.0), np.float32(1.0), np.float32(0.0), np.float32(0.0), np.float32(1.0), np.float32(1.0), np.float32(1.0)]",2.0,99531.0,31
2025-08-14_08-18-36,7598,"[np.float32(1.0), np.float32(0.0), np.float32(0.0), np.float32(0.0), np.float32(1.0), np.float32(0.0), np.float32(0.0), np.float32(0.0), np.float32(1.0), np.float32(1.0), np.float32(0.0), np.float32(1.0), np.float32(1.0), np.float32(1.0), np.float32(1.0), np.float32(0.0)]",2.0,99533.0,16
2025-08-14_08-18-36,7599,"[np.float32(0.0), np.float32(0.0), np.float32(1.0), np.float32(0.0), np.float32(0.0), np.float32(1.0), np.float32(0.0), np.float32(1.0), np.float32(1.0), np.float32(0.0), np.float32(0.0), np.float32(0.0), np.float32(0.0), np.float32(0.0), np.float32(0.0), np.float32(0.0)]",1.0,99534.0,19
2025-08-14_08-18-36,7600,"[np.float32(0.0), np.float32(1.0), np.float32(1.0), np.float32(1.0), np.float32(0.0), np.float32(1.0), np.float32(1.0), np.float32(1.0), np.float32(0.0), np.float32(1.0), np.float32(0.0), np.float32(1.0), np.float32(0.0), np.float32(0.0), np.float32(1.0), np.float32(0.0)]",4.0,99538.0,13
2025-08-14_08-18-36,7601,"[np.float32(1.0), np.float32(0.0), np.float32(0.0), np.float32(1.0), np.float32(1.0), np.float32(1.0), np.float32(1.0), np.float32(1.0), np.float32(1.0), np.float32(0.0), np.float32(0.0), np.float32(0.0), np.float32(0.0), np.float32(0.0), np.float32(1.0), np.float32(0.0)]",1.0,99539.0,25
2025-08-14_08-18-36,7602,"[np.float32(0.0), np.float32(0.0), np.float32(1.0), np.float32(0.0), np.float32(0.0), np.float32(0.0), np.float32(1.0), np.float32(1.0), np.float32(1.0), np.float32(0.0), np.float32(1.0), np.float32(1.0), np.float32(1.0), np.float32(0.0), np.float32(1.0), np.float32(0.0)]",-5.0,99534.0,31
2025-08-14_08-18-36,7603,"[np.float32(0.0), np.float32(0.0), np.float32(0.0), np.float32(1.0), np.float32(1.0), np.float32(1.0), np.float32(1.0), np.float32(1.0), np.float32(1.0), np.float32(1.0), np.float32(1.0), np.float32(0.0), np.float32(0.0), np.float32(0.0), np.float32(0.0), np.float32(0.0)]",-3.0,99531.0,18
2025-08-14_08-18-36,7604,"[np.float32(1.0), np.float32(0.0), np.float32(0.0), np.float32(0.0), np.float32(0.0), np.float32(0.0), np.float32(1.0), np.float32(0.0), np.float32(0.0), np.float32(1.0), np.float32(1.0), np.float32(0.0), np.float32(0.0), np.float32(0.0), np.float32(0.0), np.float32(0.0)]",-4.0,99527.0,33
2025-08-14_08-18-36,7605,"[np.float32(0.0), np.float32(0.0), np.float32(0.0), np.float32(0.0), np.float32(1.0), np.float32(1.0), np.float32(1.0), np.float32(0.0), np.float32(0.0), np.float32(0.0), np.float32(1.0), np.float32(1.0), np.float32(0.0), np.float32(1.0), np.float32(0.0), np.float32(0.0)]",-1.0,99526.0,1
2025-08-14_08-18-36,7606,"[np.float32(1.0), np.float32(1.0), np.float32(0.0), np.float32(0.0), np.float32(0.0), np.float32(1.0), np.float32(0.0), np.float32(1.0), np.float32(1.0), np.float32(1.0), np.float32(0.0), np.float32(0.0), np.float32(0.0), np.float32(1.0), np.float32(0.0), np.float32(0.0)]",-2.0,99524.0,10
2025-08-14_08-18-36,7607,"[np.float32(0.0), np.float32(1.0), np.float32(0.0), np.float32(0.0), np.float32(0.0), np.float32(1.0), np.float32(1.0), np.float32(1.0), np.float32(1.0), np.float32(0.0), np.float32(0.0), np.float32(1.0), np.float32(1.0), np.float32(1.0), np.float32(0.0), np.float32(1.0)]",-1.0,99523.0,4
2025-08-14_08-18-36,7608,"[np.float32(1.0), np.float32(1.0), np.float32(0.0), np.float32(1.0), np.float32(0.0), np.float32(1.0), np.float32(1.0), np.float32(1.0), np.float32(0.0), np.float32(1.0), np.float32(1.0), np.float32(1.0), np.float32(1.0), np.float32(1.0), np.float32(0.0), np.float32(1.0)]",3.0,99526.0,21
2025-08-14_08-18-36,7609,"[np.float32(1.0), np.float32(1.0), np.float32(0.0), np.float32(1.0), np.float32(0.0), np.float32(0.0), np.float32(1.0), np.float32(0.0), np.float32(1.0), np.float32(0.0), np.float32(1.0), np.float32(0.0), np.float32(1.0), np.float32(0.0), np.float32(1.0), np.float32(0.0)]",-3.0,99523.0,12
2025-08-14_08-18-36,7610,"[np.float32(1.0), np.float32(0.0), np.float32(0.0), np.float32(1.0), np.float32(1.0), np.float32(1.0), np.float32(1.0), np.float32(1.0), np.float32(0.0), np.float32(0.0), np.float32(1.0), np.float32(1.0), np.float32(1.0), np.float32(1.0), np.float32(0.0), np.float32(0.0)]",-3.0,99520.0,33
2025-08-14_08-18-36,7611,"[np.float32(1.0), np.float32(1.0), np.float32(0.0), np.float32(1.0), np.float32(0.0), np.float32(0.0), np.float32(0.0), np.float32(1.0), np.float32(1.0), np.float32(0.0), np.float32(1.0), np.float32(0.0), np.float32(1.0), np.float32(0.0), np.float32(0.0), np.float32(0.0)]",-5.0,99515.0,10
2025-08-14_08-18-36,7612,"[np.float32(1.0), np.float32(0.0), np.float32(1.0), np.float32(1.0), np.float32(0.0), np.float32(1.0), np.float32(1.0), np.float32(1.0), np.float32(0.0), np.float32(0.0), np.float32(0.0), np.float32(0.0), np.float32(1.0), np.float32(1.0), np.float32(0.0), np.float32(1.0)]",-2.0,99513.0,28
2025-08-14_08-18-36,7613,"[np.float32(1.0), np.float32(0.0), np.float32(1.0), np.float32(1.0), np.float32(1.0), np.float32(1.0), np.float32(1.0), np.float32(1.0), np.float32(0.0), np.float32(0.0), np.float32(0.0), np.float32(1.0), np.float32(1.0), np.float32(0.0), np.float32(1.0), np.float32(0.0)]",-6.0,99507.0,0
2025-08-14_08-18-36,7614,"[np.float32(0.0), np.float32(1.0), np.float32(1.0), np.float32(0.0), np.float32(1.0), np.float32(1.0), np.float32(1.0), np.float32(0.0), np.float32(1.0), np.float32(0.0), np.float32(0.0), np.float32(1.0), np.float32(1.0), np.float32(0.0), np.float32(1.0), np.float32(0.0)]",-3.0,99504.0,0
2025-08-14_08-18-36,7615,"[np.float32(1.0), np.float32(1.0), np.float32(0.0), np.float32(0.0), np.float32(0.0), np.float32(0.0), np.float32(1.0), np.float32(1.0), np.float32(0.0), np.float32(0.0), np.float32(1.0), np.float32(0.0), np.float32(0.0), np.float32(0.0), np.float32(1.0), np.float32(1.0)]",-2.0,99502.0,32
2025-08-14_08-18-36,7616,"[np.float32(0.0), np.float32(0.0), np.float32(0.0), np.float32(0.0), np.float32(0.0), np.float32(0.0), np.float32(0.0), np.float32(1.0), np.float32(1.0), np.float32(0.0), np.float32(1.0), np.float32(0.0), np.float32(1.0), np.float32(1.0), np.float32(0.0), np.float32(0.0)]",4.0,99506.0,32
2025-08-14_08-18-36,7617,"[np.float32(0.0), np.float32(0.0), np.float32(1.0), np.float32(1.0), np.float32(1.0), np.float32(1.0), np.float32(1.0), np.float32(1.0), np.float32(1.0), np.float32(0.0), np.float32(1.0), np.float32(1.0), np.float32(0.0), np.float32(0.0), np.float32(1.0), np.float32(0.0)]",0.0,99506.0,9
2025-08-14_08-18-36,7618,"[np.float32(1.0), np.float32(0.0), np.float32(1.0), np.float32(0.0), np.float32(0.0), np.float32(1.0), np.float32(0.0), np.float32(0.0), np.float32(0.0), np.float32(0.0), np.float32(1.0), np.float32(0.0), np.float32(0.0), np.float32(1.0), np.float32(1.0), np.float32(0.0)]",1.0,99507.0,16
2025-08-14_08-18-36,7619,"[np.float32(0.0), np.float32(1.0), np.float32(0.0), np.float32(1.0), np.float32(1.0), np.float32(0.0), np.float32(0.0), np.float32(1.0), np.float32(1.0), np.float32(0.0), np.float32(0.0), np.float32(1.0), np.float32(1.0), np.float32(1.0), np.float32(0.0), np.float32(0.0)]",-3.0,99504.0,0
2025-08-14_08-18-36,7620,"[np.float32(1.0), np.float32(1.0), np.float32(0.0), np.float32(0.0), np.float32(1.0), np.float32(0.0), np.float32(0.0), np.float32(0.0), np.float32(0.0), np.float32(0.0), np.float32(1.0), np.float32(0.0), np.float32(1.0), np.float32(1.0), np.float32(1.0), np.float32(0.0)]",3.0,99507.0,11
2025-08-14_08-18-36,7621,"[np.float32(0.0), np.float32(0.0), np.float32(0.0), np.float32(0.0), np.float32(1.0), np.float32(1.0), np.float32(0.0), np.float32(0.0), np.float32(0.0), np.float32(0.0), np.float32(1.0), np.float32(1.0), np.float32(0.0), np.float32(0.0), np.float32(1.0), np.float32(0.0)]",-3.0,99504.0,1
2025-08-14_08-18-36,7622,"[np.float32(1.0), np.float32(1.0), np.float32(0.0), np.float32(0.0), np.float32(1.0), np.float32(1.0), np.float32(1.0), np.float32(1.0), np.float32(1.0), np.float32(1.0), np.float32(0.0), np.float32(0.0), np.float32(1.0), np.float32(1.0), np.float32(1.0), np.float32(1.0)]",1.0,99505.0,19
2025-08-14_08-18-36,7623,"[np.float32(1.0), np.float32(0.0), np.float32(1.0), np.float32(0.0), np.float32(1.0), np.float32(1.0), np.float32(1.0), np.float32(0.0), np.float32(1.0), np.float32(0.0), np.float32(1.0), np.float32(0.0), np.float32(1.0), np.float32(0.0), np.float32(0.0), np.float32(0.0)]",2.0,99507.0,8
2025-08-14_08-18-36,7624,"[np.float32(0.0), np.float32(1.0), np.float32(1.0), np.float32(0.0), np.float32(0.0), np.float32(0.0), np.float32(0.0), np.float32(1.0), np.float32(1.0), np.float32(0.0), np.float32(1.0), np.float32(0.0), np.float32(0.0), np.float32(1.0), np.float32(0.0), np.float32(0.0)]",1.0,99508.0,24
2025-08-14_08-18-36,7625,"[np.float32(0.0), np.float32(0.0), np.float32(0.0), np.float32(1.0), np.float32(0.0), np.float32(0.0), np.float32(0.0), np.float32(1.0), np.float32(1.0), np.float32(1.0), np.float32(0.0), np.float32(0.0), np.float32(0.0), np.float32(0.0), np.float32(0.0), np.float32(0.0)]",-4.0,99504.0,2
2025-08-14_08-18-36,7626,"[np.float32(1.0), np.float32(0.0), np.float32(1.0), np.float32(1.0), np.float32(0.0), np.float32(0.0), np.float32(0.0), np.float32(1.0), np.float32(0.0), np.float32(0.0), np.float32(1.0), np.float32(0.0), np.float32(1.0), np.float32(1.0), np.float32(1.0), np.float32(1.0)]",-4.0,99500.0,28
2025-08-14_08-18-36,7627,"[np.float32(1.0), np.float32(1.0), np.float32(1.0), np.float32(0.0), np.float32(0.0), np.float32(0.0), np.float32(1.0), np.float32(1.0), np.float32(0.0), np.float32(0.0), np.float32(1.0), np.float32(0.0), np.float32(0.0), np.float32(1.0), np.float32(1.0), np.float32(0.0)]",2.0,99502.0,22
2025-08-14_08-18-36,7628,"[np.float32(1.0), np.float32(0.0), np.float32(0.0), np.float32(1.0), np.float32(0.0), np.float32(1.0), np.float32(0.0), np.float32(1.0), np.float32(0.0), np.float32(1.0), np.float32(0.0), np.float32(1.0), np.float32(0.0), np.float32(1.0), np.float32(1.0), np.float32(1.0)]",-2.0,99500.0,32
2025-08-14_08-18-36,7629,"[np.float32(1.0), np.float32(0.0), np.float32(0.0), np.float32(1.0), np.float32(0.0), np.float32(1.0), np.float32(0.0), np.float32(1.0), np.float32(1.0), np.float32(1.0), np.float32(0.0), np.float32(1.0), np.float32(1.0), np.float32(0.0), np.float32(0.0), np.float32(1.0)]",-2.0,99498.0,29
2025-08-14_08-18-36,7630,"[np.float32(0.0), np.float32(1.0), np.float32(1.0), np.float32(0.0), np.float32(1.0), np.float32(1.0), np.float32(1.0), np.float32(1.0), np.float32(0.0), np.float32(0.0), np.float32(1.0), np.float32(0.0), np.float32(1.0), np.float32(0.0), np.float32(0.0), np.float32(0.0)]",-4.0,99494.0,33
2025-08-14_08-18-36,7631,"[np.float32(1.0), np.float32(0.0), np.float32(1.0), np.float32(0.0), np.float32(1.0), np.float32(0.0), np.float32(1.0), np.float32(1.0), np.float32(0.0), np.float32(1.0), np.float32(1.0), np.float32(0.0), np.float32(0.0), np.float32(0.0), np.float32(1.0), np.float32(0.0)]",0.0,99494.0,22
2025-08-14_08-18-36,7632,"[np.float32(1.0), np.float32(0.0), np.float32(1.0), np.float32(0.0), np.float32(1.0), np.float32(0.0), np.float32(0.0), np.float32(0.0), np.float32(1.0), np.float32(0.0), np.float32(0.0), np.float32(0.0), np.float32(0.0), np.float32(1.0), np.float32(1.0), np.float32(1.0)]",-2.0,99492.0,17
2025-08-14_08-18-36,7633,"[np.float32(0.0), np.float32(0.0), np.float32(0.0), np.float32(0.0), np.float32(1.0), np.float32(0.0), np.float32(1.0), np.float32(0.0), np.float32(1.0), np.float32(1.0), np.float32(0.0), np.float32(0.0), np.float32(1.0), np.float32(0.0), np.float32(1.0), np.float32(1.0)]",-4.0,99488.0,19
2025-08-14_08-18-36,7634,"[np.float32(0.0), np.float32(1.0), np.float32(1.0), np.float32(1.0), np.float32(0.0), np.float32(1.0), np.float32(1.0), np.float32(1.0), np.float32(0.0), np.float32(0.0), np.float32(0.0), np.float32(0.0), np.float32(1.0), np.float32(1.0), np.float32(0.0), np.float32(0.0)]",2.0,99490.0,4
2025-08-14_08-18-36,7635,"[np.float32(0.0), np.float32(1.0), np.float32(1.0), np.float32(0.0), np.float32(1.0), np.float32(1.0), np.float32(1.0), np.float32(1.0), np.float32(1.0), np.float32(1.0), np.float32(1.0), np.float32(1.0), np.float32(1.0), np.float32(1.0), np.float32(0.0), np.float32(0.0)]",-1.0,99489.0,25
2025-08-14_08-18-36,7636,"[np.float32(1.0), np.float32(1.0), np.float32(1.0), np.float32(0.0), np.float32(0.0), np.float32(0.0), np.float32(1.0), np.float32(1.0), np.float32(1.0), np.float32(0.0), np.float32(0.0), np.float32(1.0), np.float32(0.0), np.float32(0.0), np.float32(0.0), np.float32(1.0)]",2.0,99491.0,12
2025-08-14_08-18-36,7637,"[np.float32(1.0), np.float32(1.0), np.float32(1.0), np.float32(1.0), np.float32(0.0), np.float32(1.0), np.float32(0.0), np.float32(1.0), np.float32(1.0), np.float32(1.0), np.float32(0.0), np.float32(0.0), np.float32(1.0), np.float32(1.0), np.float32(0.0), np.float32(1.0)]",-4.0,99487.0,10
2025-08-14_08-18-36,7638,"[np.float32(0.0), np.float32(1.0), np.float32(0.0), np.float32(1.0), np.float32(0.0), np.float32(1.0), np.float32(0.0), np.float32(1.0), np.float32(0.0), np.float32(0.0), np.float32(0.0), np.float32(1.0), np.float32(1.0), np.float32(1.0), np.float32(1.0), np.float32(1.0)]",4.0,99491.0,15
2025-08-14_08-18-36,7639,"[np.float32(1.0), np.float32(0.0), np.float32(1.0), np.float32(1.0), np.float32(1.0), np.float32(0.0), np.float32(1.0), np.float32(0.0), np.float32(1.0), np.float32(0.0), np.float32(0.0), np.float32(0.0), np.float32(1.0), np.float32(1.0), np.float32(0.0), np.float32(0.0)]",-6.0,99485.0,20
2025-08-14_08-18-36,7640,"[np.float32(1.0), np.float32(0.0), np.float32(1.0), np.float32(0.0), np.float32(1.0), np.float32(1.0), np.float32(1.0), np.float32(0.0), np.float32(0.0), np.float32(0.0), np.float32(1.0), np.float32(1.0), np.float32(1.0), np.float32(0.0), np.float32(1.0), np.float32(0.0)]",34.0,99519.0,7
2025-08-14_08-18-36,7641,"[np.float32(0.0), np.float32(1.0), np.float32(1.0), np.float32(0.0), np.float32(1.0), np.float32(0.0), np.float32(0.0), np.float32(0.0), np.float32(0.0), np.float32(1.0), np.float32(1.0), np.float32(0.0), np.float32(1.0), np.float32(1.0), np.float32(1.0), np.float32(0.0)]",-6.0,99513.0,9
2025-08-14_08-18-36,7642,"[np.float32(0.0), np.float32(0.0), np.float32(1.0), np.float32(0.0), np.float32(1.0), np.float32(1.0), np.float32(1.0), np.float32(1.0), np.float32(1.0), np.float32(0.0), np.float32(1.0), np.float32(1.0), np.float32(0.0), np.float32(1.0), np.float32(1.0), np.float32(0.0)]",3.0,99516.0,8
2025-08-14_08-18-36,7643,"[np.float32(1.0), np.float32(1.0), np.float32(0.0), np.float32(1.0), np.float32(0.0), np.float32(0.0), np.float32(1.0), np.float32(1.0), np.float32(0.0), np.float32(1.0), np.float32(0.0), np.float32(1.0), np.float32(0.0), np.float32(1.0), np.float32(0.0), np.float32(0.0)]",-3.0,99513.0,36
2025-08-14_08-18-36,7644,"[np.float32(0.0), np.float32(1.0), np.float32(1.0), np.float32(0.0), np.float32(0.0), np.float32(1.0), np.float32(0.0), np.float32(0.0), np.float32(1.0), np.float32(0.0), np.float32(1.0), np.float32(0.0), np.float32(0.0), np.float32(1.0), np.float32(0.0), np.float32(1.0)]",0.0,99513.0,4
2025-08-14_08-18-36,7645,"[np.float32(0.0), np.float32(0.0), np.float32(1.0), np.float32(0.0), np.float32(0.0), np.float32(0.0), np.float32(0.0), np.float32(1.0), np.float32(1.0), np.float32(0.0), np.float32(0.0), np.float32(0.0), np.float32(1.0), np.float32(0.0), np.float32(0.0), np.float32(1.0)]",0.0,99513.0,26
2025-08-14_08-18-36,7646,"[np.float32(0.0), np.float32(1.0), np.float32(1.0), np.float32(0.0), np.float32(0.0), np.float32(1.0), np.float32(1.0), np.float32(1.0), np.float32(0.0), np.float32(1.0), np.float32(1.0), np.float32(0.0), np.float32(1.0), np.float32(0.0), np.float32(0.0), np.float32(0.0)]",4.0,99517.0,20
2025-08-14_08-18-36,7647,"[np.float32(0.0), np.float32(1.0), np.float32(1.0), np.float32(1.0), np.float32(0.0), np.float32(0.0), np.float32(1.0), np.float32(1.0), np.float32(0.0), np.float32(0.0), np.float32(1.0), np.float32(0.0), np.float32(1.0), np.float32(0.0), np.float32(1.0), np.float32(0.0)]",2.0,99519.0,13
2025-08-14_08-18-36,7648,"[np.float32(1.0), np.float32(0.0), np.float32(0.0), np.float32(1.0), np.float32(0.0), np.float32(1.0), np.float32(1.0), np.float32(1.0), np.float32(1.0), np.float32(1.0), np.float32(0.0), np.float32(1.0), np.float32(1.0), np.float32(0.0), np.float32(0.0), np.float32(0.0)]",1.0,99520.0,36
2025-08-14_08-18-36,7649,"[np.float32(1.0), np.float32(0.0), np.float32(0.0), np.float32(0.0), np.float32(0.0), np.float32(1.0), np.float32(1.0), np.float32(1.0), np.float32(1.0), np.float32(0.0), np.float32(1.0), np.float32(1.0), np.float32(0.0), np.float32(1.0), np.float32(1.0), np.float32(1.0)]",1.0,99521.0,14
2025-08-14_08-18-36,7650,"[np.float32(1.0), np.float32(1.0), np.float32(0.0), np.float32(1.0), np.float32(0.0), np.float32(0.0), np.float32(1.0), np.float32(1.0), np.float32(1.0), np.float32(0.0), np.float32(1.0), np.float32(0.0), np.float32(0.0), np.float32(1.0), np.float32(0.0), np.float32(0.0)]",3.0,99524.0,32
2025-08-14_08-18-36,7651,"[np.float32(0.0), np.float32(0.0), np.float32(1.0), np.float32(0.0), np.float32(1.0), np.float32(0.0), np.float32(1.0), np.float32(1.0), np.float32(1.0), np.float32(0.0), np.float32(0.0), np.float32(1.0), np.float32(1.0), np.float32(0.0), np.float32(1.0), np.float32(0.0)]",2.0,99526.0,18
2025-08-14_08-18-36,7652,"[np.float32(1.0), np.float32(0.0), np.float32(1.0), np.float32(0.0), np.float32(0.0), np.float32(0.0), np.float32(1.0), np.float32(1.0), np.float32(0.0), np.float32(1.0), np.float32(1.0), np.float32(0.0), np.float32(1.0), np.float32(1.0), np.float32(1.0), np.float32(0.0)]",4.0,99530.0,16
2025-08-14_08-18-36,7653,"[np.float32(0.0), np.float32(0.0), np.float32(0.0), np.float32(0.0), np.float32(0.0), np.float32(0.0), np.float32(0.0), np.float32(1.0), np.float32(0.0), np.float32(0.0), np.float32(0.0), np.float32(1.0), np.float32(1.0), np.float32(1.0), np.float32(1.0), np.float32(0.0)]",4.0,99534.0,21
2025-08-14_08-18-36,7654,"[np.float32(0.0), np.float32(1.0), np.float32(1.0), np.float32(0.0), np.float32(1.0), np.float32(0.0), np.float32(0.0), np.float32(1.0), np.float32(1.0), np.float32(0.0), np.float32(1.0), np.float32(1.0), np.float32(1.0), np.float32(1.0), np.float32(1.0), np.float32(0.0)]",-1.0,99533.0,4
2025-08-14_08-18-36,7655,"[np.float32(0.0), np.float32(0.0), np.float32(1.0), np.float32(1.0), np.float32(1.0), np.float32(1.0), np.float32(1.0), np.float32(1.0), np.float32(0.0), np.float32(0.0), np.float32(1.0), np.float32(0.0), np.float32(1.0), np.float32(1.0), np.float32(1.0), np.float32(0.0)]",-3.0,99530.0,25
2025-08-14_08-18-36,7656,"[np.float32(0.0), np.float32(0.0), np.float32(0.0), np.float32(0.0), np.float32(1.0), np.float32(1.0), np.float32(0.0), np.float32(1.0), np.float32(1.0), np.float32(0.0), np.float32(1.0), np.float32(0.0), np.float32(1.0), np.float32(0.0), np.float32(0.0), np.float32(0.0)]",-1.0,99529.0,8
2025-08-14_08-18-36,7657,"[np.float32(0.0), np.float32(0.0), np.float32(0.0), np.float32(0.0), np.float32(1.0), np.float32(1.0), np.float32(0.0), np.float32(0.0), np.float32(1.0), np.float32(0.0), np.float32(0.0), np.float32(0.0), np.float32(0.0), np.float32(1.0), np.float32(1.0), np.float32(1.0)]",-1.0,99528.0,5
2025-08-14_08-18-36,7658,"[np.float32(0.0), np.float32(1.0), np.float32(1.0), np.float32(1.0), np.float32(1.0), np.float32(0.0), np.float32(0.0), np.float32(0.0), np.float32(1.0), np.float32(0.0), np.float32(1.0), np.float32(1.0), np.float32(1.0), np.float32(1.0), np.float32(1.0), np.float32(1.0)]",-1.0,99527.0,9
2025-08-14_08-18-36,7659,"[np.float32(1.0), np.float32(1.0), np.float32(1.0), np.float32(1.0), np.float32(1.0), np.float32(0.0), np.float32(0.0), np.float32(1.0), np.float32(0.0), np.float32(0.0), np.float32(1.0), np.float32(1.0), np.float32(1.0), np.float32(0.0), np.float32(0.0), np.float32(0.0)]",-2.0,99525.0,36
2025-08-14_08-18-36,7660,"[np.float32(1.0), np.float32(1.0), np.float32(1.0), np.float32(0.0), np.float32(0.0), np.float32(1.0), np.float32(1.0), np.float32(1.0), np.float32(0.0), np.float32(1.0), np.float32(0.0), np.float32(1.0), np.float32(0.0), np.float32(0.0), np.float32(1.0), np.float32(1.0)]",-2.0,99523.0,17
2025-08-14_08-18-36,7661,"[np.float32(1.0), np.float32(1.0), np.float32(1.0), np.float32(1.0), np.float32(1.0), np.float32(1.0), np.float32(0.0), np.float32(1.0), np.float32(1.0), np.float32(1.0), np.float32(0.0), np.float32(0.0), np.float32(0.0), np.float32(1.0), np.float32(1.0), np.float32(0.0)]",-2.0,99521.0,11
2025-08-14_08-18-36,7662,"[np.float32(0.0), np.float32(1.0), np.float32(0.0), np.float32(1.0), np.float32(1.0), np.float32(1.0), np.float32(0.0), np.float32(1.0), np.float32(0.0), np.float32(1.0), np.float32(1.0), np.float32(0.0), np.float32(1.0), np.float32(1.0), np.float32(0.0), np.float32(0.0)]",-7.0,99514.0,30
2025-08-14_08-18-36,7663,"[np.float32(1.0), np.float32(1.0), np.float32(1.0), np.float32(0.0), np.float32(0.0), np.float32(0.0), np.float32(1.0), np.float32(1.0), np.float32(1.0), np.float32(0.0), np.float32(0.0), np.float32(0.0), np.float32(1.0), np.float32(1.0), np.float32(0.0), np.float32(1.0)]",-1.0,99513.0,17
2025-08-14_08-18-36,7664,"[np.float32(1.0), np.float32(1.0), np.float32(1.0), np.float32(0.0), np.float32(1.0), np.float32(0.0), np.float32(1.0), np.float32(0.0), np.float32(0.0), np.float32(1.0), np.float32(1.0), np.float32(0.0), np.float32(0.0), np.float32(1.0), np.float32(0.0), np.float32(1.0)]",1.0,99514.0,26
2025-08-14_08-18-36,7665,"[np.float32(0.0), np.float32(1.0), np.float32(1.0), np.float32(1.0), np.float32(1.0), np.float32(1.0), np.float32(0.0), np.float32(1.0), np.float32(0.0), np.float32(1.0), np.float32(0.0), np.float32(1.0), np.float32(1.0), np.float32(1.0), np.float32(1.0), np.float32(0.0)]",-1.0,99513.0,36
2025-08-14_08-18-36,7666,"[np.float32(0.0), np.float32(0.0), np.float32(0.0), np.float32(1.0), np.float32(0.0), np.float32(1.0), np.float32(0.0), np.float32(0.0), np.float32(0.0), np.float32(0.0), np.float32(0.0), np.float32(0.0), np.float32(1.0), np.float32(0.0), np.float32(0.0), np.float32(0.0)]",1.0,99514.0,31
2025-08-14_08-18-36,7667,"[np.float32(0.0), np.float32(1.0), np.float32(0.0), np.float32(1.0), np.float32(0.0), np.float32(1.0), np.float32(0.0), np.float32(1.0), np.float32(1.0), np.float32(0.0), np.float32(1.0), np.float32(1.0), np.float32(1.0), np.float32(1.0), np.float32(0.0), np.float32(0.0)]",-4.0,99510.0,8
2025-08-14_08-18-36,7668,"[np.float32(0.0), np.float32(1.0), np.float32(0.0), np.float32(1.0), np.float32(0.0), np.float32(1.0), np.float32(1.0), np.float32(1.0), np.float32(0.0), np.float32(0.0), np.float32(0.0), np.float32(0.0), np.float32(0.0), np.float32(1.0), np.float32(0.0), np.float32(0.0)]",2.0,99512.0,4
2025-08-14_08-18-36,7669,"[np.float32(0.0), np.float32(1.0), np.float32(1.0), np.float32(0.0), np.float32(1.0), np.float32(1.0), np.float32(0.0), np.float32(1.0), np.float32(1.0), np.float32(0.0), np.float32(1.0), np.float32(0.0), np.float32(1.0), np.float32(0.0), np.float32(1.0), np.float32(1.0)]",-5.0,99507.0,1
2025-08-14_08-18-36,7670,"[np.float32(1.0), np.float32(1.0), np.float32(1.0), np.float32(1.0), np.float32(1.0), np.float32(1.0), np.float32(0.0), np.float32(0.0), np.float32(0.0), np.float32(1.0), np.float32(1.0), np.float32(1.0), np.float32(1.0), np.float32(0.0), np.float32(1.0), np.float32(1.0)]",0.0,99507.0,17
2025-08-14_08-18-36,7671,"[np.float32(0.0), np.float32(0.0), np.float32(1.0), np.float32(1.0), np.float32(1.0), np.float32(0.0), np.float32(0.0), np.float32(1.0), np.float32(1.0), np.float32(1.0), np.float32(1.0), np.float32(0.0), np.float32(0.0), np.float32(1.0), np.float32(1.0), np.float32(1.0)]",0.0,99507.0,8
2025-08-14_08-18-36,7672,"[np.float32(0.0), np.float32(0.0), np.float32(0.0), np.float32(0.0), np.float32(0.0), np.float32(1.0), np.float32(1.0), np.float32(1.0), np.float32(1.0), np.float32(1.0), np.float32(1.0), np.float32(0.0), np.float32(1.0), np.float32(1.0), np.float32(1.0), np.float32(0.0)]",-1.0,99506.0,27
2025-08-14_08-18-36,7673,"[np.float32(0.0), np.float32(0.0), np.float32(1.0), np.float32(0.0), np.float32(1.0), np.float32(0.0), np.float32(1.0), np.float32(1.0), np.float32(0.0), np.float32(1.0), np.float32(0.0), np.float32(1.0), np.float32(1.0), np.float32(0.0), np.float32(0.0), np.float32(0.0)]",1.0,99507.0,9
2025-08-14_08-18-36,7674,"[np.float32(0.0), np.float32(1.0), np.float32(0.0), np.float32(1.0), np.float32(1.0), np.float32(0.0), np.float32(0.0), np.float32(1.0), np.float32(0.0), np.float32(1.0), np.float32(1.0), np.float32(0.0), np.float32(1.0), np.float32(1.0), np.float32(0.0), np.float32(0.0)]",3.0,99510.0,22
2025-08-14_08-18-36,7675,"[np.float32(1.0), np.float32(0.0), np.float32(1.0), np.float32(0.0), np.float32(0.0), np.float32(0.0), np.float32(1.0), np.float32(1.0), np.float32(1.0), np.float32(0.0), np.float32(1.0), np.float32(1.0), np.float32(1.0), np.float32(0.0), np.float32(0.0), np.float32(1.0)]",2.0,99512.0,9
2025-08-14_08-18-36,7676,"[np.float32(1.0), np.float32(1.0), np.float32(1.0), np.float32(0.0), np.float32(1.0), np.float32(1.0), np.float32(0.0), np.float32(1.0), np.float32(1.0), np.float32(1.0), np.float32(1.0), np.float32(0.0), np.float32(0.0), np.float32(1.0), np.float32(0.0), np.float32(0.0)]",-6.0,99506.0,9
2025-08-14_08-18-36,7677,"[np.float32(0.0), np.float32(0.0), np.float32(0.0), np.float32(1.0), np.float32(0.0), np.float32(1.0), np.float32(1.0), np.float32(1.0), np.float32(0.0), np.float32(1.0), np.float32(0.0), np.float32(0.0), np.float32(0.0), np.float32(1.0), np.float32(1.0), np.float32(0.0)]",0.0,99506.0,29
2025-08-14_08-18-36,7678,"[np.float32(1.0), np.float32(1.0), np.float32(1.0), np.float32(1.0), np.float32(0.0), np.float32(1.0), np.float32(1.0), np.float32(1.0), np.float32(1.0), np.float32(0.0), np.float32(0.0), np.float32(1.0), np.float32(0.0), np.float32(0.0), np.float32(0.0), np.float32(0.0)]",0.0,99506.0,20
2025-08-14_08-18-36,7679,"[np.float32(1.0), np.float32(0.0), np.float32(1.0), np.float32(1.0), np.float32(0.0), np.float32(0.0), np.float32(1.0), np.float32(1.0), np.float32(0.0), np.float32(0.0), np.float32(0.0), np.float32(1.0), np.float32(1.0), np.float32(0.0), np.float32(0.0), np.float32(0.0)]",-2.0,99504.0,10
2025-08-14_08-18-36,7680,"[np.float32(0.0), np.float32(0.0), np.float32(0.0), np.float32(0.0), np.float32(0.0), np.float32(1.0), np.float32(0.0), np.float32(1.0), np.float32(1.0), np.float32(0.0), np.float32(0.0), np.float32(1.0), np.float32(0.0), np.float32(1.0), np.float32(0.0), np.float32(0.0)]",-2.0,99502.0,6
2025-08-14_08-18-36,7681,"[np.float32(1.0), np.float32(1.0), np.float32(1.0), np.float32(0.0), np.float32(0.0), np.float32(0.0), np.float32(0.0), np.float32(1.0), np.float32(0.0), np.float32(0.0), np.float32(1.0), np.float32(1.0), np.float32(1.0), np.float32(1.0), np.float32(1.0), np.float32(0.0)]",-1.0,99501.0,17
2025-08-14_08-18-36,7682,"[np.float32(0.0), np.float32(1.0), np.float32(1.0), np.float32(1.0), np.float32(0.0), np.float32(0.0), np.float32(1.0), np.float32(1.0), np.float32(0.0), np.float32(1.0), np.float32(0.0), np.float32(1.0), np.float32(1.0), np.float32(0.0), np.float32(1.0), np.float32(0.0)]",-2.0,99499.0,28
2025-08-14_08-18-36,7683,"[np.float32(0.0), np.float32(0.0), np.float32(0.0), np.float32(1.0), np.float32(1.0), np.float32(1.0), np.float32(0.0), np.float32(1.0), np.float32(1.0), np.float32(0.0), np.float32(1.0), np.float32(0.0), np.float32(1.0), np.float32(1.0), np.float32(0.0), np.float32(0.0)]",-1.0,99498.0,27
2025-08-14_08-18-36,7684,"[np.float32(0.0), np.float32(0.0), np.float32(1.0), np.float32(1.0), np.float32(0.0), np.float32(0.0), np.float32(1.0), np.float32(1.0), np.float32(1.0), np.float32(1.0), np.float32(1.0), np.float32(1.0), np.float32(1.0), np.float32(0.0), np.float32(1.0), np.float32(0.0)]",-2.0,99496.0,2
2025-08-14_08-18-36,7685,"[np.float32(0.0), np.float32(0.0), np.float32(1.0), np.float32(1.0), np.float32(1.0), np.float32(1.0), np.float32(0.0), np.float32(1.0), np.float32(0.0), np.float32(0.0), np.float32(0.0), np.float32(1.0), np.float32(0.0), np.float32(1.0), np.float32(1.0), np.float32(0.0)]",-1.0,99495.0,0
2025-08-14_08-18-36,7686,"[np.float32(1.0), np.float32(0.0), np.float32(1.0), np.float32(1.0), np.float32(0.0), np.float32(1.0), np.float32(0.0), np.float32(0.0), np.float32(0.0), np.float32(1.0), np.float32(1.0), np.float32(0.0), np.float32(0.0), np.float32(0.0), np.float32(1.0), np.float32(0.0)]",0.0,99495.0,31
2025-08-14_08-18-36,7687,"[np.float32(1.0), np.float32(0.0), np.float32(0.0), np.float32(1.0), np.float32(1.0), np.float32(1.0), np.float32(0.0), np.float32(1.0), np.float32(1.0), np.float32(1.0), np.float32(0.0), np.float32(0.0), np.float32(1.0), np.float32(0.0), np.float32(0.0), np.float32(0.0)]",4.0,99499.0,25
2025-08-14_08-18-36,7688,"[np.float32(1.0), np.float32(1.0), np.float32(1.0), np.float32(0.0), np.float32(1.0), np.float32(1.0), np.float32(1.0), np.float32(1.0), np.float32(1.0), np.float32(0.0), np.float32(0.0), np.float32(0.0), np.float32(0.0), np.float32(0.0), np.float32(0.0), np.float32(1.0)]",-2.0,99497.0,19
2025-08-14_08-18-36,7689,"[np.float32(0.0), np.float32(1.0), np.float32(0.0), np.float32(1.0), np.float32(1.0), np.float32(0.0), np.float32(1.0), np.float32(1.0), np.float32(1.0), np.float32(1.0), np.float32(0.0), np.float32(0.0), np.float32(1.0), np.float32(0.0), np.float32(0.0), np.float32(0.0)]",-5.0,99492.0,36
2025-08-14_08-18-36,7690,"[np.float32(0.0), np.float32(1.0), np.float32(1.0), np.float32(1.0), np.float32(0.0), np.float32(0.0), np.float32(0.0), np.float32(1.0), np.float32(0.0), np.float32(1.0), np.float32(0.0), np.float32(1.0), np.float32(0.0), np.float32(0.0), np.float32(0.0), np.float32(1.0)]",3.0,99495.0,24
2025-08-14_08-18-36,7691,"[np.float32(1.0), np.float32(1.0), np.float32(0.0), np.float32(0.0), np.float32(0.0), np.float32(1.0), np.float32(0.0), np.float32(0.0), np.float32(1.0), np.float32(0.0), np.float32(0.0), np.float32(0.0), np.float32(0.0), np.float32(0.0), np.float32(0.0), np.float32(0.0)]",0.0,99495.0,23
2025-08-14_08-18-36,7692,"[np.float32(1.0), np.float32(1.0), np.float32(0.0), np.float32(1.0), np.float32(1.0), np.float32(1.0), np.float32(1.0), np.float32(1.0), np.float32(1.0), np.float32(0.0), np.float32(1.0), np.float32(0.0), np.float32(0.0), np.float32(1.0), np.float32(1.0), np.float32(0.0)]",-1.0,99494.0,10
2025-08-14_08-18-36,7693,"[np.float32(0.0), np.float32(0.0), np.float32(0.0), np.float32(0.0), np.float32(1.0), np.float32(1.0), np.float32(1.0), np.float32(1.0), np.float32(1.0), np.float32(1.0), np.float32(0.0), np.float32(0.0), np.float32(1.0), np.float32(1.0), np.float32(1.0), np.float32(0.0)]",2.0,99496.0,16
2025-08-14_08-18-36,7694,"[np.float32(1.0), np.float32(0.0), np.float32(1.0), np.float32(0.0), np.float32(1.0), np.float32(1.0), np.float32(1.0), np.float32(0.0), np.float32(1.0), np.float32(0.0), np.float32(0.0), np.float32(0.0), np.float32(0.0), np.float32(0.0), np.float32(0.0), np.float32(0.0)]",1.0,99497.0,7
2025-08-14_08-18-36,7695,"[np.float32(0.0), np.float32(1.0), np.float32(1.0), np.float32(0.0), np.float32(0.0), np.float32(0.0), np.float32(1.0), np.float32(1.0), np.float32(0.0), np.float32(0.0), np.float32(0.0), np.float32(0.0), np.float32(1.0), np.float32(0.0), np.float32(1.0), np.float32(0.0)]",2.0,99499.0,11
2025-08-14_08-18-36,7696,"[np.float32(0.0), np.float32(1.0), np.float32(0.0), np.float32(1.0), np.float32(0.0), np.float32(0.0), np.float32(0.0), np.float32(1.0), np.float32(1.0), np.float32(0.0), np.float32(1.0), np.float32(1.0), np.float32(0.0), np.float32(0.0), np.float32(1.0), np.float32(0.0)]",-1.0,99498.0,16
2025-08-14_08-18-36,7697,"[np.float32(1.0), np.float32(1.0), np.float32(0.0), np.float32(0.0), np.float32(0.0), np.float32(0.0), np.float32(1.0), np.float32(1.0), np.float32(0.0), np.float32(1.0), np.float32(0.0), np.float32(0.0), np.float32(1.0), np.float32(0.0), np.float32(0.0), np.float32(0.0)]",-4.0,99494.0,27
2025-08-14_08-18-36,7698,"[np.float32(0.0), np.float32(0.0), np.float32(1.0), np.float32(0.0), np.float32(0.0), np.float32(1.0), np.float32(1.0), np.float32(0.0), np.float32(0.0), np.float32(0.0), np.float32(0.0), np.float32(0.0), np.float32(0.0), np.float32(0.0), np.float32(1.0), np.float32(0.0)]",0.0,99494.0,32
2025-08-14_08-18-36,7699,"[np.float32(0.0), np.float32(0.0), np.float32(1.0), np.float32(1.0), np.float32(0.0), np.float32(0.0), np.float32(0.0), np.float32(0.0), np.float32(1.0), np.float32(1.0), np.float32(1.0), np.float32(0.0), np.float32(0.0), np.float32(1.0), np.float32(1.0), np.float32(1.0)]",3.0,99497.0,35
2025-08-14_08-18-36,7700,"[np.float32(1.0), np.float32(0.0), np.float32(0.0), np.float32(1.0), np.float32(1.0), np.float32(0.0), np.float32(1.0), np.float32(0.0), np.float32(1.0), np.float32(0.0), np.float32(0.0), np.float32(0.0), np.float32(1.0), np.float32(0.0), np.float32(0.0), np.float32(0.0)]",3.0,99500.0,1
2025-08-14_08-18-36,7701,"[np.float32(1.0), np.float32(0.0), np.float32(0.0), np.float32(0.0), np.float32(1.0), np.float32(1.0), np.float32(0.0), np.float32(1.0), np.float32(1.0), np.float32(0.0), np.float32(0.0), np.float32(0.0), np.float32(0.0), np.float32(0.0), np.float32(0.0), np.float32(1.0)]",-4.0,99496.0,0
2025-08-14_08-18-36,7702,"[np.float32(0.0), np.float32(1.0), np.float32(0.0), np.float32(0.0), np.float32(0.0), np.float32(1.0), np.float32(1.0), np.float32(0.0), np.float32(1.0), np.float32(1.0), np.float32(0.0), np.float32(0.0), np.float32(0.0), np.float32(0.0), np.float32(0.0), np.float32(0.0)]",-2.0,99494.0,3
2025-08-14_08-18-36,7703,"[np.float32(0.0), np.float32(0.0), np.float32(1.0), np.float32(0.0), np.float32(0.0), np.float32(0.0), np.float32(0.0), np.float32(0.0), np.float32(1.0), np.float32(1.0), np.float32(1.0), np.float32(0.0), np.float32(0.0), np.float32(0.0), np.float32(0.0), np.float32(0.0)]",4.0,99498.0,28
2025-08-14_08-18-36,7704,"[np.float32(1.0), np.float32(0.0), np.float32(0.0), np.float32(0.0), np.float32(0.0), np.float32(0.0), np.float32(1.0), np.float32(1.0), np.float32(0.0), np.float32(1.0), np.float32(1.0), np.float32(0.0), np.float32(1.0), np.float32(1.0), np.float32(0.0), np.float32(0.0)]",-4.0,99494.0,24
2025-08-14_08-18-36,7705,"[np.float32(0.0), np.float32(1.0), np.float32(1.0), np.float32(1.0), np.float32(1.0), np.float32(1.0), np.float32(1.0), np.float32(1.0), np.float32(1.0), np.float32(1.0), np.float32(0.0), np.float32(0.0), np.float32(1.0), np.float32(1.0), np.float32(0.0), np.float32(0.0)]",-1.0,99493.0,16
2025-08-14_08-18-36,7706,"[np.float32(1.0), np.float32(1.0), np.float32(1.0), np.float32(1.0), np.float32(0.0), np.float32(0.0), np.float32(0.0), np.float32(0.0), np.float32(1.0), np.float32(0.0), np.float32(1.0), np.float32(1.0), np.float32(0.0), np.float32(1.0), np.float32(0.0), np.float32(0.0)]",5.0,99498.0,26
2025-08-14_08-18-36,7707,"[np.float32(0.0), np.float32(1.0), np.float32(0.0), np.float32(1.0), np.float32(0.0), np.float32(1.0), np.float32(1.0), np.float32(0.0), np.float32(1.0), np.float32(1.0), np.float32(0.0), np.float32(1.0), np.float32(1.0), np.float32(0.0), np.float32(0.0), np.float32(1.0)]",2.0,99500.0,9
2025-08-14_08-18-36,7708,"[np.float32(0.0), np.float32(1.0), np.float32(1.0), np.float32(1.0), np.float32(0.0), np.float32(0.0), np.float32(1.0), np.float32(1.0), np.float32(1.0), np.float32(0.0), np.float32(0.0), np.float32(0.0), np.float32(1.0), np.float32(1.0), np.float32(1.0), np.float32(0.0)]",1.0,99501.0,4
2025-08-14_08-18-36,7709,"[np.float32(1.0), np.float32(0.0), np.float32(1.0), np.float32(1.0), np.float32(0.0), np.float32(1.0), np.float32(0.0), np.float32(1.0), np.float32(1.0), np.float32(1.0), np.float32(0.0), np.float32(0.0), np.float32(1.0), np.float32(0.0), np.float32(0.0), np.float32(0.0)]",-6.0,99495.0,6
2025-08-14_08-18-36,7710,"[np.float32(0.0), np.float32(1.0), np.float32(0.0), np.float32(1.0), np.float32(1.0), np.float32(0.0), np.float32(0.0), np.float32(0.0), np.float32(0.0), np.float32(0.0), np.float32(1.0), np.float32(0.0), np.float32(1.0), np.float32(0.0), np.float32(1.0), np.float32(0.0)]",-3.0,99492.0,36
2025-08-14_08-18-36,7711,"[np.float32(0.0), np.float32(1.0), np.float32(1.0), np.float32(1.0), np.float32(1.0), np.float32(0.0), np.float32(1.0), np.float32(0.0), np.float32(0.0), np.float32(1.0), np.float32(0.0), np.float32(1.0), np.float32(1.0), np.float32(0.0), np.float32(0.0), np.float32(0.0)]",1.0,99493.0,13
2025-08-14_08-18-36,7712,"[np.float32(0.0), np.float32(1.0), np.float32(0.0), np.float32(0.0), np.float32(0.0), np.float32(0.0), np.float32(1.0), np.float32(1.0), np.float32(1.0), np.float32(1.0), np.float32(1.0), np.float32(1.0), np.float32(0.0), np.float32(1.0), np.float32(0.0), np.float32(1.0)]",0.0,99493.0,9
2025-08-14_08-18-36,7713,"[np.float32(0.0), np.float32(1.0), np.float32(1.0), np.float32(0.0), np.float32(1.0), np.float32(0.0), np.float32(0.0), np.float32(1.0), np.float32(1.0), np.float32(0.0), np.float32(1.0), np.float32(1.0), np.float32(0.0), np.float32(0.0), np.float32(1.0), np.float32(0.0)]",2.0,99495.0,13
2025-08-14_08-18-36,7714,"[np.float32(0.0), np.float32(1.0), np.float32(1.0), np.float32(0.0), np.float32(1.0), np.float32(1.0), np.float32(0.0), np.float32(1.0), np.float32(1.0), np.float32(1.0), np.float32(1.0), np.float32(0.0), np.float32(1.0), np.float32(1.0), np.float32(0.0), np.float32(1.0)]",-6.0,99489.0,27
2025-08-14_08-18-36,7715,"[np.float32(1.0), np.float32(0.0), np.float32(0.0), np.float32(1.0), np.float32(1.0), np.float32(1.0), np.float32(1.0), np.float32(1.0), np.float32(1.0), np.float32(1.0), np.float32(1.0), np.float32(0.0), np.float32(1.0), np.float32(0.0), np.float32(1.0), np.float32(0.0)]",-3.0,99486.0,4
2025-08-14_08-18-36,7716,"[np.float32(1.0), np.float32(0.0), np.float32(1.0), np.float32(1.0), np.float32(0.0), np.float32(0.0), np.float32(1.0), np.float32(1.0), np.float32(1.0), np.float32(0.0), np.float32(0.0), np.float32(0.0), np.float32(1.0), np.float32(0.0), np.float32(1.0), np.float32(0.0)]",2.0,99488.0,30
2025-08-14_08-18-36,7717,"[np.float32(0.0), np.float32(1.0), np.float32(0.0), np.float32(0.0), np.float32(0.0), np.float32(1.0), np.float32(1.0), np.float32(0.0), np.float32(1.0), np.float32(0.0), np.float32(1.0), np.float32(0.0), np.float32(1.0), np.float32(1.0), np.float32(0.0), np.float32(0.0)]",35.0,99523.0,7
2025-08-14_08-18-36,7718,"[np.float32(0.0), np.float32(0.0), np.float32(1.0), np.float32(1.0), np.float32(1.0), np.float32(1.0), np.float32(1.0), np.float32(1.0), np.float32(1.0), np.float32(1.0), np.float32(1.0), np.float32(1.0), np.float32(1.0), np.float32(0.0), np.float32(1.0), np.float32(0.0)]",-2.0,99521.0,3
2025-08-14_08-18-36,7719,"[np.float32(0.0), np.float32(1.0), np.float32(0.0), np.float32(1.0), np.float32(1.0), np.float32(0.0), np.float32(1.0), np.float32(1.0), np.float32(1.0), np.float32(1.0), np.float32(1.0), np.float32(1.0), np.float32(0.0), np.float32(0.0), np.float32(0.0), np.float32(1.0)]",-4.0,99517.0,36
2025-08-14_08-18-36,7720,"[np.float32(0.0), np.float32(0.0), np.float32(0.0), np.float32(0.0), np.float32(0.0), np.float32(1.0), np.float32(1.0), np.float32(1.0), np.float32(1.0), np.float32(1.0), np.float32(0.0), np.float32(0.0), np.float32(1.0), np.float32(1.0), np.float32(0.0), np.float32(1.0)]",-2.0,99515.0,9
2025-08-14_08-18-36,7721,"[np.float32(0.0), np.float32(1.0), np.float32(0.0), np.float32(1.0), np.float32(0.0), np.float32(0.0), np.float32(0.0), np.float32(1.0), np.float32(0.0), np.float32(0.0), np.float32(0.0), np.float32(1.0), np.float32(1.0), np.float32(1.0), np.float32(0.0), np.float32(0.0)]",-4.0,99511.0,1
2025-08-14_08-18-36,7722,"[np.float32(1.0), np.float32(1.0), np.float32(1.0), np.float32(1.0), np.float32(1.0), np.float32(1.0), np.float32(1.0), np.float32(1.0), np.float32(0.0), np.float32(0.0), np.float32(0.0), np.float32(0.0), np.float32(1.0), np.float32(0.0), np.float32(1.0), np.float32(1.0)]",1.0,99512.0,6
2025-08-14_08-18-36,7723,"[np.float32(1.0), np.float32(0.0), np.float32(0.0), np.float32(0.0), np.float32(0.0), np.float32(0.0), np.float32(1.0), np.float32(1.0), np.float32(0.0), np.float32(0.0), np.float32(1.0), np.float32(0.0), np.float32(0.0), np.float32(0.0), np.float32(1.0), np.float32(0.0)]",1.0,99513.0,24
2025-08-14_08-18-36,7724,"[np.float32(0.0), np.float32(0.0), np.float32(1.0), np.float32(1.0), np.float32(0.0), np.float32(0.0), np.float32(1.0), np.float32(1.0), np.float32(0.0), np.float32(1.0), np.float32(0.0), np.float32(1.0), np.float32(0.0), np.float32(0.0), np.float32(0.0), np.float32(0.0)]",-1.0,99512.0,2
2025-08-14_08-18-36,7725,"[np.float32(0.0), np.float32(1.0), np.float32(0.0), np.float32(1.0), np.float32(0.0), np.float32(1.0), np.float32(0.0), np.float32(0.0), np.float32(1.0), np.float32(0.0), np.float32(0.0), np.float32(0.0), np.float32(0.0), np.float32(1.0), np.float32(0.0), np.float32(1.0)]",4.0,99516.0,28
2025-08-14_08-18-36,7726,"[np.float32(0.0), np.float32(0.0), np.float32(0.0), np.float32(1.0), np.float32(0.0), np.float32(0.0), np.float32(1.0), np.float32(1.0), np.float32(0.0), np.float32(0.0), np.float32(0.0), np.float32(0.0), np.float32(0.0), np.float32(1.0), np.float32(0.0), np.float32(1.0)]",1.0,99517.0,2
2025-08-14_08-18-36,7727,"[np.float32(0.0), np.float32(0.0), np.float32(0.0), np.float32(1.0), np.float32(1.0), np.float32(1.0), np.float32(0.0), np.float32(1.0), np.float32(0.0), np.float32(1.0), np.float32(0.0), np.float32(0.0), np.float32(1.0), np.float32(0.0), np.float32(1.0), np.float32(1.0)]",-1.0,99516.0,11
2025-08-14_08-18-36,7728,"[np.float32(1.0), np.float32(1.0), np.float32(0.0), np.float32(0.0), np.float32(1.0), np.float32(1.0), np.float32(1.0), np.float32(1.0), np.float32(1.0), np.float32(1.0), np.float32(1.0), np.float32(1.0), np.float32(0.0), np.float32(1.0), np.float32(0.0), np.float32(0.0)]",2.0,99518.0,35
2025-08-14_08-18-36,7729,"[np.float32(1.0), np.float32(1.0), np.float32(0.0), np.float32(1.0), np.float32(0.0), np.float32(0.0), np.float32(1.0), np.float32(1.0), np.float32(1.0), np.float32(0.0), np.float32(1.0), np.float32(0.0), np.float32(0.0), np.float32(0.0), np.float32(1.0), np.float32(1.0)]",4.0,99522.0,11
2025-08-14_08-18-36,7730,"[np.float32(1.0), np.float32(0.0), np.float32(1.0), np.float32(0.0), np.float32(0.0), np.float32(0.0), np.float32(0.0), np.float32(0.0), np.float32(0.0), np.float32(1.0), np.float32(0.0), np.float32(1.0), np.float32(1.0), np.float32(1.0), np.float32(1.0), np.float32(1.0)]",-2.0,99520.0,13
2025-08-14_08-18-36,7731,"[np.float32(0.0), np.float32(0.0), np.float32(0.0), np.float32(0.0), np.float32(0.0), np.float32(1.0), np.float32(1.0), np.float32(0.0), np.float32(1.0), np.float32(1.0), np.float32(1.0), np.float32(1.0), np.float32(1.0), np.float32(0.0), np.float32(0.0), np.float32(0.0)]",-1.0,99519.0,10
2025-08-14_08-18-36,7732,"[np.float32(0.0), np.float32(0.0), np.float32(1.0), np.float32(0.0), np.float32(0.0), np.float32(1.0), np.float32(1.0), np.float32(1.0), np.float32(0.0), np.float32(0.0), np.float32(0.0), np.float32(1.0), np.float32(1.0), np.float32(1.0), np.float32(0.0), np.float32(0.0)]",-2.0,99517.0,10
2025-08-14_08-18-36,7733,"[np.float32(0.0), np.float32(0.0), np.float32(1.0), np.float32(1.0), np.float32(1.0), np.float32(1.0), np.float32(0.0), np.float32(0.0), np.float32(1.0), np.float32(0.0), np.float32(0.0), np.float32(0.0), np.float32(0.0), np.float32(1.0), np.float32(0.0), np.float32(0.0)]",-2.0,99515.0,1
2025-08-14_08-18-36,7734,"[np.float32(1.0), np.float32(0.0), np.float32(1.0), np.float32(1.0), np.float32(0.0), np.float32(0.0), np.float32(0.0), np.float32(1.0), np.float32(1.0), np.float32(1.0), np.float32(1.0), np.float32(0.0), np.float32(1.0), np.float32(0.0), np.float32(1.0), np.float32(0.0)]",-1.0,99514.0,8
2025-08-14_08-18-36,7735,"[np.float32(0.0), np.float32(1.0), np.float32(0.0), np.float32(0.0), np.float32(0.0), np.float32(1.0), np.float32(0.0), np.float32(1.0), np.float32(0.0), np.float32(0.0), np.float32(0.0), np.float32(0.0), np.float32(0.0), np.float32(1.0), np.float32(1.0), np.float32(0.0)]",0.0,99514.0,17
2025-08-14_08-18-36,7736,"[np.float32(1.0), np.float32(0.0), np.float32(0.0), np.float32(1.0), np.float32(1.0), np.float32(1.0), np.float32(1.0), np.float32(1.0), np.float32(1.0), np.float32(0.0), np.float32(0.0), np.float32(1.0), np.float32(0.0), np.float32(0.0), np.float32(0.0), np.float32(1.0)]",0.0,99514.0,25
2025-08-14_08-18-36,7737,"[np.float32(0.0), np.float32(0.0), np.float32(0.0), np.float32(0.0), np.float32(1.0), np.float32(0.0), np.float32(0.0), np.float32(1.0), np.float32(0.0), np.float32(1.0), np.float32(0.0), np.float32(1.0), np.float32(1.0), np.float32(1.0), np.float32(0.0), np.float32(1.0)]",-1.0,99513.0,24
2025-08-14_08-18-36,7738,"[np.float32(0.0), np.float32(1.0), np.float32(0.0), np.float32(0.0), np.float32(0.0), np.float32(0.0), np.float32(0.0), np.float32(1.0), np.float32(1.0), np.float32(1.0), np.float32(0.0), np.float32(1.0), np.float32(0.0), np.float32(0.0), np.float32(0.0), np.float32(0.0)]",1.0,99514.0,19
2025-08-14_08-18-36,7739,"[np.float32(1.0), np.float32(1.0), np.float32(0.0), np.float32(0.0), np.float32(1.0), np.float32(1.0), np.float32(0.0), np.float32(0.0), np.float32(1.0), np.float32(0.0), np.float32(0.0), np.float32(0.0), np.float32(0.0), np.float32(1.0), np.float32(1.0), np.float32(0.0)]",3.0,99517.0,28
2025-08-14_08-18-36,7740,"[np.float32(0.0), np.float32(0.0), np.float32(0.0), np.float32(0.0), np.float32(0.0), np.float32(1.0), np.float32(1.0), np.float32(1.0), np.float32(0.0), np.float32(0.0), np.float32(0.0), np.float32(1.0), np.float32(0.0), np.float32(1.0), np.float32(0.0), np.float32(0.0)]",0.0,99517.0,26
2025-08-14_08-18-36,7741,"[np.float32(1.0), np.float32(0.0), np.float32(0.0), np.float32(1.0), np.float32(0.0), np.float32(1.0), np.float32(1.0), np.float32(0.0), np.float32(1.0), np.float32(0.0), np.float32(0.0), np.float32(1.0), np.float32(1.0), np.float32(1.0), np.float32(1.0), np.float32(1.0)]",0.0,99517.0,34
2025-08-14_08-18-36,7742,"[np.float32(1.0), np.float32(1.0), np.float32(1.0), np.float32(0.0), np.float32(1.0), np.float32(0.0), np.float32(0.0), np.float32(1.0), np.float32(0.0), np.float32(1.0), np.float32(1.0), np.float32(0.0), np.float32(0.0), np.float32(0.0), np.float32(0.0), np.float32(0.0)]",0.0,99517.0,11
2025-08-14_08-18-36,7743,"[np.float32(1.0), np.float32(1.0), np.float32(0.0), np.float32(1.0), np.float32(0.0), np.float32(1.0), np.float32(1.0), np.float32(0.0), np.float32(0.0), np.float32(0.0), np.float32(1.0), np.float32(1.0), np.float32(1.0), np.float32(1.0), np.float32(0.0), np.float32(0.0)]",0.0,99517.0,33
2025-08-14_08-18-36,7744,"[np.float32(1.0), np.float32(1.0), np.float32(1.0), np.float32(0.0), np.float32(1.0), np.float32(1.0), np.float32(0.0), np.float32(1.0), np.float32(0.0), np.float32(1.0), np.float32(1.0), np.float32(0.0), np.float32(0.0), np.float32(1.0), np.float32(0.0), np.float32(0.0)]",-2.0,99515.0,1
2025-08-14_08-18-36,7745,"[np.float32(1.0), np.float32(0.0), np.float32(0.0), np.float32(0.0), np.float32(0.0), np.float32(1.0), np.float32(0.0), np.float32(1.0), np.float32(1.0), np.float32(1.0), np.float32(1.0), np.float32(0.0), np.float32(0.0), np.float32(0.0), np.float32(1.0), np.float32(0.0)]",-5.0,99510.0,3
2025-08-14_08-18-36,7746,"[np.float32(1.0), np.float32(0.0), np.float32(1.0), np.float32(0.0), np.float32(0.0), np.float32(1.0), np.float32(0.0), np.float32(1.0), np.float32(0.0), np.float32(1.0), np.float32(1.0), np.float32(0.0), np.float32(0.0), np.float32(0.0), np.float32(0.0), np.float32(0.0)]",4.0,99514.0,20
2025-08-14_08-18-36,7747,"[np.float32(1.0), np.float32(0.0), np.float32(1.0), np.float32(1.0), np.float32(0.0), np.float32(0.0), np.float32(1.0), np.float32(1.0), np.float32(0.0), np.float32(1.0), np.float32(0.0), np.float32(1.0), np.float32(0.0), np.float32(0.0), np.float32(0.0), np.float32(1.0)]",-4.0,99510.0,32
2025-08-14_08-18-36,7748,"[np.float32(0.0), np.float32(1.0), np.float32(1.0), np.float32(1.0), np.float32(0.0), np.float32(0.0), np.float32(0.0), np.float32(1.0), np.float32(1.0), np.float32(1.0), np.float32(1.0), np.float32(0.0), np.float32(1.0), np.float32(0.0), np.float32(1.0), np.float32(0.0)]",32.0,99542.0,7
2025-08-14_08-18-36,7749,"[np.float32(1.0), np.float32(1.0), np.float32(1.0), np.float32(0.0), np.float32(0.0), np.float32(1.0), np.float32(1.0), np.float32(1.0), np.float32(1.0), np.float32(0.0), np.float32(0.0), np.float32(0.0), np.float32(0.0), np.float32(1.0), np.float32(0.0), np.float32(0.0)]",4.0,99546.0,22
2025-08-14_08-18-36,7750,"[np.float32(1.0), np.float32(1.0), np.float32(0.0), np.float32(0.0), np.float32(1.0), np.float32(1.0), np.float32(1.0), np.float32(1.0), np.float32(1.0), np.float32(0.0), np.float32(0.0), np.float32(1.0), np.float32(0.0), np.float32(1.0), np.float32(0.0), np.float32(0.0)]",-2.0,99544.0,20
2025-08-14_08-18-36,7751,"[np.float32(0.0), np.float32(0.0), np.float32(0.0), np.float32(0.0), np.float32(0.0), np.float32(1.0), np.float32(0.0), np.float32(0.0), np.float32(1.0), np.float32(0.0), np.float32(0.0), np.float32(0.0), np.float32(0.0), np.float32(1.0), np.float32(1.0), np.float32(1.0)]",0.0,99544.0,23
2025-08-14_08-18-36,7752,"[np.float32(0.0), np.float32(0.0), np.float32(1.0), np.float32(0.0), np.float32(0.0), np.float32(1.0), np.float32(1.0), np.float32(0.0), np.float32(1.0), np.float32(0.0), np.float32(0.0), np.float32(0.0), np.float32(1.0), np.float32(1.0), np.float32(0.0), np.float32(0.0)]",-1.0,99543.0,31
2025-08-14_08-18-36,7753,"[np.float32(0.0), np.float32(0.0), np.float32(1.0), np.float32(0.0), np.float32(1.0), np.float32(1.0), np.float32(0.0), np.float32(1.0), np.float32(1.0), np.float32(0.0), np.float32(1.0), np.float32(0.0), np.float32(0.0), np.float32(0.0), np.float32(1.0), np.float32(0.0)]",0.0,99543.0,2
2025-08-14_08-18-36,7754,"[np.float32(0.0), np.float32(1.0), np.float32(0.0), np.float32(0.0), np.float32(0.0), np.float32(0.0), np.float32(0.0), np.float32(1.0), np.float32(0.0), np.float32(0.0), np.float32(1.0), np.float32(0.0), np.float32(1.0), np.float32(1.0), np.float32(0.0), np.float32(0.0)]",-2.0,99541.0,5
2025-08-14_08-18-36,7755,"[np.float32(0.0), np.float32(0.0), np.float32(0.0), np.float32(0.0), np.float32(1.0), np.float32(1.0), np.float32(0.0), np.float32(1.0), np.float32(0.0), np.float32(1.0), np.float32(0.0), np.float32(0.0), np.float32(0.0), np.float32(1.0), np.float32(1.0), np.float32(1.0)]",-2.0,99539.0,6
2025-08-14_08-18-36,7756,"[np.float32(0.0), np.float32(1.0), np.float32(1.0), np.float32(0.0), np.float32(0.0), np.float32(0.0), np.float32(0.0), np.float32(1.0), np.float32(1.0), np.float32(0.0), np.float32(0.0), np.float32(1.0), np.float32(1.0), np.float32(0.0), np.float32(0.0), np.float32(1.0)]",1.0,99540.0,15
2025-08-14_08-18-36,7757,"[np.float32(1.0), np.float32(1.0), np.float32(0.0), np.float32(1.0), np.float32(0.0), np.float32(1.0), np.float32(0.0), np.float32(0.0), np.float32(0.0), np.float32(0.0), np.float32(0.0), np.float32(0.0), np.float32(0.0), np.float32(0.0), np.float32(0.0), np.float32(1.0)]",-1.0,99539.0,24
2025-08-14_08-18-36,7758,"[np.float32(0.0), np.float32(0.0), np.float32(1.0), np.float32(0.0), np.float32(1.0), np.float32(0.0), np.float32(0.0), np.float32(1.0), np.float32(1.0), np.float32(0.0), np.float32(1.0), np.float32(1.0), np.float32(0.0), np.float32(0.0), np.float32(1.0), np.float32(0.0)]",1.0,99540.0,32
2025-08-14_08-18-36,7759,"[np.float32(1.0), np.float32(1.0), np.float32(0.0), np.float32(1.0), np.float32(1.0), np.float32(0.0), np.float32(0.0), np.float32(1.0), np.float32(1.0), np.float32(0.0), np.float32(1.0), np.float32(0.0), np.float32(0.0), np.float32(1.0), np.float32(0.0), np.float32(1.0)]",0.0,99540.0,3
2025-08-14_08-18-36,7760,"[np.float32(0.0), np.float32(1.0), np.float32(0.0), np.float32(1.0), np.float32(1.0), np.float32(1.0), np.float32(1.0), np.float32(1.0), np.float32(0.0), np.float32(0.0), np.float32(0.0), np.float32(1.0), np.float32(0.0), np.float32(1.0), np.float32(0.0), np.float32(0.0)]",-6.0,99534.0,34
2025-08-14_08-18-36,7761,"[np.float32(1.0), np.float32(0.0), np.float32(1.0), np.float32(1.0), np.float32(1.0), np.float32(1.0), np.float32(0.0), np.float32(1.0), np.float32(0.0), np.float32(1.0), np.float32(1.0), np.float32(0.0), np.float32(1.0), np.float32(0.0), np.float32(0.0), np.float32(1.0)]",-1.0,99533.0,18
2025-08-14_08-18-36,7762,"[np.float32(1.0), np.float32(1.0), np.float32(0.0), np.float32(1.0), np.float32(1.0), np.float32(1.0), np.float32(1.0), np.float32(1.0), np.float32(1.0), np.float32(0.0), np.float32(0.0), np.float32(0.0), np.float32(1.0), np.float32(0.0), np.float32(1.0), np.float32(0.0)]",-3.0,99530.0,4
2025-08-14_08-18-36,7763,"[np.float32(1.0), np.float32(0.0), np.float32(1.0), np.float32(0.0), np.float32(0.0), np.float32(0.0), np.float32(1.0), np.float32(1.0), np.float32(0.0), np.float32(0.0), np.float32(1.0), np.float32(0.0), np.float32(0.0), np.float32(0.0), np.float32(1.0), np.float32(1.0)]",-2.0,99528.0,4
2025-08-14_08-18-36,7764,"[np.float32(1.0), np.float32(1.0), np.float32(1.0), np.float32(1.0), np.float32(1.0), np.float32(1.0), np.float32(0.0), np.float32(0.0), np.float32(1.0), np.float32(1.0), np.float32(1.0), np.float32(1.0), np.float32(0.0), np.float32(0.0), np.float32(1.0), np.float32(0.0)]",-2.0,99526.0,14
2025-08-14_08-18-36,7765,"[np.float32(1.0), np.float32(0.0), np.float32(0.0), np.float32(0.0), np.float32(1.0), np.float32(1.0), np.float32(1.0), np.float32(1.0), np.float32(0.0), np.float32(1.0), np.float32(0.0), np.float32(0.0), np.float32(1.0), np.float32(0.0), np.float32(0.0), np.float32(0.0)]",0.0,99526.0,21
2025-08-14_08-18-36,7766,"[np.float32(0.0), np.float32(1.0), np.float32(0.0), np.float32(1.0), np.float32(0.0), np.float32(1.0), np.float32(1.0), np.float32(1.0), np.float32(1.0), np.float32(0.0), np.float32(0.0), np.float32(1.0), np.float32(1.0), np.float32(1.0), np.float32(1.0), np.float32(1.0)]",-3.0,99523.0,2
2025-08-14_08-18-36,7767,"[np.float32(1.0), np.float32(0.0), np.float32(1.0), np.float32(0.0), np.float32(0.0), np.float32(0.0), np.float32(1.0), np.float32(1.0), np.float32(1.0), np.float32(0.0), np.float32(0.0), np.float32(1.0), np.float32(1.0), np.float32(1.0), np.float32(0.0), np.float32(0.0)]",-3.0,99520.0,0
2025-08-14_08-18-36,7768,"[np.float32(1.0), np.float32(1.0), np.float32(0.0), np.float32(1.0), np.float32(1.0), np.float32(1.0), np.float32(0.0), np.float32(0.0), np.float32(0.0), np.float32(1.0), np.float32(1.0), np.float32(1.0), np.float32(0.0), np.float32(0.0), np.float32(1.0), np.float32(0.0)]",0.0,99520.0,1
2025-08-14_08-18-36,7769,"[np.float32(1.0), np.float32(1.0), np.float32(1.0), np.float32(1.0), np.float32(1.0), np.float32(0.0), np.float32(1.0), np.float32(1.0), np.float32(1.0), np.float32(1.0), np.float32(1.0), np.float32(1.0), np.float32(1.0), np.float32(0.0), np.float32(0.0), np.float32(0.0)]",0.0,99520.0,8
2025-08-14_08-18-36,7770,"[np.float32(0.0), np.float32(0.0), np.float32(1.0), np.float32(1.0), np.float32(0.0), np.float32(1.0), np.float32(1.0), np.float32(0.0), np.float32(0.0), np.float32(1.0), np.float32(1.0), np.float32(0.0), np.float32(1.0), np.float32(0.0), np.float32(0.0), np.float32(1.0)]",-1.0,99519.0,19
2025-08-14_08-18-36,7771,"[np.float32(1.0), np.float32(0.0), np.float32(0.0), np.float32(1.0), np.float32(0.0), np.float32(0.0), np.float32(1.0), np.float32(1.0), np.float32(0.0), np.float32(1.0), np.float32(1.0), np.float32(0.0), np.float32(1.0), np.float32(1.0), np.float32(0.0), np.float32(0.0)]",-2.0,99517.0,8
2025-08-14_08-18-36,7772,"[np.float32(1.0), np.float32(1.0), np.float32(0.0), np.float32(0.0), np.float32(0.0), np.float32(0.0), np.float32(0.0), np.float32(1.0), np.float32(0.0), np.float32(1.0), np.float32(0.0), np.float32(0.0), np.float32(1.0), np.float32(1.0), np.float32(1.0), np.float32(0.0)]",-5.0,99512.0,6
2025-08-14_08-18-36,7773,"[np.float32(1.0), np.float32(1.0), np.float32(0.0), np.float32(0.0), np.float32(1.0), np.float32(0.0), np.float32(1.0), np.float32(0.0), np.float32(0.0), np.float32(0.0), np.float32(1.0), np.float32(0.0), np.float32(1.0), np.float32(0.0), np.float32(1.0), np.float32(1.0)]",-6.0,99506.0,19
2025-08-14_08-18-36,7774,"[np.float32(1.0), np.float32(1.0), np.float32(1.0), np.float32(0.0), np.float32(0.0), np.float32(1.0), np.float32(1.0), np.float32(1.0), np.float32(1.0), np.float32(0.0), np.float32(0.0), np.float32(1.0), np.float32(0.0), np.float32(0.0), np.float32(0.0), np.float32(0.0)]",-1.0,99505.0,2
2025-08-14_08-18-36,7775,"[np.float32(1.0), np.float32(0.0), np.float32(1.0), np.float32(0.0), np.float32(1.0), np.float32(1.0), np.float32(1.0), np.float32(1.0), np.float32(0.0), np.float32(0.0), np.float32(1.0), np.float32(0.0), np.float32(1.0), np.float32(1.0), np.float32(0.0), np.float32(1.0)]",0.0,99505.0,3
2025-08-14_08-18-36,7776,"[np.float32(0.0), np.float32(0.0), np.float32(1.0), np.float32(0.0), np.float32(0.0), np.float32(1.0), np.float32(1.0), np.float32(1.0), np.float32(1.0), np.float32(1.0), np.float32(0.0), np.float32(0.0), np.float32(1.0), np.float32(1.0), np.float32(1.0), np.float32(1.0)]",-4.0,99501.0,9
2025-08-14_08-18-36,7777,"[np.float32(1.0), np.float32(1.0), np.float32(0.0), np.float32(0.0), np.float32(1.0), np.float32(0.0), np.float32(1.0), np.float32(0.0), np.float32(1.0), np.float32(0.0), np.float32(0.0), np.float32(0.0), np.float32(1.0), np.float32(1.0), np.float32(0.0), np.float32(1.0)]",0.0,99501.0,34
2025-08-14_08-18-36,7778,"[np.float32(1.0), np.float32(1.0), np.float32(1.0), np.float32(0.0), np.float32(1.0), np.float32(0.0), np.float32(0.0), np.float32(1.0), np.float32(0.0), np.float32(1.0), np.float32(0.0), np.float32(0.0), np.float32(1.0), np.float32(1.0), np.float32(1.0), np.float32(0.0)]",37.0,99538.0,7
2025-08-14_08-18-36,7779,"[np.float32(0.0), np.float32(1.0), np.float32(0.0), np.float32(1.0), np.float32(0.0), np.float32(0.0), np.float32(0.0), np.float32(1.0), np.float32(1.0), np.float32(0.0), np.float32(0.0), np.float32(0.0), np.float32(1.0), np.float32(1.0), np.float32(0.0), np.float32(0.0)]",4.0,99542.0,29
2025-08-14_08-18-36,7780,"[np.float32(1.0), np.float32(1.0), np.float32(0.0), np.float32(0.0), np.float32(0.0), np.float32(0.0), np.float32(0.0), np.float32(0.0), np.float32(0.0), np.float32(0.0), np.float32(1.0), np.float32(1.0), np.float32(1.0), np.float32(0.0), np.float32(0.0), np.float32(1.0)]",-1.0,99541.0,35
2025-08-14_08-18-36,7781,"[np.float32(1.0), np.float32(1.0), np.float32(0.0), np.float32(0.0), np.float32(1.0), np.float32(0.0), np.float32(1.0), np.float32(1.0), np.float32(0.0), np.float32(0.0), np.float32(0.0), np.float32(1.0), np.float32(1.0), np.float32(0.0), np.float32(1.0), np.float32(0.0)]",-1.0,99540.0,17
2025-08-14_08-18-36,7782,"[np.float32(0.0), np.float32(1.0), np.float32(1.0), np.float32(0.0), np.float32(0.0), np.float32(1.0), np.float32(1.0), np.float32(0.0), np.float32(0.0), np.float32(1.0), np.float32(0.0), np.float32(0.0), np.float32(0.0), np.float32(0.0), np.float32(0.0), np.float32(1.0)]",4.0,99544.0,31
2025-08-14_08-18-36,7783,"[np.float32(1.0), np.float32(0.0), np.float32(0.0), np.float32(0.0), np.float32(1.0), np.float32(1.0), np.float32(1.0), np.float32(1.0), np.float32(0.0), np.float32(1.0), np.float32(0.0), np.float32(0.0), np.float32(0.0), np.float32(1.0), np.float32(1.0), np.float32(1.0)]",4.0,99548.0,1
2025-08-14_08-18-36,7784,"[np.float32(0.0), np.float32(0.0), np.float32(1.0), np.float32(1.0), np.float32(1.0), np.float32(1.0), np.float32(0.0), np.float32(1.0), np.float32(1.0), np.float32(1.0), np.float32(0.0), np.float32(1.0), np.float32(1.0), np.float32(0.0), np.float32(1.0), np.float32(0.0)]",3.0,99551.0,13
2025-08-14_08-18-36,7785,"[np.float32(1.0), np.float32(1.0), np.float32(1.0), np.float32(1.0), np.float32(1.0), np.float32(1.0), np.float32(0.0), np.float32(1.0), np.float32(1.0), np.float32(1.0), np.float32(1.0), np.float32(0.0), np.float32(1.0), np.float32(1.0), np.float32(1.0), np.float32(1.0)]",1.0,99552.0,28
2025-08-14_08-18-36,7786,"[np.float32(1.0), np.float32(1.0), np.float32(0.0), np.float32(1.0), np.float32(0.0), np.float32(1.0), np.float32(0.0), np.float32(1.0), np.float32(1.0), np.float32(1.0), np.float32(0.0), np.float32(0.0), np.float32(1.0), np.float32(0.0), np.float32(0.0), np.float32(0.0)]",-3.0,99549.0,4
2025-08-14_08-18-36,7787,"[np.float32(0.0), np.float32(0.0), np.float32(0.0), np.float32(0.0), np.float32(0.0), np.float32(1.0), np.float32(1.0), np.float32(1.0), np.float32(0.0), np.float32(0.0), np.float32(0.0), np.float32(1.0), np.float32(1.0), np.float32(1.0), np.float32(1.0), np.float32(0.0)]",2.0,99551.0,3
2025-08-14_08-18-36,7788,"[np.float32(0.0), np.float32(1.0), np.float32(0.0), np.float32(0.0), np.float32(0.0), np.float32(0.0), np.float32(1.0), np.float32(1.0), np.float32(0.0), np.float32(0.0), np.float32(0.0), np.float32(1.0), np.float32(0.0), np.float32(0.0), np.float32(0.0), np.float32(0.0)]",2.0,99553.0,21
2025-08-14_08-18-36,7789,"[np.float32(0.0), np.float32(1.0), np.float32(0.0), np.float32(0.0), np.float32(0.0), np.float32(0.0), np.float32(1.0), np.float32(1.0), np.float32(0.0), np.float32(0.0), np.float32(0.0), np.float32(0.0), np.float32(1.0), np.float32(0.0), np.float32(1.0), np.float32(0.0)]",-2.0,99551.0,30
2025-08-14_08-18-36,7790,"[np.float32(0.0), np.float32(1.0), np.float32(1.0), np.float32(1.0), np.float32(0.0), np.float32(1.0), np.float32(1.0), np.float32(1.0), np.float32(1.0), np.float32(0.0), np.float32(1.0), np.float32(1.0), np.float32(1.0), np.float32(1.0), np.float32(0.0), np.float32(1.0)]",-1.0,99550.0,9
2025-08-14_08-18-36,7791,"[np.float32(0.0), np.float32(1.0), np.float32(1.0), np.float32(0.0), np.float32(0.0), np.float32(0.0), np.float32(0.0), np.float32(1.0), np.float32(1.0), np.float32(0.0), np.float32(1.0), np.float32(0.0), np.float32(0.0), np.float32(0.0), np.float32(1.0), np.float32(1.0)]",1.0,99551.0,34
2025-08-14_08-18-36,7792,"[np.float32(0.0), np.float32(0.0), np.float32(0.0), np.float32(0.0), np.float32(0.0), np.float32(0.0), np.float32(0.0), np.float32(1.0), np.float32(0.0), np.float32(1.0), np.float32(1.0), np.float32(1.0), np.float32(0.0), np.float32(0.0), np.float32(0.0), np.float32(0.0)]",-1.0,99550.0,2
2025-08-14_08-18-36,7793,"[np.float32(1.0), np.float32(1.0), np.float32(1.0), np.float32(1.0), np.float32(1.0), np.float32(1.0), np.float32(1.0), np.float32(1.0), np.float32(0.0), np.float32(0.0), np.float32(0.0), np.float32(0.0), np.float32(0.0), np.float32(0.0), np.float32(0.0), np.float32(1.0)]",-3.0,99547.0,36
2025-08-14_08-18-36,7794,"[np.float32(1.0), np.float32(0.0), np.float32(1.0), np.float32(0.0), np.float32(0.0), np.float32(1.0), np.float32(0.0), np.float32(1.0), np.float32(0.0), np.float32(1.0), np.float32(0.0), np.float32(1.0), np.float32(0.0), np.float32(0.0), np.float32(1.0), np.float32(1.0)]",5.0,99552.0,24
2025-08-14_08-18-36,7795,"[np.float32(1.0), np.float32(1.0), np.float32(0.0), np.float32(0.0), np.float32(0.0), np.float32(1.0), np.float32(0.0), np.float32(0.0), np.float32(0.0), np.float32(1.0), np.float32(1.0), np.float32(1.0), np.float32(1.0), np.float32(0.0), np.float32(1.0), np.float32(1.0)]",-1.0,99551.0,17
2025-08-14_08-18-36,7796,"[np.float32(0.0), np.float32(1.0), np.float32(1.0), np.float32(1.0), np.float32(0.0), np.float32(1.0), np.float32(0.0), np.float32(1.0), np.float32(1.0), np.float32(0.0), np.float32(1.0), np.float32(0.0), np.float32(1.0), np.float32(1.0), np.float32(1.0), np.float32(0.0)]",-1.0,99550.0,31
2025-08-14_08-18-36,7797,"[np.float32(0.0), np.float32(0.0), np.float32(0.0), np.float32(0.0), np.float32(0.0), np.float32(1.0), np.float32(1.0), np.float32(1.0), np.float32(0.0), np.float32(1.0), np.float32(0.0), np.float32(1.0), np.float32(1.0), np.float32(1.0), np.float32(1.0), np.float32(0.0)]",-2.0,99548.0,9
2025-08-14_08-18-36,7798,"[np.float32(1.0), np.float32(0.0), np.float32(0.0), np.float32(1.0), np.float32(0.0), np.float32(1.0), np.float32(1.0), np.float32(1.0), np.float32(0.0), np.float32(0.0), np.float32(1.0), np.float32(1.0), np.float32(1.0), np.float32(1.0), np.float32(1.0), np.float32(1.0)]",-5.0,99543.0,4
2025-08-14_08-18-36,7799,"[np.float32(0.0), np.float32(1.0), np.float32(0.0), np.float32(0.0), np.float32(1.0), np.float32(0.0), np.float32(0.0), np.float32(0.0), np.float32(0.0), np.float32(1.0), np.float32(0.0), np.float32(0.0), np.float32(0.0), np.float32(0.0), np.float32(1.0), np.float32(0.0)]",0.0,99543.0,6
2025-08-14_08-18-36,7800,"[np.float32(0.0), np.float32(1.0), np.float32(0.0), np.float32(1.0), np.float32(1.0), np.float32(1.0), np.float32(0.0), np.float32(1.0), np.float32(1.0), np.float32(0.0), np.float32(0.0), np.float32(0.0), np.float32(0.0), np.float32(1.0), np.float32(0.0), np.float32(1.0)]",2.0,99545.0,25
2025-08-14_08-18-36,7801,"[np.float32(0.0), np.float32(1.0), np.float32(0.0), np.float32(0.0), np.float32(1.0), np.float32(0.0), np.float32(1.0), np.float32(1.0), np.float32(0.0), np.float32(0.0), np.float32(0.0), np.float32(0.0), np.float32(0.0), np.float32(1.0), np.float32(1.0), np.float32(0.0)]",2.0,99547.0,12
2025-08-14_08-18-36,7802,"[np.float32(1.0), np.float32(1.0), np.float32(1.0), np.float32(0.0), np.float32(0.0), np.float32(0.0), np.float32(0.0), np.float32(1.0), np.float32(1.0), np.float32(0.0), np.float32(0.0), np.float32(0.0), np.float32(0.0), np.float32(0.0), np.float32(1.0), np.float32(0.0)]",-4.0,99543.0,9
2025-08-14_08-18-36,7803,"[np.float32(0.0), np.float32(0.0), np.float32(1.0), np.float32(0.0), np.float32(0.0), np.float32(0.0), np.float32(0.0), np.float32(0.0), np.float32(1.0), np.float32(1.0), np.float32(0.0), np.float32(1.0), np.float32(1.0), np.float32(0.0), np.float32(1.0), np.float32(1.0)]",-2.0,99541.0,14
2025-08-14_08-18-36,7804,"[np.float32(1.0), np.float32(1.0), np.float32(0.0), np.float32(1.0), np.float32(0.0), np.float32(1.0), np.float32(1.0), np.float32(1.0), np.float32(1.0), np.float32(1.0), np.float32(1.0), np.float32(0.0), np.float32(0.0), np.float32(0.0), np.float32(0.0), np.float32(1.0)]",-3.0,99538.0,36
2025-08-14_08-18-36,7805,"[np.float32(1.0), np.float32(0.0), np.float32(1.0), np.float32(1.0), np.float32(0.0), np.float32(0.0), np.float32(0.0), np.float32(0.0), np.float32(1.0), np.float32(1.0), np.float32(0.0), np.float32(0.0), np.float32(1.0), np.float32(1.0), np.float32(1.0), np.float32(0.0)]",-3.0,99535.0,15
2025-08-14_08-18-36,7806,"[np.float32(1.0), np.float32(0.0), np.float32(1.0), np.float32(1.0), np.float32(1.0), np.float32(1.0), np.float32(1.0), np.float32(0.0), np.float32(0.0), np.float32(1.0), np.float32(0.0), np.float32(1.0), np.float32(0.0), np.float32(1.0), np.float32(0.0), np.float32(1.0)]",0.0,99535.0,31
2025-08-14_08-18-36,7807,"[np.float32(1.0), np.float32(1.0), np.float32(0.0), np.float32(0.0), np.float32(1.0), np.float32(0.0), np.float32(0.0), np.float32(1.0), np.float32(1.0), np.float32(0.0), np.float32(0.0), np.float32(1.0), np.float32(0.0), np.float32(1.0), np.float32(1.0), np.float32(1.0)]",-1.0,99534.0,32
2025-08-14_08-18-36,7808,"[np.float32(0.0), np.float32(1.0), np.float32(1.0), np.float32(0.0), np.float32(0.0), np.float32(0.0), np.float32(0.0), np.float32(0.0), np.float32(1.0), np.float32(0.0), np.float32(1.0), np.float32(0.0), np.float32(0.0), np.float32(1.0), np.float32(1.0), np.float32(0.0)]",-6.0,99528.0,9
2025-08-14_08-18-36,7809,"[np.float32(0.0), np.float32(1.0), np.float32(0.0), np.float32(1.0), np.float32(0.0), np.float32(1.0), np.float32(0.0), np.float32(1.0), np.float32(0.0), np.float32(1.0), np.float32(1.0), np.float32(1.0), np.float32(1.0), np.float32(1.0), np.float32(1.0), np.float32(1.0)]",2.0,99530.0,20
2025-08-14_08-18-36,7810,"[np.float32(1.0), np.float32(1.0), np.float32(0.0), np.float32(0.0), np.float32(0.0), np.float32(0.0), np.float32(0.0), np.float32(1.0), np.float32(0.0), np.float32(0.0), np.float32(0.0), np.float32(0.0), np.float32(0.0), np.float32(0.0), np.float32(1.0), np.float32(0.0)]",1.0,99531.0,20
2025-08-14_08-18-36,7811,"[np.float32(1.0), np.float32(1.0), np.float32(0.0), np.float32(1.0), np.float32(0.0), np.float32(0.0), np.float32(1.0), np.float32(0.0), np.float32(0.0), np.float32(0.0), np.float32(0.0), np.float32(0.0), np.float32(1.0), np.float32(1.0), np.float32(0.0), np.float32(0.0)]",2.0,99533.0,12
2025-08-14_08-18-36,7812,"[np.float32(1.0), np.float32(1.0), np.float32(0.0), np.float32(0.0), np.float32(0.0), np.float32(0.0), np.float32(1.0), np.float32(1.0), np.float32(1.0), np.float32(1.0), np.float32(0.0), np.float32(1.0), np.float32(0.0), np.float32(1.0), np.float32(0.0), np.float32(0.0)]",-3.0,99530.0,0
2025-08-14_08-18-36,7813,"[np.float32(1.0), np.float32(1.0), np.float32(1.0), np.float32(1.0), np.float32(0.0), np.float32(0.0), np.float32(0.0), np.float32(0.0), np.float32(0.0), np.float32(0.0), np.float32(0.0), np.float32(0.0), np.float32(1.0), np.float32(0.0), np.float32(1.0), np.float32(0.0)]",-2.0,99528.0,31
2025-08-14_08-18-36,7814,"[np.float32(1.0), np.float32(1.0), np.float32(1.0), np.float32(1.0), np.float32(0.0), np.float32(1.0), np.float32(0.0), np.float32(1.0), np.float32(1.0), np.float32(1.0), np.float32(0.0), np.float32(1.0), np.float32(0.0), np.float32(0.0), np.float32(0.0), np.float32(1.0)]",-3.0,99525.0,3
2025-08-14_08-18-36,7815,"[np.float32(0.0), np.float32(1.0), np.float32(1.0), np.float32(0.0), np.float32(1.0), np.float32(0.0), np.float32(1.0), np.float32(1.0), np.float32(1.0), np.float32(0.0), np.float32(1.0), np.float32(1.0), np.float32(0.0), np.float32(0.0), np.float32(1.0), np.float32(1.0)]",1.0,99526.0,33
2025-08-14_08-18-36,7816,"[np.float32(0.0), np.float32(0.0), np.float32(0.0), np.float32(1.0), np.float32(0.0), np.float32(1.0), np.float32(1.0), np.float32(1.0), np.float32(0.0), np.float32(0.0), np.float32(0.0), np.float32(0.0), np.float32(1.0), np.float32(0.0), np.float32(1.0), np.float32(1.0)]",-5.0,99521.0,28
2025-08-14_08-18-36,7817,"[np.float32(1.0), np.float32(0.0), np.float32(1.0), np.float32(0.0), np.float32(0.0), np.float32(0.0), np.float32(1.0), np.float32(1.0), np.float32(1.0), np.float32(0.0), np.float32(0.0), np.float32(1.0), np.float32(1.0), np.float32(0.0), np.float32(1.0), np.float32(1.0)]",-6.0,99515.0,29
2025-08-14_08-18-36,7818,"[np.float32(0.0), np.float32(1.0), np.float32(1.0), np.float32(1.0), np.float32(0.0), np.float32(0.0), np.float32(1.0), np.float32(1.0), np.float32(0.0), np.float32(1.0), np.float32(1.0), np.float32(1.0), np.float32(1.0), np.float32(0.0), np.float32(1.0), np.float32(0.0)]",-2.0,99513.0,18
2025-08-14_08-18-36,7819,"[np.float32(1.0), np.float32(1.0), np.float32(0.0), np.float32(1.0), np.float32(0.0), np.float32(0.0), np.float32(1.0), np.float32(1.0), np.float32(0.0), np.float32(0.0), np.float32(1.0), np.float32(0.0), np.float32(0.0), np.float32(0.0), np.float32(0.0), np.float32(0.0)]",4.0,99517.0,11
2025-08-14_08-18-36,7820,"[np.float32(1.0), np.float32(0.0), np.float32(0.0), np.float32(1.0), np.float32(0.0), np.float32(1.0), np.float32(1.0), np.float32(0.0), np.float32(0.0), np.float32(0.0), np.float32(0.0), np.float32(0.0), np.float32(0.0), np.float32(0.0), np.float32(1.0), np.float32(0.0)]",2.0,99519.0,9
2025-08-14_08-18-36,7821,"[np.float32(1.0), np.float32(1.0), np.float32(0.0), np.float32(0.0), np.float32(0.0), np.float32(1.0), np.float32(0.0), np.float32(1.0), np.float32(0.0), np.float32(1.0), np.float32(0.0), np.float32(0.0), np.float32(0.0), np.float32(1.0), np.float32(1.0), np.float32(1.0)]",-3.0,99516.0,9
2025-08-14_08-18-36,7822,"[np.float32(1.0), np.float32(0.0), np.float32(0.0), np.float32(1.0), np.float32(0.0), np.float32(1.0), np.float32(0.0), np.float32(0.0), np.float32(1.0), np.float32(0.0), np.float32(0.0), np.float32(1.0), np.float32(0.0), np.float32(1.0), np.float32(1.0), np.float32(0.0)]",0.0,99516.0,7
2025-08-14_08-18-36,7823,"[np.float32(0.0), np.float32(0.0), np.float32(0.0), np.float32(0.0), np.float32(1.0), np.float32(0.0), np.float32(0.0), np.float32(0.0), np.float32(1.0), np.float32(0.0), np.float32(1.0), np.float32(0.0), np.float32(0.0), np.float32(0.0), np.float32(0.0), np.float32(0.0)]",0.0,99516.0,28
2025-08-14_08-18-36,7824,"[np.float32(1.0), np.float32(1.0), np.float32(0.0), np.float32(0.0), np.float32(1.0), np.float32(0.0), np.float32(0.0), np.float32(0.0), np.float32(1.0), np.float32(0.0), np.float32(0.0), np.float32(1.0), np.float32(0.0), np.float32(1.0), np.float32(1.0), np.float32(0.0)]",1.0,99517.0,28
2025-08-14_08-18-36,7825,"[np.float32(0.0), np.float32(1.0), np.float32(0.0), np.float32(1.0), np.float32(1.0), np.float32(1.0), np.float32(1.0), np.float32(0.0), np.float32(0.0), np.float32(0.0), np.float32(0.0), np.float32(1.0), np.float32(1.0), np.float32(1.0), np.float32(0.0), np.float32(0.0)]",0.0,99517.0,18
2025-08-14_08-18-36,7826,"[np.float32(1.0), np.float32(0.0), np.float32(0.0), np.float32(1.0), np.float32(1.0), np.float32(1.0), np.float32(1.0), np.float32(1.0), np.float32(0.0), np.float32(1.0), np.float32(1.0), np.float32(0.0), np.float32(0.0), np.float32(0.0), np.float32(0.0), np.float32(0.0)]",1.0,99518.0,25
2025-08-14_08-18-36,7827,"[np.float32(1.0), np.float32(1.0), np.float32(1.0), np.float32(0.0), np.float32(0.0), np.float32(0.0), np.float32(1.0), np.float32(1.0), np.float32(1.0), np.float32(0.0), np.float32(0.0), np.float32(0.0), np.float32(0.0), np.float32(1.0), np.float32(1.0), np.float32(0.0)]",-3.0,99515.0,31
2025-08-14_08-18-36,7828,"[np.float32(0.0), np.float32(1.0), np.float32(0.0), np.float32(0.0), np.float32(1.0), np.float32(0.0), np.float32(0.0), np.float32(0.0), np.float32(1.0), np.float32(0.0), np.float32(0.0), np.float32(0.0), np.float32(0.0), np.float32(0.0), np.float32(0.0), np.float32(0.0)]",0.0,99515.0,32
2025-08-14_08-18-36,7829,"[np.float32(1.0), np.float32(1.0), np.float32(0.0), np.float32(0.0), np.float32(0.0), np.float32(1.0), np.float32(0.0), np.float32(1.0), np.float32(0.0), np.float32(1.0), np.float32(1.0), np.float32(0.0), np.float32(0.0), np.float32(1.0), np.float32(1.0), np.float32(0.0)]",-1.0,99514.0,34
2025-08-14_08-18-36,7830,"[np.float32(1.0), np.float32(0.0), np.float32(0.0), np.float32(1.0), np.float32(0.0), np.float32(0.0), np.float32(0.0), np.float32(1.0), np.float32(1.0), np.float32(0.0), np.float32(1.0), np.float32(1.0), np.float32(0.0), np.float32(0.0), np.float32(0.0), np.float32(0.0)]",-2.0,99512.0,1
2025-08-14_08-18-36,7831,"[np.float32(1.0), np.float32(1.0), np.float32(1.0), np.float32(1.0), np.float32(0.0), np.float32(1.0), np.float32(1.0), np.float32(1.0), np.float32(1.0), np.float32(0.0), np.float32(0.0), np.float32(0.0), np.float32(1.0), np.float32(1.0), np.float32(0.0), np.float32(1.0)]",-4.0,99508.0,16
2025-08-14_08-18-36,7832,"[np.float32(1.0), np.float32(1.0), np.float32(1.0), np.float32(0.0), np.float32(1.0), np.float32(1.0), np.float32(1.0), np.float32(1.0), np.float32(0.0), np.float32(1.0), np.float32(1.0), np.float32(1.0), np.float32(0.0), np.float32(1.0), np.float32(1.0), np.float32(0.0)]",-2.0,99506.0,1
2025-08-14_08-18-36,7833,"[np.float32(0.0), np.float32(1.0), np.float32(0.0), np.float32(0.0), np.float32(1.0), np.float32(1.0), np.float32(0.0), np.float32(0.0), np.float32(1.0), np.float32(1.0), np.float32(1.0), np.float32(0.0), np.float32(0.0), np.float32(0.0), np.float32(1.0), np.float32(0.0)]",3.0,99509.0,31
2025-08-14_08-18-36,7834,"[np.float32(1.0), np.float32(0.0), np.float32(1.0), np.float32(0.0), np.float32(1.0), np.float32(1.0), np.float32(1.0), np.float32(1.0), np.float32(0.0), np.float32(1.0), np.float32(0.0), np.float32(1.0), np.float32(1.0), np.float32(0.0), np.float32(0.0), np.float32(1.0)]",-1.0,99508.0,30
2025-08-14_08-18-36,7835,"[np.float32(0.0), np.float32(1.0), np.float32(0.0), np.float32(1.0), np.float32(0.0), np.float32(1.0), np.float32(1.0), np.float32(1.0), np.float32(1.0), np.float32(0.0), np.float32(0.0), np.float32(1.0), np.float32(1.0), np.float32(1.0), np.float32(1.0), np.float32(0.0)]",-4.0,99504.0,16
2025-08-14_08-18-36,7836,"[np.float32(1.0), np.float32(0.0), np.float32(0.0), np.float32(1.0), np.float32(1.0), np.float32(0.0), np.float32(0.0), np.float32(1.0), np.float32(0.0), np.float32(1.0), np.float32(0.0), np.float32(0.0), np.float32(0.0), np.float32(0.0), np.float32(0.0), np.float32(1.0)]",-4.0,99500.0,33
2025-08-14_08-18-36,7837,"[np.float32(0.0), np.float32(1.0), np.float32(1.0), np.float32(0.0), np.float32(1.0), np.float32(1.0), np.float32(0.0), np.float32(0.0), np.float32(0.0), np.float32(0.0), np.float32(1.0), np.float32(1.0), np.float32(1.0), np.float32(1.0), np.float32(0.0), np.float32(1.0)]",3.0,99503.0,6
2025-08-14_08-18-36,7838,"[np.float32(0.0), np.float32(1.0), np.float32(1.0), np.float32(0.0), np.float32(0.0), np.float32(1.0), np.float32(0.0), np.float32(0.0), np.float32(1.0), np.float32(0.0), np.float32(0.0), np.float32(0.0), np.float32(1.0), np.float32(0.0), np.float32(1.0), np.float32(0.0)]",1.0,99504.0,10
2025-08-14_08-18-36,7839,"[np.float32(0.0), np.float32(1.0), np.float32(0.0), np.float32(1.0), np.float32(1.0), np.float32(0.0), np.float32(0.0), np.float32(1.0), np.float32(0.0), np.float32(0.0), np.float32(1.0), np.float32(1.0), np.float32(1.0), np.float32(1.0), np.float32(1.0), np.float32(0.0)]",1.0,99505.0,33
2025-08-14_08-18-36,7840,"[np.float32(0.0), np.float32(0.0), np.float32(0.0), np.float32(0.0), np.float32(1.0), np.float32(1.0), np.float32(1.0), np.float32(1.0), np.float32(0.0), np.float32(0.0), np.float32(0.0), np.float32(0.0), np.float32(0.0), np.float32(0.0), np.float32(0.0), np.float32(1.0)]",0.0,99505.0,22
2025-08-14_08-18-36,7841,"[np.float32(0.0), np.float32(0.0), np.float32(1.0), np.float32(1.0), np.float32(1.0), np.float32(0.0), np.float32(1.0), np.float32(0.0), np.float32(0.0), np.float32(1.0), np.float32(0.0), np.float32(0.0), np.float32(0.0), np.float32(1.0), np.float32(0.0), np.float32(0.0)]",-1.0,99504.0,21
2025-08-14_08-18-36,7842,"[np.float32(1.0), np.float32(0.0), np.float32(0.0), np.float32(0.0), np.float32(0.0), np.float32(1.0), np.float32(0.0), np.float32(0.0), np.float32(1.0), np.float32(0.0), np.float32(1.0), np.float32(0.0), np.float32(1.0), np.float32(1.0), np.float32(1.0), np.float32(0.0)]",-2.0,99502.0,16
2025-08-14_08-18-36,7843,"[np.float32(0.0), np.float32(0.0), np.float32(1.0), np.float32(0.0), np.float32(1.0), np.float32(1.0), np.float32(1.0), np.float32(1.0), np.float32(1.0), np.float32(0.0), np.float32(1.0), np.float32(1.0), np.float32(0.0), np.float32(1.0), np.float32(0.0), np.float32(1.0)]",3.0,99505.0,6
2025-08-14_08-18-36,7844,"[np.float32(1.0), np.float32(0.0), np.float32(1.0), np.float32(0.0), np.float32(0.0), np.float32(1.0), np.float32(1.0), np.float32(1.0), np.float32(1.0), np.float32(1.0), np.float32(1.0), np.float32(0.0), np.float32(1.0), np.float32(1.0), np.float32(1.0), np.float32(0.0)]",4.0,99509.0,32
2025-08-14_08-18-36,7845,"[np.float32(0.0), np.float32(0.0), np.float32(0.0), np.float32(0.0), np.float32(1.0), np.float32(1.0), np.float32(0.0), np.float32(1.0), np.float32(1.0), np.float32(1.0), np.float32(1.0), np.float32(1.0), np.float32(1.0), np.float32(1.0), np.float32(1.0), np.float32(0.0)]",1.0,99510.0,15
2025-08-14_08-18-36,7846,"[np.float32(1.0), np.float32(1.0), np.float32(1.0), np.float32(0.0), np.float32(1.0), np.float32(0.0), np.float32(0.0), np.float32(1.0), np.float32(1.0), np.float32(0.0), np.float32(0.0), np.float32(1.0), np.float32(0.0), np.float32(0.0), np.float32(1.0), np.float32(1.0)]",1.0,99511.0,20
2025-08-14_08-18-36,7847,"[np.float32(1.0), np.float32(1.0), np.float32(0.0), np.float32(0.0), np.float32(0.0), np.float32(1.0), np.float32(0.0), np.float32(1.0), np.float32(0.0), np.float32(1.0), np.float32(0.0), np.float32(0.0), np.float32(0.0), np.float32(1.0), np.float32(0.0), np.float32(1.0)]",-3.0,99508.0,33
2025-08-14_08-18-36,7848,"[np.float32(1.0), np.float32(0.0), np.float32(0.0), np.float32(0.0), np.float32(1.0), np.float32(1.0), np.float32(1.0), np.float32(1.0), np.float32(1.0), np.float32(1.0), np.float32(0.0), np.float32(0.0), np.float32(0.0), np.float32(1.0), np.float32(0.0), np.float32(0.0)]",2.0,99510.0,1
2025-08-14_08-18-36,7849,"[np.float32(1.0), np.float32(1.0), np.float32(1.0), np.float32(1.0), np.float32(1.0), np.float32(1.0), np.float32(1.0), np.float32(1.0), np.float32(1.0), np.float32(1.0), np.float32(1.0), np.float32(0.0), np.float32(1.0), np.float32(0.0), np.float32(0.0), np.float32(1.0)]",-4.0,99506.0,3
2025-08-14_08-18-36,7850,"[np.float32(0.0), np.float32(0.0), np.float32(0.0), np.float32(0.0), np.float32(0.0), np.float32(1.0), np.float32(0.0), np.float32(0.0), np.float32(0.0), np.float32(1.0), np.float32(1.0), np.float32(1.0), np.float32(1.0), np.float32(0.0), np.float32(0.0), np.float32(1.0)]",0.0,99506.0,1
2025-08-14_08-18-36,7851,"[np.float32(0.0), np.float32(0.0), np.float32(0.0), np.float32(1.0), np.float32(1.0), np.float32(1.0), np.float32(1.0), np.float32(1.0), np.float32(1.0), np.float32(0.0), np.float32(1.0), np.float32(1.0), np.float32(1.0), np.float32(1.0), np.float32(1.0), np.float32(0.0)]",-4.0,99502.0,1
2025-08-14_08-18-36,7852,"[np.float32(0.0), np.float32(1.0), np.float32(1.0), np.float32(1.0), np.float32(1.0), np.float32(0.0), np.float32(0.0), np.float32(1.0), np.float32(1.0), np.float32(0.0), np.float32(0.0), np.float32(0.0), np.float32(1.0), np.float32(0.0), np.float32(1.0), np.float32(1.0)]",-2.0,99500.0,9
2025-08-14_08-18-36,7853,"[np.float32(1.0), np.float32(0.0), np.float32(0.0), np.float32(1.0), np.float32(0.0), np.float32(1.0), np.float32(1.0), np.float32(0.0), np.float32(1.0), np.float32(1.0), np.float32(0.0), np.float32(1.0), np.float32(1.0), np.float32(0.0), np.float32(0.0), np.float32(1.0)]",4.0,99504.0,9
2025-08-14_08-18-36,7854,"[np.float32(0.0), np.float32(1.0), np.float32(0.0), np.float32(0.0), np.float32(0.0), np.float32(0.0), np.float32(1.0), np.float32(1.0), np.float32(0.0), np.float32(1.0), np.float32(0.0), np.float32(0.0), np.float32(1.0), np.float32(1.0), np.float32(1.0), np.float32(0.0)]",-4.0,99500.0,34
2025-08-14_08-18-36,7855,"[np.float32(1.0), np.float32(0.0), np.float32(0.0), np.float32(1.0), np.float32(1.0), np.float32(1.0), np.float32(1.0), np.float32(1.0), np.float32(1.0), np.float32(1.0), np.float32(0.0), np.float32(0.0), np.float32(1.0), np.float32(0.0), np.float32(1.0), np.float32(0.0)]",2.0,99502.0,27
2025-08-14_08-18-36,7856,"[np.float32(1.0), np.float32(1.0), np.float32(1.0), np.float32(0.0), np.float32(1.0), np.float32(1.0), np.float32(0.0), np.float32(1.0), np.float32(1.0), np.float32(0.0), np.float32(1.0), np.float32(0.0), np.float32(1.0), np.float32(1.0), np.float32(1.0), np.float32(0.0)]",-1.0,99501.0,11
2025-08-14_08-18-36,7857,"[np.float32(0.0), np.float32(0.0), np.float32(1.0), np.float32(0.0), np.float32(0.0), np.float32(1.0), np.float32(1.0), np.float32(1.0), np.float32(0.0), np.float32(0.0), np.float32(1.0), np.float32(0.0), np.float32(1.0), np.float32(1.0), np.float32(0.0), np.float32(1.0)]",0.0,99501.0,29
2025-08-14_08-18-36,7858,"[np.float32(0.0), np.float32(1.0), np.float32(0.0), np.float32(0.0), np.float32(0.0), np.float32(0.0), np.float32(1.0), np.float32(0.0), np.float32(0.0), np.float32(1.0), np.float32(0.0), np.float32(0.0), np.float32(0.0), np.float32(1.0), np.float32(1.0), np.float32(0.0)]",-2.0,99499.0,34
2025-08-14_08-18-36,7859,"[np.float32(0.0), np.float32(0.0), np.float32(1.0), np.float32(0.0), np.float32(1.0), np.float32(0.0), np.float32(1.0), np.float32(1.0), np.float32(0.0), np.float32(1.0), np.float32(0.0), np.float32(0.0), np.float32(1.0), np.float32(0.0), np.float32(1.0), np.float32(0.0)]",0.0,99499.0,6
2025-08-14_08-18-36,7860,"[np.float32(1.0), np.float32(1.0), np.float32(0.0), np.float32(0.0), np.float32(0.0), np.float32(0.0), np.float32(1.0), np.float32(1.0), np.float32(1.0), np.float32(1.0), np.float32(0.0), np.float32(1.0), np.float32(0.0), np.float32(1.0), np.float32(1.0), np.float32(0.0)]",2.0,99501.0,13
2025-08-14_08-18-36,7861,"[np.float32(1.0), np.float32(1.0), np.float32(1.0), np.float32(0.0), np.float32(0.0), np.float32(0.0), np.float32(0.0), np.float32(1.0), np.float32(0.0), np.float32(1.0), np.float32(0.0), np.float32(0.0), np.float32(1.0), np.float32(1.0), np.float32(0.0), np.float32(0.0)]",-5.0,99496.0,9
2025-08-14_08-18-36,7862,"[np.float32(0.0), np.float32(0.0), np.float32(0.0), np.float32(0.0), np.float32(1.0), np.float32(0.0), np.float32(0.0), np.float32(0.0), np.float32(0.0), np.float32(0.0), np.float32(0.0), np.float32(0.0), np.float32(0.0), np.float32(0.0), np.float32(1.0), np.float32(0.0)]",-2.0,99494.0,21
2025-08-14_08-18-36,7863,"[np.float32(1.0), np.float32(1.0), np.float32(0.0), np.float32(0.0), np.float32(0.0), np.float32(0.0), np.float32(0.0), np.float32(1.0), np.float32(0.0), np.float32(0.0), np.float32(0.0), np.float32(0.0), np.float32(0.0), np.float32(0.0), np.float32(0.0), np.float32(0.0)]",2.0,99496.0,19
2025-08-14_08-18-36,7864,"[np.float32(0.0), np.float32(0.0), np.float32(1.0), np.float32(1.0), np.float32(0.0), np.float32(0.0), np.float32(1.0), np.float32(1.0), np.float32(0.0), np.float32(1.0), np.float32(1.0), np.float32(0.0), np.float32(1.0), np.float32(0.0), np.float32(0.0), np.float32(1.0)]",0.0,99496.0,6
2025-08-14_08-18-36,7865,"[np.float32(0.0), np.float32(1.0), np.float32(0.0), np.float32(1.0), np.float32(1.0), np.float32(0.0), np.float32(1.0), np.float32(1.0), np.float32(0.0), np.float32(1.0), np.float32(1.0), np.float32(1.0), np.float32(0.0), np.float32(1.0), np.float32(1.0), np.float32(1.0)]",0.0,99496.0,23
2025-08-14_08-18-36,7866,"[np.float32(0.0), np.float32(0.0), np.float32(0.0), np.float32(0.0), np.float32(0.0), np.float32(0.0), np.float32(1.0), np.float32(1.0), np.float32(1.0), np.float32(0.0), np.float32(0.0), np.float32(0.0), np.float32(0.0), np.float32(0.0), np.float32(1.0), np.float32(1.0)]",1.0,99497.0,9
2025-08-14_08-18-36,7867,"[np.float32(1.0), np.float32(1.0), np.float32(0.0), np.float32(1.0), np.float32(0.0), np.float32(1.0), np.float32(1.0), np.float32(0.0), np.float32(1.0), np.float32(1.0), np.float32(0.0), np.float32(1.0), np.float32(0.0), np.float32(1.0), np.float32(0.0), np.float32(0.0)]",3.0,99500.0,35
2025-08-14_08-18-36,7868,"[np.float32(0.0), np.float32(1.0), np.float32(1.0), np.float32(0.0), np.float32(1.0), np.float32(1.0), np.float32(1.0), np.float32(0.0), np.float32(0.0), np.float32(1.0), np.float32(1.0), np.float32(1.0), np.float32(0.0), np.float32(1.0), np.float32(0.0), np.float32(1.0)]",0.0,99500.0,15
2025-08-14_08-18-36,7869,"[np.float32(0.0), np.float32(1.0), np.float32(1.0), np.float32(1.0), np.float32(0.0), np.float32(1.0), np.float32(0.0), np.float32(1.0), np.float32(1.0), np.float32(1.0), np.float32(1.0), np.float32(0.0), np.float32(0.0), np.float32(1.0), np.float32(1.0), np.float32(0.0)]",5.0,99505.0,35
2025-08-14_08-18-36,7870,"[np.float32(0.0), np.float32(0.0), np.float32(1.0), np.float32(0.0), np.float32(1.0), np.float32(0.0), np.float32(1.0), np.float32(1.0), np.float32(0.0), np.float32(1.0), np.float32(1.0), np.float32(1.0), np.float32(1.0), np.float32(1.0), np.float32(0.0), np.float32(0.0)]",-1.0,99504.0,24
2025-08-14_08-18-36,7871,"[np.float32(0.0), np.float32(0.0), np.float32(1.0), np.float32(1.0), np.float32(1.0), np.float32(1.0), np.float32(0.0), np.float32(1.0), np.float32(1.0), np.float32(1.0), np.float32(0.0), np.float32(0.0), np.float32(1.0), np.float32(0.0), np.float32(1.0), np.float32(0.0)]",1.0,99505.0,24
2025-08-14_08-18-36,7872,"[np.float32(1.0), np.float32(0.0), np.float32(0.0), np.float32(1.0), np.float32(1.0), np.float32(0.0), np.float32(1.0), np.float32(0.0), np.float32(0.0), np.float32(1.0), np.float32(0.0), np.float32(0.0), np.float32(1.0), np.float32(1.0), np.float32(1.0), np.float32(0.0)]",2.0,99507.0,12
2025-08-14_08-18-36,7873,"[np.float32(0.0), np.float32(1.0), np.float32(0.0), np.float32(0.0), np.float32(0.0), np.float32(0.0), np.float32(0.0), np.float32(1.0), np.float32(0.0), np.float32(0.0), np.float32(1.0), np.float32(1.0), np.float32(1.0), np.float32(0.0), np.float32(1.0), np.float32(0.0)]",-1.0,99506.0,10
2025-08-14_08-18-36,7874,"[np.float32(1.0), np.float32(0.0), np.float32(0.0), np.float32(0.0), np.float32(1.0), np.float32(1.0), np.float32(1.0), np.float32(1.0), np.float32(1.0), np.float32(1.0), np.float32(1.0), np.float32(0.0), np.float32(0.0), np.float32(0.0), np.float32(0.0), np.float32(0.0)]",2.0,99508.0,1
2025-08-14_08-18-36,7875,"[np.float32(1.0), np.float32(1.0), np.float32(1.0), np.float32(1.0), np.float32(0.0), np.float32(0.0), np.float32(1.0), np.float32(1.0), np.float32(1.0), np.float32(0.0), np.float32(0.0), np.float32(1.0), np.float32(1.0), np.float32(0.0), np.float32(0.0), np.float32(0.0)]",-2.0,99506.0,5
2025-08-14_08-18-36,7876,"[np.float32(1.0), np.float32(1.0), np.float32(1.0), np.float32(1.0), np.float32(0.0), np.float32(0.0), np.float32(1.0), np.float32(0.0), np.float32(0.0), np.float32(0.0), np.float32(1.0), np.float32(1.0), np.float32(1.0), np.float32(1.0), np.float32(1.0), np.float32(0.0)]",0.0,99506.0,33
2025-08-14_08-18-36,7877,"[np.float32(1.0), np.float32(0.0), np.float32(1.0), np.float32(1.0), np.float32(0.0), np.float32(1.0), np.float32(0.0), np.float32(1.0), np.float32(1.0), np.float32(0.0), np.float32(0.0), np.float32(1.0), np.float32(1.0), np.float32(1.0), np.float32(1.0), np.float32(0.0)]",0.0,99506.0,22
2025-08-14_08-18-36,7878,"[np.float32(0.0), np.float32(0.0), np.float32(0.0), np.float32(1.0), np.float32(1.0), np.float32(1.0), np.float32(0.0), np.float32(1.0), np.float32(1.0), np.float32(1.0), np.float32(1.0), np.float32(0.0), np.float32(1.0), np.float32(0.0), np.float32(1.0), np.float32(0.0)]",-1.0,99505.0,8
2025-08-14_08-18-36,7879,"[np.float32(1.0), np.float32(0.0), np.float32(1.0), np.float32(0.0), np.float32(0.0), np.float32(1.0), np.float32(1.0), np.float32(0.0), np.float32(1.0), np.float32(0.0), np.float32(0.0), np.float32(1.0), np.float32(1.0), np.float32(1.0), np.float32(1.0), np.float32(1.0)]",5.0,99510.0,36
2025-08-14_08-18-36,7880,"[np.float32(0.0), np.float32(0.0), np.float32(1.0), np.float32(1.0), np.float32(0.0), np.float32(1.0), np.float32(1.0), np.float32(1.0), np.float32(1.0), np.float32(0.0), np.float32(1.0), np.float32(1.0), np.float32(0.0), np.float32(1.0), np.float32(0.0), np.float32(0.0)]",-1.0,99509.0,6
2025-08-14_08-18-36,7881,"[np.float32(0.0), np.float32(1.0), np.float32(1.0), np.float32(0.0), np.float32(0.0), np.float32(0.0), np.float32(0.0), np.float32(0.0), np.float32(0.0), np.float32(0.0), np.float32(1.0), np.float32(0.0), np.float32(0.0), np.float32(0.0), np.float32(1.0), np.float32(1.0)]",-5.0,99504.0,3
2025-08-14_08-18-36,7882,"[np.float32(1.0), np.float32(0.0), np.float32(1.0), np.float32(0.0), np.float32(1.0), np.float32(1.0), np.float32(1.0), np.float32(1.0), np.float32(0.0), np.float32(0.0), np.float32(1.0), np.float32(1.0), np.float32(0.0), np.float32(1.0), np.float32(1.0), np.float32(1.0)]",0.0,99504.0,17
2025-08-14_08-18-36,7883,"[np.float32(0.0), np.float32(1.0), np.float32(0.0), np.float32(0.0), np.float32(1.0), np.float32(1.0), np.float32(1.0), np.float32(1.0), np.float32(1.0), np.float32(1.0), np.float32(0.0), np.float32(1.0), np.float32(1.0), np.float32(1.0), np.float32(0.0), np.float32(0.0)]",1.0,99505.0,19
2025-08-14_08-18-36,7884,"[np.float32(0.0), np.float32(1.0), np.float32(1.0), np.float32(0.0), np.float32(0.0), np.float32(0.0), np.float32(1.0), np.float32(1.0), np.float32(1.0), np.float32(0.0), np.float32(0.0), np.float32(0.0), np.float32(0.0), np.float32(1.0), np.float32(1.0), np.float32(1.0)]",0.0,99505.0,33
2025-08-14_08-18-36,7885,"[np.float32(1.0), np.float32(0.0), np.float32(1.0), np.float32(1.0), np.float32(0.0), np.float32(1.0), np.float32(1.0), np.float32(0.0), np.float32(1.0), np.float32(0.0), np.float32(1.0), np.float32(0.0), np.float32(1.0), np.float32(1.0), np.float32(1.0), np.float32(1.0)]",0.0,99505.0,2
2025-08-14_08-18-36,7886,"[np.float32(0.0), np.float32(1.0), np.float32(0.0), np.float32(0.0), np.float32(0.0), np.float32(0.0), np.float32(1.0), np.float32(1.0), np.float32(1.0), np.float32(0.0), np.float32(1.0), np.float32(1.0), np.float32(0.0), np.float32(1.0), np.float32(1.0), np.float32(1.0)]",-3.0,99502.0,25
2025-08-14_08-18-36,7887,"[np.float32(1.0), np.float32(0.0), np.float32(1.0), np.float32(1.0), np.float32(1.0), np.float32(1.0), np.float32(0.0), np.float32(1.0), np.float32(1.0), np.float32(1.0), np.float32(1.0), np.float32(1.0), np.float32(0.0), np.float32(0.0), np.float32(1.0), np.float32(0.0)]",4.0,99506.0,30
2025-08-14_08-18-36,7888,"[np.float32(0.0), np.float32(1.0), np.float32(0.0), np.float32(1.0), np.float32(1.0), np.float32(0.0), np.float32(0.0), np.float32(1.0), np.float32(0.0), np.float32(1.0), np.float32(1.0), np.float32(0.0), np.float32(0.0), np.float32(0.0), np.float32(1.0), np.float32(0.0)]",1.0,99507.0,19
2025-08-14_08-18-36,7889,"[np.float32(0.0), np.float32(1.0), np.float32(0.0), np.float32(1.0), np.float32(0.0), np.float32(1.0), np.float32(1.0), np.float32(0.0), np.float32(0.0), np.float32(0.0), np.float32(0.0), np.float32(0.0), np.float32(1.0), np.float32(0.0), np.float32(1.0), np.float32(0.0)]",-2.0,99505.0,15
2025-08-14_08-18-36,7890,"[np.float32(0.0), np.float32(0.0), np.float32(1.0), np.float32(1.0), np.float32(1.0), np.float32(1.0), np.float32(0.0), np.float32(0.0), np.float32(0.0), np.float32(1.0), np.float32(0.0), np.float32(0.0), np.float32(0.0), np.float32(0.0), np.float32(1.0), np.float32(1.0)]",3.0,99508.0,16
2025-08-14_08-18-36,7891,"[np.float32(0.0), np.float32(0.0), np.float32(0.0), np.float32(1.0), np.float32(1.0), np.float32(0.0), np.float32(0.0), np.float32(1.0), np.float32(1.0), np.float32(1.0), np.float32(0.0), np.float32(1.0), np.float32(0.0), np.float32(1.0), np.float32(1.0), np.float32(0.0)]",-2.0,99506.0,34
2025-08-14_08-18-36,7892,"[np.float32(1.0), np.float32(0.0), np.float32(0.0), np.float32(0.0), np.float32(0.0), np.float32(0.0), np.float32(0.0), np.float32(0.0), np.float32(0.0), np.float32(1.0), np.float32(1.0), np.float32(0.0), np.float32(1.0), np.float32(1.0), np.float32(0.0), np.float32(1.0)]",-1.0,99505.0,18
2025-08-14_08-18-36,7893,"[np.float32(1.0), np.float32(0.0), np.float32(1.0), np.float32(0.0), np.float32(1.0), np.float32(1.0), np.float32(0.0), np.float32(0.0), np.float32(0.0), np.float32(1.0), np.float32(1.0), np.float32(1.0), np.float32(1.0), np.float32(0.0), np.float32(1.0), np.float32(0.0)]",1.0,99506.0,27
2025-08-14_08-18-36,7894,"[np.float32(1.0), np.float32(0.0), np.float32(1.0), np.float32(1.0), np.float32(1.0), np.float32(0.0), np.float32(0.0), np.float32(1.0), np.float32(1.0), np.float32(0.0), np.float32(1.0), np.float32(0.0), np.float32(0.0), np.float32(1.0), np.float32(0.0), np.float32(0.0)]",2.0,99508.0,2
2025-08-14_08-18-36,7895,"[np.float32(1.0), np.float32(1.0), np.float32(0.0), np.float32(0.0), np.float32(1.0), np.float32(1.0), np.float32(0.0), np.float32(0.0), np.float32(1.0), np.float32(1.0), np.float32(0.0), np.float32(0.0), np.float32(0.0), np.float32(1.0), np.float32(0.0), np.float32(1.0)]",-1.0,99507.0,14
2025-08-14_08-18-36,7896,"[np.float32(1.0), np.float32(0.0), np.float32(0.0), np.float32(0.0), np.float32(0.0), np.float32(1.0), np.float32(1.0), np.float32(0.0), np.float32(0.0), np.float32(1.0), np.float32(1.0), np.float32(0.0), np.float32(0.0), np.float32(1.0), np.float32(1.0), np.float32(0.0)]",-4.0,99503.0,17
2025-08-14_08-18-36,7897,"[np.float32(0.0), np.float32(0.0), np.float32(1.0), np.float32(0.0), np.float32(1.0), np.float32(1.0), np.float32(1.0), np.float32(0.0), np.float32(0.0), np.float32(0.0), np.float32(0.0), np.float32(1.0), np.float32(0.0), np.float32(1.0), np.float32(0.0), np.float32(1.0)]",0.0,99503.0,28
2025-08-14_08-18-36,7898,"[np.float32(0.0), np.float32(1.0), np.float32(1.0), np.float32(1.0), np.float32(0.0), np.float32(1.0), np.float32(0.0), np.float32(1.0), np.float32(0.0), np.float32(0.0), np.float32(1.0), np.float32(0.0), np.float32(1.0), np.float32(1.0), np.float32(1.0), np.float32(0.0)]",1.0,99504.0,21
2025-08-14_08-18-36,7899,"[np.float32(0.0), np.float32(1.0), np.float32(1.0), np.float32(1.0), np.float32(0.0), np.float32(0.0), np.float32(1.0), np.float32(0.0), np.float32(1.0), np.float32(0.0), np.float32(0.0), np.float32(0.0), np.float32(0.0), np.float32(0.0), np.float32(1.0), np.float32(0.0)]",1.0,99505.0,6
2025-08-14_08-18-36,7900,"[np.float32(0.0), np.float32(0.0), np.float32(0.0), np.float32(1.0), np.float32(1.0), np.float32(1.0), np.float32(1.0), np.float32(1.0), np.float32(0.0), np.float32(1.0), np.float32(1.0), np.float32(0.0), np.float32(1.0), np.float32(1.0), np.float32(1.0), np.float32(1.0)]",-3.0,99502.0,6
2025-08-14_08-18-36,7901,"[np.float32(0.0), np.float32(0.0), np.float32(1.0), np.float32(0.0), np.float32(0.0), np.float32(1.0), np.float32(1.0), np.float32(0.0), np.float32(1.0), np.float32(1.0), np.float32(1.0), np.float32(1.0), np.float32(0.0), np.float32(0.0), np.float32(1.0), np.float32(0.0)]",0.0,99502.0,2
2025-08-14_08-18-36,7902,"[np.float32(1.0), np.float32(0.0), np.float32(1.0), np.float32(1.0), np.float32(0.0), np.float32(1.0), np.float32(1.0), np.float32(0.0), np.float32(1.0), np.float32(1.0), np.float32(1.0), np.float32(1.0), np.float32(0.0), np.float32(0.0), np.float32(1.0), np.float32(1.0)]",-1.0,99501.0,16
2025-08-14_08-18-36,7903,"[np.float32(1.0), np.float32(0.0), np.float32(0.0), np.float32(1.0), np.float32(0.0), np.float32(0.0), np.float32(0.0), np.float32(1.0), np.float32(1.0), np.float32(0.0), np.float32(1.0), np.float32(1.0), np.float32(1.0), np.float32(0.0), np.float32(1.0), np.float32(1.0)]",-1.0,99500.0,31
2025-08-14_08-18-36,7904,"[np.float32(0.0), np.float32(1.0), np.float32(0.0), np.float32(1.0), np.float32(1.0), np.float32(1.0), np.float32(1.0), np.float32(1.0), np.float32(1.0), np.float32(0.0), np.float32(0.0), np.float32(0.0), np.float32(0.0), np.float32(1.0), np.float32(1.0), np.float32(1.0)]",0.0,99500.0,5
2025-08-14_08-18-36,7905,"[np.float32(0.0), np.float32(0.0), np.float32(0.0), np.float32(1.0), np.float32(1.0), np.float32(1.0), np.float32(1.0), np.float32(0.0), np.float32(1.0), np.float32(1.0), np.float32(1.0), np.float32(0.0), np.float32(0.0), np.float32(0.0), np.float32(0.0), np.float32(0.0)]",1.0,99501.0,2
2025-08-14_08-18-36,7906,"[np.float32(0.0), np.float32(0.0), np.float32(0.0), np.float32(1.0), np.float32(1.0), np.float32(0.0), np.float32(1.0), np.float32(1.0), np.float32(0.0), np.float32(0.0), np.float32(1.0), np.float32(1.0), np.float32(1.0), np.float32(0.0), np.float32(1.0), np.float32(1.0)]",-1.0,99500.0,21
2025-08-14_08-18-36,7907,"[np.float32(0.0), np.float32(0.0), np.float32(0.0), np.float32(1.0), np.float32(0.0), np.float32(1.0), np.float32(0.0), np.float32(1.0), np.float32(0.0), np.float32(1.0), np.float32(1.0), np.float32(1.0), np.float32(1.0), np.float32(1.0), np.float32(0.0), np.float32(0.0)]",-3.0,99497.0,30
2025-08-14_08-18-36,7908,"[np.float32(0.0), np.float32(1.0), np.float32(0.0), np.float32(1.0), np.float32(1.0), np.float32(1.0), np.float32(0.0), np.float32(1.0), np.float32(1.0), np.float32(1.0), np.float32(1.0), np.float32(0.0), np.float32(0.0), np.float32(1.0), np.float32(0.0), np.float32(0.0)]",-2.0,99495.0,3
2025-08-14_08-18-36,7909,"[np.float32(1.0), np.float32(1.0), np.float32(1.0), np.float32(0.0), np.float32(1.0), np.float32(1.0), np.float32(0.0), np.float32(1.0), np.float32(0.0), np.float32(1.0), np.float32(1.0), np.float32(1.0), np.float32(0.0), np.float32(0.0), np.float32(0.0), np.float32(1.0)]",-1.0,99494.0,8
2025-08-14_08-18-36,7910,"[np.float32(0.0), np.float32(1.0), np.float32(0.0), np.float32(1.0), np.float32(1.0), np.float32(1.0), np.float32(0.0), np.float32(0.0), np.float32(1.0), np.float32(0.0), np.float32(0.0), np.float32(1.0), np.float32(1.0), np.float32(0.0), np.float32(0.0), np.float32(1.0)]",0.0,99494.0,30
2025-08-14_08-18-36,7911,"[np.float32(0.0), np.float32(1.0), np.float32(1.0), np.float32(1.0), np.float32(0.0), np.float32(1.0), np.float32(1.0), np.float32(1.0), np.float32(1.0), np.float32(0.0), np.float32(0.0), np.float32(1.0), np.float32(1.0), np.float32(1.0), np.float32(1.0), np.float32(1.0)]",-4.0,99490.0,5
2025-08-14_08-18-36,7912,"[np.float32(1.0), np.float32(1.0), np.float32(0.0), np.float32(1.0), np.float32(0.0), np.float32(1.0), np.float32(0.0), np.float32(1.0), np.float32(0.0), np.float32(0.0), np.float32(1.0), np.float32(1.0), np.float32(0.0), np.float32(1.0), np.float32(1.0), np.float32(0.0)]",-1.0,99489.0,16
2025-08-14_08-18-36,7913,"[np.float32(0.0), np.float32(1.0), np.float32(1.0), np.float32(1.0), np.float32(1.0), np.float32(0.0), np.float32(1.0), np.float32(1.0), np.float32(1.0), np.float32(1.0), np.float32(1.0), np.float32(1.0), np.float32(0.0), np.float32(1.0), np.float32(0.0), np.float32(0.0)]",-3.0,99486.0,36
2025-08-14_08-18-36,7914,"[np.float32(0.0), np.float32(0.0), np.float32(1.0), np.float32(1.0), np.float32(0.0), np.float32(0.0), np.float32(1.0), np.float32(0.0), np.float32(0.0), np.float32(0.0), np.float32(0.0), np.float32(0.0), np.float32(0.0), np.float32(1.0), np.float32(1.0), np.float32(0.0)]",0.0,99486.0,16
2025-08-14_08-18-36,7915,"[np.float32(1.0), np.float32(1.0), np.float32(0.0), np.float32(0.0), np.float32(1.0), np.float32(1.0), np.float32(1.0), np.float32(0.0), np.float32(0.0), np.float32(0.0), np.float32(0.0), np.float32(0.0), np.float32(1.0), np.float32(0.0), np.float32(1.0), np.float32(0.0)]",3.0,99489.0,8
2025-08-14_08-18-36,7916,"[np.float32(1.0), np.float32(1.0), np.float32(1.0), np.float32(1.0), np.float32(0.0), np.float32(0.0), np.float32(1.0), np.float32(1.0), np.float32(0.0), np.float32(1.0), np.float32(0.0), np.float32(1.0), np.float32(1.0), np.float32(1.0), np.float32(1.0), np.float32(0.0)]",2.0,99491.0,3
2025-08-14_08-18-36,7917,"[np.float32(1.0), np.float32(0.0), np.float32(0.0), np.float32(1.0), np.float32(1.0), np.float32(0.0), np.float32(0.0), np.float32(0.0), np.float32(1.0), np.float32(0.0), np.float32(0.0), np.float32(0.0), np.float32(0.0), np.float32(0.0), np.float32(0.0), np.float32(0.0)]",-4.0,99487.0,24
2025-08-14_08-18-36,7918,"[np.float32(1.0), np.float32(0.0), np.float32(0.0), np.float32(1.0), np.float32(1.0), np.float32(0.0), np.float32(0.0), np.float32(1.0), np.float32(1.0), np.float32(0.0), np.float32(0.0), np.float32(0.0), np.float32(0.0), np.float32(1.0), np.float32(0.0), np.float32(1.0)]",-2.0,99485.0,4
2025-08-14_08-18-36,7919,"[np.float32(0.0), np.float32(1.0), np.float32(0.0), np.float32(0.0), np.float32(1.0), np.float32(1.0), np.float32(1.0), np.float32(1.0), np.float32(0.0), np.float32(0.0), np.float32(0.0), np.float32(0.0), np.float32(0.0), np.float32(0.0), np.float32(0.0), np.float32(0.0)]",-1.0,99484.0,0
2025-08-14_08-18-36,7920,"[np.float32(0.0), np.float32(0.0), np.float32(0.0), np.float32(1.0), np.float32(0.0), np.float32(1.0), np.float32(1.0), np.float32(1.0), np.float32(0.0), np.float32(1.0), np.float32(0.0), np.float32(0.0), np.float32(0.0), np.float32(1.0), np.float32(0.0), np.float32(0.0)]",2.0,99486.0,3
2025-08-14_08-18-36,7921,"[np.float32(1.0), np.float32(0.0), np.float32(0.0), np.float32(1.0), np.float32(1.0), np.float32(1.0), np.float32(0.0), np.float32(0.0), np.float32(0.0), np.float32(1.0), np.float32(0.0), np.float32(0.0), np.float32(1.0), np.float32(0.0), np.float32(0.0), np.float32(0.0)]",1.0,99487.0,13
2025-08-14_08-18-36,7922,"[np.float32(1.0), np.float32(1.0), np.float32(0.0), np.float32(1.0), np.float32(1.0), np.float32(0.0), np.float32(1.0), np.float32(1.0), np.float32(0.0), np.float32(1.0), np.float32(0.0), np.float32(0.0), np.float32(1.0), np.float32(0.0), np.float32(0.0), np.float32(0.0)]",1.0,99488.0,17
2025-08-14_08-18-36,7923,"[np.float32(1.0), np.float32(1.0), np.float32(0.0), np.float32(1.0), np.float32(0.0), np.float32(0.0), np.float32(1.0), np.float32(1.0), np.float32(1.0), np.float32(1.0), np.float32(1.0), np.float32(1.0), np.float32(1.0), np.float32(1.0), np.float32(0.0), np.float32(1.0)]",1.0,99489.0,3
2025-08-14_08-18-36,7924,"[np.float32(0.0), np.float32(0.0), np.float32(0.0), np.float32(0.0), np.float32(1.0), np.float32(1.0), np.float32(0.0), np.float32(1.0), np.float32(0.0), np.float32(1.0), np.float32(1.0), np.float32(0.0), np.float32(0.0), np.float32(0.0), np.float32(1.0), np.float32(0.0)]",-1.0,99488.0,15
2025-08-14_08-18-36,7925,"[np.float32(1.0), np.float32(1.0), np.float32(1.0), np.float32(0.0), np.float32(0.0), np.float32(1.0), np.float32(0.0), np.float32(1.0), np.float32(1.0), np.float32(0.0), np.float32(1.0), np.float32(0.0), np.float32(0.0), np.float32(0.0), np.float32(0.0), np.float32(0.0)]",-3.0,99485.0,10
2025-08-14_08-18-36,7926,"[np.float32(0.0), np.float32(1.0), np.float32(1.0), np.float32(0.0), np.float32(0.0), np.float32(1.0), np.float32(1.0), np.float32(1.0), np.float32(1.0), np.float32(1.0), np.float32(0.0), np.float32(0.0), np.float32(0.0), np.float32(0.0), np.float32(1.0), np.float32(1.0)]",-1.0,99484.0,11
2025-08-14_08-18-36,7927,"[np.float32(0.0), np.float32(0.0), np.float32(0.0), np.float32(0.0), np.float32(0.0), np.float32(0.0), np.float32(0.0), np.float32(0.0), np.float32(1.0), np.float32(1.0), np.float32(1.0), np.float32(0.0), np.float32(0.0), np.float32(0.0), np.float32(1.0), np.float32(0.0)]",-1.0,99483.0,19
2025-08-14_08-18-36,7928,"[np.float32(1.0), np.float32(0.0), np.float32(0.0), np.float32(1.0), np.float32(1.0), np.float32(1.0), np.float32(1.0), np.float32(0.0), np.float32(0.0), np.float32(1.0), np.float32(0.0), np.float32(1.0), np.float32(1.0), np.float32(1.0), np.float32(0.0), np.float32(1.0)]",0.0,99483.0,34
2025-08-14_08-18-36,7929,"[np.float32(1.0), np.float32(1.0), np.float32(1.0), np.float32(0.0), np.float32(0.0), np.float32(1.0), np.float32(0.0), np.float32(0.0), np.float32(0.0), np.float32(1.0), np.float32(1.0), np.float32(0.0), np.float32(1.0), np.float32(0.0), np.float32(0.0), np.float32(0.0)]",-2.0,99481.0,5
2025-08-14_08-18-36,7930,"[np.float32(0.0), np.float32(1.0), np.float32(0.0), np.float32(1.0), np.float32(0.0), np.float32(0.0), np.float32(1.0), np.float32(0.0), np.float32(1.0), np.float32(1.0), np.float32(0.0), np.float32(0.0), np.float32(1.0), np.float32(1.0), np.float32(0.0), np.float32(1.0)]",-5.0,99476.0,16
2025-08-14_08-18-36,7931,"[np.float32(1.0), np.float32(1.0), np.float32(1.0), np.float32(0.0), np.float32(1.0), np.float32(1.0), np.float32(1.0), np.float32(0.0), np.float32(1.0), np.float32(1.0), np.float32(1.0), np.float32(0.0), np.float32(0.0), np.float32(0.0), np.float32(0.0), np.float32(0.0)]",0.0,99476.0,22
2025-08-14_08-18-36,7932,"[np.float32(1.0), np.float32(0.0), np.float32(0.0), np.float32(1.0), np.float32(0.0), np.float32(1.0), np.float32(0.0), np.float32(1.0), np.float32(0.0), np.float32(0.0), np.float32(1.0), np.float32(0.0), np.float32(0.0), np.float32(0.0), np.float32(0.0), np.float32(0.0)]",-1.0,99475.0,3
2025-08-14_08-18-36,7933,"[np.float32(1.0), np.float32(1.0), np.float32(1.0), np.float32(0.0), np.float32(0.0), np.float32(1.0), np.float32(1.0), np.float32(1.0), np.float32(0.0), np.float32(0.0), np.float32(1.0), np.float32(1.0), np.float32(0.0), np.float32(0.0), np.float32(1.0), np.float32(0.0)]",1.0,99476.0,27
2025-08-14_08-18-36,7934,"[np.float32(1.0), np.float32(0.0), np.float32(0.0), np.float32(0.0), np.float32(1.0), np.float32(0.0), np.float32(0.0), np.float32(0.0), np.float32(1.0), np.float32(1.0), np.float32(0.0), np.float32(0.0), np.float32(1.0), np.float32(0.0), np.float32(1.0), np.float32(0.0)]",-4.0,99472.0,2
2025-08-14_08-18-36,7935,"[np.float32(1.0), np.float32(1.0), np.float32(0.0), np.float32(0.0), np.float32(1.0), np.float32(1.0), np.float32(1.0), np.float32(1.0), np.float32(1.0), np.float32(0.0), np.float32(1.0), np.float32(1.0), np.float32(1.0), np.float32(0.0), np.float32(0.0), np.float32(0.0)]",-3.0,99469.0,4
2025-08-14_08-18-36,7936,"[np.float32(0.0), np.float32(0.0), np.float32(0.0), np.float32(1.0), np.float32(0.0), np.float32(1.0), np.float32(0.0), np.float32(0.0), np.float32(0.0), np.float32(0.0), np.float32(0.0), np.float32(0.0), np.float32(1.0), np.float32(0.0), np.float32(1.0), np.float32(0.0)]",3.0,99472.0,27
2025-08-14_08-18-36,7937,"[np.float32(1.0), np.float32(1.0), np.float32(1.0), np.float32(1.0), np.float32(0.0), np.float32(1.0), np.float32(1.0), np.float32(1.0), np.float32(1.0), np.float32(1.0), np.float32(1.0), np.float32(0.0), np.float32(0.0), np.float32(1.0), np.float32(1.0), np.float32(0.0)]",0.0,99472.0,36
2025-08-14_08-18-36,7938,"[np.float32(0.0), np.float32(0.0), np.float32(1.0), np.float32(0.0), np.float32(0.0), np.float32(1.0), np.float32(1.0), np.float32(1.0), np.float32(1.0), np.float32(0.0), np.float32(1.0), np.float32(1.0), np.float32(0.0), np.float32(1.0), np.float32(1.0), np.float32(0.0)]",-2.0,99470.0,34
2025-08-14_08-18-36,7939,"[np.float32(0.0), np.float32(0.0), np.float32(1.0), np.float32(0.0), np.float32(1.0), np.float32(0.0), np.float32(1.0), np.float32(0.0), np.float32(1.0), np.float32(1.0), np.float32(0.0), np.float32(1.0), np.float32(1.0), np.float32(1.0), np.float32(1.0), np.float32(1.0)]",-4.0,99466.0,29
2025-08-14_08-18-36,7940,"[np.float32(1.0), np.float32(0.0), np.float32(0.0), np.float32(0.0), np.float32(1.0), np.float32(1.0), np.float32(1.0), np.float32(1.0), np.float32(1.0), np.float32(0.0), np.float32(0.0), np.float32(1.0), np.float32(1.0), np.float32(1.0), np.float32(1.0), np.float32(0.0)]",0.0,99466.0,9
2025-08-14_08-18-36,7941,"[np.float32(0.0), np.float32(0.0), np.float32(0.0), np.float32(0.0), np.float32(0.0), np.float32(0.0), np.float32(1.0), np.float32(1.0), np.float32(1.0), np.float32(1.0), np.float32(1.0), np.float32(0.0), np.float32(1.0), np.float32(0.0), np.float32(1.0), np.float32(0.0)]",2.0,99468.0,11
2025-08-14_08-18-36,7942,"[np.float32(0.0), np.float32(0.0), np.float32(1.0), np.float32(0.0), np.float32(0.0), np.float32(1.0), np.float32(0.0), np.float32(1.0), np.float32(0.0), np.float32(0.0), np.float32(1.0), np.float32(1.0), np.float32(0.0), np.float32(1.0), np.float32(0.0), np.float32(0.0)]",3.0,99471.0,15
2025-08-14_08-18-36,7943,"[np.float32(1.0), np.float32(0.0), np.float32(1.0), np.float32(0.0), np.float32(0.0), np.float32(0.0), np.float32(0.0), np.float32(0.0), np.float32(0.0), np.float32(1.0), np.float32(0.0), np.float32(0.0), np.float32(1.0), np.float32(0.0), np.float32(0.0), np.float32(0.0)]",-2.0,99469.0,21
2025-08-14_08-18-36,7944,"[np.float32(1.0), np.float32(0.0), np.float32(0.0), np.float32(1.0), np.float32(1.0), np.float32(1.0), np.float32(1.0), np.float32(0.0), np.float32(0.0), np.float32(0.0), np.float32(1.0), np.float32(0.0), np.float32(1.0), np.float32(1.0), np.float32(0.0), np.float32(0.0)]",-1.0,99468.0,18
2025-08-14_08-18-36,7945,"[np.float32(0.0), np.float32(1.0), np.float32(0.0), np.float32(0.0), np.float32(1.0), np.float32(0.0), np.float32(1.0), np.float32(0.0), np.float32(0.0), np.float32(1.0), np.float32(0.0), np.float32(1.0), np.float32(1.0), np.float32(1.0), np.float32(0.0), np.float32(1.0)]",-3.0,99465.0,35
2025-08-14_08-18-36,7946,"[np.float32(1.0), np.float32(1.0), np.float32(0.0), np.float32(0.0), np.float32(0.0), np.float32(1.0), np.float32(1.0), np.float32(0.0), np.float32(0.0), np.float32(0.0), np.float32(1.0), np.float32(0.0), np.float32(1.0), np.float32(0.0), np.float32(1.0), np.float32(1.0)]",-3.0,99462.0,13
2025-08-14_08-18-36,7947,"[np.float32(0.0), np.float32(0.0), np.float32(0.0), np.float32(0.0), np.float32(1.0), np.float32(0.0), np.float32(0.0), np.float32(1.0), np.float32(0.0), np.float32(1.0), np.float32(1.0), np.float32(1.0), np.float32(1.0), np.float32(1.0), np.float32(1.0), np.float32(0.0)]",1.0,99463.0,22
2025-08-14_08-18-36,7948,"[np.float32(0.0), np.float32(0.0), np.float32(1.0), np.float32(1.0), np.float32(1.0), np.float32(0.0), np.float32(1.0), np.float32(0.0), np.float32(1.0), np.float32(0.0), np.float32(1.0), np.float32(0.0), np.float32(1.0), np.float32(0.0), np.float32(0.0), np.float32(0.0)]",-5.0,99458.0,19
2025-08-14_08-18-36,7949,"[np.float32(1.0), np.float32(0.0), np.float32(0.0), np.float32(0.0), np.float32(1.0), np.float32(1.0), np.float32(0.0), np.float32(0.0), np.float32(1.0), np.float32(1.0), np.float32(1.0), np.float32(0.0), np.float32(0.0), np.float32(1.0), np.float32(0.0), np.float32(0.0)]",0.0,99458.0,36
2025-08-14_08-18-36,7950,"[np.float32(0.0), np.float32(0.0), np.float32(1.0), np.float32(1.0), np.float32(0.0), np.float32(0.0), np.float32(1.0), np.float32(1.0), np.float32(1.0), np.float32(0.0), np.float32(0.0), np.float32(0.0), np.float32(0.0), np.float32(0.0), np.float32(0.0), np.float32(0.0)]",0.0,99458.0,15
2025-08-14_08-18-36,7951,"[np.float32(0.0), np.float32(0.0), np.float32(0.0), np.float32(1.0), np.float32(1.0), np.float32(1.0), np.float32(1.0), np.float32(1.0), np.float32(1.0), np.float32(0.0), np.float32(1.0), np.float32(0.0), np.float32(0.0), np.float32(0.0), np.float32(0.0), np.float32(1.0)]",0.0,99458.0,34
2025-08-14_08-18-36,7952,"[np.float32(1.0), np.float32(1.0), np.float32(1.0), np.float32(0.0), np.float32(1.0), np.float32(1.0), np.float32(0.0), np.float32(1.0), np.float32(1.0), np.float32(1.0), np.float32(0.0), np.float32(0.0), np.float32(1.0), np.float32(1.0), np.float32(1.0), np.float32(0.0)]",-1.0,99457.0,15
2025-08-14_08-18-36,7953,"[np.float32(1.0), np.float32(1.0), np.float32(0.0), np.float32(0.0), np.float32(0.0), np.float32(1.0), np.float32(1.0), np.float32(0.0), np.float32(1.0), np.float32(1.0), np.float32(0.0), np.float32(0.0), np.float32(0.0), np.float32(1.0), np.float32(0.0), np.float32(1.0)]",0.0,99457.0,9
2025-08-14_08-18-36,7954,"[np.float32(0.0), np.float32(0.0), np.float32(0.0), np.float32(1.0), np.float32(0.0), np.float32(0.0), np.float32(1.0), np.float32(1.0), np.float32(1.0), np.float32(1.0), np.float32(0.0), np.float32(0.0), np.float32(1.0), np.float32(1.0), np.float32(0.0), np.float32(0.0)]",-4.0,99453.0,0
2025-08-14_08-18-36,7955,"[np.float32(1.0), np.float32(1.0), np.float32(1.0), np.float32(0.0), np.float32(0.0), np.float32(1.0), np.float32(1.0), np.float32(0.0), np.float32(1.0), np.float32(1.0), np.float32(0.0), np.float32(0.0), np.float32(1.0), np.float32(0.0), np.float32(0.0), np.float32(0.0)]",36.0,99489.0,7
2025-08-14_08-18-36,7956,"[np.float32(1.0), np.float32(0.0), np.float32(0.0), np.float32(0.0), np.float32(0.0), np.float32(0.0), np.float32(1.0), np.float32(1.0), np.float32(1.0), np.float32(0.0), np.float32(0.0), np.float32(0.0), np.float32(1.0), np.float32(0.0), np.float32(0.0), np.float32(1.0)]",-1.0,99488.0,3
2025-08-14_08-18-36,7957,"[np.float32(1.0), np.float32(1.0), np.float32(0.0), np.float32(0.0), np.float32(0.0), np.float32(0.0), np.float32(0.0), np.float32(1.0), np.float32(0.0), np.float32(0.0), np.float32(1.0), np.float32(0.0), np.float32(1.0), np.float32(0.0), np.float32(0.0), np.float32(0.0)]",0.0,99488.0,35
2025-08-14_08-18-36,7958,"[np.float32(1.0), np.float32(1.0), np.float32(0.0), np.float32(1.0), np.float32(1.0), np.float32(1.0), np.float32(1.0), np.float32(1.0), np.float32(0.0), np.float32(0.0), np.float32(0.0), np.float32(1.0), np.float32(0.0), np.float32(1.0), np.float32(0.0), np.float32(0.0)]",1.0,99489.0,24
2025-08-14_08-18-36,7959,"[np.float32(0.0), np.float32(1.0), np.float32(1.0), np.float32(0.0), np.float32(0.0), np.float32(1.0), np.float32(0.0), np.float32(0.0), np.float32(1.0), np.float32(1.0), np.float32(0.0), np.float32(0.0), np.float32(0.0), np.float32(0.0), np.float32(0.0), np.float32(0.0)]",4.0,99493.0,26
2025-08-14_08-18-36,7960,"[np.float32(1.0), np.float32(1.0), np.float32(1.0), np.float32(1.0), np.float32(0.0), np.float32(0.0), np.float32(0.0), np.float32(1.0), np.float32(0.0), np.float32(1.0), np.float32(1.0), np.float32(0.0), np.float32(0.0), np.float32(0.0), np.float32(0.0), np.float32(0.0)]",0.0,99493.0,31
2025-08-14_08-18-36,7961,"[np.float32(0.0), np.float32(1.0), np.float32(0.0), np.float32(0.0), np.float32(0.0), np.float32(0.0), np.float32(1.0), np.float32(0.0), np.float32(0.0), np.float32(0.0), np.float32(1.0), np.float32(0.0), np.float32(0.0), np.float32(1.0), np.float32(0.0), np.float32(0.0)]",2.0,99495.0,12
2025-08-14_08-18-36,7962,"[np.float32(1.0), np.float32(0.0), np.float32(0.0), np.float32(0.0), np.float32(1.0), np.float32(1.0), np.float32(1.0), np.float32(1.0), np.float32(1.0), np.float32(1.0), np.float32(0.0), np.float32(0.0), np.float32(1.0), np.float32(1.0), np.float32(0.0), np.float32(0.0)]",-1.0,99494.0,2
2025-08-14_08-18-36,7963,"[np.float32(0.0), np.float32(1.0), np.float32(0.0), np.float32(1.0), np.float32(0.0), np.float32(0.0), np.float32(0.0), np.float32(1.0), np.float32(1.0), np.float32(0.0), np.float32(1.0), np.float32(0.0), np.float32(0.0), np.float32(1.0), np.float32(0.0), np.float32(0.0)]",2.0,99496.0,2
2025-08-14_08-18-36,7964,"[np.float32(1.0), np.float32(0.0), np.float32(1.0), np.float32(0.0), np.float32(1.0), np.float32(1.0), np.float32(0.0), np.float32(1.0), np.float32(0.0), np.float32(1.0), np.float32(1.0), np.float32(1.0), np.float32(1.0), np.float32(0.0), np.float32(1.0), np.float32(1.0)]",-1.0,99495.0,19
2025-08-14_08-18-36,7965,"[np.float32(0.0), np.float32(0.0), np.float32(1.0), np.float32(0.0), np.float32(1.0), np.float32(0.0), np.float32(1.0), np.float32(0.0), np.float32(1.0), np.float32(1.0), np.float32(1.0), np.float32(0.0), np.float32(0.0), np.float32(0.0), np.float32(1.0), np.float32(1.0)]",0.0,99495.0,36
2025-08-14_08-18-36,7966,"[np.float32(1.0), np.float32(1.0), np.float32(0.0), np.float32(1.0), np.float32(1.0), np.float32(1.0), np.float32(1.0), np.float32(1.0), np.float32(1.0), np.float32(1.0), np.float32(1.0), np.float32(1.0), np.float32(1.0), np.float32(1.0), np.float32(1.0), np.float32(0.0)]",-1.0,99494.0,30
2025-08-14_08-18-36,7967,"[np.float32(0.0), np.float32(0.0), np.float32(0.0), np.float32(1.0), np.float32(0.0), np.float32(0.0), np.float32(1.0), np.float32(0.0), np.float32(0.0), np.float32(0.0), np.float32(0.0), np.float32(1.0), np.float32(1.0), np.float32(0.0), np.float32(0.0), np.float32(1.0)]",-2.0,99492.0,2
2025-08-14_08-18-36,7968,"[np.float32(0.0), np.float32(0.0), np.float32(1.0), np.float32(0.0), np.float32(1.0), np.float32(0.0), np.float32(0.0), np.float32(1.0), np.float32(1.0), np.float32(1.0), np.float32(1.0), np.float32(0.0), np.float32(0.0), np.float32(0.0), np.float32(0.0), np.float32(0.0)]",1.0,99493.0,2
2025-08-14_08-18-36,7969,"[np.float32(0.0), np.float32(0.0), np.float32(1.0), np.float32(0.0), np.float32(0.0), np.float32(0.0), np.float32(1.0), np.float32(1.0), np.float32(1.0), np.float32(1.0), np.float32(0.0), np.float32(1.0), np.float32(0.0), np.float32(0.0), np.float32(1.0), np.float32(0.0)]",1.0,99494.0,18
2025-08-14_08-18-36,7970,"[np.float32(1.0), np.float32(1.0), np.float32(1.0), np.float32(0.0), np.float32(0.0), np.float32(0.0), np.float32(0.0), np.float32(1.0), np.float32(0.0), np.float32(1.0), np.float32(1.0), np.float32(0.0), np.float32(1.0), np.float32(1.0), np.float32(0.0), np.float32(1.0)]",-1.0,99493.0,29
2025-08-14_08-18-36,7971,"[np.float32(0.0), np.float32(0.0), np.float32(0.0), np.float32(0.0), np.float32(1.0), np.float32(0.0), np.float32(0.0), np.float32(0.0), np.float32(1.0), np.float32(1.0), np.float32(0.0), np.float32(1.0), np.float32(0.0), np.float32(1.0), np.float32(0.0), np.float32(0.0)]",1.0,99494.0,21
2025-08-14_08-18-36,7972,"[np.float32(0.0), np.float32(0.0), np.float32(1.0), np.float32(0.0), np.float32(0.0), np.float32(0.0), np.float32(0.0), np.float32(1.0), np.float32(0.0), np.float32(1.0), np.float32(0.0), np.float32(1.0), np.float32(1.0), np.float32(1.0), np.float32(1.0), np.float32(1.0)]",-2.0,99492.0,23
2025-08-14_08-18-36,7973,"[np.float32(1.0), np.float32(0.0), np.float32(1.0), np.float32(1.0), np.float32(0.0), np.float32(0.0), np.float32(1.0), np.float32(1.0), np.float32(1.0), np.float32(0.0), np.float32(1.0), np.float32(0.0), np.float32(0.0), np.float32(1.0), np.float32(0.0), np.float32(1.0)]",-2.0,99490.0,16
2025-08-14_08-18-36,7974,"[np.float32(1.0), np.float32(0.0), np.float32(0.0), np.float32(0.0), np.float32(1.0), np.float32(1.0), np.float32(0.0), np.float32(1.0), np.float32(0.0), np.float32(0.0), np.float32(1.0), np.float32(0.0), np.float32(0.0), np.float32(1.0), np.float32(0.0), np.float32(1.0)]",-2.0,99488.0,8
2025-08-14_08-18-36,7975,"[np.float32(0.0), np.float32(1.0), np.float32(1.0), np.float32(0.0), np.float32(0.0), np.float32(0.0), np.float32(0.0), np.float32(1.0), np.float32(0.0), np.float32(0.0), np.float32(0.0), np.float32(1.0), np.float32(1.0), np.float32(1.0), np.float32(1.0), np.float32(1.0)]",-3.0,99485.0,35
2025-08-14_08-18-36,7976,"[np.float32(1.0), np.float32(0.0), np.float32(0.0), np.float32(1.0), np.float32(1.0), np.float32(0.0), np.float32(1.0), np.float32(1.0), np.float32(1.0), np.float32(1.0), np.float32(1.0), np.float32(0.0), np.float32(1.0), np.float32(1.0), np.float32(0.0), np.float32(0.0)]",-2.0,99483.0,10
2025-08-14_08-18-36,7977,"[np.float32(0.0), np.float32(1.0), np.float32(0.0), np.float32(0.0), np.float32(0.0), np.float32(1.0), np.float32(1.0), np.float32(0.0), np.float32(1.0), np.float32(1.0), np.float32(1.0), np.float32(1.0), np.float32(0.0), np.float32(0.0), np.float32(1.0), np.float32(0.0)]",0.0,99483.0,23
2025-08-14_08-18-36,7978,"[np.float32(1.0), np.float32(0.0), np.float32(0.0), np.float32(0.0), np.float32(0.0), np.float32(1.0), np.float32(0.0), np.float32(1.0), np.float32(1.0), np.float32(1.0), np.float32(1.0), np.float32(1.0), np.float32(0.0), np.float32(0.0), np.float32(1.0), np.float32(0.0)]",-5.0,99478.0,6
2025-08-14_08-18-36,7979,"[np.float32(1.0), np.float32(0.0), np.float32(1.0), np.float32(0.0), np.float32(1.0), np.float32(0.0), np.float32(1.0), np.float32(0.0), np.float32(0.0), np.float32(0.0), np.float32(1.0), np.float32(1.0), np.float32(1.0), np.float32(0.0), np.float32(1.0), np.float32(0.0)]",-3.0,99475.0,20
2025-08-14_08-18-36,7980,"[np.float32(0.0), np.float32(0.0), np.float32(0.0), np.float32(1.0), np.float32(0.0), np.float32(1.0), np.float32(0.0), np.float32(0.0), np.float32(1.0), np.float32(0.0), np.float32(1.0), np.float32(0.0), np.float32(0.0), np.float32(1.0), np.float32(0.0), np.float32(0.0)]",0.0,99475.0,30
2025-08-14_08-18-36,7981,"[np.float32(0.0), np.float32(1.0), np.float32(0.0), np.float32(0.0), np.float32(1.0), np.float32(1.0), np.float32(0.0), np.float32(1.0), np.float32(0.0), np.float32(0.0), np.float32(0.0), np.float32(0.0), np.float32(0.0), np.float32(0.0), np.float32(1.0), np.float32(0.0)]",2.0,99477.0,8
2025-08-14_08-18-36,7982,"[np.float32(1.0), np.float32(0.0), np.float32(0.0), np.float32(1.0), np.float32(1.0), np.float32(1.0), np.float32(1.0), np.float32(1.0), np.float32(1.0), np.float32(0.0), np.float32(0.0), np.float32(0.0), np.float32(1.0), np.float32(0.0), np.float32(1.0), np.float32(1.0)]",0.0,99477.0,33
2025-08-14_08-18-36,7983,"[np.float32(0.0), np.float32(0.0), np.float32(0.0), np.float32(1.0), np.float32(0.0), np.float32(1.0), np.float32(1.0), np.float32(1.0), np.float32(0.0), np.float32(1.0), np.float32(1.0), np.float32(0.0), np.float32(1.0), np.float32(1.0), np.float32(1.0), np.float32(1.0)]",0.0,99477.0,31
2025-08-14_08-18-36,7984,"[np.float32(1.0), np.float32(0.0), np.float32(1.0), np.float32(1.0), np.float32(0.0), np.float32(0.0), np.float32(0.0), np.float32(1.0), np.float32(1.0), np.float32(0.0), np.float32(1.0), np.float32(0.0), np.float32(0.0), np.float32(1.0), np.float32(0.0), np.float32(1.0)]",3.0,99480.0,17
2025-08-14_08-18-36,7985,"[np.float32(0.0), np.float32(0.0), np.float32(0.0), np.float32(1.0), np.float32(0.0), np.float32(0.0), np.float32(1.0), np.float32(1.0), np.float32(1.0), np.float32(0.0), np.float32(0.0), np.float32(0.0), np.float32(1.0), np.float32(1.0), np.float32(1.0), np.float32(0.0)]",-1.0,99479.0,32
2025-08-14_08-18-36,7986,"[np.float32(0.0), np.float32(1.0), np.float32(0.0), np.float32(1.0), np.float32(0.0), np.float32(1.0), np.float32(1.0), np.float32(1.0), np.float32(1.0), np.float32(1.0), np.float32(0.0), np.float32(0.0), np.float32(0.0), np.float32(0.0), np.float32(1.0), np.float32(0.0)]",-3.0,99476.0,32
2025-08-14_08-18-36,7987,"[np.float32(1.0), np.float32(1.0), np.float32(1.0), np.float32(1.0), np.float32(1.0), np.float32(0.0), np.float32(1.0), np.float32(0.0), np.float32(0.0), np.float32(1.0), np.float32(0.0), np.float32(1.0), np.float32(0.0), np.float32(1.0), np.float32(1.0), np.float32(1.0)]",4.0,99480.0,12
2025-08-14_08-18-36,7988,"[np.float32(1.0), np.float32(0.0), np.float32(0.0), np.float32(0.0), np.float32(0.0), np.float32(1.0), np.float32(0.0), np.float32(1.0), np.float32(0.0), np.float32(1.0), np.float32(1.0), np.float32(1.0), np.float32(0.0), np.float32(1.0), np.float32(1.0), np.float32(1.0)]",1.0,99481.0,25
2025-08-14_08-18-36,7989,"[np.float32(0.0), np.float32(0.0), np.float32(1.0), np.float32(1.0), np.float32(1.0), np.float32(0.0), np.float32(1.0), np.float32(1.0), np.float32(0.0), np.float32(1.0), np.float32(1.0), np.float32(1.0), np.float32(0.0), np.float32(0.0), np.float32(0.0), np.float32(0.0)]",0.0,99481.0,19
2025-08-14_08-18-36,7990,"[np.float32(1.0), np.float32(1.0), np.float32(0.0), np.float32(0.0), np.float32(0.0), np.float32(1.0), np.float32(1.0), np.float32(1.0), np.float32(1.0), np.float32(0.0), np.float32(1.0), np.float32(1.0), np.float32(1.0), np.float32(0.0), np.float32(0.0), np.float32(0.0)]",1.0,99482.0,29
2025-08-14_08-18-36,7991,"[np.float32(1.0), np.float32(1.0), np.float32(1.0), np.float32(1.0), np.float32(0.0), np.float32(1.0), np.float32(0.0), np.float32(1.0), np.float32(0.0), np.float32(1.0), np.float32(1.0), np.float32(1.0), np.float32(0.0), np.float32(1.0), np.float32(1.0), np.float32(0.0)]",1.0,99483.0,33
2025-08-14_08-18-36,7992,"[np.float32(1.0), np.float32(0.0), np.float32(0.0), np.float32(1.0), np.float32(0.0), np.float32(1.0), np.float32(0.0), np.float32(1.0), np.float32(0.0), np.float32(0.0), np.float32(1.0), np.float32(1.0), np.float32(0.0), np.float32(1.0), np.float32(1.0), np.float32(1.0)]",1.0,99484.0,35
2025-08-14_08-18-36,7993,"[np.float32(0.0), np.float32(1.0), np.float32(0.0), np.float32(0.0), np.float32(0.0), np.float32(1.0), np.float32(1.0), np.float32(0.0), np.float32(0.0), np.float32(1.0), np.float32(1.0), np.float32(0.0), np.float32(0.0), np.float32(1.0), np.float32(0.0), np.float32(1.0)]",-2.0,99482.0,15
2025-08-14_08-18-36,7994,"[np.float32(0.0), np.float32(0.0), np.float32(1.0), np.float32(0.0), np.float32(1.0), np.float32(0.0), np.float32(1.0), np.float32(0.0), np.float32(1.0), np.float32(0.0), np.float32(1.0), np.float32(1.0), np.float32(0.0), np.float32(1.0), np.float32(1.0), np.float32(1.0)]",4.0,99486.0,12
2025-08-14_08-18-36,7995,"[np.float32(1.0), np.float32(1.0), np.float32(0.0), np.float32(0.0), np.float32(1.0), np.float32(1.0), np.float32(1.0), np.float32(1.0), np.float32(0.0), np.float32(1.0), np.float32(0.0), np.float32(0.0), np.float32(1.0), np.float32(1.0), np.float32(1.0), np.float32(1.0)]",-1.0,99485.0,3
2025-08-14_08-18-36,7996,"[np.float32(0.0), np.float32(0.0), np.float32(1.0), np.float32(0.0), np.float32(0.0), np.float32(1.0), np.float32(0.0), np.float32(0.0), np.float32(1.0), np.float32(1.0), np.float32(1.0), np.float32(1.0), np.float32(1.0), np.float32(1.0), np.float32(0.0), np.float32(0.0)]",3.0,99488.0,35
2025-08-14_08-18-36,7997,"[np.float32(1.0), np.float32(1.0), np.float32(0.0), np.float32(1.0), np.float32(1.0), np.float32(0.0), np.float32(0.0), np.float32(1.0), np.float32(1.0), np.float32(1.0), np.float32(1.0), np.float32(0.0), np.float32(0.0), np.float32(1.0), np.float32(0.0), np.float32(0.0)]",-1.0,99487.0,20
2025-08-14_08-18-36,7998,"[np.float32(1.0), np.float32(0.0), np.float32(1.0), np.float32(0.0), np.float32(1.0), np.float32(1.0), np.float32(0.0), np.float32(0.0), np.float32(1.0), np.float32(1.0), np.float32(0.0), np.float32(0.0), np.float32(0.0), np.float32(1.0), np.float32(1.0), np.float32(1.0)]",-2.0,99485.0,21
2025-08-14_08-18-36,7999,"[np.float32(1.0), np.float32(1.0), np.float32(1.0), np.float32(0.0), np.float32(0.0), np.float32(1.0), np.float32(1.0), np.float32(1.0), np.float32(0.0), np.float32(0.0), np.float32(0.0), np.float32(0.0), np.float32(1.0), np.float32(1.0), np.float32(0.0), np.float32(0.0)]",-3.0,99482.0,1
2025-08-14_08-18-36,8000,"[np.float32(1.0), np.float32(1.0), np.float32(0.0), np.float32(1.0), np.float32(0.0), np.float32(1.0), np.float32(1.0), np.float32(1.0), np.float32(1.0), np.float32(0.0), np.float32(0.0), np.float32(1.0), np.float32(0.0), np.float32(1.0), np.float32(1.0), np.float32(0.0)]",2.0,99484.0,35
2025-08-14_08-18-36,8001,"[np.float32(0.0), np.float32(1.0), np.float32(0.0), np.float32(0.0), np.float32(0.0), np.float32(1.0), np.float32(0.0), np.float32(1.0), np.float32(1.0), np.float32(0.0), np.float32(0.0), np.float32(1.0), np.float32(0.0), np.float32(1.0), np.float32(1.0), np.float32(0.0)]",3.0,99290.0,22
2025-08-14_08-18-36,8002,"[np.float32(1.0), np.float32(0.0), np.float32(0.0), np.float32(1.0), np.float32(0.0), np.float32(0.0), np.float32(1.0), np.float32(1.0), np.float32(0.0), np.float32(0.0), np.float32(0.0), np.float32(0.0), np.float32(1.0), np.float32(1.0), np.float32(1.0), np.float32(1.0)]",0.0,99290.0,11
2025-08-14_08-18-36,8003,"[np.float32(0.0), np.float32(0.0), np.float32(0.0), np.float32(0.0), np.float32(1.0), np.float32(1.0), np.float32(0.0), np.float32(0.0), np.float32(1.0), np.float32(0.0), np.float32(1.0), np.float32(1.0), np.float32(1.0), np.float32(0.0), np.float32(0.0), np.float32(1.0)]",-5.0,99285.0,13
2025-08-14_08-18-36,8004,"[np.float32(1.0), np.float32(1.0), np.float32(1.0), np.float32(1.0), np.float32(1.0), np.float32(1.0), np.float32(1.0), np.float32(0.0), np.float32(0.0), np.float32(0.0), np.float32(1.0), np.float32(0.0), np.float32(0.0), np.float32(1.0), np.float32(1.0), np.float32(0.0)]",-1.0,99284.0,18
2025-08-14_08-18-36,8005,"[np.float32(0.0), np.float32(1.0), np.float32(0.0), np.float32(1.0), np.float32(0.0), np.float32(1.0), np.float32(0.0), np.float32(0.0), np.float32(0.0), np.float32(0.0), np.float32(1.0), np.float32(0.0), np.float32(0.0), np.float32(1.0), np.float32(0.0), np.float32(1.0)]",6.0,99290.0,29
2025-08-14_08-18-36,8006,"[np.float32(0.0), np.float32(0.0), np.float32(0.0), np.float32(0.0), np.float32(0.0), np.float32(1.0), np.float32(0.0), np.float32(0.0), np.float32(1.0), np.float32(0.0), np.float32(0.0), np.float32(1.0), np.float32(1.0), np.float32(1.0), np.float32(0.0), np.float32(0.0)]",3.0,99293.0,27
2025-08-14_08-18-36,8007,"[np.float32(0.0), np.float32(1.0), np.float32(0.0), np.float32(0.0), np.float32(0.0), np.float32(0.0), np.float32(0.0), np.float32(0.0), np.float32(0.0), np.float32(1.0), np.float32(0.0), np.float32(1.0), np.float32(0.0), np.float32(1.0), np.float32(0.0), np.float32(1.0)]",-2.0,99291.0,36
2025-08-14_08-18-36,8008,"[np.float32(1.0), np.float32(0.0), np.float32(1.0), np.float32(0.0), np.float32(0.0), np.float32(0.0), np.float32(0.0), np.float32(1.0), np.float32(1.0), np.float32(1.0), np.float32(1.0), np.float32(0.0), np.float32(1.0), np.float32(1.0), np.float32(0.0), np.float32(0.0)]",0.0,99291.0,20
2025-08-14_08-18-36,8009,"[np.float32(0.0), np.float32(0.0), np.float32(0.0), np.float32(1.0), np.float32(0.0), np.float32(1.0), np.float32(0.0), np.float32(0.0), np.float32(0.0), np.float32(0.0), np.float32(0.0), np.float32(1.0), np.float32(0.0), np.float32(0.0), np.float32(0.0), np.float32(0.0)]",-3.0,99288.0,4
2025-08-14_08-18-36,8010,"[np.float32(1.0), np.float32(0.0), np.float32(0.0), np.float32(1.0), np.float32(0.0), np.float32(1.0), np.float32(1.0), np.float32(0.0), np.float32(1.0), np.float32(1.0), np.float32(1.0), np.float32(1.0), np.float32(0.0), np.float32(1.0), np.float32(1.0), np.float32(0.0)]",-2.0,99286.0,24
2025-08-14_08-18-36,8011,"[np.float32(0.0), np.float32(0.0), np.float32(1.0), np.float32(0.0), np.float32(0.0), np.float32(0.0), np.float32(0.0), np.float32(1.0), np.float32(1.0), np.float32(1.0), np.float32(0.0), np.float32(0.0), np.float32(1.0), np.float32(1.0), np.float32(0.0), np.float32(0.0)]",-6.0,99280.0,11
2025-08-14_08-18-36,8012,"[np.float32(0.0), np.float32(1.0), np.float32(0.0), np.float32(0.0), np.float32(1.0), np.float32(1.0), np.float32(0.0), np.float32(0.0), np.float32(0.0), np.float32(0.0), np.float32(0.0), np.float32(1.0), np.float32(1.0), np.float32(0.0), np.float32(0.0), np.float32(0.0)]",2.0,99282.0,6
2025-08-14_08-18-36,8013,"[np.float32(0.0), np.float32(0.0), np.float32(1.0), np.float32(0.0), np.float32(1.0), np.float32(0.0), np.float32(1.0), np.float32(0.0), np.float32(0.0), np.float32(1.0), np.float32(0.0), np.float32(1.0), np.float32(1.0), np.float32(0.0), np.float32(0.0), np.float32(1.0)]",-4.0,99278.0,27
2025-08-14_08-18-36,8014,"[np.float32(0.0), np.float32(1.0), np.float32(0.0), np.float32(1.0), np.float32(0.0), np.float32(0.0), np.float32(1.0), np.float32(0.0), np.float32(0.0), np.float32(0.0), np.float32(0.0), np.float32(0.0), np.float32(1.0), np.float32(0.0), np.float32(0.0), np.float32(0.0)]",1.0,99279.0,9
2025-08-14_08-18-36,8015,"[np.float32(0.0), np.float32(1.0), np.float32(0.0), np.float32(1.0), np.float32(0.0), np.float32(1.0), np.float32(0.0), np.float32(1.0), np.float32(0.0), np.float32(1.0), np.float32(0.0), np.float32(0.0), np.float32(1.0), np.float32(0.0), np.float32(1.0), np.float32(1.0)]",-8.0,99271.0,12
2025-08-14_08-18-36,8016,"[np.float32(0.0), np.float32(1.0), np.float32(0.0), np.float32(0.0), np.float32(0.0), np.float32(0.0), np.float32(0.0), np.float32(1.0), np.float32(0.0), np.float32(0.0), np.float32(0.0), np.float32(1.0), np.float32(0.0), np.float32(0.0), np.float32(0.0), np.float32(0.0)]",2.0,99273.0,20
2025-08-14_08-18-36,8017,"[np.float32(1.0), np.float32(1.0), np.float32(1.0), np.float32(0.0), np.float32(0.0), np.float32(0.0), np.float32(0.0), np.float32(0.0), np.float32(0.0), np.float32(0.0), np.float32(1.0), np.float32(1.0), np.float32(1.0), np.float32(1.0), np.float32(1.0), np.float32(0.0)]",-1.0,99272.0,22
2025-08-14_08-18-36,8018,"[np.float32(0.0), np.float32(0.0), np.float32(0.0), np.float32(1.0), np.float32(1.0), np.float32(0.0), np.float32(1.0), np.float32(1.0), np.float32(1.0), np.float32(0.0), np.float32(0.0), np.float32(0.0), np.float32(1.0), np.float32(1.0), np.float32(0.0), np.float32(0.0)]",39.0,99311.0,7
2025-08-14_08-18-36,8019,"[np.float32(1.0), np.float32(1.0), np.float32(1.0), np.float32(0.0), np.float32(1.0), np.float32(1.0), np.float32(0.0), np.float32(1.0), np.float32(0.0), np.float32(1.0), np.float32(0.0), np.float32(0.0), np.float32(1.0), np.float32(0.0), np.float32(1.0), np.float32(0.0)]",-5.0,99306.0,3
2025-08-14_08-18-36,8020,"[np.float32(1.0), np.float32(1.0), np.float32(1.0), np.float32(1.0), np.float32(1.0), np.float32(1.0), np.float32(0.0), np.float32(1.0), np.float32(1.0), np.float32(0.0), np.float32(0.0), np.float32(1.0), np.float32(1.0), np.float32(0.0), np.float32(1.0), np.float32(0.0)]",1.0,99307.0,21
2025-08-14_08-18-36,8021,"[np.float32(0.0), np.float32(0.0), np.float32(0.0), np.float32(1.0), np.float32(1.0), np.float32(0.0), np.float32(0.0), np.float32(1.0), np.float32(1.0), np.float32(1.0), np.float32(0.0), np.float32(0.0), np.float32(1.0), np.float32(0.0), np.float32(0.0), np.float32(0.0)]",-1.0,99306.0,23
2025-08-14_08-18-36,8022,"[np.float32(0.0), np.float32(1.0), np.float32(0.0), np.float32(1.0), np.float32(1.0), np.float32(0.0), np.float32(1.0), np.float32(0.0), np.float32(0.0), np.float32(0.0), np.float32(1.0), np.float32(0.0), np.float32(1.0), np.float32(1.0), np.float32(0.0), np.float32(0.0)]",-2.0,99304.0,20
2025-08-14_08-18-36,8023,"[np.float32(0.0), np.float32(0.0), np.float32(1.0), np.float32(0.0), np.float32(0.0), np.float32(0.0), np.float32(1.0), np.float32(0.0), np.float32(1.0), np.float32(1.0), np.float32(0.0), np.float32(0.0), np.float32(0.0), np.float32(1.0), np.float32(1.0), np.float32(1.0)]",4.0,99308.0,34
2025-08-14_08-18-36,8024,"[np.float32(0.0), np.float32(1.0), np.float32(1.0), np.float32(1.0), np.float32(0.0), np.float32(1.0), np.float32(1.0), np.float32(1.0), np.float32(1.0), np.float32(0.0), np.float32(0.0), np.float32(1.0), np.float32(1.0), np.float32(0.0), np.float32(0.0), np.float32(1.0)]",-1.0,99307.0,35
2025-08-14_08-18-36,8025,"[np.float32(0.0), np.float32(0.0), np.float32(0.0), np.float32(0.0), np.float32(0.0), np.float32(0.0), np.float32(1.0), np.float32(1.0), np.float32(0.0), np.float32(1.0), np.float32(0.0), np.float32(1.0), np.float32(1.0), np.float32(1.0), np.float32(0.0), np.float32(1.0)]",-4.0,99303.0,5
2025-08-14_08-18-36,8026,"[np.float32(1.0), np.float32(1.0), np.float32(0.0), np.float32(0.0), np.float32(1.0), np.float32(0.0), np.float32(0.0), np.float32(1.0), np.float32(0.0), np.float32(0.0), np.float32(0.0), np.float32(0.0), np.float32(1.0), np.float32(1.0), np.float32(0.0), np.float32(1.0)]",-2.0,99301.0,23
2025-08-14_08-18-36,8027,"[np.float32(0.0), np.float32(1.0), np.float32(1.0), np.float32(0.0), np.float32(0.0), np.float32(0.0), np.float32(1.0), np.float32(1.0), np.float32(1.0), np.float32(1.0), np.float32(1.0), np.float32(0.0), np.float32(1.0), np.float32(1.0), np.float32(0.0), np.float32(0.0)]",-1.0,99300.0,34
2025-08-14_08-18-36,8028,"[np.float32(1.0), np.float32(0.0), np.float32(0.0), np.float32(1.0), np.float32(0.0), np.float32(1.0), np.float32(1.0), np.float32(1.0), np.float32(0.0), np.float32(1.0), np.float32(1.0), np.float32(0.0), np.float32(0.0), np.float32(0.0), np.float32(1.0), np.float32(1.0)]",0.0,99300.0,27
2025-08-14_08-18-36,8029,"[np.float32(0.0), np.float32(0.0), np.float32(0.0), np.float32(1.0), np.float32(0.0), np.float32(0.0), np.float32(1.0), np.float32(0.0), np.float32(1.0), np.float32(0.0), np.float32(1.0), np.float32(1.0), np.float32(0.0), np.float32(1.0), np.float32(1.0), np.float32(0.0)]",4.0,99304.0,27
2025-08-14_08-18-36,8030,"[np.float32(0.0), np.float32(0.0), np.float32(1.0), np.float32(0.0), np.float32(0.0), np.float32(1.0), np.float32(1.0), np.float32(1.0), np.float32(1.0), np.float32(0.0), np.float32(1.0), np.float32(1.0), np.float32(1.0), np.float32(1.0), np.float32(0.0), np.float32(0.0)]",-6.0,99298.0,1
2025-08-14_08-18-36,8031,"[np.float32(0.0), np.float32(0.0), np.float32(1.0), np.float32(0.0), np.float32(0.0), np.float32(1.0), np.float32(1.0), np.float32(1.0), np.float32(1.0), np.float32(0.0), np.float32(0.0), np.float32(1.0), np.float32(0.0), np.float32(1.0), np.float32(1.0), np.float32(1.0)]",-3.0,99295.0,17
2025-08-14_08-18-36,8032,"[np.float32(0.0), np.float32(1.0), np.float32(0.0), np.float32(0.0), np.float32(0.0), np.float32(1.0), np.float32(0.0), np.float32(1.0), np.float32(0.0), np.float32(0.0), np.float32(1.0), np.float32(0.0), np.float32(1.0), np.float32(0.0), np.float32(1.0), np.float32(1.0)]",1.0,99296.0,11
2025-08-14_08-18-36,8033,"[np.float32(0.0), np.float32(1.0), np.float32(0.0), np.float32(0.0), np.float32(0.0), np.float32(0.0), np.float32(0.0), np.float32(1.0), np.float32(1.0), np.float32(1.0), np.float32(1.0), np.float32(1.0), np.float32(1.0), np.float32(1.0), np.float32(0.0), np.float32(0.0)]",1.0,99297.0,18
2025-08-14_08-18-36,8034,"[np.float32(1.0), np.float32(0.0), np.float32(1.0), np.float32(0.0), np.float32(1.0), np.float32(1.0), np.float32(0.0), np.float32(1.0), np.float32(1.0), np.float32(0.0), np.float32(1.0), np.float32(0.0), np.float32(1.0), np.float32(1.0), np.float32(1.0), np.float32(0.0)]",-2.0,99295.0,13
2025-08-14_08-18-36,8035,"[np.float32(1.0), np.float32(1.0), np.float32(0.0), np.float32(1.0), np.float32(0.0), np.float32(1.0), np.float32(0.0), np.float32(0.0), np.float32(0.0), np.float32(1.0), np.float32(0.0), np.float32(0.0), np.float32(0.0), np.float32(1.0), np.float32(0.0), np.float32(0.0)]",-2.0,99293.0,5
2025-08-14_08-18-36,8036,"[np.float32(1.0), np.float32(0.0), np.float32(1.0), np.float32(0.0), np.float32(1.0), np.float32(0.0), np.float32(0.0), np.float32(0.0), np.float32(1.0), np.float32(1.0), np.float32(1.0), np.float32(1.0), np.float32(0.0), np.float32(0.0), np.float32(0.0), np.float32(0.0)]",-2.0,99291.0,17
2025-08-14_08-18-36,8037,"[np.float32(1.0), np.float32(0.0), np.float32(1.0), np.float32(1.0), np.float32(0.0), np.float32(0.0), np.float32(0.0), np.float32(1.0), np.float32(1.0), np.float32(1.0), np.float32(0.0), np.float32(0.0), np.float32(0.0), np.float32(1.0), np.float32(0.0), np.float32(0.0)]",0.0,99291.0,30
2025-08-14_08-18-36,8038,"[np.float32(1.0), np.float32(1.0), np.float32(0.0), np.float32(1.0), np.float32(1.0), np.float32(1.0), np.float32(0.0), np.float32(1.0), np.float32(0.0), np.float32(0.0), np.float32(1.0), np.float32(1.0), np.float32(0.0), np.float32(1.0), np.float32(0.0), np.float32(1.0)]",0.0,99291.0,6
2025-08-14_08-18-36,8039,"[np.float32(1.0), np.float32(1.0), np.float32(0.0), np.float32(1.0), np.float32(1.0), np.float32(1.0), np.float32(1.0), np.float32(0.0), np.float32(0.0), np.float32(0.0), np.float32(1.0), np.float32(1.0), np.float32(1.0), np.float32(0.0), np.float32(1.0), np.float32(1.0)]",4.0,99295.0,9
2025-08-14_08-18-36,8040,"[np.float32(0.0), np.float32(0.0), np.float32(1.0), np.float32(1.0), np.float32(0.0), np.float32(1.0), np.float32(0.0), np.float32(1.0), np.float32(0.0), np.float32(0.0), np.float32(0.0), np.float32(0.0), np.float32(0.0), np.float32(0.0), np.float32(1.0), np.float32(1.0)]",-1.0,99294.0,1
2025-08-14_08-18-36,8041,"[np.float32(1.0), np.float32(1.0), np.float32(0.0), np.float32(1.0), np.float32(1.0), np.float32(0.0), np.float32(1.0), np.float32(1.0), np.float32(1.0), np.float32(0.0), np.float32(1.0), np.float32(1.0), np.float32(0.0), np.float32(0.0), np.float32(0.0), np.float32(1.0)]",-3.0,99291.0,19
2025-08-14_08-18-36,8042,"[np.float32(1.0), np.float32(1.0), np.float32(0.0), np.float32(0.0), np.float32(0.0), np.float32(0.0), np.float32(0.0), np.float32(0.0), np.float32(0.0), np.float32(0.0), np.float32(0.0), np.float32(0.0), np.float32(0.0), np.float32(0.0), np.float32(1.0), np.float32(0.0)]",-1.0,99290.0,17
2025-08-14_08-18-36,8043,"[np.float32(1.0), np.float32(1.0), np.float32(0.0), np.float32(1.0), np.float32(0.0), np.float32(1.0), np.float32(1.0), np.float32(1.0), np.float32(1.0), np.float32(0.0), np.float32(0.0), np.float32(0.0), np.float32(0.0), np.float32(0.0), np.float32(0.0), np.float32(0.0)]",2.0,99292.0,27
2025-08-14_08-18-36,8044,"[np.float32(1.0), np.float32(1.0), np.float32(1.0), np.float32(1.0), np.float32(1.0), np.float32(1.0), np.float32(0.0), np.float32(1.0), np.float32(0.0), np.float32(0.0), np.float32(0.0), np.float32(0.0), np.float32(1.0), np.float32(1.0), np.float32(1.0), np.float32(1.0)]",1.0,99293.0,23
2025-08-14_08-18-36,8045,"[np.float32(1.0), np.float32(1.0), np.float32(1.0), np.float32(0.0), np.float32(1.0), np.float32(0.0), np.float32(1.0), np.float32(1.0), np.float32(1.0), np.float32(1.0), np.float32(0.0), np.float32(0.0), np.float32(0.0), np.float32(0.0), np.float32(1.0), np.float32(1.0)]",3.0,99296.0,1
2025-08-14_08-18-36,8046,"[np.float32(0.0), np.float32(0.0), np.float32(0.0), np.float32(0.0), np.float32(0.0), np.float32(0.0), np.float32(0.0), np.float32(1.0), np.float32(0.0), np.float32(0.0), np.float32(1.0), np.float32(1.0), np.float32(1.0), np.float32(1.0), np.float32(0.0), np.float32(1.0)]",0.0,99296.0,3
2025-08-14_08-18-36,8047,"[np.float32(0.0), np.float32(1.0), np.float32(0.0), np.float32(0.0), np.float32(0.0), np.float32(1.0), np.float32(1.0), np.float32(0.0), np.float32(0.0), np.float32(1.0), np.float32(0.0), np.float32(0.0), np.float32(0.0), np.float32(1.0), np.float32(1.0), np.float32(0.0)]",-1.0,99295.0,27
2025-08-14_08-18-36,8048,"[np.float32(0.0), np.float32(1.0), np.float32(0.0), np.float32(1.0), np.float32(1.0), np.float32(1.0), np.float32(1.0), np.float32(1.0), np.float32(1.0), np.float32(1.0), np.float32(1.0), np.float32(0.0), np.float32(1.0), np.float32(1.0), np.float32(0.0), np.float32(1.0)]",-1.0,99294.0,34
2025-08-14_08-18-36,8049,"[np.float32(0.0), np.float32(1.0), np.float32(1.0), np.float32(0.0), np.float32(0.0), np.float32(0.0), np.float32(1.0), np.float32(1.0), np.float32(0.0), np.float32(0.0), np.float32(1.0), np.float32(0.0), np.float32(1.0), np.float32(0.0), np.float32(0.0), np.float32(1.0)]",-7.0,99287.0,27
2025-08-14_08-18-36,8050,"[np.float32(1.0), np.float32(0.0), np.float32(0.0), np.float32(0.0), np.float32(1.0), np.float32(1.0), np.float32(0.0), np.float32(0.0), np.float32(1.0), np.float32(0.0), np.float32(1.0), np.float32(0.0), np.float32(1.0), np.float32(1.0), np.float32(1.0), np.float32(0.0)]",-4.0,99283.0,9
2025-08-14_08-18-36,8051,"[np.float32(1.0), np.float32(1.0), np.float32(1.0), np.float32(0.0), np.float32(0.0), np.float32(0.0), np.float32(1.0), np.float32(1.0), np.float32(0.0), np.float32(0.0), np.float32(0.0), np.float32(0.0), np.float32(0.0), np.float32(1.0), np.float32(1.0), np.float32(0.0)]",-2.0,99281.0,9
2025-08-14_08-18-36,8052,"[np.float32(0.0), np.float32(1.0), np.float32(1.0), np.float32(1.0), np.float32(0.0), np.float32(1.0), np.float32(1.0), np.float32(1.0), np.float32(0.0), np.float32(0.0), np.float32(0.0), np.float32(0.0), np.float32(1.0), np.float32(0.0), np.float32(0.0), np.float32(0.0)]",-1.0,99280.0,28
2025-08-14_08-18-36,8053,"[np.float32(0.0), np.float32(1.0), np.float32(1.0), np.float32(0.0), np.float32(0.0), np.float32(0.0), np.float32(1.0), np.float32(1.0), np.float32(1.0), np.float32(0.0), np.float32(0.0), np.float32(1.0), np.float32(0.0), np.float32(0.0), np.float32(1.0), np.float32(0.0)]",6.0,99286.0,24
2025-08-14_08-18-36,8054,"[np.float32(0.0), np.float32(1.0), np.float32(0.0), np.float32(1.0), np.float32(1.0), np.float32(1.0), np.float32(1.0), np.float32(0.0), np.float32(1.0), np.float32(0.0), np.float32(0.0), np.float32(0.0), np.float32(0.0), np.float32(1.0), np.float32(0.0), np.float32(0.0)]",5.0,99291.0,29
2025-08-14_08-18-36,8055,"[np.float32(0.0), np.float32(0.0), np.float32(0.0), np.float32(1.0), np.float32(1.0), np.float32(0.0), np.float32(0.0), np.float32(1.0), np.float32(1.0), np.float32(0.0), np.float32(1.0), np.float32(0.0), np.float32(0.0), np.float32(0.0), np.float32(1.0), np.float32(1.0)]",1.0,99292.0,31
2025-08-14_08-18-36,8056,"[np.float32(0.0), np.float32(0.0), np.float32(0.0), np.float32(0.0), np.float32(0.0), np.float32(0.0), np.float32(0.0), np.float32(1.0), np.float32(0.0), np.float32(0.0), np.float32(0.0), np.float32(0.0), np.float32(1.0), np.float32(0.0), np.float32(1.0), np.float32(1.0)]",2.0,99294.0,14
2025-08-14_08-18-36,8057,"[np.float32(0.0), np.float32(0.0), np.float32(0.0), np.float32(1.0), np.float32(0.0), np.float32(0.0), np.float32(0.0), np.float32(1.0), np.float32(1.0), np.float32(0.0), np.float32(1.0), np.float32(0.0), np.float32(0.0), np.float32(0.0), np.float32(0.0), np.float32(0.0)]",-4.0,99290.0,4
2025-08-14_08-18-36,8058,"[np.float32(0.0), np.float32(0.0), np.float32(1.0), np.float32(1.0), np.float32(0.0), np.float32(0.0), np.float32(0.0), np.float32(0.0), np.float32(1.0), np.float32(0.0), np.float32(1.0), np.float32(1.0), np.float32(0.0), np.float32(1.0), np.float32(1.0), np.float32(1.0)]",-3.0,99287.0,22
2025-08-14_08-18-36,8059,"[np.float32(0.0), np.float32(0.0), np.float32(0.0), np.float32(1.0), np.float32(1.0), np.float32(1.0), np.float32(0.0), np.float32(1.0), np.float32(0.0), np.float32(1.0), np.float32(1.0), np.float32(0.0), np.float32(0.0), np.float32(1.0), np.float32(1.0), np.float32(0.0)]",0.0,99287.0,10
2025-08-14_08-18-36,8060,"[np.float32(0.0), np.float32(1.0), np.float32(0.0), np.float32(0.0), np.float32(0.0), np.float32(0.0), np.float32(0.0), np.float32(0.0), np.float32(1.0), np.float32(1.0), np.float32(0.0), np.float32(1.0), np.float32(1.0), np.float32(0.0), np.float32(0.0), np.float32(1.0)]",2.0,99289.0,6
2025-08-14_08-18-36,8061,"[np.float32(0.0), np.float32(0.0), np.float32(0.0), np.float32(0.0), np.float32(1.0), np.float32(1.0), np.float32(0.0), np.float32(1.0), np.float32(0.0), np.float32(1.0), np.float32(0.0), np.float32(1.0), np.float32(0.0), np.float32(0.0), np.float32(0.0), np.float32(1.0)]",2.0,99291.0,18
2025-08-14_08-18-36,8062,"[np.float32(0.0), np.float32(0.0), np.float32(1.0), np.float32(1.0), np.float32(0.0), np.float32(1.0), np.float32(1.0), np.float32(0.0), np.float32(1.0), np.float32(1.0), np.float32(1.0), np.float32(0.0), np.float32(0.0), np.float32(0.0), np.float32(0.0), np.float32(0.0)]",-5.0,99286.0,18
2025-08-14_08-18-36,8063,"[np.float32(0.0), np.float32(0.0), np.float32(1.0), np.float32(1.0), np.float32(1.0), np.float32(0.0), np.float32(0.0), np.float32(1.0), np.float32(1.0), np.float32(1.0), np.float32(1.0), np.float32(0.0), np.float32(1.0), np.float32(1.0), np.float32(1.0), np.float32(1.0)]",0.0,99286.0,26
2025-08-14_08-18-36,8064,"[np.float32(0.0), np.float32(0.0), np.float32(1.0), np.float32(1.0), np.float32(0.0), np.float32(1.0), np.float32(1.0), np.float32(0.0), np.float32(1.0), np.float32(0.0), np.float32(0.0), np.float32(0.0), np.float32(1.0), np.float32(0.0), np.float32(0.0), np.float32(0.0)]",1.0,99287.0,34
2025-08-14_08-18-36,8065,"[np.float32(1.0), np.float32(0.0), np.float32(0.0), np.float32(0.0), np.float32(1.0), np.float32(1.0), np.float32(0.0), np.float32(1.0), np.float32(0.0), np.float32(1.0), np.float32(0.0), np.float32(0.0), np.float32(1.0), np.float32(1.0), np.float32(0.0), np.float32(0.0)]",3.0,99290.0,21
2025-08-14_08-18-36,8066,"[np.float32(1.0), np.float32(1.0), np.float32(0.0), np.float32(0.0), np.float32(0.0), np.float32(0.0), np.float32(1.0), np.float32(1.0), np.float32(0.0), np.float32(0.0), np.float32(0.0), np.float32(1.0), np.float32(0.0), np.float32(1.0), np.float32(1.0), np.float32(0.0)]",1.0,99291.0,10
2025-08-14_08-18-36,8067,"[np.float32(0.0), np.float32(1.0), np.float32(0.0), np.float32(0.0), np.float32(0.0), np.float32(1.0), np.float32(0.0), np.float32(0.0), np.float32(1.0), np.float32(1.0), np.float32(1.0), np.float32(1.0), np.float32(1.0), np.float32(1.0), np.float32(1.0), np.float32(1.0)]",-4.0,99287.0,16
2025-08-14_08-18-36,8068,"[np.float32(1.0), np.float32(0.0), np.float32(0.0), np.float32(1.0), np.float32(0.0), np.float32(0.0), np.float32(1.0), np.float32(1.0), np.float32(0.0), np.float32(0.0), np.float32(0.0), np.float32(1.0), np.float32(1.0), np.float32(1.0), np.float32(0.0), np.float32(0.0)]",-4.0,99283.0,10
2025-08-14_08-18-36,8069,"[np.float32(1.0), np.float32(0.0), np.float32(0.0), np.float32(1.0), np.float32(0.0), np.float32(1.0), np.float32(0.0), np.float32(1.0), np.float32(0.0), np.float32(1.0), np.float32(1.0), np.float32(0.0), np.float32(1.0), np.float32(0.0), np.float32(1.0), np.float32(0.0)]",4.0,99287.0,19
2025-08-14_08-18-36,8070,"[np.float32(1.0), np.float32(0.0), np.float32(0.0), np.float32(1.0), np.float32(0.0), np.float32(1.0), np.float32(1.0), np.float32(0.0), np.float32(0.0), np.float32(0.0), np.float32(1.0), np.float32(0.0), np.float32(1.0), np.float32(1.0), np.float32(0.0), np.float32(1.0)]",1.0,99288.0,19
2025-08-14_08-18-36,8071,"[np.float32(0.0), np.float32(1.0), np.float32(0.0), np.float32(0.0), np.float32(1.0), np.float32(1.0), np.float32(0.0), np.float32(0.0), np.float32(0.0), np.float32(0.0), np.float32(0.0), np.float32(0.0), np.float32(1.0), np.float32(1.0), np.float32(0.0), np.float32(0.0)]",0.0,99288.0,32
2025-08-14_08-18-36,8072,"[np.float32(1.0), np.float32(1.0), np.float32(1.0), np.float32(0.0), np.float32(0.0), np.float32(1.0), np.float32(1.0), np.float32(0.0), np.float32(1.0), np.float32(1.0), np.float32(1.0), np.float32(0.0), np.float32(0.0), np.float32(1.0), np.float32(1.0), np.float32(0.0)]",0.0,99288.0,31
2025-08-14_08-18-36,8073,"[np.float32(0.0), np.float32(1.0), np.float32(1.0), np.float32(1.0), np.float32(0.0), np.float32(1.0), np.float32(0.0), np.float32(1.0), np.float32(1.0), np.float32(1.0), np.float32(1.0), np.float32(0.0), np.float32(1.0), np.float32(1.0), np.float32(1.0), np.float32(0.0)]",-6.0,99282.0,3
2025-08-14_08-18-36,8074,"[np.float32(0.0), np.float32(1.0), np.float32(0.0), np.float32(0.0), np.float32(0.0), np.float32(0.0), np.float32(1.0), np.float32(1.0), np.float32(0.0), np.float32(1.0), np.float32(0.0), np.float32(0.0), np.float32(0.0), np.float32(0.0), np.float32(0.0), np.float32(0.0)]",-1.0,99281.0,23
2025-08-14_08-18-36,8075,"[np.float32(1.0), np.float32(1.0), np.float32(1.0), np.float32(1.0), np.float32(0.0), np.float32(1.0), np.float32(1.0), np.float32(1.0), np.float32(0.0), np.float32(0.0), np.float32(0.0), np.float32(1.0), np.float32(1.0), np.float32(0.0), np.float32(0.0), np.float32(1.0)]",-4.0,99277.0,35
2025-08-14_08-18-36,8076,"[np.float32(1.0), np.float32(1.0), np.float32(0.0), np.float32(1.0), np.float32(0.0), np.float32(1.0), np.float32(1.0), np.float32(0.0), np.float32(0.0), np.float32(0.0), np.float32(1.0), np.float32(0.0), np.float32(1.0), np.float32(1.0), np.float32(1.0), np.float32(0.0)]",-5.0,99272.0,34
2025-08-14_08-18-36,8077,"[np.float32(0.0), np.float32(1.0), np.float32(0.0), np.float32(0.0), np.float32(1.0), np.float32(1.0), np.float32(0.0), np.float32(0.0), np.float32(1.0), np.float32(1.0), np.float32(1.0), np.float32(0.0), np.float32(1.0), np.float32(1.0), np.float32(0.0), np.float32(0.0)]",-1.0,99271.0,10
2025-08-14_08-18-36,8078,"[np.float32(0.0), np.float32(0.0), np.float32(0.0), np.float32(0.0), np.float32(0.0), np.float32(1.0), np.float32(1.0), np.float32(0.0), np.float32(1.0), np.float32(0.0), np.float32(1.0), np.float32(1.0), np.float32(0.0), np.float32(1.0), np.float32(0.0), np.float32(0.0)]",5.0,99276.0,26
2025-08-14_08-18-36,8079,"[np.float32(0.0), np.float32(0.0), np.float32(1.0), np.float32(0.0), np.float32(0.0), np.float32(0.0), np.float32(1.0), np.float32(0.0), np.float32(0.0), np.float32(1.0), np.float32(1.0), np.float32(0.0), np.float32(0.0), np.float32(0.0), np.float32(0.0), np.float32(0.0)]",-1.0,99275.0,29
2025-08-14_08-18-36,8080,"[np.float32(0.0), np.float32(1.0), np.float32(0.0), np.float32(0.0), np.float32(1.0), np.float32(1.0), np.float32(1.0), np.float32(1.0), np.float32(1.0), np.float32(0.0), np.float32(1.0), np.float32(0.0), np.float32(0.0), np.float32(1.0), np.float32(1.0), np.float32(0.0)]",-1.0,99274.0,36
2025-08-14_08-18-36,8081,"[np.float32(0.0), np.float32(1.0), np.float32(1.0), np.float32(0.0), np.float32(1.0), np.float32(1.0), np.float32(1.0), np.float32(0.0), np.float32(0.0), np.float32(1.0), np.float32(0.0), np.float32(1.0), np.float32(0.0), np.float32(0.0), np.float32(0.0), np.float32(1.0)]",-1.0,99273.0,15
2025-08-14_08-18-36,8082,"[np.float32(1.0), np.float32(0.0), np.float32(0.0), np.float32(0.0), np.float32(0.0), np.float32(1.0), np.float32(1.0), np.float32(1.0), np.float32(1.0), np.float32(1.0), np.float32(0.0), np.float32(1.0), np.float32(0.0), np.float32(0.0), np.float32(0.0), np.float32(0.0)]",1.0,99274.0,9
2025-08-14_08-18-36,8083,"[np.float32(1.0), np.float32(1.0), np.float32(1.0), np.float32(1.0), np.float32(0.0), np.float32(1.0), np.float32(1.0), np.float32(1.0), np.float32(1.0), np.float32(1.0), np.float32(0.0), np.float32(0.0), np.float32(1.0), np.float32(1.0), np.float32(0.0), np.float32(1.0)]",-5.0,99269.0,5
2025-08-14_08-18-36,8084,"[np.float32(0.0), np.float32(1.0), np.float32(0.0), np.float32(1.0), np.float32(0.0), np.float32(1.0), np.float32(1.0), np.float32(1.0), np.float32(1.0), np.float32(1.0), np.float32(0.0), np.float32(1.0), np.float32(0.0), np.float32(1.0), np.float32(0.0), np.float32(0.0)]",0.0,99269.0,18
2025-08-14_08-18-36,8085,"[np.float32(1.0), np.float32(0.0), np.float32(0.0), np.float32(0.0), np.float32(1.0), np.float32(1.0), np.float32(1.0), np.float32(0.0), np.float32(0.0), np.float32(1.0), np.float32(0.0), np.float32(0.0), np.float32(0.0), np.float32(0.0), np.float32(0.0), np.float32(0.0)]",-3.0,99266.0,20
2025-08-14_08-18-36,8086,"[np.float32(0.0), np.float32(1.0), np.float32(0.0), np.float32(1.0), np.float32(0.0), np.float32(1.0), np.float32(1.0), np.float32(1.0), np.float32(1.0), np.float32(1.0), np.float32(0.0), np.float32(1.0), np.float32(1.0), np.float32(0.0), np.float32(0.0), np.float32(1.0)]",0.0,99266.0,20
2025-08-14_08-18-36,8087,"[np.float32(0.0), np.float32(0.0), np.float32(0.0), np.float32(1.0), np.float32(0.0), np.float32(0.0), np.float32(0.0), np.float32(1.0), np.float32(1.0), np.float32(1.0), np.float32(0.0), np.float32(1.0), np.float32(0.0), np.float32(0.0), np.float32(0.0), np.float32(0.0)]",-5.0,99261.0,0
2025-08-14_08-18-36,8088,"[np.float32(0.0), np.float32(0.0), np.float32(0.0), np.float32(0.0), np.float32(1.0), np.float32(1.0), np.float32(0.0), np.float32(1.0), np.float32(1.0), np.float32(1.0), np.float32(0.0), np.float32(1.0), np.float32(0.0), np.float32(1.0), np.float32(0.0), np.float32(1.0)]",0.0,99261.0,30
2025-08-14_08-18-36,8089,"[np.float32(0.0), np.float32(0.0), np.float32(0.0), np.float32(1.0), np.float32(1.0), np.float32(0.0), np.float32(1.0), np.float32(0.0), np.float32(1.0), np.float32(1.0), np.float32(0.0), np.float32(0.0), np.float32(0.0), np.float32(0.0), np.float32(1.0), np.float32(0.0)]",-2.0,99259.0,15
2025-08-14_08-18-36,8090,"[np.float32(1.0), np.float32(1.0), np.float32(0.0), np.float32(0.0), np.float32(0.0), np.float32(0.0), np.float32(0.0), np.float32(0.0), np.float32(0.0), np.float32(0.0), np.float32(1.0), np.float32(0.0), np.float32(0.0), np.float32(1.0), np.float32(0.0), np.float32(1.0)]",-3.0,99256.0,16
2025-08-14_08-18-36,8091,"[np.float32(1.0), np.float32(0.0), np.float32(0.0), np.float32(1.0), np.float32(0.0), np.float32(0.0), np.float32(1.0), np.float32(0.0), np.float32(0.0), np.float32(1.0), np.float32(0.0), np.float32(1.0), np.float32(1.0), np.float32(0.0), np.float32(1.0), np.float32(1.0)]",-2.0,99254.0,24
2025-08-14_08-18-36,8092,"[np.float32(1.0), np.float32(0.0), np.float32(0.0), np.float32(0.0), np.float32(1.0), np.float32(1.0), np.float32(1.0), np.float32(1.0), np.float32(1.0), np.float32(0.0), np.float32(0.0), np.float32(0.0), np.float32(0.0), np.float32(1.0), np.float32(1.0), np.float32(1.0)]",1.0,99255.0,21
2025-08-14_08-18-36,8093,"[np.float32(0.0), np.float32(0.0), np.float32(0.0), np.float32(1.0), np.float32(0.0), np.float32(0.0), np.float32(0.0), np.float32(1.0), np.float32(0.0), np.float32(1.0), np.float32(1.0), np.float32(1.0), np.float32(1.0), np.float32(0.0), np.float32(1.0), np.float32(0.0)]",-4.0,99251.0,34
2025-08-14_08-18-36,8094,"[np.float32(0.0), np.float32(1.0), np.float32(1.0), np.float32(0.0), np.float32(0.0), np.float32(1.0), np.float32(0.0), np.float32(0.0), np.float32(1.0), np.float32(0.0), np.float32(0.0), np.float32(0.0), np.float32(1.0), np.float32(0.0), np.float32(1.0), np.float32(0.0)]",2.0,99253.0,27
2025-08-14_08-18-36,8095,"[np.float32(0.0), np.float32(0.0), np.float32(0.0), np.float32(0.0), np.float32(0.0), np.float32(1.0), np.float32(0.0), np.float32(1.0), np.float32(1.0), np.float32(0.0), np.float32(0.0), np.float32(0.0), np.float32(1.0), np.float32(0.0), np.float32(1.0), np.float32(1.0)]",-3.0,99250.0,1
2025-08-14_08-18-36,8096,"[np.float32(0.0), np.float32(1.0), np.float32(0.0), np.float32(0.0), np.float32(0.0), np.float32(0.0), np.float32(1.0), np.float32(1.0), np.float32(0.0), np.float32(1.0), np.float32(1.0), np.float32(1.0), np.float32(1.0), np.float32(0.0), np.float32(1.0), np.float32(0.0)]",-3.0,99247.0,28
2025-08-14_08-18-36,8097,"[np.float32(1.0), np.float32(1.0), np.float32(0.0), np.float32(0.0), np.float32(1.0), np.float32(0.0), np.float32(0.0), np.float32(1.0), np.float32(1.0), np.float32(1.0), np.float32(0.0), np.float32(1.0), np.float32(1.0), np.float32(0.0), np.float32(0.0), np.float32(1.0)]",1.0,99248.0,14
2025-08-14_08-18-36,8098,"[np.float32(0.0), np.float32(1.0), np.float32(0.0), np.float32(1.0), np.float32(1.0), np.float32(1.0), np.float32(0.0), np.float32(0.0), np.float32(0.0), np.float32(1.0), np.float32(0.0), np.float32(1.0), np.float32(1.0), np.float32(1.0), np.float32(0.0), np.float32(1.0)]",-1.0,99247.0,18
2025-08-14_08-18-36,8099,"[np.float32(0.0), np.float32(1.0), np.float32(1.0), np.float32(0.0), np.float32(0.0), np.float32(0.0), np.float32(0.0), np.float32(1.0), np.float32(0.0), np.float32(0.0), np.float32(1.0), np.float32(1.0), np.float32(1.0), np.float32(1.0), np.float32(0.0), np.float32(0.0)]",-2.0,99245.0,33
2025-08-14_08-18-36,8100,"[np.float32(0.0), np.float32(1.0), np.float32(1.0), np.float32(0.0), np.float32(1.0), np.float32(0.0), np.float32(0.0), np.float32(1.0), np.float32(0.0), np.float32(1.0), np.float32(0.0), np.float32(0.0), np.float32(1.0), np.float32(1.0), np.float32(0.0), np.float32(1.0)]",-3.0,99242.0,29
2025-08-14_08-18-36,8101,"[np.float32(0.0), np.float32(1.0), np.float32(0.0), np.float32(0.0), np.float32(0.0), np.float32(1.0), np.float32(1.0), np.float32(1.0), np.float32(1.0), np.float32(0.0), np.float32(0.0), np.float32(0.0), np.float32(0.0), np.float32(1.0), np.float32(1.0), np.float32(0.0)]",-4.0,99238.0,9
2025-08-14_08-18-36,8102,"[np.float32(1.0), np.float32(1.0), np.float32(0.0), np.float32(1.0), np.float32(1.0), np.float32(0.0), np.float32(1.0), np.float32(0.0), np.float32(1.0), np.float32(1.0), np.float32(1.0), np.float32(1.0), np.float32(1.0), np.float32(0.0), np.float32(0.0), np.float32(0.0)]",-2.0,99236.0,32
2025-08-14_08-18-36,8103,"[np.float32(0.0), np.float32(1.0), np.float32(0.0), np.float32(0.0), np.float32(1.0), np.float32(0.0), np.float32(0.0), np.float32(0.0), np.float32(1.0), np.float32(1.0), np.float32(0.0), np.float32(1.0), np.float32(1.0), np.float32(0.0), np.float32(0.0), np.float32(1.0)]",-7.0,99229.0,23
2025-08-14_08-18-36,8104,"[np.float32(0.0), np.float32(1.0), np.float32(1.0), np.float32(1.0), np.float32(1.0), np.float32(1.0), np.float32(1.0), np.float32(1.0), np.float32(0.0), np.float32(0.0), np.float32(1.0), np.float32(0.0), np.float32(1.0), np.float32(1.0), np.float32(0.0), np.float32(1.0)]",-1.0,99228.0,1
2025-08-14_08-18-36,8105,"[np.float32(0.0), np.float32(0.0), np.float32(1.0), np.float32(0.0), np.float32(0.0), np.float32(1.0), np.float32(1.0), np.float32(1.0), np.float32(0.0), np.float32(1.0), np.float32(1.0), np.float32(0.0), np.float32(1.0), np.float32(0.0), np.float32(1.0), np.float32(0.0)]",3.0,99231.0,23
2025-08-14_08-18-36,8106,"[np.float32(0.0), np.float32(0.0), np.float32(0.0), np.float32(0.0), np.float32(0.0), np.float32(1.0), np.float32(1.0), np.float32(1.0), np.float32(0.0), np.float32(0.0), np.float32(0.0), np.float32(1.0), np.float32(1.0), np.float32(0.0), np.float32(1.0), np.float32(1.0)]",-1.0,99230.0,14
2025-08-14_08-18-36,8107,"[np.float32(0.0), np.float32(0.0), np.float32(1.0), np.float32(0.0), np.float32(0.0), np.float32(0.0), np.float32(0.0), np.float32(0.0), np.float32(1.0), np.float32(1.0), np.float32(0.0), np.float32(0.0), np.float32(0.0), np.float32(1.0), np.float32(1.0), np.float32(0.0)]",-2.0,99228.0,3
2025-08-14_08-18-36,8108,"[np.float32(0.0), np.float32(1.0), np.float32(1.0), np.float32(1.0), np.float32(1.0), np.float32(0.0), np.float32(1.0), np.float32(0.0), np.float32(1.0), np.float32(0.0), np.float32(0.0), np.float32(1.0), np.float32(0.0), np.float32(0.0), np.float32(1.0), np.float32(0.0)]",2.0,99230.0,12
2025-08-14_08-18-36,8109,"[np.float32(1.0), np.float32(1.0), np.float32(1.0), np.float32(1.0), np.float32(0.0), np.float32(0.0), np.float32(1.0), np.float32(1.0), np.float32(1.0), np.float32(1.0), np.float32(1.0), np.float32(0.0), np.float32(0.0), np.float32(1.0), np.float32(1.0), np.float32(0.0)]",2.0,99232.0,29
2025-08-14_08-18-36,8110,"[np.float32(1.0), np.float32(0.0), np.float32(1.0), np.float32(0.0), np.float32(0.0), np.float32(0.0), np.float32(0.0), np.float32(0.0), np.float32(1.0), np.float32(1.0), np.float32(0.0), np.float32(0.0), np.float32(0.0), np.float32(1.0), np.float32(1.0), np.float32(1.0)]",-4.0,99228.0,11
2025-08-14_08-18-36,8111,"[np.float32(1.0), np.float32(0.0), np.float32(0.0), np.float32(1.0), np.float32(0.0), np.float32(0.0), np.float32(0.0), np.float32(1.0), np.float32(0.0), np.float32(0.0), np.float32(0.0), np.float32(1.0), np.float32(0.0), np.float32(1.0), np.float32(1.0), np.float32(0.0)]",-3.0,99225.0,20
2025-08-14_08-18-36,8112,"[np.float32(0.0), np.float32(0.0), np.float32(0.0), np.float32(1.0), np.float32(0.0), np.float32(1.0), np.float32(1.0), np.float32(1.0), np.float32(1.0), np.float32(1.0), np.float32(1.0), np.float32(1.0), np.float32(1.0), np.float32(1.0), np.float32(0.0), np.float32(1.0)]",2.0,99227.0,29
2025-08-14_08-18-36,8113,"[np.float32(1.0), np.float32(1.0), np.float32(0.0), np.float32(1.0), np.float32(0.0), np.float32(1.0), np.float32(0.0), np.float32(0.0), np.float32(1.0), np.float32(1.0), np.float32(1.0), np.float32(1.0), np.float32(1.0), np.float32(1.0), np.float32(1.0), np.float32(0.0)]",-3.0,99224.0,16
2025-08-14_08-18-36,8114,"[np.float32(0.0), np.float32(0.0), np.float32(1.0), np.float32(1.0), np.float32(0.0), np.float32(0.0), np.float32(0.0), np.float32(1.0), np.float32(1.0), np.float32(0.0), np.float32(1.0), np.float32(1.0), np.float32(1.0), np.float32(1.0), np.float32(0.0), np.float32(0.0)]",-3.0,99221.0,0
2025-08-14_08-18-36,8115,"[np.float32(1.0), np.float32(0.0), np.float32(1.0), np.float32(0.0), np.float32(1.0), np.float32(1.0), np.float32(0.0), np.float32(0.0), np.float32(1.0), np.float32(0.0), np.float32(0.0), np.float32(1.0), np.float32(1.0), np.float32(1.0), np.float32(0.0), np.float32(0.0)]",-1.0,99220.0,9
2025-08-14_08-18-36,8116,"[np.float32(1.0), np.float32(0.0), np.float32(1.0), np.float32(0.0), np.float32(0.0), np.float32(0.0), np.float32(1.0), np.float32(0.0), np.float32(0.0), np.float32(1.0), np.float32(0.0), np.float32(1.0), np.float32(1.0), np.float32(0.0), np.float32(0.0), np.float32(0.0)]",-6.0,99214.0,29
2025-08-14_08-18-36,8117,"[np.float32(1.0), np.float32(1.0), np.float32(0.0), np.float32(0.0), np.float32(1.0), np.float32(0.0), np.float32(0.0), np.float32(0.0), np.float32(1.0), np.float32(0.0), np.float32(0.0), np.float32(0.0), np.float32(0.0), np.float32(0.0), np.float32(0.0), np.float32(1.0)]",3.0,99217.0,34
2025-08-14_08-18-36,8118,"[np.float32(1.0), np.float32(1.0), np.float32(1.0), np.float32(1.0), np.float32(1.0), np.float32(1.0), np.float32(1.0), np.float32(1.0), np.float32(0.0), np.float32(1.0), np.float32(1.0), np.float32(0.0), np.float32(1.0), np.float32(1.0), np.float32(1.0), np.float32(1.0)]",-2.0,99215.0,28
2025-08-14_08-18-36,8119,"[np.float32(0.0), np.float32(1.0), np.float32(0.0), np.float32(1.0), np.float32(0.0), np.float32(0.0), np.float32(0.0), np.float32(1.0), np.float32(1.0), np.float32(0.0), np.float32(1.0), np.float32(0.0), np.float32(1.0), np.float32(0.0), np.float32(1.0), np.float32(0.0)]",-2.0,99213.0,21
2025-08-14_08-18-36,8120,"[np.float32(1.0), np.float32(0.0), np.float32(1.0), np.float32(0.0), np.float32(1.0), np.float32(0.0), np.float32(0.0), np.float32(1.0), np.float32(0.0), np.float32(0.0), np.float32(1.0), np.float32(0.0), np.float32(1.0), np.float32(0.0), np.float32(0.0), np.float32(1.0)]",-5.0,99208.0,25
2025-08-14_08-18-36,8121,"[np.float32(0.0), np.float32(1.0), np.float32(1.0), np.float32(1.0), np.float32(1.0), np.float32(0.0), np.float32(0.0), np.float32(0.0), np.float32(1.0), np.float32(0.0), np.float32(0.0), np.float32(0.0), np.float32(0.0), np.float32(1.0), np.float32(0.0), np.float32(0.0)]",-2.0,99206.0,20
2025-08-14_08-18-36,8122,"[np.float32(0.0), np.float32(1.0), np.float32(1.0), np.float32(0.0), np.float32(0.0), np.float32(1.0), np.float32(1.0), np.float32(0.0), np.float32(1.0), np.float32(1.0), np.float32(0.0), np.float32(1.0), np.float32(1.0), np.float32(1.0), np.float32(0.0), np.float32(0.0)]",1.0,99207.0,31
2025-08-14_08-18-36,8123,"[np.float32(0.0), np.float32(1.0), np.float32(1.0), np.float32(0.0), np.float32(1.0), np.float32(0.0), np.float32(1.0), np.float32(1.0), np.float32(1.0), np.float32(0.0), np.float32(0.0), np.float32(0.0), np.float32(0.0), np.float32(0.0), np.float32(1.0), np.float32(0.0)]",5.0,99212.0,10
2025-08-14_08-18-36,8124,"[np.float32(1.0), np.float32(0.0), np.float32(1.0), np.float32(0.0), np.float32(1.0), np.float32(1.0), np.float32(1.0), np.float32(1.0), np.float32(0.0), np.float32(1.0), np.float32(1.0), np.float32(0.0), np.float32(1.0), np.float32(0.0), np.float32(1.0), np.float32(0.0)]",-5.0,99207.0,29
2025-08-14_08-18-36,8125,"[np.float32(1.0), np.float32(1.0), np.float32(1.0), np.float32(0.0), np.float32(1.0), np.float32(1.0), np.float32(1.0), np.float32(0.0), np.float32(0.0), np.float32(0.0), np.float32(1.0), np.float32(1.0), np.float32(1.0), np.float32(0.0), np.float32(0.0), np.float32(0.0)]",-2.0,99205.0,27
2025-08-14_08-18-36,8126,"[np.float32(1.0), np.float32(0.0), np.float32(0.0), np.float32(1.0), np.float32(0.0), np.float32(0.0), np.float32(1.0), np.float32(1.0), np.float32(0.0), np.float32(0.0), np.float32(0.0), np.float32(0.0), np.float32(1.0), np.float32(1.0), np.float32(1.0), np.float32(0.0)]",3.0,99208.0,23
2025-08-14_08-18-36,8127,"[np.float32(0.0), np.float32(1.0), np.float32(0.0), np.float32(1.0), np.float32(1.0), np.float32(1.0), np.float32(1.0), np.float32(0.0), np.float32(1.0), np.float32(0.0), np.float32(1.0), np.float32(0.0), np.float32(1.0), np.float32(0.0), np.float32(1.0), np.float32(1.0)]",0.0,99208.0,2
2025-08-14_08-18-36,8128,"[np.float32(1.0), np.float32(0.0), np.float32(1.0), np.float32(1.0), np.float32(0.0), np.float32(0.0), np.float32(1.0), np.float32(1.0), np.float32(0.0), np.float32(0.0), np.float32(0.0), np.float32(0.0), np.float32(0.0), np.float32(1.0), np.float32(0.0), np.float32(1.0)]",0.0,99208.0,5
2025-08-14_08-18-36,8129,"[np.float32(0.0), np.float32(0.0), np.float32(1.0), np.float32(0.0), np.float32(0.0), np.float32(0.0), np.float32(1.0), np.float32(1.0), np.float32(0.0), np.float32(1.0), np.float32(1.0), np.float32(0.0), np.float32(0.0), np.float32(0.0), np.float32(0.0), np.float32(1.0)]",-1.0,99207.0,28
2025-08-14_08-18-36,8130,"[np.float32(1.0), np.float32(0.0), np.float32(0.0), np.float32(0.0), np.float32(0.0), np.float32(1.0), np.float32(1.0), np.float32(1.0), np.float32(1.0), np.float32(0.0), np.float32(0.0), np.float32(1.0), np.float32(1.0), np.float32(0.0), np.float32(1.0), np.float32(0.0)]",33.0,99240.0,7
2025-08-14_08-18-36,8131,"[np.float32(1.0), np.float32(1.0), np.float32(1.0), np.float32(1.0), np.float32(0.0), np.float32(0.0), np.float32(1.0), np.float32(0.0), np.float32(0.0), np.float32(1.0), np.float32(0.0), np.float32(1.0), np.float32(0.0), np.float32(0.0), np.float32(1.0), np.float32(0.0)]",-1.0,99239.0,15
2025-08-14_08-18-36,8132,"[np.float32(0.0), np.float32(1.0), np.float32(0.0), np.float32(0.0), np.float32(0.0), np.float32(1.0), np.float32(1.0), np.float32(1.0), np.float32(1.0), np.float32(0.0), np.float32(0.0), np.float32(0.0), np.float32(0.0), np.float32(0.0), np.float32(0.0), np.float32(0.0)]",2.0,99241.0,28
2025-08-14_08-18-36,8133,"[np.float32(0.0), np.float32(0.0), np.float32(0.0), np.float32(1.0), np.float32(0.0), np.float32(0.0), np.float32(1.0), np.float32(0.0), np.float32(0.0), np.float32(0.0), np.float32(0.0), np.float32(1.0), np.float32(1.0), np.float32(1.0), np.float32(0.0), np.float32(0.0)]",39.0,99280.0,7
2025-08-14_08-18-36,8134,"[np.float32(0.0), np.float32(0.0), np.float32(1.0), np.float32(0.0), np.float32(1.0), np.float32(0.0), np.float32(1.0), np.float32(0.0), np.float32(1.0), np.float32(0.0), np.float32(1.0), np.float32(0.0), np.float32(1.0), np.float32(1.0), np.float32(1.0), np.float32(0.0)]",5.0,99285.0,2
2025-08-14_08-18-36,8135,"[np.float32(0.0), np.float32(0.0), np.float32(1.0), np.float32(1.0), np.float32(0.0), np.float32(0.0), np.float32(0.0), np.float32(1.0), np.float32(0.0), np.float32(0.0), np.float32(1.0), np.float32(1.0), np.float32(0.0), np.float32(0.0), np.float32(1.0), np.float32(0.0)]",-4.0,99281.0,28
2025-08-14_08-18-36,8136,"[np.float32(0.0), np.float32(1.0), np.float32(0.0), np.float32(1.0), np.float32(1.0), np.float32(1.0), np.float32(1.0), np.float32(0.0), np.float32(0.0), np.float32(0.0), np.float32(0.0), np.float32(0.0), np.float32(0.0), np.float32(1.0), np.float32(1.0), np.float32(1.0)]",1.0,99282.0,15
2025-08-14_08-18-36,8137,"[np.float32(1.0), np.float32(0.0), np.float32(1.0), np.float32(0.0), np.float32(1.0), np.float32(0.0), np.float32(1.0), np.float32(1.0), np.float32(1.0), np.float32(0.0), np.float32(1.0), np.float32(0.0), np.float32(0.0), np.float32(0.0), np.float32(1.0), np.float32(0.0)]",5.0,99287.0,8
2025-08-14_08-18-36,8138,"[np.float32(0.0), np.float32(0.0), np.float32(0.0), np.float32(0.0), np.float32(0.0), np.float32(0.0), np.float32(1.0), np.float32(1.0), np.float32(0.0), np.float32(0.0), np.float32(0.0), np.float32(1.0), np.float32(0.0), np.float32(1.0), np.float32(0.0), np.float32(0.0)]",-1.0,99286.0,16
2025-08-14_08-18-36,8139,"[np.float32(1.0), np.float32(1.0), np.float32(1.0), np.float32(0.0), np.float32(0.0), np.float32(0.0), np.float32(1.0), np.float32(1.0), np.float32(0.0), np.float32(1.0), np.float32(0.0), np.float32(0.0), np.float32(0.0), np.float32(1.0), np.float32(0.0), np.float32(1.0)]",2.0,99288.0,14
2025-08-14_08-18-36,8140,"[np.float32(1.0), np.float32(0.0), np.float32(0.0), np.float32(0.0), np.float32(0.0), np.float32(0.0), np.float32(1.0), np.float32(1.0), np.float32(1.0), np.float32(0.0), np.float32(1.0), np.float32(1.0), np.float32(1.0), np.float32(1.0), np.float32(0.0), np.float32(1.0)]",0.0,99288.0,35
2025-08-14_08-18-36,8141,"[np.float32(0.0), np.float32(1.0), np.float32(0.0), np.float32(1.0), np.float32(1.0), np.float32(1.0), np.float32(1.0), np.float32(0.0), np.float32(1.0), np.float32(0.0), np.float32(1.0), np.float32(1.0), np.float32(1.0), np.float32(1.0), np.float32(0.0), np.float32(0.0)]",0.0,99288.0,5
2025-08-14_08-18-36,8142,"[np.float32(1.0), np.float32(0.0), np.float32(0.0), np.float32(1.0), np.float32(1.0), np.float32(1.0), np.float32(1.0), np.float32(0.0), np.float32(0.0), np.float32(0.0), np.float32(1.0), np.float32(1.0), np.float32(0.0), np.float32(1.0), np.float32(0.0), np.float32(1.0)]",3.0,99291.0,21
2025-08-14_08-18-36,8143,"[np.float32(0.0), np.float32(0.0), np.float32(1.0), np.float32(1.0), np.float32(1.0), np.float32(1.0), np.float32(1.0), np.float32(1.0), np.float32(1.0), np.float32(0.0), np.float32(0.0), np.float32(0.0), np.float32(0.0), np.float32(1.0), np.float32(1.0), np.float32(0.0)]",1.0,99292.0,11
2025-08-14_08-18-36,8144,"[np.float32(0.0), np.float32(0.0), np.float32(0.0), np.float32(1.0), np.float32(0.0), np.float32(0.0), np.float32(1.0), np.float32(1.0), np.float32(1.0), np.float32(1.0), np.float32(1.0), np.float32(0.0), np.float32(0.0), np.float32(1.0), np.float32(1.0), np.float32(1.0)]",0.0,99292.0,28
2025-08-14_08-18-36,8145,"[np.float32(0.0), np.float32(0.0), np.float32(1.0), np.float32(0.0), np.float32(0.0), np.float32(0.0), np.float32(1.0), np.float32(1.0), np.float32(1.0), np.float32(0.0), np.float32(1.0), np.float32(0.0), np.float32(1.0), np.float32(0.0), np.float32(1.0), np.float32(0.0)]",-1.0,99291.0,13
2025-08-14_08-18-36,8146,"[np.float32(0.0), np.float32(0.0), np.float32(1.0), np.float32(0.0), np.float32(0.0), np.float32(0.0), np.float32(0.0), np.float32(1.0), np.float32(0.0), np.float32(0.0), np.float32(0.0), np.float32(0.0), np.float32(1.0), np.float32(1.0), np.float32(0.0), np.float32(0.0)]",2.0,99293.0,15
2025-08-14_08-18-36,8147,"[np.float32(1.0), np.float32(1.0), np.float32(0.0), np.float32(0.0), np.float32(0.0), np.float32(1.0), np.float32(1.0), np.float32(1.0), np.float32(1.0), np.float32(1.0), np.float32(0.0), np.float32(1.0), np.float32(0.0), np.float32(1.0), np.float32(1.0), np.float32(1.0)]",-3.0,99290.0,5
2025-08-14_08-18-36,8148,"[np.float32(0.0), np.float32(0.0), np.float32(0.0), np.float32(1.0), np.float32(1.0), np.float32(1.0), np.float32(1.0), np.float32(1.0), np.float32(0.0), np.float32(0.0), np.float32(0.0), np.float32(0.0), np.float32(1.0), np.float32(0.0), np.float32(0.0), np.float32(1.0)]",-3.0,99287.0,33
2025-08-14_08-18-36,8149,"[np.float32(0.0), np.float32(1.0), np.float32(0.0), np.float32(0.0), np.float32(0.0), np.float32(1.0), np.float32(0.0), np.float32(0.0), np.float32(0.0), np.float32(1.0), np.float32(0.0), np.float32(1.0), np.float32(0.0), np.float32(0.0), np.float32(1.0), np.float32(1.0)]",-1.0,99286.0,19
2025-08-14_08-18-36,8150,"[np.float32(1.0), np.float32(1.0), np.float32(0.0), np.float32(0.0), np.float32(0.0), np.float32(1.0), np.float32(1.0), np.float32(0.0), np.float32(1.0), np.float32(1.0), np.float32(1.0), np.float32(1.0), np.float32(1.0), np.float32(1.0), np.float32(0.0), np.float32(0.0)]",0.0,99286.0,36
2025-08-14_08-18-36,8151,"[np.float32(0.0), np.float32(0.0), np.float32(1.0), np.float32(1.0), np.float32(1.0), np.float32(0.0), np.float32(0.0), np.float32(1.0), np.float32(1.0), np.float32(1.0), np.float32(1.0), np.float32(0.0), np.float32(1.0), np.float32(0.0), np.float32(1.0), np.float32(1.0)]",-2.0,99284.0,24
2025-08-14_08-18-36,8152,"[np.float32(0.0), np.float32(1.0), np.float32(0.0), np.float32(1.0), np.float32(1.0), np.float32(1.0), np.float32(1.0), np.float32(1.0), np.float32(0.0), np.float32(0.0), np.float32(0.0), np.float32(1.0), np.float32(1.0), np.float32(1.0), np.float32(0.0), np.float32(1.0)]",2.0,99286.0,17
2025-08-14_08-18-36,8153,"[np.float32(0.0), np.float32(1.0), np.float32(1.0), np.float32(0.0), np.float32(0.0), np.float32(1.0), np.float32(0.0), np.float32(0.0), np.float32(0.0), np.float32(1.0), np.float32(0.0), np.float32(0.0), np.float32(1.0), np.float32(0.0), np.float32(0.0), np.float32(1.0)]",3.0,99289.0,28
2025-08-14_08-18-36,8154,"[np.float32(0.0), np.float32(0.0), np.float32(0.0), np.float32(0.0), np.float32(0.0), np.float32(0.0), np.float32(0.0), np.float32(1.0), np.float32(0.0), np.float32(0.0), np.float32(1.0), np.float32(1.0), np.float32(0.0), np.float32(1.0), np.float32(1.0), np.float32(1.0)]",0.0,99289.0,16
2025-08-14_08-18-36,8155,"[np.float32(0.0), np.float32(1.0), np.float32(0.0), np.float32(0.0), np.float32(0.0), np.float32(0.0), np.float32(0.0), np.float32(0.0), np.float32(0.0), np.float32(1.0), np.float32(0.0), np.float32(0.0), np.float32(1.0), np.float32(0.0), np.float32(0.0), np.float32(0.0)]",-3.0,99286.0,9
2025-08-14_08-18-36,8156,"[np.float32(0.0), np.float32(0.0), np.float32(0.0), np.float32(1.0), np.float32(0.0), np.float32(0.0), np.float32(1.0), np.float32(0.0), np.float32(1.0), np.float32(1.0), np.float32(1.0), np.float32(1.0), np.float32(0.0), np.float32(1.0), np.float32(0.0), np.float32(0.0)]",4.0,99290.0,29
2025-08-14_08-18-36,8157,"[np.float32(1.0), np.float32(1.0), np.float32(1.0), np.float32(1.0), np.float32(0.0), np.float32(1.0), np.float32(1.0), np.float32(1.0), np.float32(1.0), np.float32(1.0), np.float32(0.0), np.float32(0.0), np.float32(0.0), np.float32(0.0), np.float32(0.0), np.float32(0.0)]",1.0,99291.0,16
2025-08-14_08-18-36,8158,"[np.float32(1.0), np.float32(0.0), np.float32(1.0), np.float32(1.0), np.float32(0.0), np.float32(1.0), np.float32(1.0), np.float32(1.0), np.float32(0.0), np.float32(0.0), np.float32(1.0), np.float32(0.0), np.float32(1.0), np.float32(1.0), np.float32(0.0), np.float32(0.0)]",-3.0,99288.0,30
2025-08-14_08-18-36,8159,"[np.float32(1.0), np.float32(1.0), np.float32(1.0), np.float32(0.0), np.float32(0.0), np.float32(0.0), np.float32(0.0), np.float32(0.0), np.float32(1.0), np.float32(1.0), np.float32(1.0), np.float32(0.0), np.float32(0.0), np.float32(0.0), np.float32(0.0), np.float32(0.0)]",-1.0,99287.0,27
2025-08-14_08-18-36,8160,"[np.float32(1.0), np.float32(0.0), np.float32(1.0), np.float32(1.0), np.float32(1.0), np.float32(0.0), np.float32(1.0), np.float32(0.0), np.float32(1.0), np.float32(0.0), np.float32(1.0), np.float32(0.0), np.float32(0.0), np.float32(1.0), np.float32(0.0), np.float32(0.0)]",-1.0,99286.0,21
2025-08-14_08-18-36,8161,"[np.float32(1.0), np.float32(1.0), np.float32(0.0), np.float32(0.0), np.float32(0.0), np.float32(1.0), np.float32(0.0), np.float32(1.0), np.float32(1.0), np.float32(0.0), np.float32(0.0), np.float32(0.0), np.float32(1.0), np.float32(0.0), np.float32(0.0), np.float32(1.0)]",0.0,99286.0,21
2025-08-14_08-18-36,8162,"[np.float32(0.0), np.float32(1.0), np.float32(0.0), np.float32(1.0), np.float32(0.0), np.float32(1.0), np.float32(0.0), np.float32(0.0), np.float32(1.0), np.float32(0.0), np.float32(0.0), np.float32(1.0), np.float32(0.0), np.float32(1.0), np.float32(1.0), np.float32(1.0)]",7.0,99293.0,33
2025-08-14_08-18-36,8163,"[np.float32(0.0), np.float32(0.0), np.float32(0.0), np.float32(0.0), np.float32(0.0), np.float32(1.0), np.float32(1.0), np.float32(1.0), np.float32(1.0), np.float32(0.0), np.float32(0.0), np.float32(0.0), np.float32(0.0), np.float32(1.0), np.float32(0.0), np.float32(0.0)]",-2.0,99291.0,1
2025-08-14_08-18-36,8164,"[np.float32(0.0), np.float32(1.0), np.float32(0.0), np.float32(1.0), np.float32(1.0), np.float32(1.0), np.float32(1.0), np.float32(1.0), np.float32(0.0), np.float32(0.0), np.float32(0.0), np.float32(0.0), np.float32(0.0), np.float32(1.0), np.float32(0.0), np.float32(0.0)]",3.0,99294.0,3
2025-08-14_08-18-36,8165,"[np.float32(0.0), np.float32(1.0), np.float32(0.0), np.float32(0.0), np.float32(0.0), np.float32(0.0), np.float32(0.0), np.float32(1.0), np.float32(0.0), np.float32(0.0), np.float32(1.0), np.float32(0.0), np.float32(1.0), np.float32(1.0), np.float32(1.0), np.float32(0.0)]",2.0,99296.0,17
2025-08-14_08-18-36,8166,"[np.float32(1.0), np.float32(0.0), np.float32(1.0), np.float32(1.0), np.float32(0.0), np.float32(0.0), np.float32(1.0), np.float32(0.0), np.float32(0.0), np.float32(0.0), np.float32(0.0), np.float32(1.0), np.float32(0.0), np.float32(1.0), np.float32(1.0), np.float32(1.0)]",-3.0,99293.0,20
2025-08-14_08-18-36,8167,"[np.float32(0.0), np.float32(1.0), np.float32(1.0), np.float32(0.0), np.float32(0.0), np.float32(0.0), np.float32(1.0), np.float32(0.0), np.float32(0.0), np.float32(1.0), np.float32(0.0), np.float32(0.0), np.float32(0.0), np.float32(0.0), np.float32(0.0), np.float32(1.0)]",4.0,99297.0,1
2025-08-14_08-18-36,8168,"[np.float32(1.0), np.float32(1.0), np.float32(1.0), np.float32(0.0), np.float32(1.0), np.float32(0.0), np.float32(1.0), np.float32(1.0), np.float32(0.0), np.float32(0.0), np.float32(1.0), np.float32(0.0), np.float32(1.0), np.float32(0.0), np.float32(0.0), np.float32(1.0)]",-5.0,99292.0,36
2025-08-14_08-18-36,8169,"[np.float32(1.0), np.float32(1.0), np.float32(0.0), np.float32(0.0), np.float32(0.0), np.float32(1.0), np.float32(0.0), np.float32(1.0), np.float32(1.0), np.float32(1.0), np.float32(0.0), np.float32(0.0), np.float32(1.0), np.float32(1.0), np.float32(1.0), np.float32(0.0)]",-7.0,99285.0,6
2025-08-14_08-18-36,8170,"[np.float32(0.0), np.float32(0.0), np.float32(1.0), np.float32(1.0), np.float32(1.0), np.float32(1.0), np.float32(1.0), np.float32(1.0), np.float32(1.0), np.float32(1.0), np.float32(0.0), np.float32(0.0), np.float32(0.0), np.float32(0.0), np.float32(0.0), np.float32(0.0)]",2.0,99287.0,1
2025-08-14_08-18-36,8171,"[np.float32(1.0), np.float32(0.0), np.float32(0.0), np.float32(0.0), np.float32(0.0), np.float32(1.0), np.float32(1.0), np.float32(1.0), np.float32(0.0), np.float32(0.0), np.float32(1.0), np.float32(1.0), np.float32(1.0), np.float32(1.0), np.float32(1.0), np.float32(0.0)]",-3.0,99284.0,10
2025-08-14_08-18-36,8172,"[np.float32(1.0), np.float32(0.0), np.float32(1.0), np.float32(1.0), np.float32(1.0), np.float32(1.0), np.float32(0.0), np.float32(1.0), np.float32(1.0), np.float32(0.0), np.float32(1.0), np.float32(1.0), np.float32(1.0), np.float32(0.0), np.float32(0.0), np.float32(1.0)]",1.0,99285.0,18
2025-08-14_08-18-36,8173,"[np.float32(1.0), np.float32(1.0), np.float32(1.0), np.float32(0.0), np.float32(0.0), np.float32(0.0), np.float32(1.0), np.float32(1.0), np.float32(1.0), np.float32(0.0), np.float32(0.0), np.float32(0.0), np.float32(0.0), np.float32(0.0), np.float32(1.0), np.float32(1.0)]",2.0,99287.0,20
2025-08-14_08-18-36,8174,"[np.float32(0.0), np.float32(0.0), np.float32(1.0), np.float32(0.0), np.float32(0.0), np.float32(1.0), np.float32(1.0), np.float32(1.0), np.float32(1.0), np.float32(1.0), np.float32(0.0), np.float32(0.0), np.float32(1.0), np.float32(0.0), np.float32(0.0), np.float32(0.0)]",-4.0,99283.0,15
2025-08-14_08-18-36,8175,"[np.float32(1.0), np.float32(0.0), np.float32(0.0), np.float32(0.0), np.float32(1.0), np.float32(1.0), np.float32(0.0), np.float32(1.0), np.float32(1.0), np.float32(1.0), np.float32(0.0), np.float32(1.0), np.float32(1.0), np.float32(0.0), np.float32(1.0), np.float32(0.0)]",-1.0,99282.0,31
2025-08-14_08-18-36,8176,"[np.float32(0.0), np.float32(1.0), np.float32(1.0), np.float32(1.0), np.float32(0.0), np.float32(1.0), np.float32(1.0), np.float32(1.0), np.float32(1.0), np.float32(1.0), np.float32(0.0), np.float32(1.0), np.float32(0.0), np.float32(1.0), np.float32(0.0), np.float32(0.0)]",-5.0,99277.0,14
2025-08-14_08-18-36,8177,"[np.float32(1.0), np.float32(0.0), np.float32(0.0), np.float32(1.0), np.float32(1.0), np.float32(0.0), np.float32(0.0), np.float32(0.0), np.float32(0.0), np.float32(0.0), np.float32(0.0), np.float32(0.0), np.float32(0.0), np.float32(0.0), np.float32(0.0), np.float32(1.0)]",0.0,99277.0,15
2025-08-14_08-18-36,8178,"[np.float32(1.0), np.float32(1.0), np.float32(0.0), np.float32(1.0), np.float32(0.0), np.float32(1.0), np.float32(1.0), np.float32(0.0), np.float32(0.0), np.float32(1.0), np.float32(1.0), np.float32(0.0), np.float32(1.0), np.float32(1.0), np.float32(1.0), np.float32(0.0)]",-3.0,99274.0,17
2025-08-14_08-18-36,8179,"[np.float32(0.0), np.float32(1.0), np.float32(1.0), np.float32(0.0), np.float32(0.0), np.float32(1.0), np.float32(0.0), np.float32(1.0), np.float32(0.0), np.float32(1.0), np.float32(0.0), np.float32(0.0), np.float32(0.0), np.float32(0.0), np.float32(0.0), np.float32(0.0)]",-1.0,99273.0,33
2025-08-14_08-18-36,8180,"[np.float32(0.0), np.float32(1.0), np.float32(0.0), np.float32(0.0), np.float32(1.0), np.float32(0.0), np.float32(0.0), np.float32(0.0), np.float32(1.0), np.float32(1.0), np.float32(0.0), np.float32(0.0), np.float32(1.0), np.float32(0.0), np.float32(0.0), np.float32(0.0)]",-5.0,99268.0,21
2025-08-14_08-18-36,8181,"[np.float32(0.0), np.float32(0.0), np.float32(1.0), np.float32(1.0), np.float32(1.0), np.float32(1.0), np.float32(0.0), np.float32(0.0), np.float32(1.0), np.float32(0.0), np.float32(0.0), np.float32(0.0), np.float32(1.0), np.float32(1.0), np.float32(1.0), np.float32(0.0)]",-4.0,99264.0,6
2025-08-14_08-18-36,8182,"[np.float32(0.0), np.float32(1.0), np.float32(0.0), np.float32(0.0), np.float32(0.0), np.float32(0.0), np.float32(1.0), np.float32(1.0), np.float32(0.0), np.float32(0.0), np.float32(0.0), np.float32(0.0), np.float32(1.0), np.float32(1.0), np.float32(0.0), np.float32(0.0)]",0.0,99264.0,35
2025-08-14_08-18-36,8183,"[np.float32(1.0), np.float32(0.0), np.float32(1.0), np.float32(0.0), np.float32(0.0), np.float32(1.0), np.float32(0.0), np.float32(0.0), np.float32(0.0), np.float32(0.0), np.float32(0.0), np.float32(1.0), np.float32(0.0), np.float32(0.0), np.float32(0.0), np.float32(1.0)]",4.0,99268.0,30
2025-08-14_08-18-36,8184,"[np.float32(1.0), np.float32(0.0), np.float32(1.0), np.float32(0.0), np.float32(0.0), np.float32(1.0), np.float32(1.0), np.float32(0.0), np.float32(1.0), np.float32(1.0), np.float32(0.0), np.float32(1.0), np.float32(1.0), np.float32(1.0), np.float32(1.0), np.float32(1.0)]",0.0,99268.0,9
2025-08-14_08-18-36,8185,"[np.float32(0.0), np.float32(1.0), np.float32(0.0), np.float32(0.0), np.float32(1.0), np.float32(1.0), np.float32(1.0), np.float32(0.0), np.float32(1.0), np.float32(0.0), np.float32(1.0), np.float32(0.0), np.float32(0.0), np.float32(0.0), np.float32(1.0), np.float32(0.0)]",0.0,99268.0,31
2025-08-14_08-18-36,8186,"[np.float32(1.0), np.float32(0.0), np.float32(1.0), np.float32(0.0), np.float32(1.0), np.float32(1.0), np.float32(1.0), np.float32(0.0), np.float32(0.0), np.float32(1.0), np.float32(1.0), np.float32(0.0), np.float32(1.0), np.float32(0.0), np.float32(1.0), np.float32(0.0)]",-2.0,99266.0,28
2025-08-14_08-18-36,8187,"[np.float32(0.0), np.float32(0.0), np.float32(1.0), np.float32(1.0), np.float32(0.0), np.float32(1.0), np.float32(1.0), np.float32(1.0), np.float32(0.0), np.float32(0.0), np.float32(0.0), np.float32(0.0), np.float32(0.0), np.float32(1.0), np.float32(0.0), np.float32(0.0)]",-1.0,99265.0,5
2025-08-14_08-18-36,8188,"[np.float32(0.0), np.float32(0.0), np.float32(1.0), np.float32(0.0), np.float32(1.0), np.float32(0.0), np.float32(0.0), np.float32(0.0), np.float32(1.0), np.float32(1.0), np.float32(1.0), np.float32(1.0), np.float32(1.0), np.float32(0.0), np.float32(0.0), np.float32(0.0)]",0.0,99265.0,18
2025-08-14_08-18-36,8189,"[np.float32(1.0), np.float32(1.0), np.float32(1.0), np.float32(1.0), np.float32(1.0), np.float32(1.0), np.float32(0.0), np.float32(1.0), np.float32(1.0), np.float32(0.0), np.float32(1.0), np.float32(1.0), np.float32(0.0), np.float32(0.0), np.float32(0.0), np.float32(0.0)]",2.0,99267.0,15
2025-08-14_08-18-36,8190,"[np.float32(1.0), np.float32(1.0), np.float32(1.0), np.float32(1.0), np.float32(0.0), np.float32(1.0), np.float32(1.0), np.float32(1.0), np.float32(1.0), np.float32(0.0), np.float32(0.0), np.float32(0.0), np.float32(0.0), np.float32(1.0), np.float32(0.0), np.float32(1.0)]",0.0,99267.0,6
2025-08-14_08-18-36,8191,"[np.float32(1.0), np.float32(0.0), np.float32(0.0), np.float32(0.0), np.float32(1.0), np.float32(1.0), np.float32(0.0), np.float32(0.0), np.float32(1.0), np.float32(1.0), np.float32(0.0), np.float32(1.0), np.float32(0.0), np.float32(0.0), np.float32(0.0), np.float32(0.0)]",-2.0,99265.0,5
2025-08-14_08-18-36,8192,"[np.float32(0.0), np.float32(0.0), np.float32(0.0), np.float32(0.0), np.float32(0.0), np.float32(0.0), np.float32(1.0), np.float32(0.0), np.float32(1.0), np.float32(0.0), np.float32(0.0), np.float32(0.0), np.float32(0.0), np.float32(0.0), np.float32(1.0), np.float32(0.0)]",0.0,99265.0,32
2025-08-14_08-18-36,8193,"[np.float32(1.0), np.float32(0.0), np.float32(0.0), np.float32(1.0), np.float32(0.0), np.float32(1.0), np.float32(0.0), np.float32(1.0), np.float32(1.0), np.float32(1.0), np.float32(1.0), np.float32(0.0), np.float32(1.0), np.float32(0.0), np.float32(0.0), np.float32(0.0)]",-1.0,99264.0,1
2025-08-14_08-18-36,8194,"[np.float32(1.0), np.float32(0.0), np.float32(0.0), np.float32(0.0), np.float32(0.0), np.float32(1.0), np.float32(1.0), np.float32(1.0), np.float32(0.0), np.float32(1.0), np.float32(0.0), np.float32(1.0), np.float32(0.0), np.float32(0.0), np.float32(0.0), np.float32(1.0)]",4.0,99268.0,9
2025-08-14_08-18-36,8195,"[np.float32(1.0), np.float32(0.0), np.float32(0.0), np.float32(0.0), np.float32(0.0), np.float32(0.0), np.float32(1.0), np.float32(1.0), np.float32(0.0), np.float32(1.0), np.float32(1.0), np.float32(1.0), np.float32(0.0), np.float32(0.0), np.float32(1.0), np.float32(0.0)]",-4.0,99264.0,26
2025-08-14_08-18-36,8196,"[np.float32(1.0), np.float32(0.0), np.float32(0.0), np.float32(1.0), np.float32(0.0), np.float32(1.0), np.float32(1.0), np.float32(0.0), np.float32(1.0), np.float32(1.0), np.float32(1.0), np.float32(0.0), np.float32(0.0), np.float32(1.0), np.float32(1.0), np.float32(0.0)]",3.0,99267.0,27
2025-08-14_08-18-36,8197,"[np.float32(0.0), np.float32(1.0), np.float32(0.0), np.float32(1.0), np.float32(1.0), np.float32(1.0), np.float32(0.0), np.float32(0.0), np.float32(1.0), np.float32(1.0), np.float32(1.0), np.float32(0.0), np.float32(1.0), np.float32(0.0), np.float32(0.0), np.float32(1.0)]",0.0,99267.0,13
2025-08-14_08-18-36,8198,"[np.float32(1.0), np.float32(1.0), np.float32(1.0), np.float32(0.0), np.float32(0.0), np.float32(1.0), np.float32(0.0), np.float32(1.0), np.float32(0.0), np.float32(0.0), np.float32(0.0), np.float32(0.0), np.float32(0.0), np.float32(0.0), np.float32(1.0), np.float32(0.0)]",4.0,99271.0,23
2025-08-14_08-18-36,8199,"[np.float32(0.0), np.float32(0.0), np.float32(1.0), np.float32(1.0), np.float32(0.0), np.float32(1.0), np.float32(0.0), np.float32(1.0), np.float32(1.0), np.float32(1.0), np.float32(1.0), np.float32(0.0), np.float32(1.0), np.float32(1.0), np.float32(1.0), np.float32(0.0)]",3.0,99274.0,29
2025-08-14_08-18-36,8200,"[np.float32(0.0), np.float32(0.0), np.float32(1.0), np.float32(0.0), np.float32(1.0), np.float32(0.0), np.float32(1.0), np.float32(1.0), np.float32(0.0), np.float32(1.0), np.float32(1.0), np.float32(0.0), np.float32(0.0), np.float32(0.0), np.float32(1.0), np.float32(0.0)]",0.0,99274.0,12
2025-08-14_08-18-36,8201,"[np.float32(0.0), np.float32(1.0), np.float32(1.0), np.float32(1.0), np.float32(0.0), np.float32(0.0), np.float32(1.0), np.float32(0.0), np.float32(0.0), np.float32(0.0), np.float32(0.0), np.float32(1.0), np.float32(1.0), np.float32(0.0), np.float32(0.0), np.float32(0.0)]",-1.0,99273.0,5
2025-08-14_08-18-36,8202,"[np.float32(0.0), np.float32(0.0), np.float32(0.0), np.float32(1.0), np.float32(1.0), np.float32(1.0), np.float32(0.0), np.float32(1.0), np.float32(0.0), np.float32(0.0), np.float32(0.0), np.float32(0.0), np.float32(1.0), np.float32(0.0), np.float32(1.0), np.float32(0.0)]",-4.0,99269.0,28
2025-08-14_08-18-36,8203,"[np.float32(1.0), np.float32(0.0), np.float32(1.0), np.float32(0.0), np.float32(0.0), np.float32(0.0), np.float32(1.0), np.float32(0.0), np.float32(1.0), np.float32(1.0), np.float32(0.0), np.float32(1.0), np.float32(1.0), np.float32(0.0), np.float32(0.0), np.float32(0.0)]",1.0,99270.0,9
2025-08-14_08-18-36,8204,"[np.float32(0.0), np.float32(1.0), np.float32(0.0), np.float32(0.0), np.float32(0.0), np.float32(1.0), np.float32(1.0), np.float32(0.0), np.float32(0.0), np.float32(1.0), np.float32(0.0), np.float32(0.0), np.float32(0.0), np.float32(1.0), np.float32(0.0), np.float32(1.0)]",-1.0,99269.0,17
2025-08-14_08-18-36,8205,"[np.float32(0.0), np.float32(1.0), np.float32(0.0), np.float32(1.0), np.float32(1.0), np.float32(1.0), np.float32(1.0), np.float32(1.0), np.float32(1.0), np.float32(1.0), np.float32(0.0), np.float32(0.0), np.float32(0.0), np.float32(1.0), np.float32(1.0), np.float32(0.0)]",0.0,99269.0,5
2025-08-14_08-18-36,8206,"[np.float32(1.0), np.float32(0.0), np.float32(0.0), np.float32(1.0), np.float32(0.0), np.float32(0.0), np.float32(1.0), np.float32(0.0), np.float32(1.0), np.float32(0.0), np.float32(0.0), np.float32(1.0), np.float32(1.0), np.float32(1.0), np.float32(1.0), np.float32(0.0)]",2.0,99271.0,9
2025-08-14_08-18-36,8207,"[np.float32(1.0), np.float32(1.0), np.float32(0.0), np.float32(1.0), np.float32(0.0), np.float32(0.0), np.float32(1.0), np.float32(0.0), np.float32(1.0), np.float32(0.0), np.float32(1.0), np.float32(0.0), np.float32(0.0), np.float32(1.0), np.float32(1.0), np.float32(0.0)]",5.0,99276.0,35
2025-08-14_08-18-36,8208,"[np.float32(0.0), np.float32(0.0), np.float32(0.0), np.float32(1.0), np.float32(0.0), np.float32(0.0), np.float32(0.0), np.float32(1.0), np.float32(0.0), np.float32(0.0), np.float32(1.0), np.float32(1.0), np.float32(1.0), np.float32(0.0), np.float32(0.0), np.float32(0.0)]",0.0,99276.0,3
2025-08-14_08-18-36,8209,"[np.float32(1.0), np.float32(1.0), np.float32(1.0), np.float32(1.0), np.float32(1.0), np.float32(1.0), np.float32(1.0), np.float32(0.0), np.float32(1.0), np.float32(1.0), np.float32(0.0), np.float32(0.0), np.float32(1.0), np.float32(0.0), np.float32(0.0), np.float32(0.0)]",2.0,99278.0,31
2025-08-14_08-18-36,8210,"[np.float32(1.0), np.float32(1.0), np.float32(0.0), np.float32(0.0), np.float32(1.0), np.float32(0.0), np.float32(1.0), np.float32(1.0), np.float32(0.0), np.float32(0.0), np.float32(1.0), np.float32(0.0), np.float32(1.0), np.float32(1.0), np.float32(0.0), np.float32(0.0)]",-3.0,99275.0,28
2025-08-14_08-18-36,8211,"[np.float32(0.0), np.float32(0.0), np.float32(0.0), np.float32(0.0), np.float32(0.0), np.float32(1.0), np.float32(0.0), np.float32(0.0), np.float32(0.0), np.float32(0.0), np.float32(1.0), np.float32(1.0), np.float32(1.0), np.float32(1.0), np.float32(0.0), np.float32(0.0)]",-2.0,99273.0,9
2025-08-14_08-18-36,8212,"[np.float32(1.0), np.float32(0.0), np.float32(1.0), np.float32(0.0), np.float32(0.0), np.float32(1.0), np.float32(0.0), np.float32(0.0), np.float32(1.0), np.float32(0.0), np.float32(1.0), np.float32(1.0), np.float32(0.0), np.float32(0.0), np.float32(0.0), np.float32(0.0)]",1.0,99274.0,24
2025-08-14_08-18-36,8213,"[np.float32(1.0), np.float32(1.0), np.float32(0.0), np.float32(0.0), np.float32(0.0), np.float32(1.0), np.float32(1.0), np.float32(1.0), np.float32(0.0), np.float32(1.0), np.float32(1.0), np.float32(1.0), np.float32(0.0), np.float32(1.0), np.float32(1.0), np.float32(0.0)]",1.0,99275.0,16
2025-08-14_08-18-36,8214,"[np.float32(1.0), np.float32(0.0), np.float32(1.0), np.float32(1.0), np.float32(0.0), np.float32(1.0), np.float32(0.0), np.float32(1.0), np.float32(1.0), np.float32(0.0), np.float32(1.0), np.float32(1.0), np.float32(0.0), np.float32(0.0), np.float32(1.0), np.float32(1.0)]",-5.0,99270.0,10
2025-08-14_08-18-36,8215,"[np.float32(1.0), np.float32(1.0), np.float32(1.0), np.float32(1.0), np.float32(0.0), np.float32(0.0), np.float32(1.0), np.float32(1.0), np.float32(1.0), np.float32(1.0), np.float32(0.0), np.float32(0.0), np.float32(1.0), np.float32(0.0), np.float32(0.0), np.float32(1.0)]",36.0,99306.0,7
2025-08-14_08-18-36,8216,"[np.float32(1.0), np.float32(0.0), np.float32(1.0), np.float32(0.0), np.float32(0.0), np.float32(0.0), np.float32(0.0), np.float32(1.0), np.float32(1.0), np.float32(1.0), np.float32(0.0), np.float32(0.0), np.float32(0.0), np.float32(0.0), np.float32(0.0), np.float32(1.0)]",-1.0,99305.0,24
2025-08-14_08-18-36,8217,"[np.float32(0.0), np.float32(0.0), np.float32(0.0), np.float32(0.0), np.float32(0.0), np.float32(0.0), np.float32(0.0), np.float32(0.0), np.float32(0.0), np.float32(0.0), np.float32(1.0), np.float32(1.0), np.float32(1.0), np.float32(1.0), np.float32(0.0), np.float32(0.0)]",-1.0,99304.0,11
2025-08-14_08-18-36,8218,"[np.float32(1.0), np.float32(0.0), np.float32(1.0), np.float32(1.0), np.float32(0.0), np.float32(1.0), np.float32(0.0), np.float32(1.0), np.float32(0.0), np.float32(0.0), np.float32(1.0), np.float32(1.0), np.float32(0.0), np.float32(0.0), np.float32(1.0), np.float32(1.0)]",-2.0,99302.0,35
2025-08-14_08-18-36,8219,"[np.float32(0.0), np.float32(0.0), np.float32(1.0), np.float32(0.0), np.float32(0.0), np.float32(1.0), np.float32(1.0), np.float32(1.0), np.float32(1.0), np.float32(1.0), np.float32(1.0), np.float32(1.0), np.float32(1.0), np.float32(0.0), np.float32(0.0), np.float32(0.0)]",1.0,99303.0,34
2025-08-14_08-18-36,8220,"[np.float32(1.0), np.float32(1.0), np.float32(0.0), np.float32(1.0), np.float32(0.0), np.float32(1.0), np.float32(0.0), np.float32(1.0), np.float32(1.0), np.float32(1.0), np.float32(1.0), np.float32(1.0), np.float32(1.0), np.float32(1.0), np.float32(1.0), np.float32(0.0)]",3.0,99306.0,23
2025-08-14_08-18-36,8221,"[np.float32(0.0), np.float32(1.0), np.float32(1.0), np.float32(0.0), np.float32(0.0), np.float32(1.0), np.float32(0.0), np.float32(1.0), np.float32(1.0), np.float32(0.0), np.float32(1.0), np.float32(0.0), np.float32(1.0), np.float32(0.0), np.float32(0.0), np.float32(1.0)]",2.0,99308.0,32
2025-08-14_08-18-36,8222,"[np.float32(0.0), np.float32(0.0), np.float32(1.0), np.float32(1.0), np.float32(1.0), np.float32(1.0), np.float32(1.0), np.float32(1.0), np.float32(1.0), np.float32(0.0), np.float32(0.0), np.float32(1.0), np.float32(1.0), np.float32(0.0), np.float32(0.0), np.float32(0.0)]",1.0,99309.0,3
2025-08-14_08-18-36,8223,"[np.float32(0.0), np.float32(1.0), np.float32(0.0), np.float32(1.0), np.float32(0.0), np.float32(0.0), np.float32(1.0), np.float32(1.0), np.float32(1.0), np.float32(0.0), np.float32(0.0), np.float32(0.0), np.float32(0.0), np.float32(0.0), np.float32(0.0), np.float32(1.0)]",-1.0,99308.0,2
2025-08-14_08-18-36,8224,"[np.float32(1.0), np.float32(1.0), np.float32(1.0), np.float32(0.0), np.float32(0.0), np.float32(0.0), np.float32(1.0), np.float32(0.0), np.float32(0.0), np.float32(0.0), np.float32(0.0), np.float32(0.0), np.float32(0.0), np.float32(1.0), np.float32(0.0), np.float32(1.0)]",-2.0,99306.0,16
2025-08-14_08-18-36,8225,"[np.float32(1.0), np.float32(0.0), np.float32(1.0), np.float32(0.0), np.float32(0.0), np.float32(1.0), np.float32(1.0), np.float32(1.0), np.float32(1.0), np.float32(1.0), np.float32(0.0), np.float32(0.0), np.float32(1.0), np.float32(0.0), np.float32(1.0), np.float32(1.0)]",2.0,99308.0,36
2025-08-14_08-18-36,8226,"[np.float32(0.0), np.float32(1.0), np.float32(0.0), np.float32(1.0), np.float32(0.0), np.float32(1.0), np.float32(0.0), np.float32(1.0), np.float32(0.0), np.float32(1.0), np.float32(1.0), np.float32(1.0), np.float32(0.0), np.float32(1.0), np.float32(0.0), np.float32(1.0)]",0.0,99308.0,14
2025-08-14_08-18-36,8227,"[np.float32(0.0), np.float32(1.0), np.float32(1.0), np.float32(1.0), np.float32(1.0), np.float32(1.0), np.float32(1.0), np.float32(1.0), np.float32(1.0), np.float32(0.0), np.float32(0.0), np.float32(0.0), np.float32(0.0), np.float32(0.0), np.float32(0.0), np.float32(1.0)]",0.0,99308.0,13
2025-08-14_08-18-36,8228,"[np.float32(0.0), np.float32(0.0), np.float32(0.0), np.float32(0.0), np.float32(0.0), np.float32(1.0), np.float32(1.0), np.float32(1.0), np.float32(1.0), np.float32(1.0), np.float32(1.0), np.float32(1.0), np.float32(1.0), np.float32(1.0), np.float32(1.0), np.float32(0.0)]",-1.0,99307.0,10
2025-08-14_08-18-36,8229,"[np.float32(1.0), np.float32(1.0), np.float32(1.0), np.float32(0.0), np.float32(1.0), np.float32(0.0), np.float32(1.0), np.float32(1.0), np.float32(0.0), np.float32(1.0), np.float32(1.0), np.float32(0.0), np.float32(1.0), np.float32(1.0), np.float32(1.0), np.float32(0.0)]",-1.0,99306.0,32
2025-08-14_08-18-36,8230,"[np.float32(0.0), np.float32(0.0), np.float32(0.0), np.float32(1.0), np.float32(1.0), np.float32(1.0), np.float32(0.0), np.float32(1.0), np.float32(0.0), np.float32(0.0), np.float32(1.0), np.float32(0.0), np.float32(0.0), np.float32(1.0), np.float32(0.0), np.float32(0.0)]",-2.0,99304.0,1
2025-08-14_08-18-36,8231,"[np.float32(0.0), np.float32(1.0), np.float32(1.0), np.float32(0.0), np.float32(0.0), np.float32(1.0), np.float32(0.0), np.float32(0.0), np.float32(1.0), np.float32(0.0), np.float32(0.0), np.float32(0.0), np.float32(1.0), np.float32(0.0), np.float32(0.0), np.float32(1.0)]",-4.0,99300.0,15
2025-08-14_08-18-36,8232,"[np.float32(1.0), np.float32(0.0), np.float32(0.0), np.float32(1.0), np.float32(0.0), np.float32(0.0), np.float32(1.0), np.float32(1.0), np.float32(1.0), np.float32(0.0), np.float32(1.0), np.float32(1.0), np.float32(1.0), np.float32(1.0), np.float32(0.0), np.float32(0.0)]",1.0,99301.0,9
2025-08-14_08-18-36,8233,"[np.float32(0.0), np.float32(1.0), np.float32(1.0), np.float32(0.0), np.float32(0.0), np.float32(0.0), np.float32(0.0), np.float32(0.0), np.float32(1.0), np.float32(0.0), np.float32(0.0), np.float32(0.0), np.float32(1.0), np.float32(1.0), np.float32(0.0), np.float32(1.0)]",-2.0,99299.0,24
2025-08-14_08-18-36,8234,"[np.float32(1.0), np.float32(1.0), np.float32(1.0), np.float32(1.0), np.float32(1.0), np.float32(0.0), np.float32(1.0), np.float32(1.0), np.float32(0.0), np.float32(1.0), np.float32(1.0), np.float32(0.0), np.float32(0.0), np.float32(1.0), np.float32(1.0), np.float32(1.0)]",-2.0,99297.0,21
2025-08-14_08-18-36,8235,"[np.float32(0.0), np.float32(1.0), np.float32(0.0), np.float32(0.0), np.float32(1.0), np.float32(1.0), np.float32(1.0), np.float32(1.0), np.float32(0.0), np.float32(1.0), np.float32(0.0), np.float32(1.0), np.float32(0.0), np.float32(1.0), np.float32(0.0), np.float32(0.0)]",2.0,99299.0,28
2025-08-14_08-18-36,8236,"[np.float32(1.0), np.float32(1.0), np.float32(1.0), np.float32(0.0), np.float32(0.0), np.float32(1.0), np.float32(0.0), np.float32(1.0), np.float32(1.0), np.float32(0.0), np.float32(0.0), np.float32(1.0), np.float32(0.0), np.float32(0.0), np.float32(0.0), np.float32(1.0)]",1.0,99300.0,28
2025-08-14_08-18-36,8237,"[np.float32(1.0), np.float32(1.0), np.float32(1.0), np.float32(0.0), np.float32(0.0), np.float32(1.0), np.float32(1.0), np.float32(0.0), np.float32(1.0), np.float32(0.0), np.float32(0.0), np.float32(1.0), np.float32(0.0), np.float32(1.0), np.float32(0.0), np.float32(1.0)]",4.0,99304.0,12
2025-08-14_08-18-36,8238,"[np.float32(0.0), np.float32(0.0), np.float32(1.0), np.float32(0.0), np.float32(1.0), np.float32(1.0), np.float32(0.0), np.float32(0.0), np.float32(1.0), np.float32(1.0), np.float32(1.0), np.float32(0.0), np.float32(0.0), np.float32(1.0), np.float32(1.0), np.float32(0.0)]",5.0,99309.0,26
2025-08-14_08-18-36,8239,"[np.float32(1.0), np.float32(1.0), np.float32(1.0), np.float32(1.0), np.float32(1.0), np.float32(1.0), np.float32(0.0), np.float32(0.0), np.float32(1.0), np.float32(0.0), np.float32(0.0), np.float32(1.0), np.float32(0.0), np.float32(0.0), np.float32(1.0), np.float32(0.0)]",0.0,99309.0,32
2025-08-14_08-18-36,8240,"[np.float32(1.0), np.float32(1.0), np.float32(1.0), np.float32(1.0), np.float32(0.0), np.float32(1.0), np.float32(1.0), np.float32(1.0), np.float32(1.0), np.float32(0.0), np.float32(1.0), np.float32(0.0), np.float32(1.0), np.float32(1.0), np.float32(0.0), np.float32(1.0)]",3.0,99312.0,32
2025-08-14_08-18-36,8241,"[np.float32(1.0), np.float32(1.0), np.float32(0.0), np.float32(1.0), np.float32(1.0), np.float32(0.0), np.float32(1.0), np.float32(1.0), np.float32(0.0), np.float32(0.0), np.float32(0.0), np.float32(0.0), np.float32(0.0), np.float32(1.0), np.float32(0.0), np.float32(0.0)]",-2.0,99310.0,0
2025-08-14_08-18-36,8242,"[np.float32(1.0), np.float32(0.0), np.float32(0.0), np.float32(0.0), np.float32(1.0), np.float32(1.0), np.float32(1.0), np.float32(1.0), np.float32(0.0), np.float32(0.0), np.float32(1.0), np.float32(1.0), np.float32(0.0), np.float32(1.0), np.float32(0.0), np.float32(0.0)]",0.0,99310.0,24
2025-08-14_08-18-36,8243,"[np.float32(0.0), np.float32(0.0), np.float32(0.0), np.float32(0.0), np.float32(1.0), np.float32(1.0), np.float32(0.0), np.float32(1.0), np.float32(1.0), np.float32(0.0), np.float32(0.0), np.float32(0.0), np.float32(1.0), np.float32(0.0), np.float32(0.0), np.float32(0.0)]",0.0,99310.0,34
2025-08-14_08-18-36,8244,"[np.float32(0.0), np.float32(1.0), np.float32(0.0), np.float32(0.0), np.float32(1.0), np.float32(1.0), np.float32(1.0), np.float32(1.0), np.float32(1.0), np.float32(0.0), np.float32(0.0), np.float32(0.0), np.float32(0.0), np.float32(1.0), np.float32(1.0), np.float32(0.0)]",0.0,99310.0,30
2025-08-14_08-18-36,8245,"[np.float32(1.0), np.float32(0.0), np.float32(0.0), np.float32(0.0), np.float32(1.0), np.float32(1.0), np.float32(1.0), np.float32(1.0), np.float32(1.0), np.float32(1.0), np.float32(1.0), np.float32(0.0), np.float32(1.0), np.float32(0.0), np.float32(0.0), np.float32(0.0)]",1.0,99311.0,1
2025-08-14_08-18-36,8246,"[np.float32(0.0), np.float32(0.0), np.float32(0.0), np.float32(0.0), np.float32(0.0), np.float32(0.0), np.float32(1.0), np.float32(1.0), np.float32(0.0), np.float32(0.0), np.float32(0.0), np.float32(0.0), np.float32(1.0), np.float32(1.0), np.float32(0.0), np.float32(0.0)]",-1.0,99310.0,26
2025-08-14_08-18-36,8247,"[np.float32(0.0), np.float32(0.0), np.float32(0.0), np.float32(1.0), np.float32(0.0), np.float32(1.0), np.float32(1.0), np.float32(1.0), np.float32(1.0), np.float32(1.0), np.float32(0.0), np.float32(0.0), np.float32(1.0), np.float32(1.0), np.float32(0.0), np.float32(0.0)]",-3.0,99307.0,17
2025-08-14_08-18-36,8248,"[np.float32(1.0), np.float32(0.0), np.float32(0.0), np.float32(1.0), np.float32(1.0), np.float32(0.0), np.float32(0.0), np.float32(1.0), np.float32(0.0), np.float32(1.0), np.float32(0.0), np.float32(0.0), np.float32(1.0), np.float32(0.0), np.float32(1.0), np.float32(0.0)]",-1.0,99306.0,9
2025-08-14_08-18-36,8249,"[np.float32(1.0), np.float32(0.0), np.float32(0.0), np.float32(0.0), np.float32(1.0), np.float32(1.0), np.float32(0.0), np.float32(1.0), np.float32(0.0), np.float32(1.0), np.float32(0.0), np.float32(1.0), np.float32(0.0), np.float32(0.0), np.float32(1.0), np.float32(0.0)]",3.0,99309.0,19
2025-08-14_08-18-36,8250,"[np.float32(1.0), np.float32(0.0), np.float32(0.0), np.float32(1.0), np.float32(1.0), np.float32(0.0), np.float32(1.0), np.float32(1.0), np.float32(0.0), np.float32(0.0), np.float32(0.0), np.float32(0.0), np.float32(1.0), np.float32(1.0), np.float32(0.0), np.float32(1.0)]",-3.0,99306.0,31
2025-08-14_08-18-36,8251,"[np.float32(1.0), np.float32(0.0), np.float32(0.0), np.float32(1.0), np.float32(0.0), np.float32(1.0), np.float32(0.0), np.float32(1.0), np.float32(1.0), np.float32(0.0), np.float32(0.0), np.float32(0.0), np.float32(0.0), np.float32(1.0), np.float32(1.0), np.float32(0.0)]",0.0,99306.0,31
2025-08-14_08-18-36,8252,"[np.float32(1.0), np.float32(1.0), np.float32(1.0), np.float32(1.0), np.float32(0.0), np.float32(0.0), np.float32(1.0), np.float32(0.0), np.float32(0.0), np.float32(1.0), np.float32(0.0), np.float32(0.0), np.float32(0.0), np.float32(0.0), np.float32(0.0), np.float32(0.0)]",-2.0,99304.0,0
2025-08-14_08-18-36,8253,"[np.float32(1.0), np.float32(0.0), np.float32(1.0), np.float32(0.0), np.float32(0.0), np.float32(1.0), np.float32(0.0), np.float32(1.0), np.float32(1.0), np.float32(0.0), np.float32(1.0), np.float32(1.0), np.float32(0.0), np.float32(0.0), np.float32(0.0), np.float32(1.0)]",-1.0,99303.0,19
2025-08-14_08-18-36,8254,"[np.float32(1.0), np.float32(0.0), np.float32(0.0), np.float32(1.0), np.float32(0.0), np.float32(1.0), np.float32(0.0), np.float32(1.0), np.float32(0.0), np.float32(0.0), np.float32(1.0), np.float32(1.0), np.float32(0.0), np.float32(1.0), np.float32(1.0), np.float32(0.0)]",-1.0,99302.0,7
2025-08-14_08-18-36,8255,"[np.float32(1.0), np.float32(1.0), np.float32(1.0), np.float32(0.0), np.float32(1.0), np.float32(1.0), np.float32(1.0), np.float32(0.0), np.float32(0.0), np.float32(1.0), np.float32(1.0), np.float32(0.0), np.float32(1.0), np.float32(1.0), np.float32(1.0), np.float32(1.0)]",-5.0,99297.0,21
2025-08-14_08-18-36,8256,"[np.float32(0.0), np.float32(0.0), np.float32(0.0), np.float32(1.0), np.float32(1.0), np.float32(0.0), np.float32(1.0), np.float32(1.0), np.float32(1.0), np.float32(1.0), np.float32(0.0), np.float32(1.0), np.float32(1.0), np.float32(0.0), np.float32(0.0), np.float32(0.0)]",-2.0,99295.0,28
2025-08-14_08-18-36,8257,"[np.float32(0.0), np.float32(1.0), np.float32(1.0), np.float32(1.0), np.float32(0.0), np.float32(0.0), np.float32(1.0), np.float32(1.0), np.float32(1.0), np.float32(0.0), np.float32(1.0), np.float32(0.0), np.float32(1.0), np.float32(1.0), np.float32(0.0), np.float32(0.0)]",2.0,99297.0,32
2025-08-14_08-18-36,8258,"[np.float32(1.0), np.float32(0.0), np.float32(0.0), np.float32(0.0), np.float32(0.0), np.float32(1.0), np.float32(1.0), np.float32(1.0), np.float32(1.0), np.float32(0.0), np.float32(0.0), np.float32(0.0), np.float32(0.0), np.float32(0.0), np.float32(0.0), np.float32(0.0)]",-2.0,99295.0,11
2025-08-14_08-18-36,8259,"[np.float32(1.0), np.float32(1.0), np.float32(1.0), np.float32(1.0), np.float32(1.0), np.float32(1.0), np.float32(0.0), np.float32(1.0), np.float32(1.0), np.float32(0.0), np.float32(0.0), np.float32(0.0), np.float32(1.0), np.float32(1.0), np.float32(1.0), np.float32(1.0)]",-3.0,99292.0,0
2025-08-14_08-18-36,8260,"[np.float32(0.0), np.float32(0.0), np.float32(0.0), np.float32(0.0), np.float32(1.0), np.float32(1.0), np.float32(0.0), np.float32(1.0), np.float32(0.0), np.float32(1.0), np.float32(1.0), np.float32(1.0), np.float32(0.0), np.float32(1.0), np.float32(1.0), np.float32(1.0)]",-1.0,99291.0,34
2025-08-14_08-18-36,8261,"[np.float32(0.0), np.float32(0.0), np.float32(1.0), np.float32(0.0), np.float32(0.0), np.float32(0.0), np.float32(0.0), np.float32(1.0), np.float32(0.0), np.float32(1.0), np.float32(0.0), np.float32(0.0), np.float32(0.0), np.float32(1.0), np.float32(0.0), np.float32(0.0)]",-1.0,99290.0,3
2025-08-14_08-18-36,8262,"[np.float32(0.0), np.float32(1.0), np.float32(0.0), np.float32(0.0), np.float32(0.0), np.float32(1.0), np.float32(0.0), np.float32(0.0), np.float32(1.0), np.float32(0.0), np.float32(0.0), np.float32(0.0), np.float32(0.0), np.float32(0.0), np.float32(0.0), np.float32(0.0)]",-1.0,99289.0,17
2025-08-14_08-18-36,8263,"[np.float32(0.0), np.float32(0.0), np.float32(0.0), np.float32(0.0), np.float32(0.0), np.float32(1.0), np.float32(1.0), np.float32(1.0), np.float32(1.0), np.float32(1.0), np.float32(1.0), np.float32(1.0), np.float32(0.0), np.float32(1.0), np.float32(0.0), np.float32(0.0)]",1.0,99290.0,18
2025-08-14_08-18-36,8264,"[np.float32(0.0), np.float32(1.0), np.float32(0.0), np.float32(0.0), np.float32(0.0), np.float32(1.0), np.float32(1.0), np.float32(1.0), np.float32(0.0), np.float32(0.0), np.float32(1.0), np.float32(0.0), np.float32(0.0), np.float32(0.0), np.float32(0.0), np.float32(1.0)]",2.0,99292.0,2
2025-08-14_08-18-36,8265,"[np.float32(1.0), np.float32(0.0), np.float32(1.0), np.float32(1.0), np.float32(1.0), np.float32(1.0), np.float32(1.0), np.float32(0.0), np.float32(1.0), np.float32(0.0), np.float32(0.0), np.float32(0.0), np.float32(1.0), np.float32(1.0), np.float32(0.0), np.float32(1.0)]",-1.0,99291.0,5
2025-08-14_08-18-36,8266,"[np.float32(0.0), np.float32(0.0), np.float32(1.0), np.float32(0.0), np.float32(1.0), np.float32(0.0), np.float32(0.0), np.float32(1.0), np.float32(0.0), np.float32(0.0), np.float32(0.0), np.float32(1.0), np.float32(1.0), np.float32(0.0), np.float32(0.0), np.float32(1.0)]",1.0,99292.0,16
2025-08-14_08-18-36,8267,"[np.float32(0.0), np.float32(0.0), np.float32(0.0), np.float32(1.0), np.float32(1.0), np.float32(0.0), np.float32(1.0), np.float32(1.0), np.float32(0.0), np.float32(0.0), np.float32(0.0), np.float32(0.0), np.float32(0.0), np.float32(1.0), np.float32(0.0), np.float32(0.0)]",5.0,99297.0,15
2025-08-14_08-18-36,8268,"[np.float32(0.0), np.float32(0.0), np.float32(1.0), np.float32(0.0), np.float32(0.0), np.float32(1.0), np.float32(1.0), np.float32(0.0), np.float32(0.0), np.float32(1.0), np.float32(0.0), np.float32(0.0), np.float32(0.0), np.float32(0.0), np.float32(0.0), np.float32(1.0)]",-2.0,99295.0,3
2025-08-14_08-18-36,8269,"[np.float32(0.0), np.float32(0.0), np.float32(0.0), np.float32(0.0), np.float32(0.0), np.float32(0.0), np.float32(1.0), np.float32(1.0), np.float32(1.0), np.float32(1.0), np.float32(0.0), np.float32(1.0), np.float32(1.0), np.float32(1.0), np.float32(0.0), np.float32(0.0)]",-1.0,99294.0,16
2025-08-14_08-18-36,8270,"[np.float32(0.0), np.float32(1.0), np.float32(1.0), np.float32(1.0), np.float32(1.0), np.float32(1.0), np.float32(0.0), np.float32(1.0), np.float32(1.0), np.float32(1.0), np.float32(1.0), np.float32(1.0), np.float32(0.0), np.float32(0.0), np.float32(1.0), np.float32(0.0)]",4.0,99298.0,33
2025-08-14_08-18-36,8271,"[np.float32(0.0), np.float32(0.0), np.float32(0.0), np.float32(1.0), np.float32(0.0), np.float32(1.0), np.float32(1.0), np.float32(1.0), np.float32(1.0), np.float32(0.0), np.float32(1.0), np.float32(1.0), np.float32(0.0), np.float32(0.0), np.float32(1.0), np.float32(0.0)]",-5.0,99293.0,4
2025-08-14_08-18-36,8272,"[np.float32(1.0), np.float32(0.0), np.float32(1.0), np.float32(1.0), np.float32(1.0), np.float32(1.0), np.float32(1.0), np.float32(0.0), np.float32(0.0), np.float32(1.0), np.float32(0.0), np.float32(0.0), np.float32(1.0), np.float32(0.0), np.float32(0.0), np.float32(0.0)]",-4.0,99289.0,24
2025-08-14_08-18-36,8273,"[np.float32(1.0), np.float32(1.0), np.float32(1.0), np.float32(0.0), np.float32(1.0), np.float32(1.0), np.float32(1.0), np.float32(1.0), np.float32(1.0), np.float32(1.0), np.float32(1.0), np.float32(0.0), np.float32(1.0), np.float32(0.0), np.float32(1.0), np.float32(1.0)]",-1.0,99288.0,4
2025-08-14_08-18-36,8274,"[np.float32(0.0), np.float32(0.0), np.float32(0.0), np.float32(0.0), np.float32(0.0), np.float32(1.0), np.float32(1.0), np.float32(0.0), np.float32(1.0), np.float32(0.0), np.float32(1.0), np.float32(0.0), np.float32(1.0), np.float32(1.0), np.float32(0.0), np.float32(0.0)]",-1.0,99287.0,23
2025-08-14_08-18-36,8275,"[np.float32(1.0), np.float32(0.0), np.float32(0.0), np.float32(0.0), np.float32(0.0), np.float32(0.0), np.float32(0.0), np.float32(1.0), np.float32(0.0), np.float32(0.0), np.float32(0.0), np.float32(0.0), np.float32(1.0), np.float32(0.0), np.float32(0.0), np.float32(1.0)]",-2.0,99285.0,12
2025-08-14_08-18-36,8276,"[np.float32(0.0), np.float32(1.0), np.float32(0.0), np.float32(1.0), np.float32(1.0), np.float32(1.0), np.float32(0.0), np.float32(1.0), np.float32(0.0), np.float32(1.0), np.float32(1.0), np.float32(0.0), np.float32(1.0), np.float32(0.0), np.float32(0.0), np.float32(1.0)]",-5.0,99280.0,3
2025-08-14_08-18-36,8277,"[np.float32(1.0), np.float32(0.0), np.float32(1.0), np.float32(1.0), np.float32(0.0), np.float32(1.0), np.float32(1.0), np.float32(1.0), np.float32(0.0), np.float32(0.0), np.float32(0.0), np.float32(0.0), np.float32(1.0), np.float32(1.0), np.float32(0.0), np.float32(1.0)]",-3.0,99277.0,27
2025-08-14_08-18-36,8278,"[np.float32(0.0), np.float32(1.0), np.float32(0.0), np.float32(1.0), np.float32(1.0), np.float32(0.0), np.float32(1.0), np.float32(1.0), np.float32(0.0), np.float32(0.0), np.float32(1.0), np.float32(1.0), np.float32(1.0), np.float32(1.0), np.float32(1.0), np.float32(1.0)]",-5.0,99272.0,30
2025-08-14_08-18-36,8279,"[np.float32(1.0), np.float32(1.0), np.float32(1.0), np.float32(0.0), np.float32(1.0), np.float32(0.0), np.float32(0.0), np.float32(1.0), np.float32(1.0), np.float32(0.0), np.float32(0.0), np.float32(0.0), np.float32(1.0), np.float32(1.0), np.float32(1.0), np.float32(0.0)]",-2.0,99270.0,3
2025-08-14_08-18-36,8280,"[np.float32(1.0), np.float32(0.0), np.float32(0.0), np.float32(1.0), np.float32(0.0), np.float32(0.0), np.float32(1.0), np.float32(0.0), np.float32(0.0), np.float32(1.0), np.float32(1.0), np.float32(0.0), np.float32(0.0), np.float32(0.0), np.float32(1.0), np.float32(0.0)]",-3.0,99267.0,24
2025-08-14_08-18-36,8281,"[np.float32(0.0), np.float32(1.0), np.float32(0.0), np.float32(1.0), np.float32(0.0), np.float32(0.0), np.float32(0.0), np.float32(0.0), np.float32(1.0), np.float32(0.0), np.float32(0.0), np.float32(0.0), np.float32(1.0), np.float32(0.0), np.float32(1.0), np.float32(1.0)]",-4.0,99263.0,21
2025-08-14_08-18-36,8282,"[np.float32(1.0), np.float32(0.0), np.float32(1.0), np.float32(1.0), np.float32(0.0), np.float32(1.0), np.float32(0.0), np.float32(1.0), np.float32(0.0), np.float32(1.0), np.float32(1.0), np.float32(0.0), np.float32(0.0), np.float32(0.0), np.float32(0.0), np.float32(1.0)]",-3.0,99260.0,15
2025-08-14_08-18-36,8283,"[np.float32(0.0), np.float32(1.0), np.float32(1.0), np.float32(0.0), np.float32(0.0), np.float32(1.0), np.float32(0.0), np.float32(0.0), np.float32(0.0), np.float32(0.0), np.float32(0.0), np.float32(0.0), np.float32(1.0), np.float32(0.0), np.float32(0.0), np.float32(0.0)]",-2.0,99258.0,23
2025-08-14_08-18-36,8284,"[np.float32(1.0), np.float32(1.0), np.float32(0.0), np.float32(0.0), np.float32(0.0), np.float32(1.0), np.float32(1.0), np.float32(1.0), np.float32(0.0), np.float32(0.0), np.float32(1.0), np.float32(1.0), np.float32(0.0), np.float32(1.0), np.float32(0.0), np.float32(0.0)]",3.0,99261.0,15
2025-08-14_08-18-36,8285,"[np.float32(0.0), np.float32(0.0), np.float32(0.0), np.float32(0.0), np.float32(1.0), np.float32(1.0), np.float32(0.0), np.float32(1.0), np.float32(1.0), np.float32(0.0), np.float32(0.0), np.float32(0.0), np.float32(1.0), np.float32(1.0), np.float32(1.0), np.float32(0.0)]",-2.0,99259.0,2
2025-08-14_08-18-36,8286,"[np.float32(1.0), np.float32(0.0), np.float32(0.0), np.float32(0.0), np.float32(0.0), np.float32(0.0), np.float32(0.0), np.float32(1.0), np.float32(1.0), np.float32(1.0), np.float32(0.0), np.float32(0.0), np.float32(1.0), np.float32(1.0), np.float32(0.0), np.float32(0.0)]",-3.0,99256.0,33
2025-08-14_08-18-36,8287,"[np.float32(1.0), np.float32(0.0), np.float32(1.0), np.float32(0.0), np.float32(0.0), np.float32(1.0), np.float32(0.0), np.float32(1.0), np.float32(1.0), np.float32(1.0), np.float32(1.0), np.float32(0.0), np.float32(1.0), np.float32(1.0), np.float32(1.0), np.float32(0.0)]",5.0,99261.0,32
2025-08-14_08-18-36,8288,"[np.float32(0.0), np.float32(1.0), np.float32(0.0), np.float32(0.0), np.float32(0.0), np.float32(1.0), np.float32(0.0), np.float32(1.0), np.float32(1.0), np.float32(1.0), np.float32(1.0), np.float32(0.0), np.float32(0.0), np.float32(0.0), np.float32(0.0), np.float32(1.0)]",1.0,99262.0,25
2025-08-14_08-18-36,8289,"[np.float32(1.0), np.float32(0.0), np.float32(1.0), np.float32(0.0), np.float32(1.0), np.float32(0.0), np.float32(1.0), np.float32(0.0), np.float32(0.0), np.float32(1.0), np.float32(1.0), np.float32(0.0), np.float32(1.0), np.float32(1.0), np.float32(1.0), np.float32(0.0)]",3.0,99265.0,16
2025-08-14_08-18-36,8290,"[np.float32(0.0), np.float32(1.0), np.float32(1.0), np.float32(0.0), np.float32(0.0), np.float32(0.0), np.float32(1.0), np.float32(1.0), np.float32(1.0), np.float32(1.0), np.float32(1.0), np.float32(0.0), np.float32(0.0), np.float32(1.0), np.float32(1.0), np.float32(1.0)]",-1.0,99264.0,5
2025-08-14_08-18-36,8291,"[np.float32(0.0), np.float32(1.0), np.float32(1.0), np.float32(1.0), np.float32(0.0), np.float32(0.0), np.float32(1.0), np.float32(0.0), np.float32(0.0), np.float32(0.0), np.float32(1.0), np.float32(1.0), np.float32(1.0), np.float32(1.0), np.float32(0.0), np.float32(1.0)]",1.0,99265.0,4
2025-08-14_08-18-36,8292,"[np.float32(1.0), np.float32(0.0), np.float32(1.0), np.float32(0.0), np.float32(0.0), np.float32(1.0), np.float32(0.0), np.float32(1.0), np.float32(1.0), np.float32(1.0), np.float32(0.0), np.float32(0.0), np.float32(1.0), np.float32(1.0), np.float32(0.0), np.float32(0.0)]",-3.0,99262.0,10
2025-08-14_08-18-36,8293,"[np.float32(0.0), np.float32(1.0), np.float32(1.0), np.float32(1.0), np.float32(0.0), np.float32(1.0), np.float32(0.0), np.float32(0.0), np.float32(1.0), np.float32(0.0), np.float32(1.0), np.float32(1.0), np.float32(0.0), np.float32(0.0), np.float32(0.0), np.float32(1.0)]",4.0,99266.0,20
2025-08-14_08-18-36,8294,"[np.float32(1.0), np.float32(0.0), np.float32(1.0), np.float32(0.0), np.float32(1.0), np.float32(1.0), np.float32(0.0), np.float32(0.0), np.float32(1.0), np.float32(1.0), np.float32(1.0), np.float32(0.0), np.float32(0.0), np.float32(0.0), np.float32(1.0), np.float32(1.0)]",1.0,99267.0,8
2025-08-14_08-18-36,8295,"[np.float32(0.0), np.float32(0.0), np.float32(1.0), np.float32(1.0), np.float32(1.0), np.float32(0.0), np.float32(0.0), np.float32(1.0), np.float32(1.0), np.float32(1.0), np.float32(0.0), np.float32(1.0), np.float32(1.0), np.float32(0.0), np.float32(0.0), np.float32(1.0)]",2.0,99269.0,34
2025-08-14_08-18-36,8296,"[np.float32(1.0), np.float32(1.0), np.float32(1.0), np.float32(0.0), np.float32(1.0), np.float32(1.0), np.float32(1.0), np.float32(1.0), np.float32(1.0), np.float32(1.0), np.float32(1.0), np.float32(1.0), np.float32(1.0), np.float32(0.0), np.float32(1.0), np.float32(0.0)]",-3.0,99266.0,25
2025-08-14_08-18-36,8297,"[np.float32(0.0), np.float32(0.0), np.float32(0.0), np.float32(0.0), np.float32(0.0), np.float32(0.0), np.float32(1.0), np.float32(1.0), np.float32(0.0), np.float32(1.0), np.float32(1.0), np.float32(0.0), np.float32(1.0), np.float32(0.0), np.float32(1.0), np.float32(0.0)]",0.0,99266.0,17
2025-08-14_08-18-36,8298,"[np.float32(1.0), np.float32(1.0), np.float32(0.0), np.float32(1.0), np.float32(0.0), np.float32(1.0), np.float32(0.0), np.float32(0.0), np.float32(1.0), np.float32(1.0), np.float32(0.0), np.float32(0.0), np.float32(0.0), np.float32(1.0), np.float32(0.0), np.float32(0.0)]",-5.0,99261.0,14
2025-08-14_08-18-36,8299,"[np.float32(1.0), np.float32(0.0), np.float32(0.0), np.float32(0.0), np.float32(1.0), np.float32(0.0), np.float32(0.0), np.float32(1.0), np.float32(0.0), np.float32(0.0), np.float32(0.0), np.float32(0.0), np.float32(0.0), np.float32(1.0), np.float32(0.0), np.float32(1.0)]",3.0,99264.0,21
2025-08-14_08-18-36,8300,"[np.float32(0.0), np.float32(0.0), np.float32(0.0), np.float32(1.0), np.float32(0.0), np.float32(0.0), np.float32(0.0), np.float32(0.0), np.float32(0.0), np.float32(1.0), np.float32(0.0), np.float32(0.0), np.float32(1.0), np.float32(1.0), np.float32(1.0), np.float32(0.0)]",-2.0,99262.0,2
2025-08-14_08-18-36,8301,"[np.float32(0.0), np.float32(1.0), np.float32(0.0), np.float32(1.0), np.float32(0.0), np.float32(1.0), np.float32(0.0), np.float32(1.0), np.float32(0.0), np.float32(0.0), np.float32(1.0), np.float32(1.0), np.float32(1.0), np.float32(1.0), np.float32(1.0), np.float32(1.0)]",0.0,99262.0,19
2025-08-14_08-18-36,8302,"[np.float32(0.0), np.float32(0.0), np.float32(1.0), np.float32(1.0), np.float32(1.0), np.float32(1.0), np.float32(0.0), np.float32(0.0), np.float32(0.0), np.float32(1.0), np.float32(0.0), np.float32(1.0), np.float32(1.0), np.float32(0.0), np.float32(1.0), np.float32(0.0)]",-1.0,99261.0,31
2025-08-14_08-18-36,8303,"[np.float32(1.0), np.float32(0.0), np.float32(0.0), np.float32(1.0), np.float32(1.0), np.float32(1.0), np.float32(0.0), np.float32(1.0), np.float32(0.0), np.float32(0.0), np.float32(0.0), np.float32(0.0), np.float32(0.0), np.float32(0.0), np.float32(0.0), np.float32(0.0)]",-1.0,99260.0,34
2025-08-14_08-18-36,8304,"[np.float32(1.0), np.float32(0.0), np.float32(0.0), np.float32(1.0), np.float32(1.0), np.float32(1.0), np.float32(1.0), np.float32(0.0), np.float32(0.0), np.float32(1.0), np.float32(0.0), np.float32(1.0), np.float32(1.0), np.float32(1.0), np.float32(1.0), np.float32(0.0)]",5.0,99265.0,3
2025-08-14_08-18-36,8305,"[np.float32(0.0), np.float32(0.0), np.float32(1.0), np.float32(1.0), np.float32(0.0), np.float32(1.0), np.float32(1.0), np.float32(1.0), np.float32(1.0), np.float32(0.0), np.float32(1.0), np.float32(1.0), np.float32(1.0), np.float32(1.0), np.float32(0.0), np.float32(1.0)]",0.0,99265.0,3
2025-08-14_08-18-36,8306,"[np.float32(1.0), np.float32(1.0), np.float32(1.0), np.float32(0.0), np.float32(1.0), np.float32(1.0), np.float32(1.0), np.float32(1.0), np.float32(0.0), np.float32(1.0), np.float32(0.0), np.float32(0.0), np.float32(1.0), np.float32(1.0), np.float32(0.0), np.float32(1.0)]",-1.0,99264.0,17
2025-08-14_08-18-36,8307,"[np.float32(1.0), np.float32(0.0), np.float32(0.0), np.float32(1.0), np.float32(0.0), np.float32(1.0), np.float32(1.0), np.float32(1.0), np.float32(0.0), np.float32(1.0), np.float32(0.0), np.float32(0.0), np.float32(1.0), np.float32(0.0), np.float32(0.0), np.float32(0.0)]",0.0,99264.0,3
2025-08-14_08-18-36,8308,"[np.float32(0.0), np.float32(0.0), np.float32(1.0), np.float32(0.0), np.float32(0.0), np.float32(0.0), np.float32(1.0), np.float32(0.0), np.float32(0.0), np.float32(0.0), np.float32(0.0), np.float32(0.0), np.float32(1.0), np.float32(1.0), np.float32(1.0), np.float32(0.0)]",0.0,99264.0,18
2025-08-14_08-18-36,8309,"[np.float32(1.0), np.float32(1.0), np.float32(0.0), np.float32(0.0), np.float32(0.0), np.float32(0.0), np.float32(1.0), np.float32(1.0), np.float32(0.0), np.float32(1.0), np.float32(1.0), np.float32(0.0), np.float32(0.0), np.float32(0.0), np.float32(1.0), np.float32(0.0)]",-2.0,99262.0,25
2025-08-14_08-18-36,8310,"[np.float32(0.0), np.float32(1.0), np.float32(0.0), np.float32(0.0), np.float32(1.0), np.float32(1.0), np.float32(1.0), np.float32(1.0), np.float32(1.0), np.float32(0.0), np.float32(0.0), np.float32(1.0), np.float32(1.0), np.float32(0.0), np.float32(0.0), np.float32(1.0)]",-2.0,99260.0,13
2025-08-14_08-18-36,8311,"[np.float32(0.0), np.float32(1.0), np.float32(0.0), np.float32(1.0), np.float32(0.0), np.float32(0.0), np.float32(1.0), np.float32(1.0), np.float32(1.0), np.float32(1.0), np.float32(0.0), np.float32(0.0), np.float32(1.0), np.float32(1.0), np.float32(1.0), np.float32(1.0)]",-4.0,99256.0,12
2025-08-14_08-18-36,8312,"[np.float32(1.0), np.float32(1.0), np.float32(0.0), np.float32(0.0), np.float32(0.0), np.float32(0.0), np.float32(0.0), np.float32(0.0), np.float32(0.0), np.float32(1.0), np.float32(1.0), np.float32(1.0), np.float32(0.0), np.float32(1.0), np.float32(0.0), np.float32(0.0)]",-1.0,99255.0,16
2025-08-14_08-18-36,8313,"[np.float32(0.0), np.float32(1.0), np.float32(0.0), np.float32(0.0), np.float32(1.0), np.float32(0.0), np.float32(1.0), np.float32(0.0), np.float32(1.0), np.float32(0.0), np.float32(0.0), np.float32(1.0), np.float32(0.0), np.float32(1.0), np.float32(0.0), np.float32(0.0)]",2.0,99257.0,7
2025-08-14_08-18-36,8314,"[np.float32(1.0), np.float32(1.0), np.float32(0.0), np.float32(1.0), np.float32(0.0), np.float32(1.0), np.float32(1.0), np.float32(1.0), np.float32(0.0), np.float32(0.0), np.float32(0.0), np.float32(1.0), np.float32(1.0), np.float32(1.0), np.float32(0.0), np.float32(1.0)]",0.0,99257.0,20
2025-08-14_08-18-36,8315,"[np.float32(0.0), np.float32(1.0), np.float32(0.0), np.float32(1.0), np.float32(1.0), np.float32(1.0), np.float32(0.0), np.float32(1.0), np.float32(0.0), np.float32(0.0), np.float32(0.0), np.float32(0.0), np.float32(1.0), np.float32(1.0), np.float32(1.0), np.float32(1.0)]",-2.0,99255.0,5
2025-08-14_08-18-36,8316,"[np.float32(0.0), np.float32(0.0), np.float32(1.0), np.float32(1.0), np.float32(1.0), np.float32(0.0), np.float32(0.0), np.float32(1.0), np.float32(0.0), np.float32(1.0), np.float32(1.0), np.float32(1.0), np.float32(1.0), np.float32(0.0), np.float32(1.0), np.float32(0.0)]",-1.0,99254.0,21
2025-08-14_08-18-36,8317,"[np.float32(1.0), np.float32(0.0), np.float32(1.0), np.float32(0.0), np.float32(0.0), np.float32(1.0), np.float32(1.0), np.float32(1.0), np.float32(0.0), np.float32(1.0), np.float32(0.0), np.float32(1.0), np.float32(0.0), np.float32(1.0), np.float32(0.0), np.float32(0.0)]",-2.0,99252.0,13
2025-08-14_08-18-36,8318,"[np.float32(1.0), np.float32(1.0), np.float32(0.0), np.float32(0.0), np.float32(1.0), np.float32(1.0), np.float32(1.0), np.float32(1.0), np.float32(0.0), np.float32(0.0), np.float32(0.0), np.float32(1.0), np.float32(0.0), np.float32(1.0), np.float32(1.0), np.float32(0.0)]",-2.0,99250.0,35
2025-08-14_08-18-36,8319,"[np.float32(1.0), np.float32(1.0), np.float32(1.0), np.float32(0.0), np.float32(0.0), np.float32(0.0), np.float32(0.0), np.float32(1.0), np.float32(1.0), np.float32(0.0), np.float32(1.0), np.float32(0.0), np.float32(0.0), np.float32(1.0), np.float32(1.0), np.float32(0.0)]",-6.0,99244.0,9
2025-08-14_08-18-36,8320,"[np.float32(0.0), np.float32(1.0), np.float32(1.0), np.float32(0.0), np.float32(0.0), np.float32(1.0), np.float32(1.0), np.float32(1.0), np.float32(1.0), np.float32(0.0), np.float32(1.0), np.float32(1.0), np.float32(1.0), np.float32(1.0), np.float32(1.0), np.float32(0.0)]",2.0,99246.0,33
2025-08-14_08-18-36,8321,"[np.float32(1.0), np.float32(1.0), np.float32(1.0), np.float32(0.0), np.float32(0.0), np.float32(0.0), np.float32(1.0), np.float32(1.0), np.float32(1.0), np.float32(0.0), np.float32(1.0), np.float32(1.0), np.float32(0.0), np.float32(0.0), np.float32(0.0), np.float32(1.0)]",-4.0,99242.0,25
2025-08-14_08-18-36,8322,"[np.float32(0.0), np.float32(0.0), np.float32(0.0), np.float32(1.0), np.float32(0.0), np.float32(0.0), np.float32(1.0), np.float32(1.0), np.float32(0.0), np.float32(1.0), np.float32(0.0), np.float32(1.0), np.float32(1.0), np.float32(0.0), np.float32(1.0), np.float32(0.0)]",-2.0,99240.0,31
2025-08-14_08-18-36,8323,"[np.float32(1.0), np.float32(1.0), np.float32(0.0), np.float32(1.0), np.float32(0.0), np.float32(0.0), np.float32(1.0), np.float32(1.0), np.float32(1.0), np.float32(0.0), np.float32(1.0), np.float32(0.0), np.float32(1.0), np.float32(1.0), np.float32(0.0), np.float32(0.0)]",1.0,99241.0,19
2025-08-14_08-18-36,8324,"[np.float32(0.0), np.float32(1.0), np.float32(0.0), np.float32(0.0), np.float32(1.0), np.float32(1.0), np.float32(1.0), np.float32(1.0), np.float32(1.0), np.float32(0.0), np.float32(0.0), np.float32(0.0), np.float32(1.0), np.float32(1.0), np.float32(1.0), np.float32(1.0)]",0.0,99241.0,35
2025-08-14_08-18-36,8325,"[np.float32(1.0), np.float32(1.0), np.float32(1.0), np.float32(0.0), np.float32(1.0), np.float32(0.0), np.float32(1.0), np.float32(0.0), np.float32(0.0), np.float32(0.0), np.float32(0.0), np.float32(1.0), np.float32(0.0), np.float32(0.0), np.float32(0.0), np.float32(0.0)]",-2.0,99239.0,26
2025-08-14_08-18-36,8326,"[np.float32(0.0), np.float32(0.0), np.float32(0.0), np.float32(1.0), np.float32(1.0), np.float32(1.0), np.float32(1.0), np.float32(1.0), np.float32(1.0), np.float32(1.0), np.float32(0.0), np.float32(1.0), np.float32(0.0), np.float32(1.0), np.float32(0.0), np.float32(1.0)]",3.0,99242.0,3
2025-08-14_08-18-36,8327,"[np.float32(0.0), np.float32(1.0), np.float32(1.0), np.float32(1.0), np.float32(1.0), np.float32(1.0), np.float32(1.0), np.float32(1.0), np.float32(1.0), np.float32(1.0), np.float32(1.0), np.float32(0.0), np.float32(0.0), np.float32(0.0), np.float32(0.0), np.float32(0.0)]",2.0,99244.0,29
2025-08-14_08-18-36,8328,"[np.float32(1.0), np.float32(1.0), np.float32(1.0), np.float32(0.0), np.float32(1.0), np.float32(0.0), np.float32(1.0), np.float32(0.0), np.float32(0.0), np.float32(0.0), np.float32(0.0), np.float32(0.0), np.float32(1.0), np.float32(0.0), np.float32(0.0), np.float32(1.0)]",-3.0,99241.0,30
2025-08-14_08-18-36,8329,"[np.float32(1.0), np.float32(0.0), np.float32(0.0), np.float32(1.0), np.float32(1.0), np.float32(0.0), np.float32(1.0), np.float32(0.0), np.float32(1.0), np.float32(0.0), np.float32(0.0), np.float32(0.0), np.float32(1.0), np.float32(1.0), np.float32(0.0), np.float32(1.0)]",-1.0,99240.0,14
2025-08-14_08-18-36,8330,"[np.float32(1.0), np.float32(0.0), np.float32(0.0), np.float32(1.0), np.float32(0.0), np.float32(1.0), np.float32(0.0), np.float32(1.0), np.float32(1.0), np.float32(1.0), np.float32(0.0), np.float32(1.0), np.float32(0.0), np.float32(1.0), np.float32(0.0), np.float32(1.0)]",2.0,99242.0,18
2025-08-14_08-18-36,8331,"[np.float32(1.0), np.float32(1.0), np.float32(1.0), np.float32(0.0), np.float32(1.0), np.float32(1.0), np.float32(0.0), np.float32(1.0), np.float32(0.0), np.float32(0.0), np.float32(0.0), np.float32(1.0), np.float32(1.0), np.float32(1.0), np.float32(1.0), np.float32(1.0)]",1.0,99243.0,14
2025-08-14_08-18-36,8332,"[np.float32(0.0), np.float32(0.0), np.float32(0.0), np.float32(1.0), np.float32(1.0), np.float32(0.0), np.float32(1.0), np.float32(1.0), np.float32(1.0), np.float32(0.0), np.float32(0.0), np.float32(0.0), np.float32(1.0), np.float32(0.0), np.float32(1.0), np.float32(0.0)]",0.0,99243.0,15
2025-08-14_08-18-36,8333,"[np.float32(1.0), np.float32(0.0), np.float32(1.0), np.float32(1.0), np.float32(0.0), np.float32(0.0), np.float32(1.0), np.float32(1.0), np.float32(0.0), np.float32(0.0), np.float32(1.0), np.float32(0.0), np.float32(0.0), np.float32(0.0), np.float32(0.0), np.float32(0.0)]",1.0,99244.0,18
2025-08-14_08-18-36,8334,"[np.float32(0.0), np.float32(0.0), np.float32(0.0), np.float32(0.0), np.float32(0.0), np.float32(0.0), np.float32(0.0), np.float32(0.0), np.float32(1.0), np.float32(0.0), np.float32(1.0), np.float32(0.0), np.float32(0.0), np.float32(1.0), np.float32(0.0), np.float32(0.0)]",-3.0,99241.0,6
2025-08-14_08-18-36,8335,"[np.float32(1.0), np.float32(0.0), np.float32(1.0), np.float32(0.0), np.float32(1.0), np.float32(1.0), np.float32(0.0), np.float32(0.0), np.float32(0.0), np.float32(0.0), np.float32(1.0), np.float32(0.0), np.float32(1.0), np.float32(1.0), np.float32(1.0), np.float32(1.0)]",-2.0,99239.0,4
2025-08-14_08-18-36,8336,"[np.float32(1.0), np.float32(0.0), np.float32(1.0), np.float32(0.0), np.float32(0.0), np.float32(0.0), np.float32(0.0), np.float32(0.0), np.float32(1.0), np.float32(0.0), np.float32(1.0), np.float32(1.0), np.float32(0.0), np.float32(0.0), np.float32(1.0), np.float32(0.0)]",-1.0,99238.0,28
2025-08-14_08-18-36,8337,"[np.float32(1.0), np.float32(0.0), np.float32(1.0), np.float32(1.0), np.float32(1.0), np.float32(1.0), np.float32(0.0), np.float32(1.0), np.float32(1.0), np.float32(0.0), np.float32(0.0), np.float32(1.0), np.float32(0.0), np.float32(1.0), np.float32(0.0), np.float32(0.0)]",-5.0,99233.0,10
2025-08-14_08-18-36,8338,"[np.float32(0.0), np.float32(1.0), np.float32(1.0), np.float32(1.0), np.float32(1.0), np.float32(1.0), np.float32(1.0), np.float32(1.0), np.float32(0.0), np.float32(1.0), np.float32(1.0), np.float32(1.0), np.float32(1.0), np.float32(0.0), np.float32(0.0), np.float32(1.0)]",-3.0,99230.0,26
2025-08-14_08-18-36,8339,"[np.float32(0.0), np.float32(1.0), np.float32(0.0), np.float32(1.0), np.float32(1.0), np.float32(0.0), np.float32(1.0), np.float32(1.0), np.float32(0.0), np.float32(1.0), np.float32(0.0), np.float32(0.0), np.float32(1.0), np.float32(1.0), np.float32(0.0), np.float32(1.0)]",2.0,99232.0,22
2025-08-14_08-18-36,8340,"[np.float32(0.0), np.float32(1.0), np.float32(0.0), np.float32(0.0), np.float32(1.0), np.float32(1.0), np.float32(1.0), np.float32(1.0), np.float32(0.0), np.float32(0.0), np.float32(0.0), np.float32(0.0), np.float32(1.0), np.float32(1.0), np.float32(1.0), np.float32(0.0)]",0.0,99232.0,16
2025-08-14_08-18-36,8341,"[np.float32(1.0), np.float32(1.0), np.float32(0.0), np.float32(0.0), np.float32(0.0), np.float32(1.0), np.float32(0.0), np.float32(0.0), np.float32(0.0), np.float32(1.0), np.float32(1.0), np.float32(0.0), np.float32(1.0), np.float32(1.0), np.float32(0.0), np.float32(1.0)]",-3.0,99229.0,13
2025-08-14_08-18-36,8342,"[np.float32(1.0), np.float32(0.0), np.float32(1.0), np.float32(1.0), np.float32(1.0), np.float32(1.0), np.float32(1.0), np.float32(1.0), np.float32(1.0), np.float32(0.0), np.float32(0.0), np.float32(0.0), np.float32(1.0), np.float32(1.0), np.float32(0.0), np.float32(0.0)]",-1.0,99228.0,14
2025-08-14_08-18-36,8343,"[np.float32(1.0), np.float32(1.0), np.float32(0.0), np.float32(1.0), np.float32(0.0), np.float32(0.0), np.float32(0.0), np.float32(1.0), np.float32(1.0), np.float32(0.0), np.float32(1.0), np.float32(1.0), np.float32(0.0), np.float32(0.0), np.float32(0.0), np.float32(1.0)]",2.0,99230.0,15
2025-08-14_08-18-36,8344,"[np.float32(0.0), np.float32(1.0), np.float32(0.0), np.float32(0.0), np.float32(0.0), np.float32(1.0), np.float32(1.0), np.float32(0.0), np.float32(1.0), np.float32(0.0), np.float32(0.0), np.float32(0.0), np.float32(1.0), np.float32(0.0), np.float32(0.0), np.float32(0.0)]",0.0,99230.0,6
2025-08-14_08-18-36,8345,"[np.float32(0.0), np.float32(1.0), np.float32(0.0), np.float32(1.0), np.float32(0.0), np.float32(1.0), np.float32(1.0), np.float32(1.0), np.float32(1.0), np.float32(0.0), np.float32(1.0), np.float32(1.0), np.float32(1.0), np.float32(0.0), np.float32(0.0), np.float32(1.0)]",-3.0,99227.0,22
2025-08-14_08-18-36,8346,"[np.float32(1.0), np.float32(0.0), np.float32(1.0), np.float32(1.0), np.float32(1.0), np.float32(0.0), np.float32(1.0), np.float32(1.0), np.float32(1.0), np.float32(1.0), np.float32(1.0), np.float32(0.0), np.float32(1.0), np.float32(1.0), np.float32(1.0), np.float32(1.0)]",-3.0,99224.0,27
2025-08-14_08-18-36,8347,"[np.float32(0.0), np.float32(0.0), np.float32(0.0), np.float32(0.0), np.float32(0.0), np.float32(0.0), np.float32(0.0), np.float32(1.0), np.float32(1.0), np.float32(1.0), np.float32(1.0), np.float32(1.0), np.float32(0.0), np.float32(0.0), np.float32(0.0), np.float32(0.0)]",1.0,99225.0,33
2025-08-14_08-18-36,8348,"[np.float32(0.0), np.float32(1.0), np.float32(1.0), np.float32(0.0), np.float32(0.0), np.float32(0.0), np.float32(1.0), np.float32(1.0), np.float32(1.0), np.float32(0.0), np.float32(1.0), np.float32(0.0), np.float32(1.0), np.float32(1.0), np.float32(0.0), np.float32(1.0)]",-3.0,99222.0,9
2025-08-14_08-18-36,8349,"[np.float32(1.0), np.float32(0.0), np.float32(1.0), np.float32(0.0), np.float32(1.0), np.float32(1.0), np.float32(0.0), np.float32(0.0), np.float32(1.0), np.float32(0.0), np.float32(1.0), np.float32(0.0), np.float32(0.0), np.float32(0.0), np.float32(0.0), np.float32(1.0)]",5.0,99227.0,34
2025-08-14_08-18-36,8350,"[np.float32(1.0), np.float32(1.0), np.float32(0.0), np.float32(1.0), np.float32(0.0), np.float32(1.0), np.float32(0.0), np.float32(1.0), np.float32(1.0), np.float32(1.0), np.float32(0.0), np.float32(0.0), np.float32(1.0), np.float32(0.0), np.float32(0.0), np.float32(0.0)]",1.0,99228.0,35
2025-08-14_08-18-36,8351,"[np.float32(0.0), np.float32(0.0), np.float32(1.0), np.float32(1.0), np.float32(1.0), np.float32(1.0), np.float32(0.0), np.float32(1.0), np.float32(1.0), np.float32(1.0), np.float32(1.0), np.float32(1.0), np.float32(0.0), np.float32(0.0), np.float32(0.0), np.float32(0.0)]",1.0,99229.0,25
2025-08-14_08-18-36,8352,"[np.float32(1.0), np.float32(0.0), np.float32(1.0), np.float32(1.0), np.float32(0.0), np.float32(0.0), np.float32(1.0), np.float32(1.0), np.float32(0.0), np.float32(1.0), np.float32(0.0), np.float32(1.0), np.float32(0.0), np.float32(1.0), np.float32(1.0), np.float32(0.0)]",2.0,99231.0,15
2025-08-14_08-18-36,8353,"[np.float32(0.0), np.float32(1.0), np.float32(0.0), np.float32(0.0), np.float32(1.0), np.float32(1.0), np.float32(0.0), np.float32(0.0), np.float32(1.0), np.float32(1.0), np.float32(1.0), np.float32(1.0), np.float32(1.0), np.float32(1.0), np.float32(0.0), np.float32(0.0)]",-2.0,99229.0,13
2025-08-14_08-18-36,8354,"[np.float32(1.0), np.float32(0.0), np.float32(1.0), np.float32(1.0), np.float32(1.0), np.float32(0.0), np.float32(1.0), np.float32(1.0), np.float32(0.0), np.float32(1.0), np.float32(0.0), np.float32(0.0), np.float32(1.0), np.float32(0.0), np.float32(1.0), np.float32(1.0)]",-2.0,99227.0,20
2025-08-14_08-18-36,8355,"[np.float32(0.0), np.float32(1.0), np.float32(0.0), np.float32(1.0), np.float32(0.0), np.float32(0.0), np.float32(0.0), np.float32(1.0), np.float32(1.0), np.float32(1.0), np.float32(0.0), np.float32(0.0), np.float32(1.0), np.float32(0.0), np.float32(0.0), np.float32(0.0)]",-2.0,99225.0,11
2025-08-14_08-18-36,8356,"[np.float32(0.0), np.float32(0.0), np.float32(1.0), np.float32(1.0), np.float32(0.0), np.float32(0.0), np.float32(1.0), np.float32(1.0), np.float32(1.0), np.float32(0.0), np.float32(0.0), np.float32(1.0), np.float32(1.0), np.float32(1.0), np.float32(1.0), np.float32(0.0)]",-1.0,99224.0,5
2025-08-14_08-18-36,8357,"[np.float32(1.0), np.float32(1.0), np.float32(0.0), np.float32(1.0), np.float32(0.0), np.float32(1.0), np.float32(0.0), np.float32(1.0), np.float32(0.0), np.float32(1.0), np.float32(1.0), np.float32(0.0), np.float32(0.0), np.float32(1.0), np.float32(1.0), np.float32(0.0)]",1.0,99225.0,24
2025-08-14_08-18-36,8358,"[np.float32(0.0), np.float32(1.0), np.float32(1.0), np.float32(1.0), np.float32(0.0), np.float32(1.0), np.float32(0.0), np.float32(1.0), np.float32(0.0), np.float32(1.0), np.float32(1.0), np.float32(1.0), np.float32(1.0), np.float32(0.0), np.float32(0.0), np.float32(0.0)]",3.0,99228.0,24
2025-08-14_08-18-36,8359,"[np.float32(1.0), np.float32(1.0), np.float32(0.0), np.float32(0.0), np.float32(0.0), np.float32(0.0), np.float32(1.0), np.float32(1.0), np.float32(0.0), np.float32(1.0), np.float32(1.0), np.float32(0.0), np.float32(0.0), np.float32(0.0), np.float32(1.0), np.float32(0.0)]",1.0,99229.0,7
2025-08-14_08-18-36,8360,"[np.float32(0.0), np.float32(1.0), np.float32(0.0), np.float32(0.0), np.float32(1.0), np.float32(1.0), np.float32(1.0), np.float32(1.0), np.float32(0.0), np.float32(1.0), np.float32(0.0), np.float32(0.0), np.float32(1.0), np.float32(1.0), np.float32(0.0), np.float32(1.0)]",-4.0,99225.0,5
2025-08-14_08-18-36,8361,"[np.float32(0.0), np.float32(0.0), np.float32(1.0), np.float32(1.0), np.float32(1.0), np.float32(1.0), np.float32(1.0), np.float32(1.0), np.float32(1.0), np.float32(0.0), np.float32(1.0), np.float32(1.0), np.float32(0.0), np.float32(1.0), np.float32(0.0), np.float32(0.0)]",0.0,99225.0,25
2025-08-14_08-18-36,8362,"[np.float32(0.0), np.float32(1.0), np.float32(0.0), np.float32(0.0), np.float32(0.0), np.float32(0.0), np.float32(1.0), np.float32(0.0), np.float32(1.0), np.float32(1.0), np.float32(0.0), np.float32(1.0), np.float32(1.0), np.float32(1.0), np.float32(0.0), np.float32(0.0)]",-4.0,99221.0,16
2025-08-14_08-18-36,8363,"[np.float32(1.0), np.float32(1.0), np.float32(1.0), np.float32(1.0), np.float32(1.0), np.float32(0.0), np.float32(0.0), np.float32(1.0), np.float32(0.0), np.float32(1.0), np.float32(1.0), np.float32(1.0), np.float32(1.0), np.float32(0.0), np.float32(0.0), np.float32(0.0)]",-3.0,99218.0,36
2025-08-14_08-18-36,8364,"[np.float32(0.0), np.float32(1.0), np.float32(0.0), np.float32(1.0), np.float32(0.0), np.float32(1.0), np.float32(1.0), np.float32(1.0), np.float32(1.0), np.float32(1.0), np.float32(1.0), np.float32(0.0), np.float32(0.0), np.float32(1.0), np.float32(0.0), np.float32(0.0)]",4.0,99222.0,19
2025-08-14_08-18-36,8365,"[np.float32(1.0), np.float32(0.0), np.float32(0.0), np.float32(0.0), np.float32(0.0), np.float32(1.0), np.float32(1.0), np.float32(1.0), np.float32(0.0), np.float32(0.0), np.float32(0.0), np.float32(0.0), np.float32(1.0), np.float32(0.0), np.float32(1.0), np.float32(0.0)]",-3.0,99219.0,15
2025-08-14_08-18-36,8366,"[np.float32(1.0), np.float32(1.0), np.float32(0.0), np.float32(1.0), np.float32(0.0), np.float32(1.0), np.float32(1.0), np.float32(1.0), np.float32(1.0), np.float32(1.0), np.float32(0.0), np.float32(1.0), np.float32(0.0), np.float32(0.0), np.float32(0.0), np.float32(0.0)]",0.0,99219.0,23
2025-08-14_08-18-36,8367,"[np.float32(0.0), np.float32(0.0), np.float32(1.0), np.float32(0.0), np.float32(0.0), np.float32(1.0), np.float32(1.0), np.float32(1.0), np.float32(0.0), np.float32(0.0), np.float32(0.0), np.float32(0.0), np.float32(1.0), np.float32(1.0), np.float32(1.0), np.float32(1.0)]",-2.0,99217.0,13
2025-08-14_08-18-36,8368,"[np.float32(1.0), np.float32(0.0), np.float32(1.0), np.float32(1.0), np.float32(1.0), np.float32(1.0), np.float32(0.0), np.float32(1.0), np.float32(1.0), np.float32(1.0), np.float32(1.0), np.float32(1.0), np.float32(0.0), np.float32(0.0), np.float32(0.0), np.float32(0.0)]",0.0,99217.0,29
2025-08-14_08-18-36,8369,"[np.float32(0.0), np.float32(0.0), np.float32(0.0), np.float32(0.0), np.float32(1.0), np.float32(1.0), np.float32(0.0), np.float32(1.0), np.float32(1.0), np.float32(0.0), np.float32(1.0), np.float32(0.0), np.float32(1.0), np.float32(0.0), np.float32(0.0), np.float32(1.0)]",-2.0,99215.0,6
2025-08-14_08-18-36,8370,"[np.float32(1.0), np.float32(0.0), np.float32(1.0), np.float32(1.0), np.float32(1.0), np.float32(1.0), np.float32(0.0), np.float32(1.0), np.float32(0.0), np.float32(1.0), np.float32(0.0), np.float32(0.0), np.float32(1.0), np.float32(1.0), np.float32(0.0), np.float32(1.0)]",-3.0,99212.0,6
2025-08-14_08-18-36,8371,"[np.float32(0.0), np.float32(0.0), np.float32(1.0), np.float32(1.0), np.float32(0.0), np.float32(1.0), np.float32(0.0), np.float32(1.0), np.float32(1.0), np.float32(0.0), np.float32(1.0), np.float32(1.0), np.float32(0.0), np.float32(0.0), np.float32(1.0), np.float32(0.0)]",2.0,99214.0,26
2025-08-14_08-18-36,8372,"[np.float32(0.0), np.float32(1.0), np.float32(1.0), np.float32(1.0), np.float32(0.0), np.float32(1.0), np.float32(0.0), np.float32(1.0), np.float32(1.0), np.float32(0.0), np.float32(0.0), np.float32(1.0), np.float32(1.0), np.float32(1.0), np.float32(1.0), np.float32(0.0)]",-3.0,99211.0,34
2025-08-14_08-18-36,8373,"[np.float32(0.0), np.float32(1.0), np.float32(0.0), np.float32(1.0), np.float32(0.0), np.float32(0.0), np.float32(1.0), np.float32(1.0), np.float32(1.0), np.float32(0.0), np.float32(0.0), np.float32(1.0), np.float32(0.0), np.float32(0.0), np.float32(0.0), np.float32(0.0)]",0.0,99211.0,30
2025-08-14_08-18-36,8374,"[np.float32(0.0), np.float32(0.0), np.float32(1.0), np.float32(1.0), np.float32(1.0), np.float32(0.0), np.float32(1.0), np.float32(1.0), np.float32(0.0), np.float32(0.0), np.float32(0.0), np.float32(1.0), np.float32(0.0), np.float32(0.0), np.float32(0.0), np.float32(0.0)]",-4.0,99207.0,28
2025-08-14_08-18-36,8375,"[np.float32(0.0), np.float32(0.0), np.float32(0.0), np.float32(1.0), np.float32(0.0), np.float32(1.0), np.float32(1.0), np.float32(0.0), np.float32(1.0), np.float32(1.0), np.float32(0.0), np.float32(1.0), np.float32(1.0), np.float32(1.0), np.float32(1.0), np.float32(1.0)]",-2.0,99205.0,26
2025-08-14_08-18-36,8376,"[np.float32(0.0), np.float32(1.0), np.float32(0.0), np.float32(1.0), np.float32(1.0), np.float32(1.0), np.float32(1.0), np.float32(1.0), np.float32(0.0), np.float32(1.0), np.float32(1.0), np.float32(1.0), np.float32(1.0), np.float32(0.0), np.float32(0.0), np.float32(1.0)]",-1.0,99204.0,8
2025-08-14_08-18-36,8377,"[np.float32(1.0), np.float32(0.0), np.float32(0.0), np.float32(0.0), np.float32(1.0), np.float32(0.0), np.float32(0.0), np.float32(1.0), np.float32(0.0), np.float32(1.0), np.float32(1.0), np.float32(0.0), np.float32(1.0), np.float32(1.0), np.float32(1.0), np.float32(1.0)]",-3.0,99201.0,28
2025-08-14_08-18-36,8378,"[np.float32(0.0), np.float32(0.0), np.float32(0.0), np.float32(1.0), np.float32(0.0), np.float32(1.0), np.float32(0.0), np.float32(1.0), np.float32(0.0), np.float32(0.0), np.float32(0.0), np.float32(0.0), np.float32(1.0), np.float32(1.0), np.float32(1.0), np.float32(0.0)]",2.0,99203.0,13
2025-08-14_08-18-36,8379,"[np.float32(1.0), np.float32(0.0), np.float32(0.0), np.float32(1.0), np.float32(1.0), np.float32(0.0), np.float32(1.0), np.float32(1.0), np.float32(1.0), np.float32(0.0), np.float32(1.0), np.float32(0.0), np.float32(0.0), np.float32(1.0), np.float32(0.0), np.float32(1.0)]",3.0,99206.0,1
2025-08-14_08-18-36,8380,"[np.float32(0.0), np.float32(1.0), np.float32(0.0), np.float32(0.0), np.float32(0.0), np.float32(0.0), np.float32(1.0), np.float32(1.0), np.float32(0.0), np.float32(0.0), np.float32(0.0), np.float32(0.0), np.float32(0.0), np.float32(0.0), np.float32(1.0), np.float32(0.0)]",-2.0,99204.0,28
2025-08-14_08-18-36,8381,"[np.float32(1.0), np.float32(0.0), np.float32(0.0), np.float32(0.0), np.float32(0.0), np.float32(1.0), np.float32(0.0), np.float32(1.0), np.float32(0.0), np.float32(0.0), np.float32(1.0), np.float32(1.0), np.float32(0.0), np.float32(0.0), np.float32(0.0), np.float32(0.0)]",-2.0,99202.0,2
2025-08-14_08-18-36,8382,"[np.float32(1.0), np.float32(0.0), np.float32(0.0), np.float32(0.0), np.float32(0.0), np.float32(1.0), np.float32(0.0), np.float32(1.0), np.float32(1.0), np.float32(1.0), np.float32(1.0), np.float32(1.0), np.float32(1.0), np.float32(0.0), np.float32(1.0), np.float32(0.0)]",4.0,99206.0,36
2025-08-14_08-18-36,8383,"[np.float32(1.0), np.float32(0.0), np.float32(1.0), np.float32(1.0), np.float32(1.0), np.float32(1.0), np.float32(0.0), np.float32(0.0), np.float32(1.0), np.float32(0.0), np.float32(1.0), np.float32(0.0), np.float32(0.0), np.float32(0.0), np.float32(0.0), np.float32(0.0)]",2.0,99208.0,34
2025-08-14_08-18-36,8384,"[np.float32(0.0), np.float32(0.0), np.float32(1.0), np.float32(0.0), np.float32(0.0), np.float32(0.0), np.float32(0.0), np.float32(1.0), np.float32(1.0), np.float32(1.0), np.float32(1.0), np.float32(0.0), np.float32(1.0), np.float32(0.0), np.float32(0.0), np.float32(0.0)]",-3.0,99205.0,21
2025-08-14_08-18-36,8385,"[np.float32(1.0), np.float32(1.0), np.float32(0.0), np.float32(1.0), np.float32(1.0), np.float32(1.0), np.float32(1.0), np.float32(0.0), np.float32(0.0), np.float32(1.0), np.float32(1.0), np.float32(0.0), np.float32(1.0), np.float32(1.0), np.float32(0.0), np.float32(0.0)]",-3.0,99202.0,34
2025-08-14_08-18-36,8386,"[np.float32(1.0), np.float32(0.0), np.float32(1.0), np.float32(1.0), np.float32(0.0), np.float32(0.0), np.float32(0.0), np.float32(1.0), np.float32(1.0), np.float32(1.0), np.float32(1.0), np.float32(0.0), np.float32(1.0), np.float32(1.0), np.float32(1.0), np.float32(0.0)]",-2.0,99200.0,8
2025-08-14_08-18-36,8387,"[np.float32(0.0), np.float32(1.0), np.float32(0.0), np.float32(1.0), np.float32(0.0), np.float32(1.0), np.float32(0.0), np.float32(1.0), np.float32(1.0), np.float32(0.0), np.float32(0.0), np.float32(1.0), np.float32(1.0), np.float32(1.0), np.float32(0.0), np.float32(0.0)]",2.0,99202.0,22
2025-08-14_08-18-36,8388,"[np.float32(0.0), np.float32(1.0), np.float32(1.0), np.float32(0.0), np.float32(0.0), np.float32(1.0), np.float32(0.0), np.float32(0.0), np.float32(0.0), np.float32(0.0), np.float32(0.0), np.float32(1.0), np.float32(0.0), np.float32(0.0), np.float32(1.0), np.float32(1.0)]",0.0,99202.0,0
2025-08-14_08-18-36,8389,"[np.float32(1.0), np.float32(1.0), np.float32(1.0), np.float32(0.0), np.float32(0.0), np.float32(1.0), np.float32(0.0), np.float32(1.0), np.float32(1.0), np.float32(1.0), np.float32(0.0), np.float32(1.0), np.float32(1.0), np.float32(1.0), np.float32(0.0), np.float32(0.0)]",3.0,99205.0,25
2025-08-14_08-18-36,8390,"[np.float32(1.0), np.float32(0.0), np.float32(1.0), np.float32(1.0), np.float32(1.0), np.float32(0.0), np.float32(1.0), np.float32(1.0), np.float32(0.0), np.float32(1.0), np.float32(0.0), np.float32(0.0), np.float32(0.0), np.float32(0.0), np.float32(0.0), np.float32(0.0)]",-3.0,99202.0,30
2025-08-14_08-18-36,8391,"[np.float32(0.0), np.float32(0.0), np.float32(0.0), np.float32(0.0), np.float32(1.0), np.float32(1.0), np.float32(1.0), np.float32(0.0), np.float32(0.0), np.float32(1.0), np.float32(1.0), np.float32(1.0), np.float32(0.0), np.float32(0.0), np.float32(1.0), np.float32(1.0)]",3.0,99205.0,10
2025-08-14_08-18-36,8392,"[np.float32(1.0), np.float32(0.0), np.float32(0.0), np.float32(0.0), np.float32(1.0), np.float32(1.0), np.float32(1.0), np.float32(1.0), np.float32(0.0), np.float32(0.0), np.float32(0.0), np.float32(0.0), np.float32(1.0), np.float32(0.0), np.float32(1.0), np.float32(1.0)]",0.0,99205.0,17
2025-08-14_08-18-36,8393,"[np.float32(1.0), np.float32(1.0), np.float32(1.0), np.float32(0.0), np.float32(0.0), np.float32(0.0), np.float32(1.0), np.float32(0.0), np.float32(0.0), np.float32(1.0), np.float32(1.0), np.float32(1.0), np.float32(0.0), np.float32(1.0), np.float32(1.0), np.float32(1.0)]",-2.0,99203.0,13
2025-08-14_08-18-36,8394,"[np.float32(0.0), np.float32(0.0), np.float32(0.0), np.float32(0.0), np.float32(0.0), np.float32(0.0), np.float32(1.0), np.float32(1.0), np.float32(0.0), np.float32(1.0), np.float32(1.0), np.float32(0.0), np.float32(0.0), np.float32(0.0), np.float32(0.0), np.float32(1.0)]",-2.0,99201.0,32
2025-08-14_08-18-36,8395,"[np.float32(1.0), np.float32(1.0), np.float32(0.0), np.float32(1.0), np.float32(1.0), np.float32(1.0), np.float32(0.0), np.float32(1.0), np.float32(1.0), np.float32(1.0), np.float32(1.0), np.float32(0.0), np.float32(0.0), np.float32(1.0), np.float32(0.0), np.float32(0.0)]",2.0,99203.0,21
2025-08-14_08-18-36,8396,"[np.float32(0.0), np.float32(0.0), np.float32(1.0), np.float32(0.0), np.float32(0.0), np.float32(1.0), np.float32(1.0), np.float32(1.0), np.float32(1.0), np.float32(1.0), np.float32(0.0), np.float32(1.0), np.float32(0.0), np.float32(1.0), np.float32(0.0), np.float32(1.0)]",-1.0,99202.0,14
2025-08-14_08-18-36,8397,"[np.float32(0.0), np.float32(1.0), np.float32(1.0), np.float32(0.0), np.float32(1.0), np.float32(0.0), np.float32(0.0), np.float32(1.0), np.float32(1.0), np.float32(1.0), np.float32(0.0), np.float32(1.0), np.float32(0.0), np.float32(1.0), np.float32(0.0), np.float32(1.0)]",4.0,99206.0,28
2025-08-14_08-18-36,8398,"[np.float32(1.0), np.float32(0.0), np.float32(1.0), np.float32(0.0), np.float32(1.0), np.float32(1.0), np.float32(1.0), np.float32(1.0), np.float32(0.0), np.float32(0.0), np.float32(1.0), np.float32(0.0), np.float32(1.0), np.float32(1.0), np.float32(0.0), np.float32(0.0)]",1.0,99207.0,21
2025-08-14_08-18-36,8399,"[np.float32(1.0), np.float32(0.0), np.float32(1.0), np.float32(0.0), np.float32(1.0), np.float32(0.0), np.float32(0.0), np.float32(1.0), np.float32(0.0), np.float32(1.0), np.float32(1.0), np.float32(1.0), np.float32(1.0), np.float32(1.0), np.float32(0.0), np.float32(0.0)]",-1.0,99206.0,13
2025-08-14_08-18-36,8400,"[np.float32(0.0), np.float32(0.0), np.float32(1.0), np.float32(1.0), np.float32(0.0), np.float32(1.0), np.float32(0.0), np.float32(1.0), np.float32(1.0), np.float32(1.0), np.float32(1.0), np.float32(0.0), np.float32(0.0), np.float32(0.0), np.float32(0.0), np.float32(1.0)]",-3.0,99203.0,8
2025-08-14_08-18-36,8401,"[np.float32(1.0), np.float32(0.0), np.float32(1.0), np.float32(0.0), np.float32(0.0), np.float32(1.0), np.float32(0.0), np.float32(1.0), np.float32(0.0), np.float32(0.0), np.float32(1.0), np.float32(0.0), np.float32(0.0), np.float32(1.0), np.float32(1.0), np.float32(0.0)]",3.0,99206.0,22
2025-08-14_08-18-36,8402,"[np.float32(1.0), np.float32(1.0), np.float32(0.0), np.float32(0.0), np.float32(1.0), np.float32(1.0), np.float32(1.0), np.float32(1.0), np.float32(1.0), np.float32(1.0), np.float32(0.0), np.float32(1.0), np.float32(1.0), np.float32(0.0), np.float32(0.0), np.float32(1.0)]",-4.0,99202.0,35
2025-08-14_08-18-36,8403,"[np.float32(1.0), np.float32(0.0), np.float32(1.0), np.float32(0.0), np.float32(0.0), np.float32(0.0), np.float32(0.0), np.float32(1.0), np.float32(1.0), np.float32(0.0), np.float32(1.0), np.float32(1.0), np.float32(0.0), np.float32(0.0), np.float32(1.0), np.float32(0.0)]",-1.0,99201.0,29
2025-08-14_08-18-36,8404,"[np.float32(1.0), np.float32(0.0), np.float32(0.0), np.float32(0.0), np.float32(0.0), np.float32(1.0), np.float32(1.0), np.float32(1.0), np.float32(1.0), np.float32(0.0), np.float32(0.0), np.float32(0.0), np.float32(0.0), np.float32(1.0), np.float32(0.0), np.float32(0.0)]",1.0,99202.0,30
2025-08-14_08-18-36,8405,"[np.float32(0.0), np.float32(0.0), np.float32(1.0), np.float32(1.0), np.float32(0.0), np.float32(0.0), np.float32(1.0), np.float32(1.0), np.float32(1.0), np.float32(1.0), np.float32(1.0), np.float32(1.0), np.float32(1.0), np.float32(0.0), np.float32(1.0), np.float32(0.0)]",-2.0,99200.0,21
2025-08-14_08-18-36,8406,"[np.float32(1.0), np.float32(0.0), np.float32(0.0), np.float32(0.0), np.float32(0.0), np.float32(0.0), np.float32(1.0), np.float32(0.0), np.float32(0.0), np.float32(0.0), np.float32(0.0), np.float32(0.0), np.float32(0.0), np.float32(0.0), np.float32(1.0), np.float32(0.0)]",3.0,99203.0,10
2025-08-14_08-18-36,8407,"[np.float32(1.0), np.float32(1.0), np.float32(0.0), np.float32(1.0), np.float32(1.0), np.float32(0.0), np.float32(1.0), np.float32(1.0), np.float32(0.0), np.float32(1.0), np.float32(0.0), np.float32(1.0), np.float32(0.0), np.float32(1.0), np.float32(0.0), np.float32(0.0)]",6.0,99209.0,3
2025-08-14_08-18-36,8408,"[np.float32(0.0), np.float32(1.0), np.float32(1.0), np.float32(0.0), np.float32(1.0), np.float32(0.0), np.float32(1.0), np.float32(1.0), np.float32(1.0), np.float32(1.0), np.float32(0.0), np.float32(1.0), np.float32(1.0), np.float32(1.0), np.float32(1.0), np.float32(0.0)]",-3.0,99206.0,29
2025-08-14_08-18-36,8409,"[np.float32(1.0), np.float32(0.0), np.float32(0.0), np.float32(0.0), np.float32(0.0), np.float32(0.0), np.float32(1.0), np.float32(0.0), np.float32(1.0), np.float32(1.0), np.float32(0.0), np.float32(1.0), np.float32(1.0), np.float32(1.0), np.float32(1.0), np.float32(0.0)]",-2.0,99204.0,8
2025-08-14_08-18-36,8410,"[np.float32(0.0), np.float32(1.0), np.float32(0.0), np.float32(1.0), np.float32(1.0), np.float32(0.0), np.float32(1.0), np.float32(1.0), np.float32(1.0), np.float32(1.0), np.float32(1.0), np.float32(1.0), np.float32(1.0), np.float32(1.0), np.float32(0.0), np.float32(1.0)]",1.0,99205.0,9
2025-08-14_08-18-36,8411,"[np.float32(1.0), np.float32(0.0), np.float32(0.0), np.float32(0.0), np.float32(1.0), np.float32(0.0), np.float32(1.0), np.float32(1.0), np.float32(0.0), np.float32(1.0), np.float32(1.0), np.float32(0.0), np.float32(0.0), np.float32(0.0), np.float32(0.0), np.float32(1.0)]",-2.0,99203.0,21
2025-08-14_08-18-36,8412,"[np.float32(1.0), np.float32(0.0), np.float32(0.0), np.float32(1.0), np.float32(0.0), np.float32(1.0), np.float32(1.0), np.float32(0.0), np.float32(1.0), np.float32(0.0), np.float32(0.0), np.float32(0.0), np.float32(1.0), np.float32(0.0), np.float32(0.0), np.float32(1.0)]",-4.0,99199.0,2
2025-08-14_08-18-36,8413,"[np.float32(1.0), np.float32(0.0), np.float32(1.0), np.float32(0.0), np.float32(0.0), np.float32(1.0), np.float32(0.0), np.float32(0.0), np.float32(1.0), np.float32(1.0), np.float32(0.0), np.float32(1.0), np.float32(0.0), np.float32(1.0), np.float32(1.0), np.float32(0.0)]",0.0,99199.0,31
2025-08-14_08-18-36,8414,"[np.float32(1.0), np.float32(1.0), np.float32(1.0), np.float32(1.0), np.float32(1.0), np.float32(1.0), np.float32(1.0), np.float32(0.0), np.float32(1.0), np.float32(1.0), np.float32(0.0), np.float32(0.0), np.float32(0.0), np.float32(0.0), np.float32(0.0), np.float32(1.0)]",-1.0,99198.0,3
2025-08-14_08-18-36,8415,"[np.float32(0.0), np.float32(1.0), np.float32(0.0), np.float32(0.0), np.float32(0.0), np.float32(0.0), np.float32(0.0), np.float32(1.0), np.float32(0.0), np.float32(1.0), np.float32(0.0), np.float32(0.0), np.float32(0.0), np.float32(0.0), np.float32(0.0), np.float32(0.0)]",2.0,99200.0,17
2025-08-14_08-18-36,8416,"[np.float32(0.0), np.float32(1.0), np.float32(0.0), np.float32(1.0), np.float32(0.0), np.float32(0.0), np.float32(1.0), np.float32(1.0), np.float32(1.0), np.float32(1.0), np.float32(1.0), np.float32(0.0), np.float32(0.0), np.float32(1.0), np.float32(0.0), np.float32(1.0)]",0.0,99200.0,14
2025-08-14_08-18-36,8417,"[np.float32(1.0), np.float32(1.0), np.float32(0.0), np.float32(1.0), np.float32(1.0), np.float32(1.0), np.float32(1.0), np.float32(1.0), np.float32(1.0), np.float32(0.0), np.float32(0.0), np.float32(0.0), np.float32(1.0), np.float32(1.0), np.float32(0.0), np.float32(0.0)]",-1.0,99199.0,17
2025-08-14_08-18-36,8418,"[np.float32(0.0), np.float32(1.0), np.float32(1.0), np.float32(1.0), np.float32(0.0), np.float32(0.0), np.float32(0.0), np.float32(0.0), np.float32(0.0), np.float32(1.0), np.float32(1.0), np.float32(0.0), np.float32(1.0), np.float32(0.0), np.float32(0.0), np.float32(0.0)]",1.0,99200.0,10
2025-08-14_08-18-36,8419,"[np.float32(1.0), np.float32(0.0), np.float32(1.0), np.float32(0.0), np.float32(1.0), np.float32(1.0), np.float32(0.0), np.float32(1.0), np.float32(1.0), np.float32(1.0), np.float32(0.0), np.float32(1.0), np.float32(0.0), np.float32(0.0), np.float32(1.0), np.float32(0.0)]",-2.0,99198.0,7
2025-08-14_08-18-36,8420,"[np.float32(1.0), np.float32(0.0), np.float32(0.0), np.float32(0.0), np.float32(0.0), np.float32(1.0), np.float32(0.0), np.float32(1.0), np.float32(0.0), np.float32(0.0), np.float32(1.0), np.float32(0.0), np.float32(0.0), np.float32(0.0), np.float32(1.0), np.float32(0.0)]",-2.0,99196.0,2
2025-08-14_08-18-36,8421,"[np.float32(1.0), np.float32(1.0), np.float32(0.0), np.float32(1.0), np.float32(1.0), np.float32(0.0), np.float32(1.0), np.float32(1.0), np.float32(1.0), np.float32(0.0), np.float32(1.0), np.float32(1.0), np.float32(1.0), np.float32(0.0), np.float32(0.0), np.float32(0.0)]",-3.0,99193.0,19
2025-08-14_08-18-36,8422,"[np.float32(0.0), np.float32(0.0), np.float32(0.0), np.float32(0.0), np.float32(0.0), np.float32(0.0), np.float32(0.0), np.float32(1.0), np.float32(1.0), np.float32(1.0), np.float32(0.0), np.float32(1.0), np.float32(0.0), np.float32(1.0), np.float32(0.0), np.float32(0.0)]",-5.0,99188.0,8
2025-08-14_08-18-36,8423,"[np.float32(0.0), np.float32(0.0), np.float32(1.0), np.float32(1.0), np.float32(1.0), np.float32(1.0), np.float32(1.0), np.float32(0.0), np.float32(1.0), np.float32(0.0), np.float32(0.0), np.float32(1.0), np.float32(0.0), np.float32(0.0), np.float32(0.0), np.float32(1.0)]",2.0,99190.0,36
2025-08-14_08-18-36,8424,"[np.float32(0.0), np.float32(0.0), np.float32(1.0), np.float32(0.0), np.float32(0.0), np.float32(0.0), np.float32(0.0), np.float32(0.0), np.float32(0.0), np.float32(1.0), np.float32(0.0), np.float32(1.0), np.float32(0.0), np.float32(1.0), np.float32(0.0), np.float32(1.0)]",3.0,99193.0,6
2025-08-14_08-18-36,8425,"[np.float32(0.0), np.float32(1.0), np.float32(1.0), np.float32(1.0), np.float32(0.0), np.float32(1.0), np.float32(0.0), np.float32(1.0), np.float32(1.0), np.float32(1.0), np.float32(0.0), np.float32(0.0), np.float32(1.0), np.float32(1.0), np.float32(1.0), np.float32(1.0)]",-4.0,99189.0,6
2025-08-14_08-18-36,8426,"[np.float32(0.0), np.float32(0.0), np.float32(1.0), np.float32(1.0), np.float32(0.0), np.float32(0.0), np.float32(1.0), np.float32(1.0), np.float32(1.0), np.float32(1.0), np.float32(1.0), np.float32(0.0), np.float32(0.0), np.float32(1.0), np.float32(1.0), np.float32(0.0)]",2.0,99191.0,23
2025-08-14_08-18-36,8427,"[np.float32(0.0), np.float32(1.0), np.float32(0.0), np.float32(1.0), np.float32(0.0), np.float32(1.0), np.float32(1.0), np.float32(0.0), np.float32(0.0), np.float32(1.0), np.float32(0.0), np.float32(1.0), np.float32(1.0), np.float32(0.0), np.float32(0.0), np.float32(1.0)]",-3.0,99188.0,30
2025-08-14_08-18-36,8428,"[np.float32(0.0), np.float32(0.0), np.float32(1.0), np.float32(1.0), np.float32(0.0), np.float32(1.0), np.float32(1.0), np.float32(1.0), np.float32(0.0), np.float32(1.0), np.float32(1.0), np.float32(0.0), np.float32(1.0), np.float32(1.0), np.float32(1.0), np.float32(0.0)]",-2.0,99186.0,17
2025-08-14_08-18-36,8429,"[np.float32(0.0), np.float32(1.0), np.float32(0.0), np.float32(0.0), np.float32(1.0), np.float32(1.0), np.float32(1.0), np.float32(1.0), np.float32(0.0), np.float32(0.0), np.float32(1.0), np.float32(0.0), np.float32(0.0), np.float32(1.0), np.float32(1.0), np.float32(0.0)]",2.0,99188.0,20
2025-08-14_08-18-36,8430,"[np.float32(1.0), np.float32(1.0), np.float32(0.0), np.float32(1.0), np.float32(0.0), np.float32(0.0), np.float32(1.0), np.float32(0.0), np.float32(1.0), np.float32(1.0), np.float32(1.0), np.float32(0.0), np.float32(1.0), np.float32(0.0), np.float32(0.0), np.float32(0.0)]",0.0,99188.0,4
2025-08-14_08-18-36,8431,"[np.float32(1.0), np.float32(0.0), np.float32(0.0), np.float32(0.0), np.float32(0.0), np.float32(1.0), np.float32(0.0), np.float32(1.0), np.float32(1.0), np.float32(1.0), np.float32(1.0), np.float32(1.0), np.float32(1.0), np.float32(1.0), np.float32(0.0), np.float32(0.0)]",-1.0,99187.0,31
2025-08-14_08-18-36,8432,"[np.float32(0.0), np.float32(1.0), np.float32(0.0), np.float32(0.0), np.float32(0.0), np.float32(1.0), np.float32(1.0), np.float32(1.0), np.float32(1.0), np.float32(1.0), np.float32(0.0), np.float32(1.0), np.float32(0.0), np.float32(0.0), np.float32(1.0), np.float32(0.0)]",5.0,99192.0,24
2025-08-14_08-18-36,8433,"[np.float32(0.0), np.float32(0.0), np.float32(1.0), np.float32(1.0), np.float32(0.0), np.float32(1.0), np.float32(1.0), np.float32(1.0), np.float32(1.0), np.float32(1.0), np.float32(0.0), np.float32(0.0), np.float32(1.0), np.float32(1.0), np.float32(1.0), np.float32(0.0)]",-2.0,99190.0,2
2025-08-14_08-18-36,8434,"[np.float32(1.0), np.float32(0.0), np.float32(0.0), np.float32(0.0), np.float32(1.0), np.float32(1.0), np.float32(0.0), np.float32(1.0), np.float32(1.0), np.float32(1.0), np.float32(0.0), np.float32(0.0), np.float32(0.0), np.float32(0.0), np.float32(0.0), np.float32(1.0)]",0.0,99190.0,27
2025-08-14_08-18-36,8435,"[np.float32(0.0), np.float32(1.0), np.float32(1.0), np.float32(1.0), np.float32(1.0), np.float32(0.0), np.float32(1.0), np.float32(1.0), np.float32(0.0), np.float32(1.0), np.float32(0.0), np.float32(1.0), np.float32(1.0), np.float32(1.0), np.float32(1.0), np.float32(0.0)]",2.0,99192.0,18
2025-08-14_08-18-36,8436,"[np.float32(1.0), np.float32(0.0), np.float32(0.0), np.float32(1.0), np.float32(0.0), np.float32(1.0), np.float32(0.0), np.float32(1.0), np.float32(0.0), np.float32(0.0), np.float32(0.0), np.float32(0.0), np.float32(1.0), np.float32(1.0), np.float32(0.0), np.float32(0.0)]",2.0,99194.0,18
2025-08-14_08-18-36,8437,"[np.float32(0.0), np.float32(1.0), np.float32(0.0), np.float32(0.0), np.float32(1.0), np.float32(0.0), np.float32(1.0), np.float32(1.0), np.float32(1.0), np.float32(0.0), np.float32(0.0), np.float32(1.0), np.float32(0.0), np.float32(1.0), np.float32(0.0), np.float32(0.0)]",-1.0,99193.0,25
2025-08-14_08-18-36,8438,"[np.float32(1.0), np.float32(1.0), np.float32(1.0), np.float32(0.0), np.float32(0.0), np.float32(0.0), np.float32(1.0), np.float32(1.0), np.float32(1.0), np.float32(0.0), np.float32(0.0), np.float32(0.0), np.float32(0.0), np.float32(0.0), np.float32(0.0), np.float32(0.0)]",1.0,99194.0,26
2025-08-14_08-18-36,8439,"[np.float32(0.0), np.float32(1.0), np.float32(1.0), np.float32(1.0), np.float32(0.0), np.float32(1.0), np.float32(0.0), np.float32(1.0), np.float32(0.0), np.float32(0.0), np.float32(0.0), np.float32(1.0), np.float32(0.0), np.float32(1.0), np.float32(0.0), np.float32(0.0)]",1.0,99195.0,12
2025-08-14_08-18-36,8440,"[np.float32(1.0), np.float32(0.0), np.float32(0.0), np.float32(1.0), np.float32(0.0), np.float32(1.0), np.float32(0.0), np.float32(1.0), np.float32(1.0), np.float32(0.0), np.float32(0.0), np.float32(0.0), np.float32(1.0), np.float32(1.0), np.float32(0.0), np.float32(1.0)]",2.0,99197.0,31
2025-08-14_08-18-36,8441,"[np.float32(0.0), np.float32(0.0), np.float32(1.0), np.float32(0.0), np.float32(0.0), np.float32(1.0), np.float32(1.0), np.float32(1.0), np.float32(1.0), np.float32(1.0), np.float32(0.0), np.float32(0.0), np.float32(1.0), np.float32(1.0), np.float32(0.0), np.float32(1.0)]",2.0,99199.0,4
2025-08-14_08-18-36,8442,"[np.float32(0.0), np.float32(1.0), np.float32(0.0), np.float32(1.0), np.float32(1.0), np.float32(1.0), np.float32(1.0), np.float32(0.0), np.float32(0.0), np.float32(0.0), np.float32(0.0), np.float32(0.0), np.float32(1.0), np.float32(0.0), np.float32(0.0), np.float32(0.0)]",1.0,99200.0,10
2025-08-14_08-18-36,8443,"[np.float32(1.0), np.float32(1.0), np.float32(0.0), np.float32(1.0), np.float32(0.0), np.float32(0.0), np.float32(1.0), np.float32(0.0), np.float32(0.0), np.float32(1.0), np.float32(0.0), np.float32(0.0), np.float32(0.0), np.float32(0.0), np.float32(0.0), np.float32(1.0)]",-4.0,99196.0,30
2025-08-14_08-18-36,8444,"[np.float32(0.0), np.float32(1.0), np.float32(1.0), np.float32(0.0), np.float32(0.0), np.float32(0.0), np.float32(1.0), np.float32(1.0), np.float32(1.0), np.float32(0.0), np.float32(0.0), np.float32(0.0), np.float32(1.0), np.float32(1.0), np.float32(0.0), np.float32(0.0)]",-2.0,99194.0,16
2025-08-14_08-18-36,8445,"[np.float32(0.0), np.float32(0.0), np.float32(0.0), np.float32(1.0), np.float32(1.0), np.float32(1.0), np.float32(0.0), np.float32(0.0), np.float32(1.0), np.float32(1.0), np.float32(0.0), np.float32(0.0), np.float32(0.0), np.float32(0.0), np.float32(0.0), np.float32(0.0)]",0.0,99194.0,36
2025-08-14_08-18-36,8446,"[np.float32(0.0), np.float32(0.0), np.float32(0.0), np.float32(1.0), np.float32(0.0), np.float32(1.0), np.float32(1.0), np.float32(1.0), np.float32(0.0), np.float32(1.0), np.float32(1.0), np.float32(0.0), np.float32(0.0), np.float32(0.0), np.float32(1.0), np.float32(0.0)]",0.0,99194.0,33
2025-08-14_08-18-36,8447,"[np.float32(1.0), np.float32(1.0), np.float32(1.0), np.float32(0.0), np.float32(0.0), np.float32(0.0), np.float32(0.0), np.float32(1.0), np.float32(1.0), np.float32(0.0), np.float32(1.0), np.float32(1.0), np.float32(1.0), np.float32(1.0), np.float32(1.0), np.float32(0.0)]",-3.0,99191.0,10
2025-08-14_08-18-36,8448,"[np.float32(1.0), np.float32(1.0), np.float32(1.0), np.float32(1.0), np.float32(1.0), np.float32(0.0), np.float32(1.0), np.float32(1.0), np.float32(0.0), np.float32(1.0), np.float32(1.0), np.float32(1.0), np.float32(0.0), np.float32(0.0), np.float32(1.0), np.float32(0.0)]",1.0,99192.0,17
2025-08-14_08-18-36,8449,"[np.float32(1.0), np.float32(0.0), np.float32(1.0), np.float32(1.0), np.float32(1.0), np.float32(1.0), np.float32(1.0), np.float32(0.0), np.float32(1.0), np.float32(0.0), np.float32(1.0), np.float32(1.0), np.float32(0.0), np.float32(0.0), np.float32(1.0), np.float32(0.0)]",5.0,99197.0,27
2025-08-14_08-18-36,8450,"[np.float32(1.0), np.float32(1.0), np.float32(0.0), np.float32(0.0), np.float32(1.0), np.float32(0.0), np.float32(0.0), np.float32(1.0), np.float32(1.0), np.float32(0.0), np.float32(0.0), np.float32(0.0), np.float32(1.0), np.float32(1.0), np.float32(0.0), np.float32(1.0)]",0.0,99197.0,26
2025-08-14_08-18-36,8451,"[np.float32(0.0), np.float32(1.0), np.float32(1.0), np.float32(0.0), np.float32(0.0), np.float32(0.0), np.float32(0.0), np.float32(0.0), np.float32(1.0), np.float32(1.0), np.float32(1.0), np.float32(1.0), np.float32(1.0), np.float32(1.0), np.float32(0.0), np.float32(1.0)]",-1.0,99196.0,30
2025-08-14_08-18-36,8452,"[np.float32(0.0), np.float32(0.0), np.float32(0.0), np.float32(1.0), np.float32(1.0), np.float32(0.0), np.float32(1.0), np.float32(1.0), np.float32(1.0), np.float32(0.0), np.float32(0.0), np.float32(1.0), np.float32(1.0), np.float32(1.0), np.float32(0.0), np.float32(0.0)]",3.0,99199.0,21
2025-08-14_08-18-36,8453,"[np.float32(1.0), np.float32(1.0), np.float32(0.0), np.float32(1.0), np.float32(0.0), np.float32(1.0), np.float32(0.0), np.float32(0.0), np.float32(0.0), np.float32(1.0), np.float32(1.0), np.float32(0.0), np.float32(0.0), np.float32(1.0), np.float32(1.0), np.float32(1.0)]",-2.0,99197.0,30
2025-08-14_08-18-36,8454,"[np.float32(0.0), np.float32(0.0), np.float32(0.0), np.float32(0.0), np.float32(0.0), np.float32(1.0), np.float32(1.0), np.float32(1.0), np.float32(0.0), np.float32(0.0), np.float32(0.0), np.float32(0.0), np.float32(1.0), np.float32(0.0), np.float32(0.0), np.float32(1.0)]",-2.0,99195.0,2
2025-08-14_08-18-36,8455,"[np.float32(1.0), np.float32(0.0), np.float32(1.0), np.float32(1.0), np.float32(1.0), np.float32(1.0), np.float32(1.0), np.float32(0.0), np.float32(1.0), np.float32(1.0), np.float32(1.0), np.float32(0.0), np.float32(0.0), np.float32(1.0), np.float32(0.0), np.float32(1.0)]",4.0,99199.0,7
2025-08-14_08-18-36,8456,"[np.float32(1.0), np.float32(0.0), np.float32(0.0), np.float32(0.0), np.float32(0.0), np.float32(1.0), np.float32(0.0), np.float32(0.0), np.float32(1.0), np.float32(1.0), np.float32(0.0), np.float32(0.0), np.float32(0.0), np.float32(0.0), np.float32(0.0), np.float32(1.0)]",-1.0,99198.0,23
2025-08-14_08-18-36,8457,"[np.float32(1.0), np.float32(0.0), np.float32(1.0), np.float32(0.0), np.float32(1.0), np.float32(1.0), np.float32(0.0), np.float32(1.0), np.float32(1.0), np.float32(1.0), np.float32(0.0), np.float32(0.0), np.float32(0.0), np.float32(0.0), np.float32(0.0), np.float32(0.0)]",1.0,99199.0,31
2025-08-14_08-18-36,8458,"[np.float32(1.0), np.float32(1.0), np.float32(1.0), np.float32(0.0), np.float32(0.0), np.float32(1.0), np.float32(1.0), np.float32(0.0), np.float32(1.0), np.float32(1.0), np.float32(1.0), np.float32(1.0), np.float32(1.0), np.float32(1.0), np.float32(0.0), np.float32(1.0)]",1.0,99200.0,2
2025-08-14_08-18-36,8459,"[np.float32(1.0), np.float32(0.0), np.float32(1.0), np.float32(0.0), np.float32(0.0), np.float32(0.0), np.float32(1.0), np.float32(1.0), np.float32(0.0), np.float32(0.0), np.float32(0.0), np.float32(1.0), np.float32(1.0), np.float32(0.0), np.float32(1.0), np.float32(1.0)]",2.0,99202.0,14
2025-08-14_08-18-36,8460,"[np.float32(1.0), np.float32(1.0), np.float32(1.0), np.float32(1.0), np.float32(0.0), np.float32(1.0), np.float32(1.0), np.float32(1.0), np.float32(1.0), np.float32(1.0), np.float32(1.0), np.float32(0.0), np.float32(1.0), np.float32(1.0), np.float32(0.0), np.float32(1.0)]",-3.0,99199.0,15
2025-08-14_08-18-36,8461,"[np.float32(0.0), np.float32(1.0), np.float32(0.0), np.float32(0.0), np.float32(1.0), np.float32(1.0), np.float32(0.0), np.float32(0.0), np.float32(0.0), np.float32(0.0), np.float32(0.0), np.float32(0.0), np.float32(1.0), np.float32(1.0), np.float32(0.0), np.float32(0.0)]",2.0,99201.0,29
2025-08-14_08-18-36,8462,"[np.float32(1.0), np.float32(0.0), np.float32(0.0), np.float32(0.0), np.float32(0.0), np.float32(0.0), np.float32(0.0), np.float32(0.0), np.float32(1.0), np.float32(1.0), np.float32(1.0), np.float32(0.0), np.float32(1.0), np.float32(0.0), np.float32(0.0), np.float32(0.0)]",0.0,99201.0,36
2025-08-14_08-18-36,8463,"[np.float32(1.0), np.float32(0.0), np.float32(0.0), np.float32(1.0), np.float32(0.0), np.float32(1.0), np.float32(1.0), np.float32(1.0), np.float32(1.0), np.float32(1.0), np.float32(1.0), np.float32(0.0), np.float32(1.0), np.float32(1.0), np.float32(0.0), np.float32(1.0)]",0.0,99201.0,20
2025-08-14_08-18-36,8464,"[np.float32(0.0), np.float32(1.0), np.float32(0.0), np.float32(0.0), np.float32(1.0), np.float32(1.0), np.float32(0.0), np.float32(0.0), np.float32(1.0), np.float32(0.0), np.float32(0.0), np.float32(1.0), np.float32(0.0), np.float32(0.0), np.float32(1.0), np.float32(0.0)]",-1.0,99200.0,32
2025-08-14_08-18-36,8465,"[np.float32(0.0), np.float32(0.0), np.float32(1.0), np.float32(0.0), np.float32(1.0), np.float32(0.0), np.float32(0.0), np.float32(1.0), np.float32(0.0), np.float32(0.0), np.float32(0.0), np.float32(1.0), np.float32(1.0), np.float32(1.0), np.float32(1.0), np.float32(1.0)]",1.0,99201.0,21
2025-08-14_08-18-36,8466,"[np.float32(0.0), np.float32(0.0), np.float32(1.0), np.float32(1.0), np.float32(1.0), np.float32(0.0), np.float32(1.0), np.float32(0.0), np.float32(1.0), np.float32(1.0), np.float32(0.0), np.float32(0.0), np.float32(1.0), np.float32(0.0), np.float32(0.0), np.float32(1.0)]",-3.0,99198.0,33
2025-08-14_08-18-36,8467,"[np.float32(0.0), np.float32(1.0), np.float32(0.0), np.float32(1.0), np.float32(1.0), np.float32(1.0), np.float32(0.0), np.float32(0.0), np.float32(1.0), np.float32(1.0), np.float32(0.0), np.float32(0.0), np.float32(1.0), np.float32(0.0), np.float32(1.0), np.float32(1.0)]",1.0,99199.0,28
2025-08-14_08-18-36,8468,"[np.float32(0.0), np.float32(0.0), np.float32(1.0), np.float32(1.0), np.float32(0.0), np.float32(0.0), np.float32(0.0), np.float32(0.0), np.float32(1.0), np.float32(1.0), np.float32(0.0), np.float32(0.0), np.float32(1.0), np.float32(0.0), np.float32(0.0), np.float32(1.0)]",-1.0,99198.0,20
2025-08-14_08-18-36,8469,"[np.float32(1.0), np.float32(1.0), np.float32(0.0), np.float32(1.0), np.float32(0.0), np.float32(0.0), np.float32(0.0), np.float32(1.0), np.float32(0.0), np.float32(0.0), np.float32(1.0), np.float32(1.0), np.float32(0.0), np.float32(0.0), np.float32(0.0), np.float32(0.0)]",-1.0,99197.0,32
2025-08-14_08-18-36,8470,"[np.float32(1.0), np.float32(1.0), np.float32(1.0), np.float32(0.0), np.float32(0.0), np.float32(0.0), np.float32(0.0), np.float32(1.0), np.float32(1.0), np.float32(1.0), np.float32(1.0), np.float32(1.0), np.float32(0.0), np.float32(0.0), np.float32(1.0), np.float32(1.0)]",0.0,99197.0,32
2025-08-14_08-18-36,8471,"[np.float32(0.0), np.float32(0.0), np.float32(0.0), np.float32(1.0), np.float32(0.0), np.float32(1.0), np.float32(0.0), np.float32(1.0), np.float32(0.0), np.float32(0.0), np.float32(1.0), np.float32(1.0), np.float32(1.0), np.float32(1.0), np.float32(1.0), np.float32(1.0)]",-1.0,99196.0,26
2025-08-14_08-18-36,8472,"[np.float32(1.0), np.float32(1.0), np.float32(1.0), np.float32(0.0), np.float32(0.0), np.float32(0.0), np.float32(1.0), np.float32(1.0), np.float32(1.0), np.float32(1.0), np.float32(1.0), np.float32(1.0), np.float32(1.0), np.float32(0.0), np.float32(0.0), np.float32(0.0)]",0.0,99196.0,30
2025-08-14_08-18-36,8473,"[np.float32(0.0), np.float32(1.0), np.float32(0.0), np.float32(0.0), np.float32(0.0), np.float32(1.0), np.float32(0.0), np.float32(0.0), np.float32(1.0), np.float32(0.0), np.float32(0.0), np.float32(0.0), np.float32(1.0), np.float32(0.0), np.float32(0.0), np.float32(0.0)]",3.0,99199.0,31
2025-08-14_08-18-36,8474,"[np.float32(1.0), np.float32(1.0), np.float32(0.0), np.float32(0.0), np.float32(1.0), np.float32(0.0), np.float32(1.0), np.float32(0.0), np.float32(0.0), np.float32(1.0), np.float32(1.0), np.float32(0.0), np.float32(0.0), np.float32(1.0), np.float32(0.0), np.float32(1.0)]",2.0,99201.0,3
2025-08-14_08-18-36,8475,"[np.float32(0.0), np.float32(0.0), np.float32(1.0), np.float32(1.0), np.float32(0.0), np.float32(1.0), np.float32(0.0), np.float32(0.0), np.float32(0.0), np.float32(0.0), np.float32(1.0), np.float32(1.0), np.float32(1.0), np.float32(1.0), np.float32(0.0), np.float32(1.0)]",-6.0,99195.0,13
2025-08-14_08-18-36,8476,"[np.float32(0.0), np.float32(1.0), np.float32(0.0), np.float32(1.0), np.float32(0.0), np.float32(1.0), np.float32(1.0), np.float32(0.0), np.float32(0.0), np.float32(0.0), np.float32(1.0), np.float32(1.0), np.float32(1.0), np.float32(0.0), np.float32(0.0), np.float32(0.0)]",0.0,99195.0,17
2025-08-14_08-18-36,8477,"[np.float32(1.0), np.float32(0.0), np.float32(1.0), np.float32(0.0), np.float32(0.0), np.float32(0.0), np.float32(1.0), np.float32(0.0), np.float32(0.0), np.float32(1.0), np.float32(0.0), np.float32(0.0), np.float32(1.0), np.float32(0.0), np.float32(1.0), np.float32(0.0)]",-6.0,99189.0,29
2025-08-14_08-18-36,8478,"[np.float32(0.0), np.float32(0.0), np.float32(1.0), np.float32(1.0), np.float32(0.0), np.float32(1.0), np.float32(1.0), np.float32(1.0), np.float32(1.0), np.float32(0.0), np.float32(1.0), np.float32(1.0), np.float32(0.0), np.float32(1.0), np.float32(1.0), np.float32(0.0)]",1.0,99190.0,18
2025-08-14_08-18-36,8479,"[np.float32(0.0), np.float32(1.0), np.float32(0.0), np.float32(0.0), np.float32(0.0), np.float32(0.0), np.float32(1.0), np.float32(0.0), np.float32(1.0), np.float32(0.0), np.float32(0.0), np.float32(0.0), np.float32(1.0), np.float32(0.0), np.float32(0.0), np.float32(0.0)]",1.0,99191.0,11
2025-08-14_08-18-36,8480,"[np.float32(0.0), np.float32(0.0), np.float32(0.0), np.float32(1.0), np.float32(1.0), np.float32(1.0), np.float32(1.0), np.float32(0.0), np.float32(1.0), np.float32(0.0), np.float32(0.0), np.float32(0.0), np.float32(0.0), np.float32(1.0), np.float32(1.0), np.float32(0.0)]",1.0,99192.0,30
2025-08-14_08-18-36,8481,"[np.float32(0.0), np.float32(1.0), np.float32(1.0), np.float32(0.0), np.float32(0.0), np.float32(0.0), np.float32(0.0), np.float32(1.0), np.float32(1.0), np.float32(0.0), np.float32(0.0), np.float32(1.0), np.float32(0.0), np.float32(1.0), np.float32(0.0), np.float32(1.0)]",-1.0,99191.0,25
2025-08-14_08-18-36,8482,"[np.float32(0.0), np.float32(0.0), np.float32(1.0), np.float32(0.0), np.float32(0.0), np.float32(0.0), np.float32(1.0), np.float32(1.0), np.float32(0.0), np.float32(1.0), np.float32(1.0), np.float32(1.0), np.float32(1.0), np.float32(1.0), np.float32(1.0), np.float32(0.0)]",-1.0,99190.0,20
2025-08-14_08-18-36,8483,"[np.float32(0.0), np.float32(1.0), np.float32(0.0), np.float32(0.0), np.float32(1.0), np.float32(1.0), np.float32(1.0), np.float32(0.0), np.float32(0.0), np.float32(0.0), np.float32(0.0), np.float32(1.0), np.float32(0.0), np.float32(0.0), np.float32(0.0), np.float32(1.0)]",-4.0,99186.0,32
2025-08-14_08-18-36,8484,"[np.float32(1.0), np.float32(1.0), np.float32(1.0), np.float32(1.0), np.float32(0.0), np.float32(1.0), np.float32(1.0), np.float32(0.0), np.float32(0.0), np.float32(0.0), np.float32(0.0), np.float32(1.0), np.float32(1.0), np.float32(0.0), np.float32(0.0), np.float32(0.0)]",1.0,99187.0,33
2025-08-14_08-18-36,8485,"[np.float32(1.0), np.float32(1.0), np.float32(1.0), np.float32(0.0), np.float32(1.0), np.float32(0.0), np.float32(1.0), np.float32(1.0), np.float32(0.0), np.float32(1.0), np.float32(0.0), np.float32(1.0), np.float32(0.0), np.float32(0.0), np.float32(0.0), np.float32(0.0)]",4.0,99191.0,10
2025-08-14_08-18-36,8486,"[np.float32(0.0), np.float32(1.0), np.float32(0.0), np.float32(1.0), np.float32(1.0), np.float32(0.0), np.float32(1.0), np.float32(1.0), np.float32(1.0), np.float32(1.0), np.float32(0.0), np.float32(1.0), np.float32(0.0), np.float32(1.0), np.float32(1.0), np.float32(0.0)]",1.0,99192.0,19
2025-08-14_08-18-36,8487,"[np.float32(0.0), np.float32(0.0), np.float32(1.0), np.float32(1.0), np.float32(0.0), np.float32(0.0), np.float32(1.0), np.float32(0.0), np.float32(0.0), np.float32(0.0), np.float32(1.0), np.float32(1.0), np.float32(1.0), np.float32(0.0), np.float32(0.0), np.float32(0.0)]",-1.0,99191.0,32
2025-08-14_08-18-36,8488,"[np.float32(0.0), np.float32(1.0), np.float32(0.0), np.float32(0.0), np.float32(0.0), np.float32(0.0), np.float32(0.0), np.float32(1.0), np.float32(0.0), np.float32(0.0), np.float32(0.0), np.float32(1.0), np.float32(0.0), np.float32(1.0), np.float32(0.0), np.float32(0.0)]",-1.0,99190.0,36
2025-08-14_08-18-36,8489,"[np.float32(1.0), np.float32(0.0), np.float32(0.0), np.float32(0.0), np.float32(1.0), np.float32(1.0), np.float32(1.0), np.float32(1.0), np.float32(0.0), np.float32(1.0), np.float32(1.0), np.float32(1.0), np.float32(0.0), np.float32(0.0), np.float32(0.0), np.float32(0.0)]",0.0,99190.0,2
2025-08-14_08-18-36,8490,"[np.float32(1.0), np.float32(0.0), np.float32(1.0), np.float32(1.0), np.float32(1.0), np.float32(1.0), np.float32(1.0), np.float32(0.0), np.float32(1.0), np.float32(0.0), np.float32(0.0), np.float32(0.0), np.float32(1.0), np.float32(1.0), np.float32(1.0), np.float32(1.0)]",-1.0,99189.0,11
2025-08-14_08-18-36,8491,"[np.float32(0.0), np.float32(1.0), np.float32(1.0), np.float32(1.0), np.float32(0.0), np.float32(1.0), np.float32(1.0), np.float32(1.0), np.float32(0.0), np.float32(1.0), np.float32(1.0), np.float32(0.0), np.float32(1.0), np.float32(0.0), np.float32(0.0), np.float32(1.0)]",5.0,99194.0,20
2025-08-14_08-18-36,8492,"[np.float32(0.0), np.float32(0.0), np.float32(0.0), np.float32(0.0), np.float32(0.0), np.float32(0.0), np.float32(0.0), np.float32(0.0), np.float32(0.0), np.float32(0.0), np.float32(0.0), np.float32(1.0), np.float32(1.0), np.float32(1.0), np.float32(0.0), np.float32(0.0)]",3.0,99197.0,18
2025-08-14_08-18-36,8493,"[np.float32(1.0), np.float32(1.0), np.float32(1.0), np.float32(0.0), np.float32(0.0), np.float32(1.0), np.float32(1.0), np.float32(1.0), np.float32(1.0), np.float32(0.0), np.float32(1.0), np.float32(0.0), np.float32(0.0), np.float32(1.0), np.float32(0.0), np.float32(0.0)]",4.0,99201.0,29
2025-08-14_08-18-36,8494,"[np.float32(0.0), np.float32(1.0), np.float32(0.0), np.float32(0.0), np.float32(0.0), np.float32(1.0), np.float32(0.0), np.float32(1.0), np.float32(1.0), np.float32(1.0), np.float32(0.0), np.float32(0.0), np.float32(0.0), np.float32(1.0), np.float32(1.0), np.float32(0.0)]",-2.0,99199.0,8
2025-08-14_08-18-36,8495,"[np.float32(1.0), np.float32(1.0), np.float32(1.0), np.float32(0.0), np.float32(0.0), np.float32(1.0), np.float32(0.0), np.float32(1.0), np.float32(1.0), np.float32(1.0), np.float32(1.0), np.float32(1.0), np.float32(1.0), np.float32(0.0), np.float32(1.0), np.float32(1.0)]",-2.0,99197.0,8
2025-08-14_08-18-36,8496,"[np.float32(1.0), np.float32(0.0), np.float32(0.0), np.float32(1.0), np.float32(1.0), np.float32(1.0), np.float32(0.0), np.float32(1.0), np.float32(1.0), np.float32(1.0), np.float32(1.0), np.float32(0.0), np.float32(0.0), np.float32(1.0), np.float32(1.0), np.float32(0.0)]",5.0,99202.0,19
2025-08-14_08-18-36,8497,"[np.float32(1.0), np.float32(1.0), np.float32(1.0), np.float32(1.0), np.float32(0.0), np.float32(0.0), np.float32(1.0), np.float32(0.0), np.float32(1.0), np.float32(1.0), np.float32(0.0), np.float32(1.0), np.float32(0.0), np.float32(1.0), np.float32(0.0), np.float32(0.0)]",4.0,99206.0,25
2025-08-14_08-18-36,8498,"[np.float32(0.0), np.float32(0.0), np.float32(0.0), np.float32(0.0), np.float32(0.0), np.float32(1.0), np.float32(1.0), np.float32(1.0), np.float32(1.0), np.float32(1.0), np.float32(1.0), np.float32(0.0), np.float32(0.0), np.float32(0.0), np.float32(0.0), np.float32(1.0)]",-2.0,99204.0,30
2025-08-14_08-18-36,8499,"[np.float32(1.0), np.float32(1.0), np.float32(0.0), np.float32(0.0), np.float32(0.0), np.float32(0.0), np.float32(1.0), np.float32(1.0), np.float32(1.0), np.float32(1.0), np.float32(0.0), np.float32(0.0), np.float32(1.0), np.float32(0.0), np.float32(1.0), np.float32(0.0)]",0.0,99204.0,31
2025-08-14_08-18-36,8500,"[np.float32(0.0), np.float32(1.0), np.float32(1.0), np.float32(0.0), np.float32(0.0), np.float32(1.0), np.float32(0.0), np.float32(1.0), np.float32(1.0), np.float32(0.0), np.float32(0.0), np.float32(1.0), np.float32(0.0), np.float32(0.0), np.float32(1.0), np.float32(0.0)]",6.0,99210.0,36
2025-08-14_08-18-36,8501,"[np.float32(1.0), np.float32(0.0), np.float32(0.0), np.float32(0.0), np.float32(0.0), np.float32(0.0), np.float32(1.0), np.float32(1.0), np.float32(1.0), np.float32(0.0), np.float32(0.0), np.float32(0.0), np.float32(1.0), np.float32(0.0), np.float32(0.0), np.float32(0.0)]",0.0,99210.0,36
2025-08-14_08-18-36,8502,"[np.float32(0.0), np.float32(1.0), np.float32(1.0), np.float32(1.0), np.float32(0.0), np.float32(1.0), np.float32(0.0), np.float32(1.0), np.float32(1.0), np.float32(0.0), np.float32(1.0), np.float32(0.0), np.float32(1.0), np.float32(1.0), np.float32(1.0), np.float32(1.0)]",-3.0,99207.0,16
2025-08-14_08-18-36,8503,"[np.float32(1.0), np.float32(0.0), np.float32(1.0), np.float32(0.0), np.float32(0.0), np.float32(0.0), np.float32(0.0), np.float32(0.0), np.float32(1.0), np.float32(1.0), np.float32(0.0), np.float32(0.0), np.float32(0.0), np.float32(1.0), np.float32(1.0), np.float32(0.0)]",-4.0,99203.0,20
2025-08-14_08-18-36,8504,"[np.float32(1.0), np.float32(0.0), np.float32(1.0), np.float32(1.0), np.float32(0.0), np.float32(1.0), np.float32(0.0), np.float32(0.0), np.float32(0.0), np.float32(0.0), np.float32(1.0), np.float32(0.0), np.float32(1.0), np.float32(1.0), np.float32(0.0), np.float32(0.0)]",-1.0,99202.0,36
2025-08-14_08-18-36,8505,"[np.float32(1.0), np.float32(1.0), np.float32(0.0), np.float32(0.0), np.float32(1.0), np.float32(1.0), np.float32(1.0), np.float32(1.0), np.float32(0.0), np.float32(0.0), np.float32(1.0), np.float32(0.0), np.float32(0.0), np.float32(0.0), np.float32(0.0), np.float32(1.0)]",-1.0,99201.0,19
2025-08-14_08-18-36,8506,"[np.float32(0.0), np.float32(1.0), np.float32(0.0), np.float32(1.0), np.float32(0.0), np.float32(1.0), np.float32(0.0), np.float32(1.0), np.float32(0.0), np.float32(1.0), np.float32(0.0), np.float32(0.0), np.float32(1.0), np.float32(0.0), np.float32(0.0), np.float32(1.0)]",-1.0,99200.0,29
2025-08-14_08-18-36,8507,"[np.float32(1.0), np.float32(1.0), np.float32(0.0), np.float32(0.0), np.float32(0.0), np.float32(1.0), np.float32(1.0), np.float32(1.0), np.float32(1.0), np.float32(0.0), np.float32(1.0), np.float32(1.0), np.float32(1.0), np.float32(1.0), np.float32(0.0), np.float32(1.0)]",-1.0,99199.0,23
2025-08-14_08-18-36,8508,"[np.float32(1.0), np.float32(0.0), np.float32(1.0), np.float32(1.0), np.float32(0.0), np.float32(1.0), np.float32(0.0), np.float32(1.0), np.float32(1.0), np.float32(0.0), np.float32(0.0), np.float32(1.0), np.float32(0.0), np.float32(1.0), np.float32(0.0), np.float32(0.0)]",4.0,99203.0,19
2025-08-14_08-18-36,8509,"[np.float32(1.0), np.float32(1.0), np.float32(0.0), np.float32(1.0), np.float32(1.0), np.float32(1.0), np.float32(1.0), np.float32(1.0), np.float32(1.0), np.float32(1.0), np.float32(0.0), np.float32(1.0), np.float32(1.0), np.float32(0.0), np.float32(1.0), np.float32(0.0)]",0.0,99203.0,15
2025-08-14_08-18-36,8510,"[np.float32(1.0), np.float32(1.0), np.float32(0.0), np.float32(1.0), np.float32(1.0), np.float32(0.0), np.float32(0.0), np.float32(1.0), np.float32(0.0), np.float32(0.0), np.float32(0.0), np.float32(1.0), np.float32(1.0), np.float32(1.0), np.float32(1.0), np.float32(0.0)]",-7.0,99196.0,34
2025-08-14_08-18-36,8511,"[np.float32(1.0), np.float32(0.0), np.float32(1.0), np.float32(1.0), np.float32(0.0), np.float32(0.0), np.float32(0.0), np.float32(1.0), np.float32(1.0), np.float32(0.0), np.float32(0.0), np.float32(0.0), np.float32(1.0), np.float32(1.0), np.float32(1.0), np.float32(0.0)]",-3.0,99193.0,10
2025-08-14_08-18-36,8512,"[np.float32(0.0), np.float32(0.0), np.float32(0.0), np.float32(0.0), np.float32(1.0), np.float32(0.0), np.float32(0.0), np.float32(0.0), np.float32(1.0), np.float32(0.0), np.float32(0.0), np.float32(1.0), np.float32(0.0), np.float32(1.0), np.float32(0.0), np.float32(1.0)]",3.0,99196.0,3
2025-08-14_08-18-36,8513,"[np.float32(0.0), np.float32(1.0), np.float32(0.0), np.float32(0.0), np.float32(0.0), np.float32(0.0), np.float32(1.0), np.float32(0.0), np.float32(1.0), np.float32(0.0), np.float32(0.0), np.float32(0.0), np.float32(0.0), np.float32(1.0), np.float32(0.0), np.float32(1.0)]",3.0,99199.0,35
2025-08-14_08-18-36,8514,"[np.float32(0.0), np.float32(1.0), np.float32(0.0), np.float32(0.0), np.float32(1.0), np.float32(0.0), np.float32(1.0), np.float32(0.0), np.float32(1.0), np.float32(1.0), np.float32(0.0), np.float32(0.0), np.float32(1.0), np.float32(0.0), np.float32(0.0), np.float32(0.0)]",-3.0,99196.0,19
2025-08-14_08-18-36,8515,"[np.float32(1.0), np.float32(1.0), np.float32(0.0), np.float32(0.0), np.float32(0.0), np.float32(1.0), np.float32(1.0), np.float32(1.0), np.float32(1.0), np.float32(0.0), np.float32(1.0), np.float32(0.0), np.float32(1.0), np.float32(0.0), np.float32(1.0), np.float32(0.0)]",-5.0,99191.0,0
2025-08-14_08-18-36,8516,"[np.float32(0.0), np.float32(0.0), np.float32(1.0), np.float32(0.0), np.float32(1.0), np.float32(0.0), np.float32(1.0), np.float32(1.0), np.float32(0.0), np.float32(1.0), np.float32(0.0), np.float32(0.0), np.float32(0.0), np.float32(0.0), np.float32(1.0), np.float32(1.0)]",1.0,99192.0,7
2025-08-14_08-18-36,8517,"[np.float32(0.0), np.float32(0.0), np.float32(0.0), np.float32(0.0), np.float32(1.0), np.float32(0.0), np.float32(0.0), np.float32(0.0), np.float32(1.0), np.float32(0.0), np.float32(1.0), np.float32(1.0), np.float32(0.0), np.float32(1.0), np.float32(1.0), np.float32(1.0)]",-1.0,99191.0,28
2025-08-14_08-18-36,8518,"[np.float32(1.0), np.float32(0.0), np.float32(0.0), np.float32(1.0), np.float32(0.0), np.float32(1.0), np.float32(1.0), np.float32(1.0), np.float32(1.0), np.float32(0.0), np.float32(0.0), np.float32(0.0), np.float32(1.0), np.float32(1.0), np.float32(1.0), np.float32(0.0)]",-1.0,99190.0,28
2025-08-14_08-18-36,8519,"[np.float32(0.0), np.float32(0.0), np.float32(1.0), np.float32(1.0), np.float32(0.0), np.float32(0.0), np.float32(0.0), np.float32(1.0), np.float32(1.0), np.float32(0.0), np.float32(0.0), np.float32(1.0), np.float32(0.0), np.float32(0.0), np.float32(0.0), np.float32(0.0)]",0.0,99190.0,14
2025-08-14_08-18-36,8520,"[np.float32(0.0), np.float32(1.0), np.float32(1.0), np.float32(0.0), np.float32(0.0), np.float32(1.0), np.float32(0.0), np.float32(1.0), np.float32(1.0), np.float32(1.0), np.float32(1.0), np.float32(1.0), np.float32(0.0), np.float32(1.0), np.float32(1.0), np.float32(0.0)]",1.0,99191.0,16
2025-08-14_08-18-36,8521,"[np.float32(1.0), np.float32(0.0), np.float32(0.0), np.float32(0.0), np.float32(1.0), np.float32(0.0), np.float32(0.0), np.float32(0.0), np.float32(1.0), np.float32(0.0), np.float32(1.0), np.float32(1.0), np.float32(1.0), np.float32(1.0), np.float32(0.0), np.float32(1.0)]",1.0,99192.0,26
2025-08-14_08-18-36,8522,"[np.float32(0.0), np.float32(1.0), np.float32(0.0), np.float32(0.0), np.float32(0.0), np.float32(1.0), np.float32(1.0), np.float32(0.0), np.float32(0.0), np.float32(0.0), np.float32(0.0), np.float32(1.0), np.float32(1.0), np.float32(1.0), np.float32(0.0), np.float32(0.0)]",-2.0,99190.0,20
2025-08-14_08-18-36,8523,"[np.float32(0.0), np.float32(1.0), np.float32(0.0), np.float32(0.0), np.float32(0.0), np.float32(1.0), np.float32(0.0), np.float32(1.0), np.float32(1.0), np.float32(0.0), np.float32(0.0), np.float32(0.0), np.float32(1.0), np.float32(0.0), np.float32(0.0), np.float32(0.0)]",2.0,99192.0,20
2025-08-14_08-18-36,8524,"[np.float32(1.0), np.float32(1.0), np.float32(0.0), np.float32(0.0), np.float32(1.0), np.float32(1.0), np.float32(0.0), np.float32(1.0), np.float32(0.0), np.float32(0.0), np.float32(1.0), np.float32(0.0), np.float32(1.0), np.float32(1.0), np.float32(1.0), np.float32(0.0)]",1.0,99193.0,35
2025-08-14_08-18-36,8525,"[np.float32(0.0), np.float32(1.0), np.float32(1.0), np.float32(1.0), np.float32(0.0), np.float32(1.0), np.float32(0.0), np.float32(1.0), np.float32(1.0), np.float32(0.0), np.float32(0.0), np.float32(1.0), np.float32(0.0), np.float32(0.0), np.float32(0.0), np.float32(1.0)]",2.0,99195.0,34
2025-08-14_08-18-36,8526,"[np.float32(0.0), np.float32(1.0), np.float32(1.0), np.float32(1.0), np.float32(1.0), np.float32(1.0), np.float32(1.0), np.float32(1.0), np.float32(1.0), np.float32(1.0), np.float32(1.0), np.float32(0.0), np.float32(0.0), np.float32(0.0), np.float32(0.0), np.float32(0.0)]",2.0,99197.0,10
2025-08-14_08-18-36,8527,"[np.float32(1.0), np.float32(0.0), np.float32(0.0), np.float32(0.0), np.float32(0.0), np.float32(0.0), np.float32(1.0), np.float32(1.0), np.float32(1.0), np.float32(1.0), np.float32(0.0), np.float32(0.0), np.float32(1.0), np.float32(1.0), np.float32(0.0), np.float32(0.0)]",4.0,99201.0,19
2025-08-14_08-18-36,8528,"[np.float32(1.0), np.float32(1.0), np.float32(1.0), np.float32(1.0), np.float32(1.0), np.float32(1.0), np.float32(1.0), np.float32(1.0), np.float32(1.0), np.float32(0.0), np.float32(1.0), np.float32(1.0), np.float32(1.0), np.float32(1.0), np.float32(0.0), np.float32(0.0)]",-1.0,99200.0,23
2025-08-14_08-18-36,8529,"[np.float32(0.0), np.float32(0.0), np.float32(0.0), np.float32(1.0), np.float32(0.0), np.float32(0.0), np.float32(1.0), np.float32(1.0), np.float32(1.0), np.float32(1.0), np.float32(0.0), np.float32(1.0), np.float32(1.0), np.float32(1.0), np.float32(1.0), np.float32(1.0)]",1.0,99201.0,15
2025-08-14_08-18-36,8530,"[np.float32(0.0), np.float32(1.0), np.float32(0.0), np.float32(1.0), np.float32(1.0), np.float32(0.0), np.float32(0.0), np.float32(1.0), np.float32(0.0), np.float32(0.0), np.float32(0.0), np.float32(0.0), np.float32(0.0), np.float32(1.0), np.float32(0.0), np.float32(0.0)]",-1.0,99200.0,31
2025-08-14_08-18-36,8531,"[np.float32(1.0), np.float32(0.0), np.float32(0.0), np.float32(0.0), np.float32(1.0), np.float32(1.0), np.float32(1.0), np.float32(1.0), np.float32(0.0), np.float32(0.0), np.float32(1.0), np.float32(1.0), np.float32(0.0), np.float32(1.0), np.float32(1.0), np.float32(0.0)]",-2.0,99198.0,1
2025-08-14_08-18-36,8532,"[np.float32(0.0), np.float32(1.0), np.float32(1.0), np.float32(0.0), np.float32(0.0), np.float32(1.0), np.float32(1.0), np.float32(0.0), np.float32(0.0), np.float32(1.0), np.float32(0.0), np.float32(1.0), np.float32(1.0), np.float32(0.0), np.float32(0.0), np.float32(1.0)]",2.0,99200.0,31
2025-08-14_08-18-36,8533,"[np.float32(1.0), np.float32(0.0), np.float32(0.0), np.float32(0.0), np.float32(0.0), np.float32(0.0), np.float32(1.0), np.float32(1.0), np.float32(1.0), np.float32(1.0), np.float32(1.0), np.float32(1.0), np.float32(1.0), np.float32(1.0), np.float32(0.0), np.float32(1.0)]",1.0,99201.0,3
2025-08-14_08-18-36,8534,"[np.float32(0.0), np.float32(0.0), np.float32(1.0), np.float32(1.0), np.float32(0.0), np.float32(0.0), np.float32(0.0), np.float32(1.0), np.float32(0.0), np.float32(0.0), np.float32(1.0), np.float32(1.0), np.float32(1.0), np.float32(1.0), np.float32(1.0), np.float32(1.0)]",-1.0,99200.0,8
2025-08-14_08-18-36,8535,"[np.float32(0.0), np.float32(1.0), np.float32(0.0), np.float32(0.0), np.float32(0.0), np.float32(0.0), np.float32(1.0), np.float32(1.0), np.float32(0.0), np.float32(1.0), np.float32(1.0), np.float32(0.0), np.float32(0.0), np.float32(0.0), np.float32(0.0), np.float32(1.0)]",2.0,99202.0,31
2025-08-14_08-18-36,8536,"[np.float32(0.0), np.float32(0.0), np.float32(0.0), np.float32(1.0), np.float32(1.0), np.float32(0.0), np.float32(1.0), np.float32(1.0), np.float32(1.0), np.float32(1.0), np.float32(0.0), np.float32(1.0), np.float32(0.0), np.float32(1.0), np.float32(0.0), np.float32(0.0)]",1.0,99203.0,28
2025-08-14_08-18-36,8537,"[np.float32(1.0), np.float32(0.0), np.float32(0.0), np.float32(0.0), np.float32(0.0), np.float32(0.0), np.float32(1.0), np.float32(1.0), np.float32(0.0), np.float32(1.0), np.float32(0.0), np.float32(0.0), np.float32(0.0), np.float32(0.0), np.float32(1.0), np.float32(0.0)]",0.0,99203.0,12
2025-08-14_08-18-36,8538,"[np.float32(0.0), np.float32(0.0), np.float32(1.0), np.float32(1.0), np.float32(0.0), np.float32(1.0), np.float32(0.0), np.float32(1.0), np.float32(1.0), np.float32(0.0), np.float32(0.0), np.float32(1.0), np.float32(0.0), np.float32(1.0), np.float32(0.0), np.float32(0.0)]",3.0,99206.0,26
2025-08-14_08-18-36,8539,"[np.float32(1.0), np.float32(0.0), np.float32(0.0), np.float32(1.0), np.float32(1.0), np.float32(0.0), np.float32(1.0), np.float32(1.0), np.float32(1.0), np.float32(0.0), np.float32(0.0), np.float32(1.0), np.float32(0.0), np.float32(1.0), np.float32(0.0), np.float32(0.0)]",0.0,99206.0,2
2025-08-14_08-18-36,8540,"[np.float32(0.0), np.float32(1.0), np.float32(0.0), np.float32(1.0), np.float32(0.0), np.float32(1.0), np.float32(1.0), np.float32(1.0), np.float32(1.0), np.float32(1.0), np.float32(1.0), np.float32(0.0), np.float32(1.0), np.float32(1.0), np.float32(0.0), np.float32(1.0)]",0.0,99206.0,34
2025-08-14_08-18-36,8541,"[np.float32(0.0), np.float32(0.0), np.float32(0.0), np.float32(1.0), np.float32(1.0), np.float32(0.0), np.float32(0.0), np.float32(1.0), np.float32(1.0), np.float32(1.0), np.float32(1.0), np.float32(0.0), np.float32(0.0), np.float32(0.0), np.float32(1.0), np.float32(0.0)]",1.0,99207.0,27
2025-08-14_08-18-36,8542,"[np.float32(1.0), np.float32(1.0), np.float32(0.0), np.float32(1.0), np.float32(1.0), np.float32(1.0), np.float32(0.0), np.float32(1.0), np.float32(0.0), np.float32(0.0), np.float32(0.0), np.float32(1.0), np.float32(0.0), np.float32(0.0), np.float32(0.0), np.float32(1.0)]",1.0,99208.0,19
2025-08-14_08-18-36,8543,"[np.float32(0.0), np.float32(1.0), np.float32(1.0), np.float32(0.0), np.float32(0.0), np.float32(0.0), np.float32(1.0), np.float32(1.0), np.float32(0.0), np.float32(1.0), np.float32(1.0), np.float32(0.0), np.float32(0.0), np.float32(0.0), np.float32(0.0), np.float32(1.0)]",3.0,99211.0,10
2025-08-14_08-18-36,8544,"[np.float32(0.0), np.float32(0.0), np.float32(1.0), np.float32(1.0), np.float32(1.0), np.float32(0.0), np.float32(1.0), np.float32(0.0), np.float32(0.0), np.float32(0.0), np.float32(0.0), np.float32(0.0), np.float32(1.0), np.float32(0.0), np.float32(0.0), np.float32(0.0)]",2.0,99213.0,12
2025-08-14_08-18-36,8545,"[np.float32(1.0), np.float32(1.0), np.float32(1.0), np.float32(0.0), np.float32(0.0), np.float32(0.0), np.float32(1.0), np.float32(1.0), np.float32(1.0), np.float32(1.0), np.float32(1.0), np.float32(0.0), np.float32(1.0), np.float32(0.0), np.float32(0.0), np.float32(0.0)]",-2.0,99211.0,12
2025-08-14_08-18-36,8546,"[np.float32(1.0), np.float32(1.0), np.float32(0.0), np.float32(1.0), np.float32(0.0), np.float32(0.0), np.float32(0.0), np.float32(1.0), np.float32(0.0), np.float32(0.0), np.float32(1.0), np.float32(1.0), np.float32(1.0), np.float32(1.0), np.float32(1.0), np.float32(0.0)]",1.0,99212.0,33
2025-08-14_08-18-36,8547,"[np.float32(1.0), np.float32(0.0), np.float32(1.0), np.float32(0.0), np.float32(1.0), np.float32(0.0), np.float32(0.0), np.float32(0.0), np.float32(0.0), np.float32(0.0), np.float32(0.0), np.float32(0.0), np.float32(1.0), np.float32(1.0), np.float32(0.0), np.float32(0.0)]",-3.0,99209.0,27
2025-08-14_08-18-36,8548,"[np.float32(1.0), np.float32(0.0), np.float32(0.0), np.float32(1.0), np.float32(1.0), np.float32(1.0), np.float32(0.0), np.float32(1.0), np.float32(0.0), np.float32(0.0), np.float32(0.0), np.float32(1.0), np.float32(1.0), np.float32(0.0), np.float32(1.0), np.float32(0.0)]",-6.0,99203.0,28
2025-08-14_08-18-36,8549,"[np.float32(0.0), np.float32(1.0), np.float32(0.0), np.float32(1.0), np.float32(1.0), np.float32(0.0), np.float32(1.0), np.float32(0.0), np.float32(1.0), np.float32(1.0), np.float32(0.0), np.float32(0.0), np.float32(1.0), np.float32(0.0), np.float32(0.0), np.float32(0.0)]",-5.0,99198.0,0
2025-08-14_08-18-36,8550,"[np.float32(1.0), np.float32(0.0), np.float32(0.0), np.float32(0.0), np.float32(0.0), np.float32(0.0), np.float32(0.0), np.float32(0.0), np.float32(0.0), np.float32(0.0), np.float32(1.0), np.float32(1.0), np.float32(1.0), np.float32(1.0), np.float32(0.0), np.float32(1.0)]",-3.0,99195.0,24
2025-08-14_08-18-36,8551,"[np.float32(0.0), np.float32(0.0), np.float32(0.0), np.float32(0.0), np.float32(0.0), np.float32(0.0), np.float32(1.0), np.float32(1.0), np.float32(0.0), np.float32(1.0), np.float32(1.0), np.float32(0.0), np.float32(1.0), np.float32(0.0), np.float32(0.0), np.float32(0.0)]",1.0,99196.0,23
2025-08-14_08-18-36,8552,"[np.float32(0.0), np.float32(0.0), np.float32(1.0), np.float32(1.0), np.float32(0.0), np.float32(0.0), np.float32(1.0), np.float32(1.0), np.float32(1.0), np.float32(0.0), np.float32(1.0), np.float32(0.0), np.float32(1.0), np.float32(1.0), np.float32(1.0), np.float32(0.0)]",2.0,99198.0,8
2025-08-14_08-18-36,8553,"[np.float32(1.0), np.float32(0.0), np.float32(1.0), np.float32(1.0), np.float32(0.0), np.float32(0.0), np.float32(1.0), np.float32(1.0), np.float32(0.0), np.float32(0.0), np.float32(1.0), np.float32(1.0), np.float32(1.0), np.float32(0.0), np.float32(1.0), np.float32(0.0)]",-2.0,99196.0,1
2025-08-14_08-18-36,8554,"[np.float32(1.0), np.float32(1.0), np.float32(0.0), np.float32(1.0), np.float32(1.0), np.float32(1.0), np.float32(0.0), np.float32(1.0), np.float32(0.0), np.float32(1.0), np.float32(1.0), np.float32(0.0), np.float32(0.0), np.float32(1.0), np.float32(1.0), np.float32(1.0)]",-1.0,99195.0,26
2025-08-14_08-18-36,8555,"[np.float32(0.0), np.float32(1.0), np.float32(0.0), np.float32(0.0), np.float32(0.0), np.float32(1.0), np.float32(1.0), np.float32(0.0), np.float32(0.0), np.float32(0.0), np.float32(1.0), np.float32(0.0), np.float32(1.0), np.float32(0.0), np.float32(1.0), np.float32(1.0)]",-2.0,99193.0,36
2025-08-14_08-18-36,8556,"[np.float32(1.0), np.float32(0.0), np.float32(0.0), np.float32(1.0), np.float32(0.0), np.float32(0.0), np.float32(1.0), np.float32(0.0), np.float32(1.0), np.float32(0.0), np.float32(0.0), np.float32(1.0), np.float32(1.0), np.float32(1.0), np.float32(0.0), np.float32(0.0)]",6.0,99199.0,3
2025-08-14_08-18-36,8557,"[np.float32(1.0), np.float32(1.0), np.float32(0.0), np.float32(0.0), np.float32(0.0), np.float32(0.0), np.float32(0.0), np.float32(1.0), np.float32(1.0), np.float32(1.0), np.float32(1.0), np.float32(1.0), np.float32(1.0), np.float32(0.0), np.float32(1.0), np.float32(0.0)]",-1.0,99198.0,8
2025-08-14_08-18-36,8558,"[np.float32(0.0), np.float32(1.0), np.float32(0.0), np.float32(0.0), np.float32(1.0), np.float32(0.0), np.float32(0.0), np.float32(1.0), np.float32(0.0), np.float32(1.0), np.float32(1.0), np.float32(1.0), np.float32(1.0), np.float32(1.0), np.float32(0.0), np.float32(0.0)]",36.0,99234.0,7
2025-08-14_08-18-36,8559,"[np.float32(0.0), np.float32(1.0), np.float32(0.0), np.float32(1.0), np.float32(1.0), np.float32(1.0), np.float32(1.0), np.float32(1.0), np.float32(1.0), np.float32(1.0), np.float32(0.0), np.float32(0.0), np.float32(1.0), np.float32(0.0), np.float32(1.0), np.float32(0.0)]",3.0,99237.0,10
2025-08-14_08-18-36,8560,"[np.float32(0.0), np.float32(0.0), np.float32(1.0), np.float32(1.0), np.float32(0.0), np.float32(0.0), np.float32(0.0), np.float32(1.0), np.float32(0.0), np.float32(0.0), np.float32(1.0), np.float32(0.0), np.float32(1.0), np.float32(1.0), np.float32(0.0), np.float32(1.0)]",-5.0,99232.0,30
2025-08-14_08-18-36,8561,"[np.float32(0.0), np.float32(0.0), np.float32(1.0), np.float32(1.0), np.float32(1.0), np.float32(1.0), np.float32(1.0), np.float32(1.0), np.float32(0.0), np.float32(0.0), np.float32(0.0), np.float32(0.0), np.float32(0.0), np.float32(0.0), np.float32(0.0), np.float32(0.0)]",1.0,99233.0,1
2025-08-14_08-18-36,8562,"[np.float32(1.0), np.float32(0.0), np.float32(1.0), np.float32(1.0), np.float32(0.0), np.float32(1.0), np.float32(1.0), np.float32(1.0), np.float32(0.0), np.float32(1.0), np.float32(1.0), np.float32(0.0), np.float32(0.0), np.float32(1.0), np.float32(0.0), np.float32(0.0)]",4.0,99237.0,7
2025-08-14_08-18-36,8563,"[np.float32(0.0), np.float32(0.0), np.float32(0.0), np.float32(1.0), np.float32(1.0), np.float32(0.0), np.float32(0.0), np.float32(0.0), np.float32(1.0), np.float32(0.0), np.float32(1.0), np.float32(0.0), np.float32(0.0), np.float32(1.0), np.float32(0.0), np.float32(0.0)]",-2.0,99235.0,20
2025-08-14_08-18-36,8564,"[np.float32(0.0), np.float32(0.0), np.float32(0.0), np.float32(0.0), np.float32(0.0), np.float32(1.0), np.float32(1.0), np.float32(1.0), np.float32(1.0), np.float32(1.0), np.float32(1.0), np.float32(0.0), np.float32(0.0), np.float32(1.0), np.float32(1.0), np.float32(0.0)]",1.0,99236.0,16
2025-08-14_08-18-36,8565,"[np.float32(1.0), np.float32(0.0), np.float32(1.0), np.float32(0.0), np.float32(0.0), np.float32(1.0), np.float32(0.0), np.float32(1.0), np.float32(0.0), np.float32(0.0), np.float32(0.0), np.float32(1.0), np.float32(1.0), np.float32(1.0), np.float32(1.0), np.float32(0.0)]",1.0,99237.0,32
2025-08-14_08-18-36,8566,"[np.float32(0.0), np.float32(1.0), np.float32(0.0), np.float32(1.0), np.float32(0.0), np.float32(0.0), np.float32(1.0), np.float32(1.0), np.float32(0.0), np.float32(0.0), np.float32(1.0), np.float32(0.0), np.float32(1.0), np.float32(1.0), np.float32(1.0), np.float32(0.0)]",0.0,99237.0,3
2025-08-14_08-18-36,8567,"[np.float32(0.0), np.float32(1.0), np.float32(0.0), np.float32(0.0), np.float32(1.0), np.float32(1.0), np.float32(1.0), np.float32(1.0), np.float32(0.0), np.float32(0.0), np.float32(1.0), np.float32(0.0), np.float32(0.0), np.float32(0.0), np.float32(0.0), np.float32(0.0)]",-4.0,99233.0,36
2025-08-14_08-18-36,8568,"[np.float32(1.0), np.float32(1.0), np.float32(0.0), np.float32(0.0), np.float32(0.0), np.float32(1.0), np.float32(0.0), np.float32(1.0), np.float32(1.0), np.float32(0.0), np.float32(1.0), np.float32(0.0), np.float32(1.0), np.float32(0.0), np.float32(0.0), np.float32(0.0)]",-2.0,99231.0,11
2025-08-14_08-18-36,8569,"[np.float32(0.0), np.float32(0.0), np.float32(1.0), np.float32(0.0), np.float32(0.0), np.float32(1.0), np.float32(1.0), np.float32(1.0), np.float32(1.0), np.float32(0.0), np.float32(1.0), np.float32(0.0), np.float32(1.0), np.float32(1.0), np.float32(1.0), np.float32(1.0)]",-2.0,99229.0,16
2025-08-14_08-18-36,8570,"[np.float32(1.0), np.float32(1.0), np.float32(0.0), np.float32(1.0), np.float32(0.0), np.float32(0.0), np.float32(1.0), np.float32(1.0), np.float32(0.0), np.float32(1.0), np.float32(0.0), np.float32(0.0), np.float32(0.0), np.float32(0.0), np.float32(0.0), np.float32(0.0)]",1.0,99230.0,3
2025-08-14_08-18-36,8571,"[np.float32(0.0), np.float32(1.0), np.float32(0.0), np.float32(0.0), np.float32(0.0), np.float32(1.0), np.float32(0.0), np.float32(1.0), np.float32(1.0), np.float32(0.0), np.float32(1.0), np.float32(1.0), np.float32(1.0), np.float32(0.0), np.float32(1.0), np.float32(0.0)]",-1.0,99229.0,22
2025-08-14_08-18-36,8572,"[np.float32(0.0), np.float32(1.0), np.float32(0.0), np.float32(1.0), np.float32(0.0), np.float32(1.0), np.float32(0.0), np.float32(1.0), np.float32(1.0), np.float32(0.0), np.float32(0.0), np.float32(1.0), np.float32(1.0), np.float32(1.0), np.float32(0.0), np.float32(1.0)]",-1.0,99228.0,32
2025-08-14_08-18-36,8573,"[np.float32(0.0), np.float32(0.0), np.float32(1.0), np.float32(1.0), np.float32(1.0), np.float32(0.0), np.float32(1.0), np.float32(1.0), np.float32(0.0), np.float32(0.0), np.float32(1.0), np.float32(1.0), np.float32(0.0), np.float32(1.0), np.float32(0.0), np.float32(0.0)]",2.0,99230.0,9
2025-08-14_08-18-36,8574,"[np.float32(0.0), np.float32(0.0), np.float32(0.0), np.float32(1.0), np.float32(0.0), np.float32(1.0), np.float32(1.0), np.float32(0.0), np.float32(0.0), np.float32(0.0), np.float32(0.0), np.float32(1.0), np.float32(0.0), np.float32(1.0), np.float32(1.0), np.float32(0.0)]",-6.0,99224.0,14
2025-08-14_08-18-36,8575,"[np.float32(0.0), np.float32(0.0), np.float32(0.0), np.float32(0.0), np.float32(0.0), np.float32(0.0), np.float32(1.0), np.float32(1.0), np.float32(0.0), np.float32(0.0), np.float32(1.0), np.float32(1.0), np.float32(0.0), np.float32(1.0), np.float32(0.0), np.float32(0.0)]",1.0,99225.0,14
2025-08-14_08-18-36,8576,"[np.float32(0.0), np.float32(0.0), np.float32(0.0), np.float32(0.0), np.float32(0.0), np.float32(0.0), np.float32(1.0), np.float32(1.0), np.float32(0.0), np.float32(0.0), np.float32(1.0), np.float32(1.0), np.float32(0.0), np.float32(0.0), np.float32(0.0), np.float32(0.0)]",2.0,99227.0,21
2025-08-14_08-18-36,8577,"[np.float32(0.0), np.float32(0.0), np.float32(0.0), np.float32(1.0), np.float32(0.0), np.float32(1.0), np.float32(0.0), np.float32(0.0), np.float32(1.0), np.float32(1.0), np.float32(0.0), np.float32(1.0), np.float32(1.0), np.float32(1.0), np.float32(0.0), np.float32(1.0)]",-3.0,99224.0,17
2025-08-14_08-18-36,8578,"[np.float32(1.0), np.float32(0.0), np.float32(0.0), np.float32(1.0), np.float32(0.0), np.float32(1.0), np.float32(0.0), np.float32(0.0), np.float32(0.0), np.float32(0.0), np.float32(1.0), np.float32(1.0), np.float32(0.0), np.float32(0.0), np.float32(0.0), np.float32(1.0)]",-3.0,99221.0,2
2025-08-14_08-18-36,8579,"[np.float32(0.0), np.float32(0.0), np.float32(1.0), np.float32(0.0), np.float32(1.0), np.float32(1.0), np.float32(1.0), np.float32(1.0), np.float32(1.0), np.float32(1.0), np.float32(1.0), np.float32(1.0), np.float32(0.0), np.float32(1.0), np.float32(0.0), np.float32(1.0)]",0.0,99221.0,31
2025-08-14_08-18-36,8580,"[np.float32(0.0), np.float32(0.0), np.float32(0.0), np.float32(0.0), np.float32(1.0), np.float32(0.0), np.float32(1.0), np.float32(1.0), np.float32(1.0), np.float32(0.0), np.float32(1.0), np.float32(0.0), np.float32(1.0), np.float32(1.0), np.float32(1.0), np.float32(0.0)]",0.0,99221.0,16
2025-08-14_08-18-36,8581,"[np.float32(0.0), np.float32(0.0), np.float32(1.0), np.float32(0.0), np.float32(1.0), np.float32(0.0), np.float32(0.0), np.float32(1.0), np.float32(0.0), np.float32(0.0), np.float32(0.0), np.float32(1.0), np.float32(1.0), np.float32(1.0), np.float32(1.0), np.float32(1.0)]",3.0,99224.0,15
2025-08-14_08-18-36,8582,"[np.float32(1.0), np.float32(0.0), np.float32(0.0), np.float32(0.0), np.float32(0.0), np.float32(0.0), np.float32(0.0), np.float32(0.0), np.float32(0.0), np.float32(0.0), np.float32(0.0), np.float32(1.0), np.float32(0.0), np.float32(0.0), np.float32(0.0), np.float32(0.0)]",0.0,99224.0,7
2025-08-14_08-18-36,8583,"[np.float32(1.0), np.float32(0.0), np.float32(1.0), np.float32(0.0), np.float32(1.0), np.float32(1.0), np.float32(1.0), np.float32(1.0), np.float32(0.0), np.float32(0.0), np.float32(0.0), np.float32(1.0), np.float32(1.0), np.float32(0.0), np.float32(0.0), np.float32(0.0)]",-6.0,99218.0,31
2025-08-14_08-18-36,8584,"[np.float32(1.0), np.float32(1.0), np.float32(0.0), np.float32(1.0), np.float32(0.0), np.float32(1.0), np.float32(1.0), np.float32(1.0), np.float32(0.0), np.float32(0.0), np.float32(0.0), np.float32(0.0), np.float32(0.0), np.float32(1.0), np.float32(0.0), np.float32(0.0)]",1.0,99219.0,12
2025-08-14_08-18-36,8585,"[np.float32(0.0), np.float32(0.0), np.float32(0.0), np.float32(1.0), np.float32(1.0), np.float32(1.0), np.float32(0.0), np.float32(1.0), np.float32(0.0), np.float32(1.0), np.float32(1.0), np.float32(0.0), np.float32(1.0), np.float32(0.0), np.float32(1.0), np.float32(1.0)]",-2.0,99217.0,9
2025-08-14_08-18-36,8586,"[np.float32(1.0), np.float32(0.0), np.float32(0.0), np.float32(1.0), np.float32(0.0), np.float32(0.0), np.float32(1.0), np.float32(1.0), np.float32(0.0), np.float32(0.0), np.float32(0.0), np.float32(1.0), np.float32(1.0), np.float32(1.0), np.float32(0.0), np.float32(1.0)]",3.0,99220.0,18
2025-08-14_08-18-36,8587,"[np.float32(1.0), np.float32(0.0), np.float32(0.0), np.float32(0.0), np.float32(0.0), np.float32(1.0), np.float32(0.0), np.float32(1.0), np.float32(0.0), np.float32(0.0), np.float32(1.0), np.float32(1.0), np.float32(0.0), np.float32(1.0), np.float32(1.0), np.float32(0.0)]",-2.0,99218.0,9
2025-08-14_08-18-36,8588,"[np.float32(1.0), np.float32(1.0), np.float32(1.0), np.float32(0.0), np.float32(1.0), np.float32(1.0), np.float32(0.0), np.float32(1.0), np.float32(1.0), np.float32(0.0), np.float32(0.0), np.float32(1.0), np.float32(1.0), np.float32(0.0), np.float32(0.0), np.float32(1.0)]",-4.0,99214.0,0
2025-08-14_08-18-36,8589,"[np.float32(1.0), np.float32(1.0), np.float32(1.0), np.float32(0.0), np.float32(1.0), np.float32(0.0), np.float32(0.0), np.float32(1.0), np.float32(0.0), np.float32(1.0), np.float32(1.0), np.float32(0.0), np.float32(1.0), np.float32(1.0), np.float32(0.0), np.float32(1.0)]",-2.0,99212.0,21
2025-08-14_08-18-36,8590,"[np.float32(0.0), np.float32(1.0), np.float32(1.0), np.float32(0.0), np.float32(0.0), np.float32(1.0), np.float32(0.0), np.float32(1.0), np.float32(0.0), np.float32(1.0), np.float32(1.0), np.float32(1.0), np.float32(0.0), np.float32(0.0), np.float32(0.0), np.float32(1.0)]",0.0,99212.0,19
2025-08-14_08-18-36,8591,"[np.float32(0.0), np.float32(0.0), np.float32(1.0), np.float32(1.0), np.float32(1.0), np.float32(1.0), np.float32(0.0), np.float32(1.0), np.float32(1.0), np.float32(0.0), np.float32(0.0), np.float32(0.0), np.float32(1.0), np.float32(0.0), np.float32(1.0), np.float32(1.0)]",-2.0,99210.0,35
2025-08-14_08-18-36,8592,"[np.float32(1.0), np.float32(1.0), np.float32(0.0), np.float32(1.0), np.float32(0.0), np.float32(1.0), np.float32(1.0), np.float32(0.0), np.float32(0.0), np.float32(0.0), np.float32(0.0), np.float32(0.0), np.float32(1.0), np.float32(1.0), np.float32(0.0), np.float32(0.0)]",-3.0,99207.0,30
2025-08-14_08-18-36,8593,"[np.float32(1.0), np.float32(0.0), np.float32(0.0), np.float32(0.0), np.float32(0.0), np.float32(0.0), np.float32(1.0), np.float32(1.0), np.float32(0.0), np.float32(0.0), np.float32(1.0), np.float32(0.0), np.float32(1.0), np.float32(0.0), np.float32(1.0), np.float32(0.0)]",-3.0,99204.0,6
2025-08-14_08-18-36,8594,"[np.float32(1.0), np.float32(1.0), np.float32(0.0), np.float32(0.0), np.float32(1.0), np.float32(0.0), np.float32(1.0), np.float32(0.0), np.float32(0.0), np.float32(0.0), np.float32(0.0), np.float32(0.0), np.float32(1.0), np.float32(1.0), np.float32(0.0), np.float32(0.0)]",4.0,99208.0,2
2025-08-14_08-18-36,8595,"[np.float32(0.0), np.float32(0.0), np.float32(0.0), np.float32(0.0), np.float32(1.0), np.float32(1.0), np.float32(0.0), np.float32(0.0), np.float32(1.0), np.float32(0.0), np.float32(1.0), np.float32(1.0), np.float32(1.0), np.float32(0.0), np.float32(0.0), np.float32(0.0)]",-1.0,99207.0,25
2025-08-14_08-18-36,8596,"[np.float32(1.0), np.float32(1.0), np.float32(1.0), np.float32(0.0), np.float32(0.0), np.float32(0.0), np.float32(1.0), np.float32(1.0), np.float32(1.0), np.float32(0.0), np.float32(0.0), np.float32(0.0), np.float32(0.0), np.float32(1.0), np.float32(1.0), np.float32(1.0)]",1.0,99208.0,16
2025-08-14_08-18-36,8597,"[np.float32(0.0), np.float32(1.0), np.float32(0.0), np.float32(1.0), np.float32(0.0), np.float32(1.0), np.float32(1.0), np.float32(1.0), np.float32(1.0), np.float32(1.0), np.float32(0.0), np.float32(0.0), np.float32(0.0), np.float32(0.0), np.float32(1.0), np.float32(0.0)]",0.0,99208.0,4
2025-08-14_08-18-36,8598,"[np.float32(1.0), np.float32(1.0), np.float32(0.0), np.float32(1.0), np.float32(0.0), np.float32(0.0), np.float32(1.0), np.float32(1.0), np.float32(1.0), np.float32(0.0), np.float32(1.0), np.float32(1.0), np.float32(1.0), np.float32(0.0), np.float32(0.0), np.float32(0.0)]",-4.0,99204.0,28
2025-08-14_08-18-36,8599,"[np.float32(1.0), np.float32(1.0), np.float32(1.0), np.float32(1.0), np.float32(0.0), np.float32(1.0), np.float32(0.0), np.float32(1.0), np.float32(0.0), np.float32(0.0), np.float32(0.0), np.float32(1.0), np.float32(0.0), np.float32(0.0), np.float32(0.0), np.float32(0.0)]",0.0,99204.0,17
2025-08-14_08-18-36,8600,"[np.float32(1.0), np.float32(0.0), np.float32(0.0), np.float32(0.0), np.float32(0.0), np.float32(1.0), np.float32(1.0), np.float32(0.0), np.float32(1.0), np.float32(1.0), np.float32(0.0), np.float32(1.0), np.float32(1.0), np.float32(1.0), np.float32(1.0), np.float32(0.0)]",-1.0,99203.0,26
2025-08-14_08-18-36,8601,"[np.float32(1.0), np.float32(0.0), np.float32(0.0), np.float32(0.0), np.float32(0.0), np.float32(1.0), np.float32(0.0), np.float32(1.0), np.float32(1.0), np.float32(1.0), np.float32(0.0), np.float32(0.0), np.float32(0.0), np.float32(1.0), np.float32(0.0), np.float32(1.0)]",0.0,99203.0,36
2025-08-14_08-18-36,8602,"[np.float32(1.0), np.float32(0.0), np.float32(0.0), np.float32(1.0), np.float32(1.0), np.float32(0.0), np.float32(1.0), np.float32(1.0), np.float32(1.0), np.float32(1.0), np.float32(1.0), np.float32(0.0), np.float32(0.0), np.float32(1.0), np.float32(0.0), np.float32(0.0)]",3.0,99206.0,5
2025-08-14_08-18-36,8603,"[np.float32(1.0), np.float32(1.0), np.float32(0.0), np.float32(0.0), np.float32(0.0), np.float32(1.0), np.float32(0.0), np.float32(1.0), np.float32(1.0), np.float32(0.0), np.float32(0.0), np.float32(0.0), np.float32(1.0), np.float32(1.0), np.float32(1.0), np.float32(0.0)]",-6.0,99200.0,6
2025-08-14_08-18-36,8604,"[np.float32(1.0), np.float32(1.0), np.float32(1.0), np.float32(1.0), np.float32(1.0), np.float32(0.0), np.float32(0.0), np.float32(1.0), np.float32(0.0), np.float32(1.0), np.float32(1.0), np.float32(0.0), np.float32(0.0), np.float32(1.0), np.float32(0.0), np.float32(0.0)]",0.0,99200.0,3
2025-08-14_08-18-36,8605,"[np.float32(0.0), np.float32(0.0), np.float32(0.0), np.float32(0.0), np.float32(0.0), np.float32(1.0), np.float32(1.0), np.float32(1.0), np.float32(0.0), np.float32(1.0), np.float32(1.0), np.float32(0.0), np.float32(0.0), np.float32(1.0), np.float32(1.0), np.float32(0.0)]",-2.0,99198.0,33
2025-08-14_08-18-36,8606,"[np.float32(0.0), np.float32(0.0), np.float32(0.0), np.float32(1.0), np.float32(0.0), np.float32(1.0), np.float32(0.0), np.float32(1.0), np.float32(0.0), np.float32(1.0), np.float32(1.0), np.float32(0.0), np.float32(1.0), np.float32(1.0), np.float32(0.0), np.float32(1.0)]",36.0,99234.0,7
2025-08-14_08-18-36,8607,"[np.float32(0.0), np.float32(1.0), np.float32(0.0), np.float32(0.0), np.float32(0.0), np.float32(0.0), np.float32(1.0), np.float32(1.0), np.float32(1.0), np.float32(0.0), np.float32(1.0), np.float32(0.0), np.float32(0.0), np.float32(1.0), np.float32(1.0), np.float32(0.0)]",-1.0,99233.0,18
2025-08-14_08-18-36,8608,"[np.float32(0.0), np.float32(1.0), np.float32(0.0), np.float32(0.0), np.float32(0.0), np.float32(0.0), np.float32(1.0), np.float32(1.0), np.float32(0.0), np.float32(0.0), np.float32(0.0), np.float32(1.0), np.float32(0.0), np.float32(1.0), np.float32(0.0), np.float32(1.0)]",-3.0,99230.0,27
2025-08-14_08-18-36,8609,"[np.float32(0.0), np.float32(1.0), np.float32(0.0), np.float32(0.0), np.float32(1.0), np.float32(0.0), np.float32(0.0), np.float32(1.0), np.float32(1.0), np.float32(0.0), np.float32(1.0), np.float32(0.0), np.float32(0.0), np.float32(0.0), np.float32(1.0), np.float32(0.0)]",1.0,99231.0,2
2025-08-14_08-18-36,8610,"[np.float32(0.0), np.float32(1.0), np.float32(0.0), np.float32(1.0), np.float32(1.0), np.float32(1.0), np.float32(0.0), np.float32(1.0), np.float32(1.0), np.float32(0.0), np.float32(1.0), np.float32(0.0), np.float32(1.0), np.float32(1.0), np.float32(0.0), np.float32(1.0)]",1.0,99232.0,32
2025-08-14_08-18-36,8611,"[np.float32(0.0), np.float32(0.0), np.float32(0.0), np.float32(0.0), np.float32(1.0), np.float32(0.0), np.float32(0.0), np.float32(1.0), np.float32(0.0), np.float32(0.0), np.float32(0.0), np.float32(1.0), np.float32(1.0), np.float32(1.0), np.float32(1.0), np.float32(1.0)]",1.0,99233.0,3
2025-08-14_08-18-36,8612,"[np.float32(1.0), np.float32(1.0), np.float32(0.0), np.float32(1.0), np.float32(1.0), np.float32(0.0), np.float32(1.0), np.float32(1.0), np.float32(1.0), np.float32(0.0), np.float32(0.0), np.float32(0.0), np.float32(0.0), np.float32(1.0), np.float32(0.0), np.float32(0.0)]",1.0,99234.0,17
2025-08-14_08-18-36,8613,"[np.float32(1.0), np.float32(1.0), np.float32(1.0), np.float32(0.0), np.float32(1.0), np.float32(1.0), np.float32(1.0), np.float32(1.0), np.float32(1.0), np.float32(1.0), np.float32(0.0), np.float32(1.0), np.float32(1.0), np.float32(0.0), np.float32(0.0), np.float32(1.0)]",-3.0,99231.0,26
2025-08-14_08-18-36,8614,"[np.float32(0.0), np.float32(0.0), np.float32(0.0), np.float32(0.0), np.float32(1.0), np.float32(0.0), np.float32(0.0), np.float32(0.0), np.float32(0.0), np.float32(0.0), np.float32(1.0), np.float32(0.0), np.float32(1.0), np.float32(1.0), np.float32(1.0), np.float32(1.0)]",-1.0,99230.0,4
2025-08-14_08-18-36,8615,"[np.float32(1.0), np.float32(0.0), np.float32(0.0), np.float32(0.0), np.float32(0.0), np.float32(0.0), np.float32(1.0), np.float32(1.0), np.float32(0.0), np.float32(0.0), np.float32(0.0), np.float32(1.0), np.float32(0.0), np.float32(1.0), np.float32(0.0), np.float32(0.0)]",-5.0,99225.0,31
2025-08-14_08-18-36,8616,"[np.float32(0.0), np.float32(0.0), np.float32(0.0), np.float32(0.0), np.float32(0.0), np.float32(1.0), np.float32(1.0), np.float32(0.0), np.float32(0.0), np.float32(0.0), np.float32(1.0), np.float32(1.0), np.float32(0.0), np.float32(0.0), np.float32(0.0), np.float32(1.0)]",1.0,99226.0,1
2025-08-14_08-18-36,8617,"[np.float32(0.0), np.float32(1.0), np.float32(1.0), np.float32(1.0), np.float32(0.0), np.float32(1.0), np.float32(1.0), np.float32(1.0), np.float32(0.0), np.float32(0.0), np.float32(0.0), np.float32(1.0), np.float32(0.0), np.float32(1.0), np.float32(1.0), np.float32(1.0)]",3.0,99229.0,15
2025-08-14_08-18-36,8618,"[np.float32(0.0), np.float32(1.0), np.float32(0.0), np.float32(0.0), np.float32(0.0), np.float32(1.0), np.float32(1.0), np.float32(0.0), np.float32(1.0), np.float32(0.0), np.float32(0.0), np.float32(1.0), np.float32(1.0), np.float32(1.0), np.float32(1.0), np.float32(1.0)]",2.0,99231.0,36
2025-08-14_08-18-36,8619,"[np.float32(1.0), np.float32(1.0), np.float32(0.0), np.float32(0.0), np.float32(1.0), np.float32(1.0), np.float32(0.0), np.float32(1.0), np.float32(1.0), np.float32(0.0), np.float32(1.0), np.float32(1.0), np.float32(0.0), np.float32(1.0), np.float32(0.0), np.float32(1.0)]",3.0,99234.0,29
2025-08-14_08-18-36,8620,"[np.float32(0.0), np.float32(1.0), np.float32(1.0), np.float32(0.0), np.float32(0.0), np.float32(0.0), np.float32(1.0), np.float32(0.0), np.float32(0.0), np.float32(0.0), np.float32(0.0), np.float32(0.0), np.float32(0.0), np.float32(0.0), np.float32(0.0), np.float32(1.0)]",-4.0,99230.0,19
2025-08-14_08-18-36,8621,"[np.float32(1.0), np.float32(0.0), np.float32(1.0), np.float32(0.0), np.float32(0.0), np.float32(0.0), np.float32(1.0), np.float32(1.0), np.float32(1.0), np.float32(1.0), np.float32(0.0), np.float32(0.0), np.float32(1.0), np.float32(1.0), np.float32(0.0), np.float32(0.0)]",0.0,99230.0,10
2025-08-14_08-18-36,8622,"[np.float32(0.0), np.float32(1.0), np.float32(0.0), np.float32(1.0), np.float32(1.0), np.float32(1.0), np.float32(1.0), np.float32(1.0), np.float32(1.0), np.float32(1.0), np.float32(0.0), np.float32(1.0), np.float32(1.0), np.float32(0.0), np.float32(0.0), np.float32(0.0)]",2.0,99232.0,33
2025-08-14_08-18-36,8623,"[np.float32(0.0), np.float32(0.0), np.float32(1.0), np.float32(1.0), np.float32(1.0), np.float32(1.0), np.float32(1.0), np.float32(1.0), np.float32(1.0), np.float32(1.0), np.float32(1.0), np.float32(1.0), np.float32(0.0), np.float32(1.0), np.float32(1.0), np.float32(0.0)]",-2.0,99230.0,31
2025-08-14_08-18-36,8624,"[np.float32(1.0), np.float32(0.0), np.float32(1.0), np.float32(1.0), np.float32(1.0), np.float32(1.0), np.float32(1.0), np.float32(1.0), np.float32(1.0), np.float32(1.0), np.float32(0.0), np.float32(0.0), np.float32(0.0), np.float32(1.0), np.float32(1.0), np.float32(0.0)]",-1.0,99229.0,31
2025-08-14_08-18-36,8625,"[np.float32(1.0), np.float32(0.0), np.float32(0.0), np.float32(1.0), np.float32(1.0), np.float32(1.0), np.float32(1.0), np.float32(1.0), np.float32(1.0), np.float32(0.0), np.float32(1.0), np.float32(0.0), np.float32(1.0), np.float32(0.0), np.float32(1.0), np.float32(1.0)]",-4.0,99225.0,12
2025-08-14_08-18-36,8626,"[np.float32(1.0), np.float32(0.0), np.float32(1.0), np.float32(1.0), np.float32(1.0), np.float32(0.0), np.float32(1.0), np.float32(1.0), np.float32(0.0), np.float32(1.0), np.float32(1.0), np.float32(0.0), np.float32(1.0), np.float32(0.0), np.float32(0.0), np.float32(0.0)]",1.0,99226.0,2
2025-08-14_08-18-36,8627,"[np.float32(1.0), np.float32(1.0), np.float32(1.0), np.float32(1.0), np.float32(0.0), np.float32(1.0), np.float32(1.0), np.float32(1.0), np.float32(0.0), np.float32(0.0), np.float32(1.0), np.float32(0.0), np.float32(1.0), np.float32(1.0), np.float32(0.0), np.float32(0.0)]",-3.0,99223.0,6
2025-08-14_08-18-36,8628,"[np.float32(1.0), np.float32(1.0), np.float32(0.0), np.float32(1.0), np.float32(0.0), np.float32(1.0), np.float32(1.0), np.float32(1.0), np.float32(0.0), np.float32(1.0), np.float32(0.0), np.float32(0.0), np.float32(1.0), np.float32(1.0), np.float32(0.0), np.float32(0.0)]",1.0,99224.0,13
2025-08-14_08-18-36,8629,"[np.float32(1.0), np.float32(0.0), np.float32(0.0), np.float32(1.0), np.float32(1.0), np.float32(0.0), np.float32(0.0), np.float32(1.0), np.float32(1.0), np.float32(1.0), np.float32(1.0), np.float32(1.0), np.float32(1.0), np.float32(0.0), np.float32(1.0), np.float32(1.0)]",0.0,99224.0,31
2025-08-14_08-18-36,8630,"[np.float32(1.0), np.float32(0.0), np.float32(0.0), np.float32(0.0), np.float32(1.0), np.float32(0.0), np.float32(0.0), np.float32(1.0), np.float32(0.0), np.float32(0.0), np.float32(1.0), np.float32(0.0), np.float32(0.0), np.float32(0.0), np.float32(0.0), np.float32(0.0)]",-2.0,99222.0,10
2025-08-14_08-18-36,8631,"[np.float32(0.0), np.float32(1.0), np.float32(0.0), np.float32(0.0), np.float32(0.0), np.float32(0.0), np.float32(0.0), np.float32(0.0), np.float32(1.0), np.float32(0.0), np.float32(1.0), np.float32(0.0), np.float32(1.0), np.float32(0.0), np.float32(0.0), np.float32(0.0)]",-1.0,99221.0,25
2025-08-14_08-18-36,8632,"[np.float32(0.0), np.float32(0.0), np.float32(1.0), np.float32(1.0), np.float32(1.0), np.float32(1.0), np.float32(0.0), np.float32(1.0), np.float32(0.0), np.float32(1.0), np.float32(1.0), np.float32(1.0), np.float32(1.0), np.float32(1.0), np.float32(0.0), np.float32(0.0)]",0.0,99221.0,12
2025-08-14_08-18-36,8633,"[np.float32(1.0), np.float32(0.0), np.float32(0.0), np.float32(1.0), np.float32(1.0), np.float32(1.0), np.float32(1.0), np.float32(1.0), np.float32(1.0), np.float32(1.0), np.float32(0.0), np.float32(0.0), np.float32(1.0), np.float32(1.0), np.float32(0.0), np.float32(0.0)]",-5.0,99216.0,0
2025-08-14_08-18-36,8634,"[np.float32(0.0), np.float32(1.0), np.float32(0.0), np.float32(1.0), np.float32(1.0), np.float32(1.0), np.float32(1.0), np.float32(1.0), np.float32(1.0), np.float32(1.0), np.float32(1.0), np.float32(0.0), np.float32(1.0), np.float32(0.0), np.float32(1.0), np.float32(1.0)]",-2.0,99214.0,22
2025-08-14_08-18-36,8635,"[np.float32(0.0), np.float32(1.0), np.float32(1.0), np.float32(1.0), np.float32(0.0), np.float32(1.0), np.float32(0.0), np.float32(1.0), np.float32(0.0), np.float32(0.0), np.float32(1.0), np.float32(1.0), np.float32(1.0), np.float32(0.0), np.float32(0.0), np.float32(1.0)]",1.0,99215.0,21
2025-08-14_08-18-36,8636,"[np.float32(1.0), np.float32(1.0), np.float32(0.0), np.float32(1.0), np.float32(0.0), np.float32(1.0), np.float32(0.0), np.float32(1.0), np.float32(1.0), np.float32(0.0), np.float32(1.0), np.float32(1.0), np.float32(0.0), np.float32(0.0), np.float32(1.0), np.float32(0.0)]",-5.0,99210.0,7
2025-08-14_08-18-36,8637,"[np.float32(1.0), np.float32(1.0), np.float32(1.0), np.float32(0.0), np.float32(0.0), np.float32(0.0), np.float32(0.0), np.float32(0.0), np.float32(0.0), np.float32(0.0), np.float32(0.0), np.float32(1.0), np.float32(1.0), np.float32(0.0), np.float32(1.0), np.float32(0.0)]",-2.0,99208.0,14
2025-08-14_08-18-36,8638,"[np.float32(0.0), np.float32(1.0), np.float32(1.0), np.float32(0.0), np.float32(0.0), np.float32(1.0), np.float32(1.0), np.float32(1.0), np.float32(1.0), np.float32(0.0), np.float32(0.0), np.float32(0.0), np.float32(1.0), np.float32(0.0), np.float32(0.0), np.float32(0.0)]",0.0,99208.0,36
2025-08-14_08-18-36,8639,"[np.float32(1.0), np.float32(0.0), np.float32(1.0), np.float32(1.0), np.float32(0.0), np.float32(1.0), np.float32(0.0), np.float32(1.0), np.float32(0.0), np.float32(0.0), np.float32(0.0), np.float32(0.0), np.float32(1.0), np.float32(0.0), np.float32(0.0), np.float32(0.0)]",3.0,99211.0,23
2025-08-14_08-18-36,8640,"[np.float32(0.0), np.float32(1.0), np.float32(1.0), np.float32(1.0), np.float32(0.0), np.float32(0.0), np.float32(0.0), np.float32(1.0), np.float32(0.0), np.float32(1.0), np.float32(0.0), np.float32(0.0), np.float32(0.0), np.float32(0.0), np.float32(1.0), np.float32(0.0)]",1.0,99212.0,33
2025-08-14_08-18-36,8641,"[np.float32(0.0), np.float32(1.0), np.float32(0.0), np.float32(0.0), np.float32(0.0), np.float32(1.0), np.float32(0.0), np.float32(1.0), np.float32(0.0), np.float32(0.0), np.float32(1.0), np.float32(1.0), np.float32(1.0), np.float32(0.0), np.float32(1.0), np.float32(0.0)]",-2.0,99210.0,19
2025-08-14_08-18-36,8642,"[np.float32(1.0), np.float32(0.0), np.float32(1.0), np.float32(1.0), np.float32(0.0), np.float32(1.0), np.float32(1.0), np.float32(1.0), np.float32(1.0), np.float32(1.0), np.float32(1.0), np.float32(1.0), np.float32(1.0), np.float32(0.0), np.float32(0.0), np.float32(1.0)]",-2.0,99208.0,18
2025-08-14_08-18-36,8643,"[np.float32(1.0), np.float32(0.0), np.float32(1.0), np.float32(1.0), np.float32(1.0), np.float32(0.0), np.float32(1.0), np.float32(0.0), np.float32(1.0), np.float32(0.0), np.float32(1.0), np.float32(0.0), np.float32(1.0), np.float32(1.0), np.float32(0.0), np.float32(1.0)]",0.0,99208.0,25
2025-08-14_08-18-36,8644,"[np.float32(0.0), np.float32(1.0), np.float32(1.0), np.float32(1.0), np.float32(0.0), np.float32(1.0), np.float32(1.0), np.float32(1.0), np.float32(0.0), np.float32(0.0), np.float32(0.0), np.float32(0.0), np.float32(0.0), np.float32(1.0), np.float32(1.0), np.float32(0.0)]",2.0,99210.0,23
2025-08-14_08-18-36,8645,"[np.float32(0.0), np.float32(1.0), np.float32(1.0), np.float32(1.0), np.float32(0.0), np.float32(0.0), np.float32(0.0), np.float32(0.0), np.float32(1.0), np.float32(0.0), np.float32(0.0), np.float32(0.0), np.float32(1.0), np.float32(1.0), np.float32(0.0), np.float32(0.0)]",-4.0,99206.0,5
2025-08-14_08-18-36,8646,"[np.float32(1.0), np.float32(1.0), np.float32(0.0), np.float32(0.0), np.float32(1.0), np.float32(0.0), np.float32(1.0), np.float32(0.0), np.float32(1.0), np.float32(1.0), np.float32(0.0), np.float32(0.0), np.float32(1.0), np.float32(1.0), np.float32(1.0), np.float32(1.0)]",0.0,99206.0,5
2025-08-14_08-18-36,8647,"[np.float32(1.0), np.float32(1.0), np.float32(1.0), np.float32(1.0), np.float32(0.0), np.float32(1.0), np.float32(1.0), np.float32(1.0), np.float32(1.0), np.float32(0.0), np.float32(1.0), np.float32(1.0), np.float32(0.0), np.float32(0.0), np.float32(0.0), np.float32(0.0)]",2.0,99208.0,23
2025-08-14_08-18-36,8648,"[np.float32(1.0), np.float32(1.0), np.float32(0.0), np.float32(0.0), np.float32(0.0), np.float32(1.0), np.float32(1.0), np.float32(1.0), np.float32(0.0), np.float32(0.0), np.float32(0.0), np.float32(1.0), np.float32(1.0), np.float32(1.0), np.float32(0.0), np.float32(0.0)]",-1.0,99207.0,23
2025-08-14_08-18-36,8649,"[np.float32(1.0), np.float32(0.0), np.float32(0.0), np.float32(1.0), np.float32(0.0), np.float32(1.0), np.float32(1.0), np.float32(1.0), np.float32(0.0), np.float32(0.0), np.float32(1.0), np.float32(0.0), np.float32(0.0), np.float32(1.0), np.float32(0.0), np.float32(0.0)]",3.0,99210.0,3
2025-08-14_08-18-36,8650,"[np.float32(1.0), np.float32(0.0), np.float32(0.0), np.float32(1.0), np.float32(1.0), np.float32(0.0), np.float32(0.0), np.float32(1.0), np.float32(1.0), np.float32(0.0), np.float32(0.0), np.float32(1.0), np.float32(1.0), np.float32(1.0), np.float32(0.0), np.float32(0.0)]",5.0,99215.0,15
2025-08-14_08-18-36,8651,"[np.float32(0.0), np.float32(0.0), np.float32(1.0), np.float32(0.0), np.float32(1.0), np.float32(1.0), np.float32(1.0), np.float32(1.0), np.float32(1.0), np.float32(1.0), np.float32(1.0), np.float32(1.0), np.float32(1.0), np.float32(0.0), np.float32(0.0), np.float32(1.0)]",-1.0,99214.0,30
2025-08-14_08-18-36,8652,"[np.float32(0.0), np.float32(1.0), np.float32(1.0), np.float32(0.0), np.float32(1.0), np.float32(1.0), np.float32(1.0), np.float32(1.0), np.float32(1.0), np.float32(1.0), np.float32(0.0), np.float32(1.0), np.float32(0.0), np.float32(1.0), np.float32(0.0), np.float32(0.0)]",-1.0,99213.0,8
2025-08-14_08-18-36,8653,"[np.float32(0.0), np.float32(0.0), np.float32(1.0), np.float32(0.0), np.float32(1.0), np.float32(1.0), np.float32(1.0), np.float32(1.0), np.float32(1.0), np.float32(0.0), np.float32(0.0), np.float32(0.0), np.float32(0.0), np.float32(1.0), np.float32(0.0), np.float32(1.0)]",-1.0,99212.0,10
2025-08-14_08-18-36,8654,"[np.float32(1.0), np.float32(0.0), np.float32(1.0), np.float32(1.0), np.float32(0.0), np.float32(1.0), np.float32(0.0), np.float32(1.0), np.float32(0.0), np.float32(1.0), np.float32(0.0), np.float32(1.0), np.float32(0.0), np.float32(1.0), np.float32(0.0), np.float32(0.0)]",-1.0,99211.0,35
2025-08-14_08-18-36,8655,"[np.float32(1.0), np.float32(1.0), np.float32(0.0), np.float32(1.0), np.float32(0.0), np.float32(1.0), np.float32(0.0), np.float32(1.0), np.float32(0.0), np.float32(0.0), np.float32(0.0), np.float32(1.0), np.float32(0.0), np.float32(1.0), np.float32(0.0), np.float32(0.0)]",-5.0,99206.0,10
2025-08-14_08-18-36,8656,"[np.float32(0.0), np.float32(0.0), np.float32(0.0), np.float32(1.0), np.float32(1.0), np.float32(1.0), np.float32(1.0), np.float32(1.0), np.float32(0.0), np.float32(1.0), np.float32(1.0), np.float32(0.0), np.float32(0.0), np.float32(0.0), np.float32(0.0), np.float32(1.0)]",2.0,99208.0,11
2025-08-14_08-18-36,8657,"[np.float32(0.0), np.float32(1.0), np.float32(1.0), np.float32(1.0), np.float32(0.0), np.float32(1.0), np.float32(0.0), np.float32(1.0), np.float32(0.0), np.float32(0.0), np.float32(0.0), np.float32(1.0), np.float32(1.0), np.float32(1.0), np.float32(0.0), np.float32(0.0)]",-3.0,99205.0,9
2025-08-14_08-18-36,8658,"[np.float32(0.0), np.float32(0.0), np.float32(0.0), np.float32(0.0), np.float32(1.0), np.float32(0.0), np.float32(0.0), np.float32(1.0), np.float32(0.0), np.float32(1.0), np.float32(1.0), np.float32(1.0), np.float32(0.0), np.float32(0.0), np.float32(1.0), np.float32(0.0)]",-3.0,99202.0,31
2025-08-14_08-18-36,8659,"[np.float32(1.0), np.float32(1.0), np.float32(0.0), np.float32(1.0), np.float32(0.0), np.float32(1.0), np.float32(0.0), np.float32(0.0), np.float32(1.0), np.float32(1.0), np.float32(0.0), np.float32(0.0), np.float32(1.0), np.float32(0.0), np.float32(0.0), np.float32(1.0)]",-3.0,99199.0,16
2025-08-14_08-18-36,8660,"[np.float32(0.0), np.float32(0.0), np.float32(0.0), np.float32(0.0), np.float32(1.0), np.float32(1.0), np.float32(1.0), np.float32(0.0), np.float32(1.0), np.float32(0.0), np.float32(0.0), np.float32(0.0), np.float32(1.0), np.float32(0.0), np.float32(0.0), np.float32(0.0)]",0.0,99199.0,33
2025-08-14_08-18-36,8661,"[np.float32(1.0), np.float32(0.0), np.float32(1.0), np.float32(0.0), np.float32(0.0), np.float32(0.0), np.float32(1.0), np.float32(0.0), np.float32(0.0), np.float32(1.0), np.float32(1.0), np.float32(0.0), np.float32(1.0), np.float32(1.0), np.float32(0.0), np.float32(0.0)]",1.0,99200.0,22
2025-08-14_08-18-36,8662,"[np.float32(0.0), np.float32(0.0), np.float32(1.0), np.float32(1.0), np.float32(1.0), np.float32(0.0), np.float32(1.0), np.float32(0.0), np.float32(1.0), np.float32(1.0), np.float32(1.0), np.float32(1.0), np.float32(1.0), np.float32(1.0), np.float32(0.0), np.float32(0.0)]",0.0,99200.0,10
2025-08-14_08-18-36,8663,"[np.float32(1.0), np.float32(1.0), np.float32(0.0), np.float32(1.0), np.float32(1.0), np.float32(0.0), np.float32(1.0), np.float32(0.0), np.float32(1.0), np.float32(0.0), np.float32(0.0), np.float32(0.0), np.float32(0.0), np.float32(0.0), np.float32(1.0), np.float32(1.0)]",-1.0,99199.0,16
2025-08-14_08-18-36,8664,"[np.float32(1.0), np.float32(0.0), np.float32(0.0), np.float32(0.0), np.float32(1.0), np.float32(1.0), np.float32(1.0), np.float32(0.0), np.float32(0.0), np.float32(1.0), np.float32(0.0), np.float32(0.0), np.float32(1.0), np.float32(0.0), np.float32(1.0), np.float32(0.0)]",0.0,99199.0,36
2025-08-14_08-18-36,8665,"[np.float32(0.0), np.float32(0.0), np.float32(1.0), np.float32(0.0), np.float32(1.0), np.float32(1.0), np.float32(0.0), np.float32(0.0), np.float32(0.0), np.float32(1.0), np.float32(0.0), np.float32(0.0), np.float32(1.0), np.float32(1.0), np.float32(1.0), np.float32(0.0)]",1.0,99200.0,25
2025-08-14_08-18-36,8666,"[np.float32(0.0), np.float32(1.0), np.float32(0.0), np.float32(1.0), np.float32(0.0), np.float32(0.0), np.float32(1.0), np.float32(0.0), np.float32(0.0), np.float32(1.0), np.float32(1.0), np.float32(0.0), np.float32(1.0), np.float32(1.0), np.float32(0.0), np.float32(0.0)]",3.0,99203.0,11
2025-08-14_08-18-36,8667,"[np.float32(1.0), np.float32(0.0), np.float32(1.0), np.float32(1.0), np.float32(0.0), np.float32(0.0), np.float32(1.0), np.float32(0.0), np.float32(0.0), np.float32(0.0), np.float32(1.0), np.float32(1.0), np.float32(0.0), np.float32(1.0), np.float32(0.0), np.float32(0.0)]",-5.0,99198.0,13
2025-08-14_08-18-36,8668,"[np.float32(0.0), np.float32(1.0), np.float32(0.0), np.float32(1.0), np.float32(1.0), np.float32(0.0), np.float32(0.0), np.float32(0.0), np.float32(0.0), np.float32(0.0), np.float32(1.0), np.float32(1.0), np.float32(1.0), np.float32(1.0), np.float32(1.0), np.float32(0.0)]",0.0,99198.0,23
2025-08-14_08-18-36,8669,"[np.float32(1.0), np.float32(1.0), np.float32(1.0), np.float32(0.0), np.float32(0.0), np.float32(0.0), np.float32(1.0), np.float32(1.0), np.float32(0.0), np.float32(0.0), np.float32(1.0), np.float32(1.0), np.float32(1.0), np.float32(1.0), np.float32(0.0), np.float32(0.0)]",1.0,99199.0,32
2025-08-14_08-18-36,8670,"[np.float32(0.0), np.float32(0.0), np.float32(1.0), np.float32(0.0), np.float32(1.0), np.float32(1.0), np.float32(0.0), np.float32(1.0), np.float32(0.0), np.float32(0.0), np.float32(1.0), np.float32(0.0), np.float32(1.0), np.float32(1.0), np.float32(0.0), np.float32(0.0)]",-2.0,99197.0,11
2025-08-14_08-18-36,8671,"[np.float32(1.0), np.float32(1.0), np.float32(0.0), np.float32(1.0), np.float32(0.0), np.float32(1.0), np.float32(0.0), np.float32(1.0), np.float32(0.0), np.float32(0.0), np.float32(0.0), np.float32(1.0), np.float32(0.0), np.float32(0.0), np.float32(0.0), np.float32(0.0)]",-2.0,99195.0,5
2025-08-14_08-18-36,8672,"[np.float32(1.0), np.float32(1.0), np.float32(0.0), np.float32(1.0), np.float32(1.0), np.float32(1.0), np.float32(1.0), np.float32(1.0), np.float32(1.0), np.float32(1.0), np.float32(0.0), np.float32(0.0), np.float32(1.0), np.float32(1.0), np.float32(0.0), np.float32(1.0)]",-2.0,99193.0,10
2025-08-14_08-18-36,8673,"[np.float32(0.0), np.float32(1.0), np.float32(0.0), np.float32(1.0), np.float32(1.0), np.float32(1.0), np.float32(0.0), np.float32(0.0), np.float32(0.0), np.float32(1.0), np.float32(1.0), np.float32(1.0), np.float32(0.0), np.float32(1.0), np.float32(0.0), np.float32(1.0)]",-4.0,99189.0,30
2025-08-14_08-18-36,8674,"[np.float32(1.0), np.float32(1.0), np.float32(1.0), np.float32(0.0), np.float32(1.0), np.float32(0.0), np.float32(1.0), np.float32(1.0), np.float32(1.0), np.float32(1.0), np.float32(0.0), np.float32(1.0), np.float32(0.0), np.float32(1.0), np.float32(0.0), np.float32(1.0)]",2.0,99191.0,28
2025-08-14_08-18-36,8675,"[np.float32(0.0), np.float32(0.0), np.float32(1.0), np.float32(0.0), np.float32(0.0), np.float32(1.0), np.float32(1.0), np.float32(0.0), np.float32(0.0), np.float32(1.0), np.float32(0.0), np.float32(0.0), np.float32(1.0), np.float32(1.0), np.float32(0.0), np.float32(1.0)]",-2.0,99189.0,16
2025-08-14_08-18-36,8676,"[np.float32(0.0), np.float32(1.0), np.float32(1.0), np.float32(1.0), np.float32(0.0), np.float32(0.0), np.float32(1.0), np.float32(0.0), np.float32(0.0), np.float32(1.0), np.float32(1.0), np.float32(1.0), np.float32(1.0), np.float32(1.0), np.float32(0.0), np.float32(1.0)]",-2.0,99187.0,34
2025-08-14_08-18-36,8677,"[np.float32(0.0), np.float32(0.0), np.float32(1.0), np.float32(1.0), np.float32(0.0), np.float32(1.0), np.float32(1.0), np.float32(1.0), np.float32(1.0), np.float32(1.0), np.float32(1.0), np.float32(1.0), np.float32(0.0), np.float32(0.0), np.float32(1.0), np.float32(0.0)]",0.0,99187.0,21
2025-08-14_08-18-36,8678,"[np.float32(0.0), np.float32(0.0), np.float32(0.0), np.float32(1.0), np.float32(1.0), np.float32(1.0), np.float32(0.0), np.float32(0.0), np.float32(0.0), np.float32(0.0), np.float32(0.0), np.float32(0.0), np.float32(0.0), np.float32(0.0), np.float32(0.0), np.float32(0.0)]",-1.0,99186.0,8
2025-08-14_08-18-36,8679,"[np.float32(0.0), np.float32(0.0), np.float32(0.0), np.float32(1.0), np.float32(1.0), np.float32(1.0), np.float32(0.0), np.float32(1.0), np.float32(1.0), np.float32(0.0), np.float32(1.0), np.float32(1.0), np.float32(0.0), np.float32(0.0), np.float32(0.0), np.float32(0.0)]",-2.0,99184.0,2
2025-08-14_08-18-36,8680,"[np.float32(1.0), np.float32(1.0), np.float32(0.0), np.float32(1.0), np.float32(0.0), np.float32(1.0), np.float32(1.0), np.float32(1.0), np.float32(1.0), np.float32(0.0), np.float32(0.0), np.float32(1.0), np.float32(1.0), np.float32(1.0), np.float32(1.0), np.float32(0.0)]",-1.0,99183.0,22
2025-08-14_08-18-36,8681,"[np.float32(0.0), np.float32(1.0), np.float32(0.0), np.float32(1.0), np.float32(1.0), np.float32(1.0), np.float32(1.0), np.float32(1.0), np.float32(1.0), np.float32(0.0), np.float32(0.0), np.float32(0.0), np.float32(1.0), np.float32(0.0), np.float32(0.0), np.float32(1.0)]",0.0,99183.0,29
2025-08-14_08-18-36,8682,"[np.float32(0.0), np.float32(0.0), np.float32(0.0), np.float32(0.0), np.float32(0.0), np.float32(0.0), np.float32(1.0), np.float32(0.0), np.float32(1.0), np.float32(0.0), np.float32(0.0), np.float32(1.0), np.float32(1.0), np.float32(1.0), np.float32(0.0), np.float32(1.0)]",0.0,99183.0,34
2025-08-14_08-18-36,8683,"[np.float32(1.0), np.float32(1.0), np.float32(0.0), np.float32(0.0), np.float32(0.0), np.float32(1.0), np.float32(0.0), np.float32(1.0), np.float32(1.0), np.float32(1.0), np.float32(1.0), np.float32(1.0), np.float32(0.0), np.float32(1.0), np.float32(0.0), np.float32(1.0)]",3.0,99186.0,22
2025-08-14_08-18-36,8684,"[np.float32(0.0), np.float32(0.0), np.float32(0.0), np.float32(0.0), np.float32(0.0), np.float32(0.0), np.float32(0.0), np.float32(0.0), np.float32(0.0), np.float32(0.0), np.float32(0.0), np.float32(0.0), np.float32(0.0), np.float32(0.0), np.float32(0.0), np.float32(0.0)]",-0.5,99185.5,20
2025-08-14_08-18-36,8685,"[np.float32(0.0), np.float32(0.0), np.float32(0.0), np.float32(0.0), np.float32(0.0), np.float32(1.0), np.float32(1.0), np.float32(1.0), np.float32(0.0), np.float32(0.0), np.float32(0.0), np.float32(1.0), np.float32(1.0), np.float32(1.0), np.float32(1.0), np.float32(0.0)]",-1.0,99184.5,6
2025-08-14_08-18-36,8686,"[np.float32(1.0), np.float32(0.0), np.float32(0.0), np.float32(1.0), np.float32(0.0), np.float32(1.0), np.float32(1.0), np.float32(1.0), np.float32(1.0), np.float32(1.0), np.float32(1.0), np.float32(0.0), np.float32(1.0), np.float32(1.0), np.float32(1.0), np.float32(1.0)]",-3.0,99181.5,2
2025-08-14_08-18-36,8687,"[np.float32(0.0), np.float32(0.0), np.float32(0.0), np.float32(0.0), np.float32(1.0), np.float32(0.0), np.float32(0.0), np.float32(0.0), np.float32(0.0), np.float32(1.0), np.float32(0.0), np.float32(0.0), np.float32(0.0), np.float32(0.0), np.float32(0.0), np.float32(0.0)]",0.0,99181.5,5
2025-08-14_08-18-36,8688,"[np.float32(0.0), np.float32(1.0), np.float32(0.0), np.float32(1.0), np.float32(0.0), np.float32(0.0), np.float32(0.0), np.float32(1.0), np.float32(1.0), np.float32(1.0), np.float32(0.0), np.float32(0.0), np.float32(0.0), np.float32(1.0), np.float32(1.0), np.float32(0.0)]",-2.0,99179.5,2
2025-08-14_08-18-36,8689,"[np.float32(0.0), np.float32(1.0), np.float32(0.0), np.float32(0.0), np.float32(1.0), np.float32(1.0), np.float32(1.0), np.float32(0.0), np.float32(0.0), np.float32(1.0), np.float32(1.0), np.float32(1.0), np.float32(1.0), np.float32(0.0), np.float32(0.0), np.float32(0.0)]",-1.0,99178.5,24
2025-08-14_08-18-36,8690,"[np.float32(0.0), np.float32(0.0), np.float32(0.0), np.float32(0.0), np.float32(0.0), np.float32(0.0), np.float32(1.0), np.float32(1.0), np.float32(1.0), np.float32(0.0), np.float32(1.0), np.float32(0.0), np.float32(0.0), np.float32(1.0), np.float32(0.0), np.float32(0.0)]",-2.0,99176.5,16
2025-08-14_08-18-36,8691,"[np.float32(1.0), np.float32(0.0), np.float32(0.0), np.float32(0.0), np.float32(0.0), np.float32(1.0), np.float32(0.0), np.float32(1.0), np.float32(1.0), np.float32(0.0), np.float32(1.0), np.float32(1.0), np.float32(1.0), np.float32(1.0), np.float32(0.0), np.float32(1.0)]",2.0,99178.5,20
2025-08-14_08-18-36,8692,"[np.float32(0.0), np.float32(0.0), np.float32(1.0), np.float32(0.0), np.float32(0.0), np.float32(1.0), np.float32(1.0), np.float32(0.0), np.float32(1.0), np.float32(1.0), np.float32(0.0), np.float32(1.0), np.float32(1.0), np.float32(0.0), np.float32(0.0), np.float32(0.0)]",-5.0,99173.5,14
2025-08-14_08-18-36,8693,"[np.float32(1.0), np.float32(1.0), np.float32(1.0), np.float32(0.0), np.float32(0.0), np.float32(0.0), np.float32(0.0), np.float32(1.0), np.float32(0.0), np.float32(0.0), np.float32(1.0), np.float32(0.0), np.float32(1.0), np.float32(1.0), np.float32(0.0), np.float32(0.0)]",3.0,99176.5,22
2025-08-14_08-18-36,8694,"[np.float32(1.0), np.float32(0.0), np.float32(1.0), np.float32(0.0), np.float32(0.0), np.float32(1.0), np.float32(0.0), np.float32(0.0), np.float32(0.0), np.float32(1.0), np.float32(1.0), np.float32(0.0), np.float32(1.0), np.float32(0.0), np.float32(0.0), np.float32(0.0)]",1.0,99177.5,16
2025-08-14_08-18-36,8695,"[np.float32(1.0), np.float32(1.0), np.float32(0.0), np.float32(0.0), np.float32(1.0), np.float32(1.0), np.float32(0.0), np.float32(0.0), np.float32(0.0), np.float32(0.0), np.float32(1.0), np.float32(1.0), np.float32(0.0), np.float32(1.0), np.float32(1.0), np.float32(0.0)]",-4.0,99173.5,34
2025-08-14_08-18-36,8696,"[np.float32(0.0), np.float32(0.0), np.float32(0.0), np.float32(1.0), np.float32(0.0), np.float32(0.0), np.float32(1.0), np.float32(1.0), np.float32(1.0), np.float32(1.0), np.float32(0.0), np.float32(0.0), np.float32(0.0), np.float32(1.0), np.float32(0.0), np.float32(1.0)]",-1.0,99172.5,16
2025-08-14_08-18-36,8697,"[np.float32(0.0), np.float32(1.0), np.float32(0.0), np.float32(0.0), np.float32(1.0), np.float32(1.0), np.float32(0.0), np.float32(1.0), np.float32(1.0), np.float32(1.0), np.float32(1.0), np.float32(0.0), np.float32(0.0), np.float32(1.0), np.float32(1.0), np.float32(1.0)]",-2.0,99170.5,5
2025-08-14_08-18-36,8698,"[np.float32(0.0), np.float32(1.0), np.float32(0.0), np.float32(1.0), np.float32(0.0), np.float32(0.0), np.float32(1.0), np.float32(0.0), np.float32(1.0), np.float32(0.0), np.float32(0.0), np.float32(0.0), np.float32(1.0), np.float32(1.0), np.float32(0.0), np.float32(0.0)]",-1.0,99169.5,5
2025-08-14_08-18-36,8699,"[np.float32(1.0), np.float32(0.0), np.float32(1.0), np.float32(0.0), np.float32(0.0), np.float32(1.0), np.float32(0.0), np.float32(1.0), np.float32(1.0), np.float32(0.0), np.float32(1.0), np.float32(0.0), np.float32(1.0), np.float32(0.0), np.float32(0.0), np.float32(1.0)]",2.0,99171.5,23
2025-08-14_08-18-36,8700,"[np.float32(0.0), np.float32(1.0), np.float32(1.0), np.float32(0.0), np.float32(0.0), np.float32(1.0), np.float32(1.0), np.float32(1.0), np.float32(1.0), np.float32(0.0), np.float32(1.0), np.float32(0.0), np.float32(0.0), np.float32(1.0), np.float32(1.0), np.float32(0.0)]",-1.0,99170.5,16
2025-08-14_08-18-36,8701,"[np.float32(1.0), np.float32(0.0), np.float32(0.0), np.float32(0.0), np.float32(1.0), np.float32(0.0), np.float32(1.0), np.float32(1.0), np.float32(1.0), np.float32(1.0), np.float32(0.0), np.float32(0.0), np.float32(1.0), np.float32(1.0), np.float32(0.0), np.float32(0.0)]",-3.0,99167.5,6
2025-08-14_08-18-36,8702,"[np.float32(0.0), np.float32(1.0), np.float32(1.0), np.float32(0.0), np.float32(1.0), np.float32(0.0), np.float32(0.0), np.float32(0.0), np.float32(1.0), np.float32(0.0), np.float32(1.0), np.float32(1.0), np.float32(0.0), np.float32(1.0), np.float32(0.0), np.float32(1.0)]",-4.0,99163.5,13
2025-08-14_08-18-36,8703,"[np.float32(0.0), np.float32(0.0), np.float32(0.0), np.float32(1.0), np.float32(0.0), np.float32(1.0), np.float32(1.0), np.float32(0.0), np.float32(1.0), np.float32(0.0), np.float32(0.0), np.float32(1.0), np.float32(0.0), np.float32(0.0), np.float32(1.0), np.float32(0.0)]",0.0,99163.5,6
2025-08-14_08-18-36,8704,"[np.float32(0.0), np.float32(1.0), np.float32(1.0), np.float32(0.0), np.float32(1.0), np.float32(0.0), np.float32(0.0), np.float32(1.0), np.float32(1.0), np.float32(0.0), np.float32(0.0), np.float32(0.0), np.float32(1.0), np.float32(1.0), np.float32(0.0), np.float32(1.0)]",-4.0,99159.5,11
2025-08-14_08-18-36,8705,"[np.float32(1.0), np.float32(1.0), np.float32(1.0), np.float32(1.0), np.float32(0.0), np.float32(0.0), np.float32(1.0), np.float32(1.0), np.float32(1.0), np.float32(1.0), np.float32(0.0), np.float32(0.0), np.float32(1.0), np.float32(0.0), np.float32(0.0), np.float32(0.0)]",-2.0,99157.5,20
2025-08-14_08-18-36,8706,"[np.float32(1.0), np.float32(1.0), np.float32(0.0), np.float32(1.0), np.float32(1.0), np.float32(1.0), np.float32(1.0), np.float32(1.0), np.float32(0.0), np.float32(1.0), np.float32(0.0), np.float32(0.0), np.float32(1.0), np.float32(1.0), np.float32(1.0), np.float32(0.0)]",-4.0,99153.5,30
2025-08-14_08-18-36,8707,"[np.float32(0.0), np.float32(1.0), np.float32(0.0), np.float32(1.0), np.float32(1.0), np.float32(0.0), np.float32(1.0), np.float32(0.0), np.float32(0.0), np.float32(1.0), np.float32(0.0), np.float32(0.0), np.float32(0.0), np.float32(1.0), np.float32(0.0), np.float32(0.0)]",-4.0,99149.5,14
2025-08-14_08-18-36,8708,"[np.float32(1.0), np.float32(0.0), np.float32(0.0), np.float32(0.0), np.float32(1.0), np.float32(1.0), np.float32(1.0), np.float32(1.0), np.float32(0.0), np.float32(0.0), np.float32(1.0), np.float32(1.0), np.float32(1.0), np.float32(1.0), np.float32(0.0), np.float32(0.0)]",-1.0,99148.5,6
2025-08-14_08-18-36,8709,"[np.float32(0.0), np.float32(1.0), np.float32(1.0), np.float32(0.0), np.float32(1.0), np.float32(1.0), np.float32(0.0), np.float32(1.0), np.float32(0.0), np.float32(1.0), np.float32(0.0), np.float32(0.0), np.float32(1.0), np.float32(1.0), np.float32(0.0), np.float32(0.0)]",1.0,99149.5,24
2025-08-14_08-18-36,8710,"[np.float32(1.0), np.float32(0.0), np.float32(0.0), np.float32(0.0), np.float32(1.0), np.float32(0.0), np.float32(1.0), np.float32(1.0), np.float32(1.0), np.float32(0.0), np.float32(1.0), np.float32(1.0), np.float32(1.0), np.float32(0.0), np.float32(1.0), np.float32(0.0)]",1.0,99150.5,16
2025-08-14_08-18-36,8711,"[np.float32(1.0), np.float32(0.0), np.float32(0.0), np.float32(1.0), np.float32(0.0), np.float32(1.0), np.float32(0.0), np.float32(1.0), np.float32(1.0), np.float32(1.0), np.float32(0.0), np.float32(1.0), np.float32(1.0), np.float32(1.0), np.float32(0.0), np.float32(1.0)]",-6.0,99144.5,5
2025-08-14_08-18-36,8712,"[np.float32(1.0), np.float32(1.0), np.float32(0.0), np.float32(0.0), np.float32(0.0), np.float32(1.0), np.float32(0.0), np.float32(1.0), np.float32(1.0), np.float32(1.0), np.float32(0.0), np.float32(0.0), np.float32(1.0), np.float32(0.0), np.float32(1.0), np.float32(1.0)]",-2.0,99142.5,32
2025-08-14_08-18-36,8713,"[np.float32(0.0), np.float32(1.0), np.float32(1.0), np.float32(0.0), np.float32(1.0), np.float32(0.0), np.float32(0.0), np.float32(1.0), np.float32(1.0), np.float32(0.0), np.float32(1.0), np.float32(0.0), np.float32(0.0), np.float32(1.0), np.float32(0.0), np.float32(0.0)]",2.0,99144.5,4
2025-08-14_08-18-36,8714,"[np.float32(0.0), np.float32(0.0), np.float32(0.0), np.float32(0.0), np.float32(1.0), np.float32(0.0), np.float32(1.0), np.float32(1.0), np.float32(1.0), np.float32(0.0), np.float32(1.0), np.float32(1.0), np.float32(0.0), np.float32(0.0), np.float32(1.0), np.float32(0.0)]",-4.0,99140.5,34
2025-08-14_08-18-36,8715,"[np.float32(1.0), np.float32(1.0), np.float32(0.0), np.float32(0.0), np.float32(0.0), np.float32(1.0), np.float32(0.0), np.float32(1.0), np.float32(0.0), np.float32(0.0), np.float32(0.0), np.float32(0.0), np.float32(1.0), np.float32(0.0), np.float32(1.0), np.float32(0.0)]",-2.0,99138.5,25
2025-08-14_08-18-36,8716,"[np.float32(1.0), np.float32(0.0), np.float32(1.0), np.float32(1.0), np.float32(1.0), np.float32(0.0), np.float32(0.0), np.float32(0.0), np.float32(1.0), np.float32(1.0), np.float32(1.0), np.float32(0.0), np.float32(1.0), np.float32(1.0), np.float32(1.0), np.float32(0.0)]",-1.0,99137.5,3
2025-08-14_08-18-36,8717,"[np.float32(0.0), np.float32(0.0), np.float32(1.0), np.float32(1.0), np.float32(1.0), np.float32(1.0), np.float32(0.0), np.float32(1.0), np.float32(0.0), np.float32(0.0), np.float32(0.0), np.float32(0.0), np.float32(0.0), np.float32(0.0), np.float32(1.0), np.float32(1.0)]",0.0,99137.5,19
2025-08-14_08-18-36,8718,"[np.float32(1.0), np.float32(0.0), np.float32(1.0), np.float32(0.0), np.float32(0.0), np.float32(1.0), np.float32(0.0), np.float32(0.0), np.float32(1.0), np.float32(1.0), np.float32(0.0), np.float32(1.0), np.float32(1.0), np.float32(0.0), np.float32(0.0), np.float32(1.0)]",33.0,99170.5,7
2025-08-14_08-18-36,8719,"[np.float32(1.0), np.float32(0.0), np.float32(1.0), np.float32(1.0), np.float32(0.0), np.float32(1.0), np.float32(1.0), np.float32(1.0), np.float32(1.0), np.float32(1.0), np.float32(0.0), np.float32(0.0), np.float32(0.0), np.float32(1.0), np.float32(1.0), np.float32(1.0)]",1.0,99171.5,27
2025-08-14_08-18-36,8720,"[np.float32(0.0), np.float32(1.0), np.float32(0.0), np.float32(1.0), np.float32(0.0), np.float32(1.0), np.float32(0.0), np.float32(0.0), np.float32(0.0), np.float32(1.0), np.float32(1.0), np.float32(0.0), np.float32(0.0), np.float32(0.0), np.float32(0.0), np.float32(0.0)]",4.0,99175.5,35
2025-08-14_08-18-36,8721,"[np.float32(0.0), np.float32(1.0), np.float32(0.0), np.float32(0.0), np.float32(1.0), np.float32(1.0), np.float32(1.0), np.float32(1.0), np.float32(0.0), np.float32(1.0), np.float32(1.0), np.float32(1.0), np.float32(0.0), np.float32(0.0), np.float32(0.0), np.float32(1.0)]",-2.0,99173.5,33
2025-08-14_08-18-36,8722,"[np.float32(0.0), np.float32(0.0), np.float32(1.0), np.float32(0.0), np.float32(1.0), np.float32(0.0), np.float32(0.0), np.float32(1.0), np.float32(1.0), np.float32(1.0), np.float32(1.0), np.float32(0.0), np.float32(0.0), np.float32(1.0), np.float32(0.0), np.float32(0.0)]",0.0,99173.5,10
2025-08-14_08-18-36,8723,"[np.float32(1.0), np.float32(1.0), np.float32(1.0), np.float32(0.0), np.float32(0.0), np.float32(1.0), np.float32(1.0), np.float32(1.0), np.float32(1.0), np.float32(1.0), np.float32(0.0), np.float32(0.0), np.float32(0.0), np.float32(0.0), np.float32(1.0), np.float32(0.0)]",-1.0,99172.5,5
2025-08-14_08-18-36,8724,"[np.float32(1.0), np.float32(1.0), np.float32(1.0), np.float32(0.0), np.float32(1.0), np.float32(0.0), np.float32(0.0), np.float32(1.0), np.float32(1.0), np.float32(0.0), np.float32(1.0), np.float32(0.0), np.float32(0.0), np.float32(1.0), np.float32(1.0), np.float32(0.0)]",2.0,99174.5,29
2025-08-14_08-18-36,8725,"[np.float32(0.0), np.float32(1.0), np.float32(1.0), np.float32(0.0), np.float32(1.0), np.float32(1.0), np.float32(1.0), np.float32(1.0), np.float32(1.0), np.float32(1.0), np.float32(1.0), np.float32(1.0), np.float32(1.0), np.float32(1.0), np.float32(1.0), np.float32(1.0)]",-3.0,99171.5,1
2025-08-14_08-18-36,8726,"[np.float32(1.0), np.float32(0.0), np.float32(0.0), np.float32(0.0), np.float32(0.0), np.float32(1.0), np.float32(1.0), np.float32(1.0), np.float32(0.0), np.float32(1.0), np.float32(0.0), np.float32(0.0), np.float32(1.0), np.float32(1.0), np.float32(1.0), np.float32(0.0)]",-2.0,99169.5,11
2025-08-14_08-18-36,8727,"[np.float32(1.0), np.float32(1.0), np.float32(0.0), np.float32(1.0), np.float32(1.0), np.float32(0.0), np.float32(0.0), np.float32(1.0), np.float32(0.0), np.float32(0.0), np.float32(0.0), np.float32(1.0), np.float32(0.0), np.float32(1.0), np.float32(1.0), np.float32(1.0)]",0.0,99169.5,11
2025-08-14_08-18-36,8728,"[np.float32(1.0), np.float32(0.0), np.float32(1.0), np.float32(0.0), np.float32(1.0), np.float32(1.0), np.float32(1.0), np.float32(1.0), np.float32(1.0), np.float32(0.0), np.float32(1.0), np.float32(0.0), np.float32(0.0), np.float32(0.0), np.float32(0.0), np.float32(1.0)]",3.0,99172.5,32
2025-08-14_08-18-36,8729,"[np.float32(1.0), np.float32(0.0), np.float32(1.0), np.float32(1.0), np.float32(0.0), np.float32(0.0), np.float32(0.0), np.float32(1.0), np.float32(0.0), np.float32(0.0), np.float32(0.0), np.float32(1.0), np.float32(1.0), np.float32(0.0), np.float32(0.0), np.float32(1.0)]",0.0,99172.5,36
2025-08-14_08-18-36,8730,"[np.float32(0.0), np.float32(0.0), np.float32(1.0), np.float32(1.0), np.float32(0.0), np.float32(1.0), np.float32(1.0), np.float32(1.0), np.float32(1.0), np.float32(1.0), np.float32(0.0), np.float32(0.0), np.float32(0.0), np.float32(0.0), np.float32(1.0), np.float32(1.0)]",2.0,99174.5,1
2025-08-14_08-18-36,8731,"[np.float32(0.0), np.float32(0.0), np.float32(0.0), np.float32(0.0), np.float32(1.0), np.float32(0.0), np.float32(0.0), np.float32(1.0), np.float32(0.0), np.float32(1.0), np.float32(0.0), np.float32(1.0), np.float32(0.0), np.float32(1.0), np.float32(0.0), np.float32(1.0)]",-3.0,99171.5,36
2025-08-14_08-18-36,8732,"[np.float32(1.0), np.float32(1.0), np.float32(0.0), np.float32(0.0), np.float32(0.0), np.float32(0.0), np.float32(1.0), np.float32(0.0), np.float32(1.0), np.float32(0.0), np.float32(0.0), np.float32(1.0), np.float32(1.0), np.float32(1.0), np.float32(0.0), np.float32(0.0)]",1.0,99172.5,25
2025-08-14_08-18-36,8733,"[np.float32(1.0), np.float32(1.0), np.float32(0.0), np.float32(1.0), np.float32(0.0), np.float32(0.0), np.float32(1.0), np.float32(1.0), np.float32(1.0), np.float32(0.0), np.float32(0.0), np.float32(1.0), np.float32(0.0), np.float32(0.0), np.float32(0.0), np.float32(1.0)]",0.0,99172.5,14
2025-08-14_08-18-36,8734,"[np.float32(0.0), np.float32(0.0), np.float32(1.0), np.float32(0.0), np.float32(0.0), np.float32(1.0), np.float32(1.0), np.float32(1.0), np.float32(1.0), np.float32(1.0), np.float32(1.0), np.float32(1.0), np.float32(1.0), np.float32(0.0), np.float32(1.0), np.float32(1.0)]",-3.0,99169.5,18
2025-08-14_08-18-36,8735,"[np.float32(0.0), np.float32(0.0), np.float32(0.0), np.float32(1.0), np.float32(0.0), np.float32(1.0), np.float32(1.0), np.float32(1.0), np.float32(0.0), np.float32(1.0), np.float32(1.0), np.float32(0.0), np.float32(1.0), np.float32(1.0), np.float32(0.0), np.float32(1.0)]",-1.0,99168.5,32
2025-08-14_08-18-36,8736,"[np.float32(0.0), np.float32(1.0), np.float32(1.0), np.float32(0.0), np.float32(0.0), np.float32(1.0), np.float32(0.0), np.float32(1.0), np.float32(0.0), np.float32(0.0), np.float32(0.0), np.float32(1.0), np.float32(0.0), np.float32(1.0), np.float32(0.0), np.float32(1.0)]",0.0,99168.5,29
2025-08-14_08-18-36,8737,"[np.float32(0.0), np.float32(1.0), np.float32(1.0), np.float32(1.0), np.float32(0.0), np.float32(1.0), np.float32(1.0), np.float32(1.0), np.float32(0.0), np.float32(1.0), np.float32(1.0), np.float32(0.0), np.float32(1.0), np.float32(0.0), np.float32(1.0), np.float32(0.0)]",-3.0,99165.5,21
2025-08-14_08-18-36,8738,"[np.float32(1.0), np.float32(0.0), np.float32(1.0), np.float32(1.0), np.float32(0.0), np.float32(1.0), np.float32(0.0), np.float32(1.0), np.float32(1.0), np.float32(1.0), np.float32(1.0), np.float32(0.0), np.float32(1.0), np.float32(1.0), np.float32(0.0), np.float32(0.0)]",-2.0,99163.5,17
2025-08-14_08-18-36,8739,"[np.float32(0.0), np.float32(0.0), np.float32(1.0), np.float32(0.0), np.float32(0.0), np.float32(0.0), np.float32(1.0), np.float32(1.0), np.float32(0.0), np.float32(0.0), np.float32(1.0), np.float32(1.0), np.float32(1.0), np.float32(1.0), np.float32(0.0), np.float32(0.0)]",-1.0,99162.5,11
2025-08-14_08-18-36,8740,"[np.float32(1.0), np.float32(0.0), np.float32(1.0), np.float32(1.0), np.float32(1.0), np.float32(0.0), np.float32(0.0), np.float32(0.0), np.float32(0.0), np.float32(0.0), np.float32(1.0), np.float32(0.0), np.float32(0.0), np.float32(1.0), np.float32(0.0), np.float32(0.0)]",1.0,99163.5,11
2025-08-14_08-18-36,8741,"[np.float32(0.0), np.float32(1.0), np.float32(0.0), np.float32(1.0), np.float32(0.0), np.float32(1.0), np.float32(1.0), np.float32(0.0), np.float32(1.0), np.float32(0.0), np.float32(1.0), np.float32(0.0), np.float32(1.0), np.float32(0.0), np.float32(0.0), np.float32(1.0)]",-3.0,99160.5,36
2025-08-14_08-18-36,8742,"[np.float32(1.0), np.float32(1.0), np.float32(1.0), np.float32(1.0), np.float32(0.0), np.float32(0.0), np.float32(1.0), np.float32(0.0), np.float32(0.0), np.float32(0.0), np.float32(0.0), np.float32(0.0), np.float32(0.0), np.float32(0.0), np.float32(0.0), np.float32(1.0)]",1.0,99161.5,2
2025-08-14_08-18-36,8743,"[np.float32(0.0), np.float32(1.0), np.float32(1.0), np.float32(0.0), np.float32(0.0), np.float32(1.0), np.float32(1.0), np.float32(1.0), np.float32(0.0), np.float32(1.0), np.float32(1.0), np.float32(1.0), np.float32(0.0), np.float32(1.0), np.float32(1.0), np.float32(1.0)]",0.0,99161.5,17
2025-08-14_08-18-36,8744,"[np.float32(1.0), np.float32(1.0), np.float32(1.0), np.float32(0.0), np.float32(0.0), np.float32(1.0), np.float32(1.0), np.float32(1.0), np.float32(0.0), np.float32(0.0), np.float32(1.0), np.float32(0.0), np.float32(0.0), np.float32(1.0), np.float32(1.0), np.float32(0.0)]",3.0,99164.5,20
2025-08-14_08-18-36,8745,"[np.float32(1.0), np.float32(1.0), np.float32(0.0), np.float32(0.0), np.float32(0.0), np.float32(0.0), np.float32(0.0), np.float32(0.0), np.float32(1.0), np.float32(1.0), np.float32(0.0), np.float32(0.0), np.float32(0.0), np.float32(1.0), np.float32(0.0), np.float32(0.0)]",0.0,99164.5,0
2025-08-14_08-18-36,8746,"[np.float32(1.0), np.float32(1.0), np.float32(1.0), np.float32(0.0), np.float32(0.0), np.float32(0.0), np.float32(0.0), np.float32(0.0), np.float32(0.0), np.float32(0.0), np.float32(1.0), np.float32(0.0), np.float32(1.0), np.float32(1.0), np.float32(1.0), np.float32(0.0)]",-5.0,99159.5,31
2025-08-14_08-18-36,8747,"[np.float32(0.0), np.float32(0.0), np.float32(0.0), np.float32(0.0), np.float32(0.0), np.float32(1.0), np.float32(0.0), np.float32(0.0), np.float32(0.0), np.float32(0.0), np.float32(1.0), np.float32(0.0), np.float32(0.0), np.float32(1.0), np.float32(0.0), np.float32(0.0)]",-1.0,99158.5,33
2025-08-14_08-18-36,8748,"[np.float32(1.0), np.float32(0.0), np.float32(0.0), np.float32(0.0), np.float32(0.0), np.float32(1.0), np.float32(0.0), np.float32(0.0), np.float32(1.0), np.float32(1.0), np.float32(1.0), np.float32(0.0), np.float32(0.0), np.float32(1.0), np.float32(1.0), np.float32(0.0)]",6.0,99164.5,25
2025-08-14_08-18-36,8749,"[np.float32(0.0), np.float32(1.0), np.float32(0.0), np.float32(1.0), np.float32(1.0), np.float32(1.0), np.float32(0.0), np.float32(0.0), np.float32(1.0), np.float32(0.0), np.float32(1.0), np.float32(1.0), np.float32(0.0), np.float32(0.0), np.float32(0.0), np.float32(0.0)]",2.0,99166.5,31
2025-08-14_08-18-36,8750,"[np.float32(0.0), np.float32(0.0), np.float32(0.0), np.float32(0.0), np.float32(0.0), np.float32(0.0), np.float32(1.0), np.float32(1.0), np.float32(0.0), np.float32(1.0), np.float32(0.0), np.float32(0.0), np.float32(0.0), np.float32(1.0), np.float32(0.0), np.float32(0.0)]",-1.0,99165.5,0
2025-08-14_08-18-36,8751,"[np.float32(1.0), np.float32(0.0), np.float32(1.0), np.float32(0.0), np.float32(0.0), np.float32(0.0), np.float32(1.0), np.float32(1.0), np.float32(1.0), np.float32(0.0), np.float32(0.0), np.float32(1.0), np.float32(0.0), np.float32(1.0), np.float32(0.0), np.float32(1.0)]",3.0,99168.5,9
2025-08-14_08-18-36,8752,"[np.float32(1.0), np.float32(0.0), np.float32(1.0), np.float32(1.0), np.float32(1.0), np.float32(1.0), np.float32(0.0), np.float32(1.0), np.float32(0.0), np.float32(1.0), np.float32(1.0), np.float32(0.0), np.float32(1.0), np.float32(0.0), np.float32(0.0), np.float32(0.0)]",0.0,99168.5,32
2025-08-14_08-18-36,8753,"[np.float32(1.0), np.float32(0.0), np.float32(0.0), np.float32(0.0), np.float32(1.0), np.float32(1.0), np.float32(1.0), np.float32(1.0), np.float32(1.0), np.float32(1.0), np.float32(1.0), np.float32(1.0), np.float32(1.0), np.float32(1.0), np.float32(1.0), np.float32(1.0)]",0.0,99168.5,32
2025-08-14_08-18-36,8754,"[np.float32(0.0), np.float32(0.0), np.float32(0.0), np.float32(0.0), np.float32(0.0), np.float32(1.0), np.float32(1.0), np.float32(1.0), np.float32(1.0), np.float32(0.0), np.float32(1.0), np.float32(1.0), np.float32(0.0), np.float32(1.0), np.float32(0.0), np.float32(1.0)]",3.0,99171.5,20
2025-08-14_08-18-36,8755,"[np.float32(1.0), np.float32(1.0), np.float32(1.0), np.float32(0.0), np.float32(0.0), np.float32(1.0), np.float32(0.0), np.float32(0.0), np.float32(1.0), np.float32(0.0), np.float32(1.0), np.float32(0.0), np.float32(0.0), np.float32(0.0), np.float32(0.0), np.float32(0.0)]",-4.0,99167.5,15
2025-08-14_08-18-36,8756,"[np.float32(1.0), np.float32(1.0), np.float32(1.0), np.float32(0.0), np.float32(0.0), np.float32(0.0), np.float32(0.0), np.float32(1.0), np.float32(0.0), np.float32(1.0), np.float32(0.0), np.float32(0.0), np.float32(0.0), np.float32(1.0), np.float32(0.0), np.float32(0.0)]",4.0,99171.5,4
2025-08-14_08-18-36,8757,"[np.float32(1.0), np.float32(1.0), np.float32(0.0), np.float32(1.0), np.float32(0.0), np.float32(1.0), np.float32(0.0), np.float32(1.0), np.float32(1.0), np.float32(1.0), np.float32(1.0), np.float32(0.0), np.float32(1.0), np.float32(1.0), np.float32(0.0), np.float32(1.0)]",2.0,99173.5,32
2025-08-14_08-18-36,8758,"[np.float32(0.0), np.float32(0.0), np.float32(1.0), np.float32(0.0), np.float32(0.0), np.float32(1.0), np.float32(0.0), np.float32(1.0), np.float32(1.0), np.float32(1.0), np.float32(1.0), np.float32(0.0), np.float32(1.0), np.float32(0.0), np.float32(1.0), np.float32(0.0)]",2.0,99175.5,36
2025-08-14_08-18-36,8759,"[np.float32(0.0), np.float32(0.0), np.float32(0.0), np.float32(0.0), np.float32(1.0), np.float32(0.0), np.float32(0.0), np.float32(1.0), np.float32(0.0), np.float32(1.0), np.float32(0.0), np.float32(1.0), np.float32(1.0), np.float32(0.0), np.float32(1.0), np.float32(1.0)]",1.0,99176.5,1
2025-08-14_08-18-36,8760,"[np.float32(1.0), np.float32(1.0), np.float32(1.0), np.float32(1.0), np.float32(1.0), np.float32(1.0), np.float32(0.0), np.float32(1.0), np.float32(1.0), np.float32(0.0), np.float32(0.0), np.float32(1.0), np.float32(0.0), np.float32(1.0), np.float32(0.0), np.float32(0.0)]",2.0,99178.5,36
2025-08-14_08-18-36,8761,"[np.float32(0.0), np.float32(1.0), np.float32(0.0), np.float32(0.0), np.float32(1.0), np.float32(0.0), np.float32(0.0), np.float32(1.0), np.float32(1.0), np.float32(0.0), np.float32(0.0), np.float32(0.0), np.float32(1.0), np.float32(0.0), np.float32(0.0), np.float32(1.0)]",4.0,99182.5,17
2025-08-14_08-18-36,8762,"[np.float32(0.0), np.float32(0.0), np.float32(1.0), np.float32(1.0), np.float32(0.0), np.float32(1.0), np.float32(1.0), np.float32(1.0), np.float32(1.0), np.float32(1.0), np.float32(0.0), np.float32(1.0), np.float32(1.0), np.float32(0.0), np.float32(1.0), np.float32(0.0)]",-2.0,99180.5,9
2025-08-14_08-18-36,8763,"[np.float32(0.0), np.float32(0.0), np.float32(0.0), np.float32(0.0), np.float32(0.0), np.float32(1.0), np.float32(0.0), np.float32(1.0), np.float32(1.0), np.float32(1.0), np.float32(1.0), np.float32(1.0), np.float32(1.0), np.float32(0.0), np.float32(1.0), np.float32(0.0)]",-2.0,99178.5,15
2025-08-14_08-18-36,8764,"[np.float32(0.0), np.float32(0.0), np.float32(1.0), np.float32(0.0), np.float32(1.0), np.float32(1.0), np.float32(1.0), np.float32(0.0), np.float32(1.0), np.float32(1.0), np.float32(0.0), np.float32(1.0), np.float32(1.0), np.float32(1.0), np.float32(1.0), np.float32(0.0)]",0.0,99178.5,16
2025-08-14_08-18-36,8765,"[np.float32(1.0), np.float32(1.0), np.float32(0.0), np.float32(1.0), np.float32(1.0), np.float32(1.0), np.float32(1.0), np.float32(1.0), np.float32(0.0), np.float32(0.0), np.float32(0.0), np.float32(0.0), np.float32(0.0), np.float32(1.0), np.float32(0.0), np.float32(0.0)]",2.0,99180.5,2
2025-08-14_08-18-36,8766,"[np.float32(1.0), np.float32(1.0), np.float32(0.0), np.float32(0.0), np.float32(1.0), np.float32(1.0), np.float32(1.0), np.float32(1.0), np.float32(1.0), np.float32(1.0), np.float32(0.0), np.float32(0.0), np.float32(0.0), np.float32(0.0), np.float32(0.0), np.float32(1.0)]",-2.0,99178.5,33
2025-08-14_08-18-36,8767,"[np.float32(0.0), np.float32(0.0), np.float32(1.0), np.float32(0.0), np.float32(0.0), np.float32(1.0), np.float32(1.0), np.float32(0.0), np.float32(0.0), np.float32(1.0), np.float32(0.0), np.float32(1.0), np.float32(0.0), np.float32(1.0), np.float32(0.0), np.float32(0.0)]",-1.0,99177.5,29
2025-08-14_08-18-36,8768,"[np.float32(1.0), np.float32(1.0), np.float32(0.0), np.float32(0.0), np.float32(0.0), np.float32(1.0), np.float32(0.0), np.float32(1.0), np.float32(1.0), np.float32(0.0), np.float32(1.0), np.float32(0.0), np.float32(1.0), np.float32(0.0), np.float32(0.0), np.float32(0.0)]",0.0,99177.5,21
2025-08-14_08-18-36,8769,"[np.float32(0.0), np.float32(0.0), np.float32(0.0), np.float32(0.0), np.float32(1.0), np.float32(1.0), np.float32(1.0), np.float32(1.0), np.float32(0.0), np.float32(1.0), np.float32(0.0), np.float32(1.0), np.float32(0.0), np.float32(1.0), np.float32(0.0), np.float32(0.0)]",-2.0,99175.5,0
2025-08-14_08-18-36,8770,"[np.float32(1.0), np.float32(0.0), np.float32(1.0), np.float32(1.0), np.float32(0.0), np.float32(1.0), np.float32(0.0), np.float32(1.0), np.float32(1.0), np.float32(0.0), np.float32(0.0), np.float32(0.0), np.float32(1.0), np.float32(0.0), np.float32(0.0), np.float32(0.0)]",-2.0,99173.5,13
2025-08-14_08-18-36,8771,"[np.float32(0.0), np.float32(1.0), np.float32(0.0), np.float32(1.0), np.float32(0.0), np.float32(0.0), np.float32(1.0), np.float32(0.0), np.float32(0.0), np.float32(0.0), np.float32(0.0), np.float32(1.0), np.float32(1.0), np.float32(0.0), np.float32(0.0), np.float32(0.0)]",1.0,99174.5,12
2025-08-14_08-18-36,8772,"[np.float32(1.0), np.float32(0.0), np.float32(1.0), np.float32(0.0), np.float32(1.0), np.float32(0.0), np.float32(0.0), np.float32(0.0), np.float32(0.0), np.float32(1.0), np.float32(0.0), np.float32(0.0), np.float32(0.0), np.float32(1.0), np.float32(0.0), np.float32(0.0)]",-3.0,99171.5,11
2025-08-14_08-18-36,8773,"[np.float32(1.0), np.float32(0.0), np.float32(0.0), np.float32(0.0), np.float32(1.0), np.float32(1.0), np.float32(0.0), np.float32(1.0), np.float32(1.0), np.float32(0.0), np.float32(1.0), np.float32(1.0), np.float32(1.0), np.float32(1.0), np.float32(0.0), np.float32(0.0)]",1.0,99172.5,30
2025-08-14_08-18-36,8774,"[np.float32(0.0), np.float32(1.0), np.float32(1.0), np.float32(0.0), np.float32(1.0), np.float32(1.0), np.float32(0.0), np.float32(1.0), np.float32(1.0), np.float32(1.0), np.float32(1.0), np.float32(1.0), np.float32(0.0), np.float32(1.0), np.float32(0.0), np.float32(0.0)]",2.0,99174.5,4
2025-08-14_08-18-36,8775,"[np.float32(0.0), np.float32(1.0), np.float32(0.0), np.float32(1.0), np.float32(0.0), np.float32(0.0), np.float32(1.0), np.float32(0.0), np.float32(0.0), np.float32(0.0), np.float32(1.0), np.float32(0.0), np.float32(1.0), np.float32(1.0), np.float32(0.0), np.float32(1.0)]",0.0,99174.5,15
2025-08-14_08-18-36,8776,"[np.float32(0.0), np.float32(1.0), np.float32(1.0), np.float32(0.0), np.float32(1.0), np.float32(1.0), np.float32(0.0), np.float32(1.0), np.float32(0.0), np.float32(0.0), np.float32(0.0), np.float32(0.0), np.float32(0.0), np.float32(0.0), np.float32(0.0), np.float32(1.0)]",1.0,99175.5,13
2025-08-14_08-18-36,8777,"[np.float32(0.0), np.float32(0.0), np.float32(1.0), np.float32(0.0), np.float32(0.0), np.float32(0.0), np.float32(0.0), np.float32(1.0), np.float32(1.0), np.float32(0.0), np.float32(1.0), np.float32(1.0), np.float32(0.0), np.float32(0.0), np.float32(1.0), np.float32(0.0)]",-1.0,99174.5,12
2025-08-14_08-18-36,8778,"[np.float32(1.0), np.float32(0.0), np.float32(0.0), np.float32(1.0), np.float32(1.0), np.float32(1.0), np.float32(1.0), np.float32(1.0), np.float32(0.0), np.float32(1.0), np.float32(1.0), np.float32(1.0), np.float32(1.0), np.float32(1.0), np.float32(1.0), np.float32(0.0)]",-5.0,99169.5,31
2025-08-14_08-18-36,8779,"[np.float32(1.0), np.float32(1.0), np.float32(1.0), np.float32(0.0), np.float32(1.0), np.float32(0.0), np.float32(0.0), np.float32(1.0), np.float32(0.0), np.float32(0.0), np.float32(1.0), np.float32(0.0), np.float32(1.0), np.float32(0.0), np.float32(1.0), np.float32(1.0)]",-2.0,99167.5,26
2025-08-14_08-18-36,8780,"[np.float32(1.0), np.float32(0.0), np.float32(0.0), np.float32(0.0), np.float32(0.0), np.float32(0.0), np.float32(1.0), np.float32(0.0), np.float32(1.0), np.float32(0.0), np.float32(0.0), np.float32(0.0), np.float32(0.0), np.float32(1.0), np.float32(0.0), np.float32(0.0)]",-1.0,99166.5,10
2025-08-14_08-18-36,8781,"[np.float32(1.0), np.float32(0.0), np.float32(1.0), np.float32(0.0), np.float32(1.0), np.float32(1.0), np.float32(1.0), np.float32(1.0), np.float32(1.0), np.float32(1.0), np.float32(1.0), np.float32(0.0), np.float32(0.0), np.float32(1.0), np.float32(0.0), np.float32(0.0)]",-2.0,99164.5,31
2025-08-14_08-18-36,8782,"[np.float32(0.0), np.float32(0.0), np.float32(1.0), np.float32(1.0), np.float32(1.0), np.float32(0.0), np.float32(1.0), np.float32(0.0), np.float32(1.0), np.float32(1.0), np.float32(0.0), np.float32(0.0), np.float32(1.0), np.float32(0.0), np.float32(0.0), np.float32(0.0)]",39.0,99203.5,7
2025-08-14_08-18-36,8783,"[np.float32(1.0), np.float32(0.0), np.float32(1.0), np.float32(0.0), np.float32(0.0), np.float32(0.0), np.float32(0.0), np.float32(1.0), np.float32(1.0), np.float32(0.0), np.float32(0.0), np.float32(1.0), np.float32(1.0), np.float32(0.0), np.float32(0.0), np.float32(0.0)]",-3.0,99200.5,31
2025-08-14_08-18-36,8784,"[np.float32(0.0), np.float32(0.0), np.float32(1.0), np.float32(0.0), np.float32(0.0), np.float32(1.0), np.float32(1.0), np.float32(0.0), np.float32(1.0), np.float32(0.0), np.float32(0.0), np.float32(1.0), np.float32(0.0), np.float32(1.0), np.float32(1.0), np.float32(0.0)]",1.0,99201.5,8
2025-08-14_08-18-36,8785,"[np.float32(0.0), np.float32(1.0), np.float32(1.0), np.float32(0.0), np.float32(1.0), np.float32(1.0), np.float32(0.0), np.float32(1.0), np.float32(0.0), np.float32(0.0), np.float32(1.0), np.float32(0.0), np.float32(1.0), np.float32(1.0), np.float32(0.0), np.float32(1.0)]",-5.0,99196.5,36
2025-08-14_08-18-36,8786,"[np.float32(0.0), np.float32(0.0), np.float32(1.0), np.float32(1.0), np.float32(0.0), np.float32(0.0), np.float32(0.0), np.float32(1.0), np.float32(0.0), np.float32(0.0), np.float32(1.0), np.float32(1.0), np.float32(0.0), np.float32(1.0), np.float32(0.0), np.float32(0.0)]",2.0,99198.5,3
2025-08-14_08-18-36,8787,"[np.float32(0.0), np.float32(0.0), np.float32(0.0), np.float32(0.0), np.float32(0.0), np.float32(1.0), np.float32(0.0), np.float32(0.0), np.float32(0.0), np.float32(1.0), np.float32(0.0), np.float32(0.0), np.float32(1.0), np.float32(0.0), np.float32(0.0), np.float32(1.0)]",-1.0,99197.5,9
2025-08-14_08-18-36,8788,"[np.float32(1.0), np.float32(0.0), np.float32(1.0), np.float32(1.0), np.float32(0.0), np.float32(1.0), np.float32(0.0), np.float32(0.0), np.float32(1.0), np.float32(0.0), np.float32(0.0), np.float32(1.0), np.float32(1.0), np.float32(0.0), np.float32(0.0), np.float32(1.0)]",4.0,99201.5,30
2025-08-14_08-18-36,8789,"[np.float32(0.0), np.float32(0.0), np.float32(0.0), np.float32(0.0), np.float32(0.0), np.float32(1.0), np.float32(1.0), np.float32(1.0), np.float32(1.0), np.float32(1.0), np.float32(1.0), np.float32(0.0), np.float32(1.0), np.float32(1.0), np.float32(1.0), np.float32(0.0)]",2.0,99203.5,19
2025-08-14_08-18-36,8790,"[np.float32(0.0), np.float32(0.0), np.float32(0.0), np.float32(0.0), np.float32(0.0), np.float32(0.0), np.float32(1.0), np.float32(1.0), np.float32(0.0), np.float32(0.0), np.float32(0.0), np.float32(0.0), np.float32(1.0), np.float32(1.0), np.float32(0.0), np.float32(0.0)]",-1.0,99202.5,13
2025-08-14_08-18-36,8791,"[np.float32(0.0), np.float32(1.0), np.float32(1.0), np.float32(0.0), np.float32(1.0), np.float32(1.0), np.float32(1.0), np.float32(0.0), np.float32(0.0), np.float32(1.0), np.float32(1.0), np.float32(0.0), np.float32(1.0), np.float32(1.0), np.float32(0.0), np.float32(0.0)]",-2.0,99200.5,15
2025-08-14_08-18-36,8792,"[np.float32(0.0), np.float32(1.0), np.float32(0.0), np.float32(1.0), np.float32(1.0), np.float32(1.0), np.float32(0.0), np.float32(1.0), np.float32(0.0), np.float32(1.0), np.float32(0.0), np.float32(0.0), np.float32(0.0), np.float32(0.0), np.float32(0.0), np.float32(0.0)]",4.0,99204.5,19
2025-08-14_08-18-36,8793,"[np.float32(0.0), np.float32(0.0), np.float32(0.0), np.float32(0.0), np.float32(0.0), np.float32(1.0), np.float32(1.0), np.float32(0.0), np.float32(1.0), np.float32(1.0), np.float32(1.0), np.float32(1.0), np.float32(1.0), np.float32(1.0), np.float32(0.0), np.float32(1.0)]",0.0,99204.5,6
2025-08-14_08-18-36,8794,"[np.float32(0.0), np.float32(0.0), np.float32(1.0), np.float32(0.0), np.float32(0.0), np.float32(1.0), np.float32(0.0), np.float32(1.0), np.float32(1.0), np.float32(1.0), np.float32(0.0), np.float32(0.0), np.float32(1.0), np.float32(1.0), np.float32(0.0), np.float32(0.0)]",1.0,99205.5,18
2025-08-14_08-18-36,8795,"[np.float32(1.0), np.float32(0.0), np.float32(0.0), np.float32(0.0), np.float32(1.0), np.float32(0.0), np.float32(1.0), np.float32(0.0), np.float32(0.0), np.float32(1.0), np.float32(1.0), np.float32(0.0), np.float32(1.0), np.float32(1.0), np.float32(0.0), np.float32(0.0)]",0.0,99205.5,16
2025-08-14_08-18-36,8796,"[np.float32(0.0), np.float32(1.0), np.float32(0.0), np.float32(0.0), np.float32(1.0), np.float32(0.0), np.float32(1.0), np.float32(1.0), np.float32(0.0), np.float32(1.0), np.float32(1.0), np.float32(1.0), np.float32(1.0), np.float32(0.0), np.float32(0.0), np.float32(0.0)]",2.0,99207.5,15
2025-08-14_08-18-36,8797,"[np.float32(0.0), np.float32(1.0), np.float32(0.0), np.float32(1.0), np.float32(0.0), np.float32(1.0), np.float32(1.0), np.float32(1.0), np.float32(1.0), np.float32(0.0), np.float32(0.0), np.float32(1.0), np.float32(1.0), np.float32(0.0), np.float32(0.0), np.float32(0.0)]",2.0,99209.5,27
2025-08-14_08-18-36,8798,"[np.float32(0.0), np.float32(0.0), np.float32(0.0), np.float32(0.0), np.float32(1.0), np.float32(1.0), np.float32(0.0), np.float32(1.0), np.float32(0.0), np.float32(1.0), np.float32(1.0), np.float32(0.0), np.float32(1.0), np.float32(1.0), np.float32(1.0), np.float32(0.0)]",3.0,99212.5,16
2025-08-14_08-18-36,8799,"[np.float32(1.0), np.float32(0.0), np.float32(1.0), np.float32(1.0), np.float32(1.0), np.float32(1.0), np.float32(0.0), np.float32(0.0), np.float32(0.0), np.float32(0.0), np.float32(0.0), np.float32(0.0), np.float32(1.0), np.float32(1.0), np.float32(0.0), np.float32(0.0)]",-3.0,99209.5,31
2025-08-14_08-18-36,8800,"[np.float32(0.0), np.float32(1.0), np.float32(1.0), np.float32(0.0), np.float32(1.0), np.float32(1.0), np.float32(1.0), np.float32(0.0), np.float32(1.0), np.float32(0.0), np.float32(0.0), np.float32(1.0), np.float32(0.0), np.float32(0.0), np.float32(1.0), np.float32(1.0)]",-4.0,99205.5,25
2025-08-14_08-18-36,8801,"[np.float32(1.0), np.float32(1.0), np.float32(1.0), np.float32(0.0), np.float32(1.0), np.float32(0.0), np.float32(0.0), np.float32(0.0), np.float32(1.0), np.float32(0.0), np.float32(0.0), np.float32(1.0), np.float32(0.0), np.float32(0.0), np.float32(0.0), np.float32(1.0)]",-1.0,99204.5,8
2025-08-14_08-18-36,8802,"[np.float32(0.0), np.float32(0.0), np.float32(0.0), np.float32(1.0), np.float32(0.0), np.float32(1.0), np.float32(0.0), np.float32(1.0), np.float32(1.0), np.float32(1.0), np.float32(0.0), np.float32(0.0), np.float32(1.0), np.float32(1.0), np.float32(0.0), np.float32(0.0)]",-5.0,99199.5,9
2025-08-14_08-18-36,8803,"[np.float32(1.0), np.float32(0.0), np.float32(0.0), np.float32(0.0), np.float32(0.0), np.float32(0.0), np.float32(1.0), np.float32(0.0), np.float32(1.0), np.float32(1.0), np.float32(1.0), np.float32(0.0), np.float32(1.0), np.float32(1.0), np.float32(0.0), np.float32(0.0)]",-2.0,99197.5,27
2025-08-14_08-18-36,8804,"[np.float32(1.0), np.float32(1.0), np.float32(1.0), np.float32(1.0), np.float32(1.0), np.float32(1.0), np.float32(0.0), np.float32(0.0), np.float32(1.0), np.float32(0.0), np.float32(1.0), np.float32(0.0), np.float32(0.0), np.float32(0.0), np.float32(0.0), np.float32(0.0)]",-2.0,99195.5,10
2025-08-14_08-18-36,8805,"[np.float32(0.0), np.float32(0.0), np.float32(0.0), np.float32(0.0), np.float32(0.0), np.float32(1.0), np.float32(0.0), np.float32(0.0), np.float32(0.0), np.float32(0.0), np.float32(0.0), np.float32(0.0), np.float32(0.0), np.float32(1.0), np.float32(1.0), np.float32(0.0)]",-3.0,99192.5,17
2025-08-14_08-18-36,8806,"[np.float32(1.0), np.float32(1.0), np.float32(0.0), np.float32(0.0), np.float32(0.0), np.float32(0.0), np.float32(0.0), np.float32(1.0), np.float32(0.0), np.float32(1.0), np.float32(0.0), np.float32(0.0), np.float32(0.0), np.float32(0.0), np.float32(0.0), np.float32(1.0)]",3.0,99195.5,14
2025-08-14_08-18-36,8807,"[np.float32(0.0), np.float32(0.0), np.float32(1.0), np.float32(1.0), np.float32(0.0), np.float32(0.0), np.float32(1.0), np.float32(0.0), np.float32(0.0), np.float32(0.0), np.float32(1.0), np.float32(0.0), np.float32(1.0), np.float32(0.0), np.float32(0.0), np.float32(0.0)]",-3.0,99192.5,16
2025-08-14_08-18-36,8808,"[np.float32(1.0), np.float32(0.0), np.float32(1.0), np.float32(0.0), np.float32(1.0), np.float32(1.0), np.float32(1.0), np.float32(0.0), np.float32(1.0), np.float32(1.0), np.float32(0.0), np.float32(0.0), np.float32(0.0), np.float32(0.0), np.float32(0.0), np.float32(1.0)]",-3.0,99189.5,11
2025-08-14_08-18-36,8809,"[np.float32(0.0), np.float32(1.0), np.float32(1.0), np.float32(1.0), np.float32(0.0), np.float32(1.0), np.float32(0.0), np.float32(0.0), np.float32(0.0), np.float32(1.0), np.float32(0.0), np.float32(0.0), np.float32(1.0), np.float32(0.0), np.float32(0.0), np.float32(0.0)]",3.0,99192.5,31
2025-08-14_08-18-36,8810,"[np.float32(0.0), np.float32(1.0), np.float32(0.0), np.float32(0.0), np.float32(1.0), np.float32(1.0), np.float32(0.0), np.float32(0.0), np.float32(0.0), np.float32(0.0), np.float32(1.0), np.float32(0.0), np.float32(0.0), np.float32(0.0), np.float32(1.0), np.float32(0.0)]",-1.0,99191.5,22
2025-08-14_08-18-36,8811,"[np.float32(1.0), np.float32(1.0), np.float32(1.0), np.float32(0.0), np.float32(1.0), np.float32(1.0), np.float32(1.0), np.float32(1.0), np.float32(0.0), np.float32(0.0), np.float32(1.0), np.float32(1.0), np.float32(1.0), np.float32(1.0), np.float32(0.0), np.float32(1.0)]",0.0,99191.5,32
2025-08-14_08-18-36,8812,"[np.float32(0.0), np.float32(1.0), np.float32(1.0), np.float32(1.0), np.float32(0.0), np.float32(1.0), np.float32(1.0), np.float32(1.0), np.float32(1.0), np.float32(0.0), np.float32(0.0), np.float32(1.0), np.float32(1.0), np.float32(0.0), np.float32(1.0), np.float32(1.0)]",1.0,99192.5,31
2025-08-14_08-18-36,8813,"[np.float32(0.0), np.float32(1.0), np.float32(0.0), np.float32(1.0), np.float32(1.0), np.float32(0.0), np.float32(0.0), np.float32(0.0), np.float32(1.0), np.float32(0.0), np.float32(0.0), np.float32(0.0), np.float32(0.0), np.float32(1.0), np.float32(0.0), np.float32(0.0)]",3.0,99195.5,26
2025-08-14_08-18-36,8814,"[np.float32(1.0), np.float32(1.0), np.float32(0.0), np.float32(1.0), np.float32(0.0), np.float32(1.0), np.float32(0.0), np.float32(1.0), np.float32(1.0), np.float32(1.0), np.float32(1.0), np.float32(1.0), np.float32(1.0), np.float32(1.0), np.float32(0.0), np.float32(1.0)]",-1.0,99194.5,18
2025-08-14_08-18-36,8815,"[np.float32(0.0), np.float32(0.0), np.float32(0.0), np.float32(0.0), np.float32(0.0), np.float32(1.0), np.float32(0.0), np.float32(1.0), np.float32(1.0), np.float32(0.0), np.float32(1.0), np.float32(0.0), np.float32(1.0), np.float32(1.0), np.float32(0.0), np.float32(0.0)]",2.0,99196.5,19
2025-08-14_08-18-36,8816,"[np.float32(1.0), np.float32(1.0), np.float32(0.0), np.float32(1.0), np.float32(1.0), np.float32(1.0), np.float32(1.0), np.float32(0.0), np.float32(0.0), np.float32(1.0), np.float32(0.0), np.float32(0.0), np.float32(0.0), np.float32(1.0), np.float32(1.0), np.float32(0.0)]",1.0,99197.5,12
2025-08-14_08-18-36,8817,"[np.float32(1.0), np.float32(0.0), np.float32(0.0), np.float32(0.0), np.float32(1.0), np.float32(0.0), np.float32(0.0), np.float32(1.0), np.float32(0.0), np.float32(1.0), np.float32(0.0), np.float32(1.0), np.float32(1.0), np.float32(1.0), np.float32(0.0), np.float32(0.0)]",-2.0,99195.5,32
2025-08-14_08-18-36,8818,"[np.float32(1.0), np.float32(0.0), np.float32(0.0), np.float32(0.0), np.float32(0.0), np.float32(1.0), np.float32(0.0), np.float32(0.0), np.float32(0.0), np.float32(0.0), np.float32(0.0), np.float32(0.0), np.float32(0.0), np.float32(0.0), np.float32(0.0), np.float32(1.0)]",-1.0,99194.5,26
2025-08-14_08-18-36,8819,"[np.float32(0.0), np.float32(0.0), np.float32(0.0), np.float32(0.0), np.float32(1.0), np.float32(0.0), np.float32(0.0), np.float32(1.0), np.float32(1.0), np.float32(0.0), np.float32(1.0), np.float32(0.0), np.float32(1.0), np.float32(1.0), np.float32(0.0), np.float32(0.0)]",0.0,99194.5,25
2025-08-14_08-18-36,8820,"[np.float32(0.0), np.float32(1.0), np.float32(1.0), np.float32(1.0), np.float32(1.0), np.float32(1.0), np.float32(0.0), np.float32(1.0), np.float32(1.0), np.float32(0.0), np.float32(1.0), np.float32(0.0), np.float32(1.0), np.float32(1.0), np.float32(0.0), np.float32(1.0)]",-1.0,99193.5,19
2025-08-14_08-18-36,8821,"[np.float32(1.0), np.float32(1.0), np.float32(1.0), np.float32(1.0), np.float32(1.0), np.float32(1.0), np.float32(0.0), np.float32(1.0), np.float32(1.0), np.float32(0.0), np.float32(1.0), np.float32(1.0), np.float32(0.0), np.float32(0.0), np.float32(1.0), np.float32(0.0)]",1.0,99194.5,15
2025-08-14_08-18-36,8822,"[np.float32(0.0), np.float32(1.0), np.float32(0.0), np.float32(1.0), np.float32(0.0), np.float32(1.0), np.float32(0.0), np.float32(0.0), np.float32(0.0), np.float32(0.0), np.float32(1.0), np.float32(1.0), np.float32(0.0), np.float32(1.0), np.float32(0.0), np.float32(0.0)]",4.0,99198.5,26
2025-08-14_08-18-36,8823,"[np.float32(0.0), np.float32(0.0), np.float32(0.0), np.float32(0.0), np.float32(0.0), np.float32(0.0), np.float32(1.0), np.float32(1.0), np.float32(1.0), np.float32(0.0), np.float32(0.0), np.float32(0.0), np.float32(1.0), np.float32(0.0), np.float32(0.0), np.float32(1.0)]",1.0,99199.5,31
2025-08-14_08-18-36,8824,"[np.float32(0.0), np.float32(0.0), np.float32(0.0), np.float32(1.0), np.float32(0.0), np.float32(0.0), np.float32(1.0), np.float32(1.0), np.float32(0.0), np.float32(0.0), np.float32(1.0), np.float32(0.0), np.float32(1.0), np.float32(1.0), np.float32(0.0), np.float32(1.0)]",-4.0,99195.5,16
2025-08-14_08-18-36,8825,"[np.float32(0.0), np.float32(1.0), np.float32(1.0), np.float32(0.0), np.float32(0.0), np.float32(1.0), np.float32(0.0), np.float32(1.0), np.float32(1.0), np.float32(0.0), np.float32(1.0), np.float32(1.0), np.float32(1.0), np.float32(1.0), np.float32(0.0), np.float32(1.0)]",1.0,99196.5,21
2025-08-14_08-18-36,8826,"[np.float32(0.0), np.float32(1.0), np.float32(0.0), np.float32(1.0), np.float32(0.0), np.float32(1.0), np.float32(0.0), np.float32(1.0), np.float32(1.0), np.float32(0.0), np.float32(0.0), np.float32(1.0), np.float32(1.0), np.float32(1.0), np.float32(0.0), np.float32(0.0)]",-1.0,99195.5,20
2025-08-14_08-18-36,8827,"[np.float32(1.0), np.float32(0.0), np.float32(0.0), np.float32(1.0), np.float32(0.0), np.float32(1.0), np.float32(1.0), np.float32(1.0), np.float32(0.0), np.float32(1.0), np.float32(0.0), np.float32(0.0), np.float32(1.0), np.float32(1.0), np.float32(0.0), np.float32(0.0)]",0.0,99195.5,15
2025-08-14_08-18-36,8828,"[np.float32(0.0), np.float32(0.0), np.float32(0.0), np.float32(0.0), np.float32(0.0), np.float32(1.0), np.float32(0.0), np.float32(1.0), np.float32(1.0), np.float32(0.0), np.float32(0.0), np.float32(1.0), np.float32(0.0), np.float32(0.0), np.float32(0.0), np.float32(1.0)]",-3.0,99192.5,0
2025-08-14_08-18-36,8829,"[np.float32(0.0), np.float32(1.0), np.float32(0.0), np.float32(0.0), np.float32(0.0), np.float32(1.0), np.float32(1.0), np.float32(1.0), np.float32(1.0), np.float32(0.0), np.float32(0.0), np.float32(0.0), np.float32(1.0), np.float32(1.0), np.float32(0.0), np.float32(0.0)]",-4.0,99188.5,9
2025-08-14_08-18-36,8830,"[np.float32(1.0), np.float32(1.0), np.float32(1.0), np.float32(0.0), np.float32(1.0), np.float32(0.0), np.float32(0.0), np.float32(1.0), np.float32(0.0), np.float32(0.0), np.float32(0.0), np.float32(1.0), np.float32(1.0), np.float32(0.0), np.float32(0.0), np.float32(1.0)]",-3.0,99185.5,19
2025-08-14_08-18-36,8831,"[np.float32(1.0), np.float32(1.0), np.float32(1.0), np.float32(1.0), np.float32(0.0), np.float32(1.0), np.float32(0.0), np.float32(0.0), np.float32(0.0), np.float32(0.0), np.float32(1.0), np.float32(0.0), np.float32(0.0), np.float32(1.0), np.float32(0.0), np.float32(0.0)]",-3.0,99182.5,9
2025-08-14_08-18-36,8832,"[np.float32(0.0), np.float32(1.0), np.float32(0.0), np.float32(0.0), np.float32(1.0), np.float32(1.0), np.float32(0.0), np.float32(1.0), np.float32(1.0), np.float32(0.0), np.float32(1.0), np.float32(0.0), np.float32(1.0), np.float32(1.0), np.float32(1.0), np.float32(0.0)]",1.0,99183.5,13
2025-08-14_08-18-36,8833,"[np.float32(1.0), np.float32(1.0), np.float32(0.0), np.float32(0.0), np.float32(1.0), np.float32(0.0), np.float32(1.0), np.float32(0.0), np.float32(1.0), np.float32(0.0), np.float32(1.0), np.float32(1.0), np.float32(1.0), np.float32(1.0), np.float32(1.0), np.float32(0.0)]",-3.0,99180.5,13
2025-08-14_08-18-36,8834,"[np.float32(0.0), np.float32(0.0), np.float32(1.0), np.float32(1.0), np.float32(0.0), np.float32(1.0), np.float32(0.0), np.float32(1.0), np.float32(1.0), np.float32(0.0), np.float32(0.0), np.float32(0.0), np.float32(1.0), np.float32(1.0), np.float32(1.0), np.float32(0.0)]",2.0,99182.5,24
2025-08-14_08-18-36,8835,"[np.float32(1.0), np.float32(0.0), np.float32(1.0), np.float32(0.0), np.float32(0.0), np.float32(1.0), np.float32(1.0), np.float32(0.0), np.float32(0.0), np.float32(0.0), np.float32(1.0), np.float32(1.0), np.float32(1.0), np.float32(0.0), np.float32(1.0), np.float32(1.0)]",-6.0,99176.5,15
2025-08-14_08-18-36,8836,"[np.float32(0.0), np.float32(0.0), np.float32(1.0), np.float32(0.0), np.float32(1.0), np.float32(1.0), np.float32(0.0), np.float32(1.0), np.float32(1.0), np.float32(0.0), np.float32(0.0), np.float32(1.0), np.float32(1.0), np.float32(0.0), np.float32(0.0), np.float32(0.0)]",-2.0,99174.5,17
2025-08-14_08-18-36,8837,"[np.float32(0.0), np.float32(0.0), np.float32(1.0), np.float32(0.0), np.float32(0.0), np.float32(1.0), np.float32(1.0), np.float32(0.0), np.float32(0.0), np.float32(1.0), np.float32(1.0), np.float32(1.0), np.float32(0.0), np.float32(0.0), np.float32(0.0), np.float32(1.0)]",0.0,99174.5,36
2025-08-14_08-18-36,8838,"[np.float32(0.0), np.float32(1.0), np.float32(0.0), np.float32(1.0), np.float32(1.0), np.float32(0.0), np.float32(0.0), np.float32(1.0), np.float32(1.0), np.float32(1.0), np.float32(1.0), np.float32(0.0), np.float32(0.0), np.float32(1.0), np.float32(1.0), np.float32(0.0)]",-5.0,99169.5,6
2025-08-14_08-18-36,8839,"[np.float32(0.0), np.float32(1.0), np.float32(1.0), np.float32(0.0), np.float32(0.0), np.float32(0.0), np.float32(1.0), np.float32(1.0), np.float32(1.0), np.float32(0.0), np.float32(0.0), np.float32(0.0), np.float32(0.0), np.float32(0.0), np.float32(0.0), np.float32(1.0)]",-1.0,99168.5,16
2025-08-14_08-18-36,8840,"[np.float32(0.0), np.float32(1.0), np.float32(0.0), np.float32(0.0), np.float32(0.0), np.float32(0.0), np.float32(0.0), np.float32(1.0), np.float32(1.0), np.float32(1.0), np.float32(0.0), np.float32(0.0), np.float32(1.0), np.float32(1.0), np.float32(0.0), np.float32(0.0)]",2.0,99170.5,15
2025-08-14_08-18-36,8841,"[np.float32(0.0), np.float32(1.0), np.float32(1.0), np.float32(1.0), np.float32(0.0), np.float32(0.0), np.float32(1.0), np.float32(1.0), np.float32(1.0), np.float32(0.0), np.float32(0.0), np.float32(1.0), np.float32(0.0), np.float32(0.0), np.float32(0.0), np.float32(1.0)]",0.0,99170.5,14
2025-08-14_08-18-36,8842,"[np.float32(1.0), np.float32(0.0), np.float32(1.0), np.float32(1.0), np.float32(1.0), np.float32(1.0), np.float32(0.0), np.float32(1.0), np.float32(0.0), np.float32(1.0), np.float32(1.0), np.float32(0.0), np.float32(1.0), np.float32(1.0), np.float32(0.0), np.float32(1.0)]",1.0,99171.5,21
2025-08-14_08-18-36,8843,"[np.float32(0.0), np.float32(1.0), np.float32(0.0), np.float32(0.0), np.float32(0.0), np.float32(0.0), np.float32(0.0), np.float32(0.0), np.float32(0.0), np.float32(0.0), np.float32(1.0), np.float32(1.0), np.float32(1.0), np.float32(0.0), np.float32(0.0), np.float32(1.0)]",-5.0,99166.5,25
2025-08-14_08-18-36,8844,"[np.float32(0.0), np.float32(0.0), np.float32(0.0), np.float32(0.0), np.float32(1.0), np.float32(1.0), np.float32(0.0), np.float32(1.0), np.float32(0.0), np.float32(0.0), np.float32(1.0), np.float32(1.0), np.float32(1.0), np.float32(0.0), np.float32(0.0), np.float32(0.0)]",-4.0,99162.5,28
2025-08-14_08-18-36,8845,"[np.float32(1.0), np.float32(0.0), np.float32(0.0), np.float32(0.0), np.float32(1.0), np.float32(0.0), np.float32(1.0), np.float32(1.0), np.float32(1.0), np.float32(1.0), np.float32(1.0), np.float32(0.0), np.float32(1.0), np.float32(0.0), np.float32(0.0), np.float32(1.0)]",1.0,99163.5,16
2025-08-14_08-18-36,8846,"[np.float32(0.0), np.float32(1.0), np.float32(1.0), np.float32(0.0), np.float32(0.0), np.float32(1.0), np.float32(0.0), np.float32(0.0), np.float32(0.0), np.float32(1.0), np.float32(1.0), np.float32(0.0), np.float32(1.0), np.float32(0.0), np.float32(1.0), np.float32(1.0)]",-8.0,99155.5,3
2025-08-14_08-18-36,8847,"[np.float32(1.0), np.float32(1.0), np.float32(0.0), np.float32(1.0), np.float32(1.0), np.float32(0.0), np.float32(0.0), np.float32(1.0), np.float32(0.0), np.float32(0.0), np.float32(0.0), np.float32(1.0), np.float32(0.0), np.float32(0.0), np.float32(0.0), np.float32(1.0)]",0.0,99155.5,16
2025-08-14_08-18-36,8848,"[np.float32(0.0), np.float32(1.0), np.float32(0.0), np.float32(0.0), np.float32(0.0), np.float32(0.0), np.float32(1.0), np.float32(1.0), np.float32(0.0), np.float32(0.0), np.float32(0.0), np.float32(1.0), np.float32(0.0), np.float32(1.0), np.float32(1.0), np.float32(1.0)]",1.0,99156.5,10
2025-08-14_08-18-36,8849,"[np.float32(1.0), np.float32(1.0), np.float32(0.0), np.float32(1.0), np.float32(1.0), np.float32(1.0), np.float32(1.0), np.float32(1.0), np.float32(1.0), np.float32(1.0), np.float32(0.0), np.float32(0.0), np.float32(0.0), np.float32(0.0), np.float32(0.0), np.float32(0.0)]",0.0,99156.5,27
2025-08-14_08-18-36,8850,"[np.float32(0.0), np.float32(1.0), np.float32(0.0), np.float32(0.0), np.float32(0.0), np.float32(1.0), np.float32(1.0), np.float32(1.0), np.float32(0.0), np.float32(0.0), np.float32(1.0), np.float32(1.0), np.float32(1.0), np.float32(1.0), np.float32(0.0), np.float32(0.0)]",0.0,99156.5,11
2025-08-14_08-18-36,8851,"[np.float32(1.0), np.float32(0.0), np.float32(1.0), np.float32(1.0), np.float32(0.0), np.float32(0.0), np.float32(0.0), np.float32(0.0), np.float32(1.0), np.float32(1.0), np.float32(1.0), np.float32(1.0), np.float32(1.0), np.float32(1.0), np.float32(0.0), np.float32(0.0)]",-1.0,99155.5,15
2025-08-14_08-18-36,8852,"[np.float32(0.0), np.float32(1.0), np.float32(0.0), np.float32(0.0), np.float32(0.0), np.float32(0.0), np.float32(1.0), np.float32(0.0), np.float32(0.0), np.float32(0.0), np.float32(0.0), np.float32(0.0), np.float32(1.0), np.float32(1.0), np.float32(0.0), np.float32(0.0)]",-1.0,99154.5,32
2025-08-14_08-18-36,8853,"[np.float32(1.0), np.float32(1.0), np.float32(0.0), np.float32(1.0), np.float32(0.0), np.float32(0.0), np.float32(0.0), np.float32(1.0), np.float32(0.0), np.float32(1.0), np.float32(0.0), np.float32(1.0), np.float32(1.0), np.float32(0.0), np.float32(1.0), np.float32(1.0)]",1.0,99155.5,31
2025-08-14_08-18-36,8854,"[np.float32(1.0), np.float32(0.0), np.float32(0.0), np.float32(0.0), np.float32(0.0), np.float32(0.0), np.float32(0.0), np.float32(1.0), np.float32(1.0), np.float32(0.0), np.float32(1.0), np.float32(1.0), np.float32(1.0), np.float32(1.0), np.float32(0.0), np.float32(0.0)]",-7.0,99148.5,10
2025-08-14_08-18-36,8855,"[np.float32(0.0), np.float32(1.0), np.float32(0.0), np.float32(1.0), np.float32(0.0), np.float32(1.0), np.float32(1.0), np.float32(1.0), np.float32(0.0), np.float32(0.0), np.float32(0.0), np.float32(0.0), np.float32(1.0), np.float32(0.0), np.float32(0.0), np.float32(1.0)]",1.0,99149.5,9
2025-08-14_08-18-36,8856,"[np.float32(0.0), np.float32(0.0), np.float32(1.0), np.float32(0.0), np.float32(0.0), np.float32(0.0), np.float32(1.0), np.float32(1.0), np.float32(0.0), np.float32(0.0), np.float32(0.0), np.float32(1.0), np.float32(1.0), np.float32(1.0), np.float32(1.0), np.float32(0.0)]",1.0,99150.5,36
2025-08-14_08-18-36,8857,"[np.float32(0.0), np.float32(1.0), np.float32(1.0), np.float32(1.0), np.float32(0.0), np.float32(1.0), np.float32(0.0), np.float32(0.0), np.float32(1.0), np.float32(1.0), np.float32(0.0), np.float32(0.0), np.float32(0.0), np.float32(1.0), np.float32(1.0), np.float32(0.0)]",-1.0,99149.5,11
2025-08-14_08-18-36,8858,"[np.float32(0.0), np.float32(0.0), np.float32(0.0), np.float32(1.0), np.float32(1.0), np.float32(1.0), np.float32(0.0), np.float32(1.0), np.float32(0.0), np.float32(0.0), np.float32(1.0), np.float32(1.0), np.float32(0.0), np.float32(1.0), np.float32(0.0), np.float32(1.0)]",-1.0,99148.5,5
2025-08-14_08-18-36,8859,"[np.float32(1.0), np.float32(1.0), np.float32(0.0), np.float32(1.0), np.float32(0.0), np.float32(1.0), np.float32(0.0), np.float32(0.0), np.float32(1.0), np.float32(1.0), np.float32(0.0), np.float32(0.0), np.float32(1.0), np.float32(0.0), np.float32(0.0), np.float32(1.0)]",-6.0,99142.5,12
2025-08-14_08-18-36,8860,"[np.float32(1.0), np.float32(0.0), np.float32(0.0), np.float32(0.0), np.float32(1.0), np.float32(0.0), np.float32(0.0), np.float32(1.0), np.float32(0.0), np.float32(0.0), np.float32(1.0), np.float32(1.0), np.float32(1.0), np.float32(0.0), np.float32(0.0), np.float32(0.0)]",-1.0,99141.5,11
2025-08-14_08-18-36,8861,"[np.float32(0.0), np.float32(1.0), np.float32(0.0), np.float32(1.0), np.float32(0.0), np.float32(0.0), np.float32(0.0), np.float32(1.0), np.float32(0.0), np.float32(0.0), np.float32(0.0), np.float32(1.0), np.float32(0.0), np.float32(1.0), np.float32(0.0), np.float32(0.0)]",-3.0,99138.5,10
2025-08-14_08-18-36,8862,"[np.float32(1.0), np.float32(0.0), np.float32(1.0), np.float32(1.0), np.float32(0.0), np.float32(1.0), np.float32(0.0), np.float32(0.0), np.float32(1.0), np.float32(0.0), np.float32(0.0), np.float32(0.0), np.float32(1.0), np.float32(1.0), np.float32(0.0), np.float32(1.0)]",-4.0,99134.5,5
2025-08-14_08-18-36,8863,"[np.float32(0.0), np.float32(0.0), np.float32(0.0), np.float32(1.0), np.float32(0.0), np.float32(1.0), np.float32(0.0), np.float32(1.0), np.float32(0.0), np.float32(1.0), np.float32(0.0), np.float32(0.0), np.float32(1.0), np.float32(1.0), np.float32(1.0), np.float32(1.0)]",-3.0,99131.5,30
2025-08-14_08-18-36,8864,"[np.float32(1.0), np.float32(1.0), np.float32(1.0), np.float32(0.0), np.float32(0.0), np.float32(1.0), np.float32(1.0), np.float32(0.0), np.float32(0.0), np.float32(0.0), np.float32(0.0), np.float32(1.0), np.float32(1.0), np.float32(0.0), np.float32(0.0), np.float32(1.0)]",-1.0,99130.5,10
2025-08-14_08-18-36,8865,"[np.float32(0.0), np.float32(1.0), np.float32(1.0), np.float32(0.0), np.float32(1.0), np.float32(1.0), np.float32(1.0), np.float32(1.0), np.float32(1.0), np.float32(0.0), np.float32(0.0), np.float32(1.0), np.float32(1.0), np.float32(1.0), np.float32(1.0), np.float32(1.0)]",0.0,99130.5,28
2025-08-14_08-18-36,8866,"[np.float32(1.0), np.float32(1.0), np.float32(0.0), np.float32(0.0), np.float32(1.0), np.float32(1.0), np.float32(1.0), np.float32(1.0), np.float32(0.0), np.float32(0.0), np.float32(1.0), np.float32(1.0), np.float32(1.0), np.float32(0.0), np.float32(0.0), np.float32(0.0)]",-5.0,99125.5,28
2025-08-14_08-18-36,8867,"[np.float32(0.0), np.float32(1.0), np.float32(1.0), np.float32(1.0), np.float32(1.0), np.float32(1.0), np.float32(0.0), np.float32(0.0), np.float32(1.0), np.float32(1.0), np.float32(0.0), np.float32(0.0), np.float32(0.0), np.float32(1.0), np.float32(0.0), np.float32(0.0)]",1.0,99126.5,33
2025-08-14_08-18-36,8868,"[np.float32(0.0), np.float32(0.0), np.float32(0.0), np.float32(0.0), np.float32(0.0), np.float32(0.0), np.float32(0.0), np.float32(1.0), np.float32(1.0), np.float32(1.0), np.float32(1.0), np.float32(1.0), np.float32(1.0), np.float32(1.0), np.float32(1.0), np.float32(0.0)]",1.0,99127.5,24
2025-08-14_08-18-36,8869,"[np.float32(0.0), np.float32(1.0), np.float32(1.0), np.float32(0.0), np.float32(0.0), np.float32(1.0), np.float32(1.0), np.float32(0.0), np.float32(1.0), np.float32(0.0), np.float32(0.0), np.float32(1.0), np.float32(0.0), np.float32(1.0), np.float32(1.0), np.float32(0.0)]",0.0,99127.5,25
2025-08-14_08-18-36,8870,"[np.float32(1.0), np.float32(1.0), np.float32(1.0), np.float32(0.0), np.float32(1.0), np.float32(1.0), np.float32(1.0), np.float32(1.0), np.float32(0.0), np.float32(0.0), np.float32(1.0), np.float32(0.0), np.float32(0.0), np.float32(0.0), np.float32(0.0), np.float32(0.0)]",-1.0,99126.5,1
2025-08-14_08-18-36,8871,"[np.float32(0.0), np.float32(0.0), np.float32(0.0), np.float32(0.0), np.float32(0.0), np.float32(1.0), np.float32(1.0), np.float32(1.0), np.float32(1.0), np.float32(1.0), np.float32(1.0), np.float32(0.0), np.float32(0.0), np.float32(0.0), np.float32(0.0), np.float32(0.0)]",-4.0,99122.5,0
2025-08-14_08-18-36,8872,"[np.float32(0.0), np.float32(0.0), np.float32(0.0), np.float32(0.0), np.float32(0.0), np.float32(1.0), np.float32(1.0), np.float32(0.0), np.float32(1.0), np.float32(0.0), np.float32(1.0), np.float32(1.0), np.float32(1.0), np.float32(1.0), np.float32(0.0), np.float32(0.0)]",35.0,99157.5,7
2025-08-14_08-18-36,8873,"[np.float32(0.0), np.float32(1.0), np.float32(1.0), np.float32(1.0), np.float32(0.0), np.float32(0.0), np.float32(0.0), np.float32(0.0), np.float32(1.0), np.float32(1.0), np.float32(0.0), np.float32(1.0), np.float32(0.0), np.float32(0.0), np.float32(0.0), np.float32(0.0)]",-2.0,99155.5,20
2025-08-14_08-18-36,8874,"[np.float32(0.0), np.float32(1.0), np.float32(0.0), np.float32(1.0), np.float32(1.0), np.float32(1.0), np.float32(0.0), np.float32(1.0), np.float32(0.0), np.float32(0.0), np.float32(1.0), np.float32(1.0), np.float32(1.0), np.float32(1.0), np.float32(0.0), np.float32(1.0)]",0.0,99155.5,26
2025-08-14_08-18-36,8875,"[np.float32(0.0), np.float32(0.0), np.float32(0.0), np.float32(0.0), np.float32(0.0), np.float32(1.0), np.float32(1.0), np.float32(0.0), np.float32(0.0), np.float32(1.0), np.float32(1.0), np.float32(1.0), np.float32(0.0), np.float32(0.0), np.float32(0.0), np.float32(0.0)]",0.0,99155.5,26
2025-08-14_08-18-36,8876,"[np.float32(0.0), np.float32(0.0), np.float32(0.0), np.float32(1.0), np.float32(0.0), np.float32(1.0), np.float32(1.0), np.float32(0.0), np.float32(0.0), np.float32(0.0), np.float32(0.0), np.float32(0.0), np.float32(0.0), np.float32(0.0), np.float32(0.0), np.float32(0.0)]",0.0,99155.5,6
2025-08-14_08-18-36,8877,"[np.float32(0.0), np.float32(1.0), np.float32(1.0), np.float32(0.0), np.float32(0.0), np.float32(0.0), np.float32(0.0), np.float32(1.0), np.float32(1.0), np.float32(0.0), np.float32(1.0), np.float32(0.0), np.float32(1.0), np.float32(0.0), np.float32(0.0), np.float32(1.0)]",-7.0,99148.5,3
2025-08-14_08-18-36,8878,"[np.float32(0.0), np.float32(0.0), np.float32(1.0), np.float32(0.0), np.float32(0.0), np.float32(1.0), np.float32(0.0), np.float32(1.0), np.float32(0.0), np.float32(0.0), np.float32(0.0), np.float32(0.0), np.float32(0.0), np.float32(1.0), np.float32(0.0), np.float32(1.0)]",2.0,99150.5,24
2025-08-14_08-18-36,8879,"[np.float32(1.0), np.float32(0.0), np.float32(0.0), np.float32(1.0), np.float32(0.0), np.float32(0.0), np.float32(1.0), np.float32(1.0), np.float32(0.0), np.float32(0.0), np.float32(0.0), np.float32(1.0), np.float32(1.0), np.float32(1.0), np.float32(1.0), np.float32(1.0)]",0.0,99150.5,6
2025-08-14_08-18-36,8880,"[np.float32(1.0), np.float32(1.0), np.float32(1.0), np.float32(1.0), np.float32(0.0), np.float32(1.0), np.float32(1.0), np.float32(0.0), np.float32(0.0), np.float32(0.0), np.float32(1.0), np.float32(0.0), np.float32(1.0), np.float32(1.0), np.float32(1.0), np.float32(0.0)]",-1.0,99149.5,22
2025-08-14_08-18-36,8881,"[np.float32(0.0), np.float32(0.0), np.float32(1.0), np.float32(0.0), np.float32(0.0), np.float32(0.0), np.float32(1.0), np.float32(1.0), np.float32(0.0), np.float32(0.0), np.float32(0.0), np.float32(0.0), np.float32(1.0), np.float32(0.0), np.float32(0.0), np.float32(1.0)]",-5.0,99144.5,29
2025-08-14_08-18-36,8882,"[np.float32(1.0), np.float32(1.0), np.float32(1.0), np.float32(1.0), np.float32(0.0), np.float32(0.0), np.float32(0.0), np.float32(1.0), np.float32(1.0), np.float32(0.0), np.float32(0.0), np.float32(0.0), np.float32(0.0), np.float32(0.0), np.float32(1.0), np.float32(1.0)]",2.0,99146.5,27
2025-08-14_08-18-36,8883,"[np.float32(1.0), np.float32(1.0), np.float32(1.0), np.float32(1.0), np.float32(0.0), np.float32(0.0), np.float32(1.0), np.float32(1.0), np.float32(0.0), np.float32(0.0), np.float32(0.0), np.float32(0.0), np.float32(0.0), np.float32(1.0), np.float32(0.0), np.float32(0.0)]",3.0,99149.5,22
2025-08-14_08-18-36,8884,"[np.float32(0.0), np.float32(0.0), np.float32(0.0), np.float32(0.0), np.float32(1.0), np.float32(1.0), np.float32(0.0), np.float32(1.0), np.float32(0.0), np.float32(1.0), np.float32(0.0), np.float32(0.0), np.float32(0.0), np.float32(1.0), np.float32(0.0), np.float32(0.0)]",3.0,99152.5,4
2025-08-14_08-18-36,8885,"[np.float32(1.0), np.float32(0.0), np.float32(0.0), np.float32(1.0), np.float32(1.0), np.float32(1.0), np.float32(1.0), np.float32(1.0), np.float32(0.0), np.float32(0.0), np.float32(1.0), np.float32(1.0), np.float32(1.0), np.float32(1.0), np.float32(0.0), np.float32(0.0)]",3.0,99155.5,18
2025-08-14_08-18-36,8886,"[np.float32(1.0), np.float32(1.0), np.float32(0.0), np.float32(0.0), np.float32(0.0), np.float32(1.0), np.float32(1.0), np.float32(1.0), np.float32(1.0), np.float32(0.0), np.float32(0.0), np.float32(1.0), np.float32(0.0), np.float32(1.0), np.float32(0.0), np.float32(0.0)]",2.0,99157.5,36
2025-08-14_08-18-36,8887,"[np.float32(0.0), np.float32(0.0), np.float32(0.0), np.float32(0.0), np.float32(0.0), np.float32(0.0), np.float32(1.0), np.float32(1.0), np.float32(0.0), np.float32(0.0), np.float32(0.0), np.float32(0.0), np.float32(1.0), np.float32(1.0), np.float32(0.0), np.float32(1.0)]",1.0,99158.5,6
2025-08-14_08-18-36,8888,"[np.float32(0.0), np.float32(1.0), np.float32(0.0), np.float32(1.0), np.float32(0.0), np.float32(1.0), np.float32(0.0), np.float32(1.0), np.float32(1.0), np.float32(0.0), np.float32(0.0), np.float32(0.0), np.float32(1.0), np.float32(1.0), np.float32(0.0), np.float32(0.0)]",3.0,99161.5,28
2025-08-14_08-18-36,8889,"[np.float32(1.0), np.float32(0.0), np.float32(1.0), np.float32(0.0), np.float32(0.0), np.float32(0.0), np.float32(1.0), np.float32(1.0), np.float32(1.0), np.float32(0.0), np.float32(0.0), np.float32(0.0), np.float32(1.0), np.float32(0.0), np.float32(0.0), np.float32(1.0)]",0.0,99161.5,16
2025-08-14_08-18-36,8890,"[np.float32(1.0), np.float32(1.0), np.float32(1.0), np.float32(0.0), np.float32(0.0), np.float32(1.0), np.float32(0.0), np.float32(1.0), np.float32(1.0), np.float32(0.0), np.float32(0.0), np.float32(0.0), np.float32(1.0), np.float32(0.0), np.float32(0.0), np.float32(1.0)]",-6.0,99155.5,11
2025-08-14_08-18-36,8891,"[np.float32(1.0), np.float32(1.0), np.float32(0.0), np.float32(0.0), np.float32(0.0), np.float32(1.0), np.float32(1.0), np.float32(1.0), np.float32(0.0), np.float32(0.0), np.float32(0.0), np.float32(0.0), np.float32(1.0), np.float32(0.0), np.float32(1.0), np.float32(0.0)]",-3.0,99152.5,25
2025-08-14_08-18-36,8892,"[np.float32(1.0), np.float32(1.0), np.float32(1.0), np.float32(0.0), np.float32(0.0), np.float32(0.0), np.float32(1.0), np.float32(0.0), np.float32(1.0), np.float32(0.0), np.float32(1.0), np.float32(0.0), np.float32(0.0), np.float32(0.0), np.float32(1.0), np.float32(0.0)]",-3.0,99149.5,0
2025-08-14_08-18-36,8893,"[np.float32(0.0), np.float32(0.0), np.float32(0.0), np.float32(1.0), np.float32(1.0), np.float32(1.0), np.float32(1.0), np.float32(1.0), np.float32(1.0), np.float32(0.0), np.float32(0.0), np.float32(0.0), np.float32(0.0), np.float32(1.0), np.float32(1.0), np.float32(0.0)]",0.0,99149.5,36
2025-08-14_08-18-36,8894,"[np.float32(0.0), np.float32(1.0), np.float32(0.0), np.float32(1.0), np.float32(0.0), np.float32(0.0), np.float32(0.0), np.float32(0.0), np.float32(1.0), np.float32(0.0), np.float32(0.0), np.float32(0.0), np.float32(0.0), np.float32(0.0), np.float32(1.0), np.float32(1.0)]",5.0,99154.5,33
2025-08-14_08-18-36,8895,"[np.float32(0.0), np.float32(1.0), np.float32(1.0), np.float32(1.0), np.float32(0.0), np.float32(0.0), np.float32(0.0), np.float32(0.0), np.float32(1.0), np.float32(0.0), np.float32(0.0), np.float32(1.0), np.float32(1.0), np.float32(0.0), np.float32(1.0), np.float32(0.0)]",0.0,99154.5,8
2025-08-14_08-18-36,8896,"[np.float32(0.0), np.float32(1.0), np.float32(1.0), np.float32(0.0), np.float32(0.0), np.float32(0.0), np.float32(1.0), np.float32(1.0), np.float32(0.0), np.float32(0.0), np.float32(1.0), np.float32(1.0), np.float32(0.0), np.float32(1.0), np.float32(1.0), np.float32(1.0)]",-1.0,99153.5,16
2025-08-14_08-18-36,8897,"[np.float32(1.0), np.float32(0.0), np.float32(1.0), np.float32(1.0), np.float32(0.0), np.float32(0.0), np.float32(1.0), np.float32(1.0), np.float32(1.0), np.float32(0.0), np.float32(1.0), np.float32(1.0), np.float32(0.0), np.float32(0.0), np.float32(0.0), np.float32(0.0)]",-3.0,99150.5,10
2025-08-14_08-18-36,8898,"[np.float32(1.0), np.float32(0.0), np.float32(1.0), np.float32(0.0), np.float32(1.0), np.float32(1.0), np.float32(0.0), np.float32(1.0), np.float32(0.0), np.float32(1.0), np.float32(1.0), np.float32(1.0), np.float32(1.0), np.float32(1.0), np.float32(1.0), np.float32(1.0)]",-1.0,99149.5,15
2025-08-14_08-18-36,8899,"[np.float32(0.0), np.float32(0.0), np.float32(1.0), np.float32(0.0), np.float32(0.0), np.float32(0.0), np.float32(0.0), np.float32(0.0), np.float32(0.0), np.float32(0.0), np.float32(0.0), np.float32(0.0), np.float32(0.0), np.float32(0.0), np.float32(0.0), np.float32(1.0)]",1.0,99150.5,9
2025-08-14_08-18-36,8900,"[np.float32(0.0), np.float32(0.0), np.float32(0.0), np.float32(1.0), np.float32(1.0), np.float32(0.0), np.float32(1.0), np.float32(1.0), np.float32(1.0), np.float32(0.0), np.float32(0.0), np.float32(0.0), np.float32(0.0), np.float32(0.0), np.float32(0.0), np.float32(0.0)]",-2.0,99148.5,36
2025-08-14_08-18-36,8901,"[np.float32(0.0), np.float32(0.0), np.float32(0.0), np.float32(1.0), np.float32(1.0), np.float32(1.0), np.float32(1.0), np.float32(1.0), np.float32(1.0), np.float32(0.0), np.float32(0.0), np.float32(0.0), np.float32(0.0), np.float32(1.0), np.float32(1.0), np.float32(0.0)]",-1.0,99147.5,1
2025-08-14_08-18-36,8902,"[np.float32(1.0), np.float32(1.0), np.float32(1.0), np.float32(1.0), np.float32(0.0), np.float32(1.0), np.float32(1.0), np.float32(1.0), np.float32(1.0), np.float32(0.0), np.float32(0.0), np.float32(1.0), np.float32(0.0), np.float32(1.0), np.float32(1.0), np.float32(0.0)]",2.0,99149.5,18
2025-08-14_08-18-36,8903,"[np.float32(1.0), np.float32(0.0), np.float32(1.0), np.float32(0.0), np.float32(0.0), np.float32(0.0), np.float32(1.0), np.float32(0.0), np.float32(1.0), np.float32(0.0), np.float32(0.0), np.float32(0.0), np.float32(1.0), np.float32(0.0), np.float32(0.0), np.float32(0.0)]",-1.0,99148.5,18
2025-08-14_08-18-36,8904,"[np.float32(1.0), np.float32(1.0), np.float32(1.0), np.float32(1.0), np.float32(0.0), np.float32(0.0), np.float32(0.0), np.float32(1.0), np.float32(1.0), np.float32(1.0), np.float32(1.0), np.float32(1.0), np.float32(1.0), np.float32(1.0), np.float32(0.0), np.float32(0.0)]",-1.0,99147.5,23
2025-08-14_08-18-36,8905,"[np.float32(0.0), np.float32(1.0), np.float32(1.0), np.float32(0.0), np.float32(1.0), np.float32(1.0), np.float32(1.0), np.float32(1.0), np.float32(0.0), np.float32(0.0), np.float32(1.0), np.float32(0.0), np.float32(1.0), np.float32(1.0), np.float32(1.0), np.float32(1.0)]",-4.0,99143.5,34
2025-08-14_08-18-36,8906,"[np.float32(0.0), np.float32(0.0), np.float32(0.0), np.float32(0.0), np.float32(0.0), np.float32(0.0), np.float32(1.0), np.float32(1.0), np.float32(0.0), np.float32(1.0), np.float32(1.0), np.float32(1.0), np.float32(1.0), np.float32(0.0), np.float32(1.0), np.float32(1.0)]",-2.0,99141.5,2
2025-08-14_08-18-36,8907,"[np.float32(1.0), np.float32(0.0), np.float32(1.0), np.float32(0.0), np.float32(1.0), np.float32(1.0), np.float32(0.0), np.float32(1.0), np.float32(1.0), np.float32(0.0), np.float32(1.0), np.float32(1.0), np.float32(0.0), np.float32(1.0), np.float32(0.0), np.float32(1.0)]",2.0,99143.5,12
2025-08-14_08-18-36,8908,"[np.float32(0.0), np.float32(0.0), np.float32(1.0), np.float32(0.0), np.float32(0.0), np.float32(1.0), np.float32(1.0), np.float32(0.0), np.float32(1.0), np.float32(1.0), np.float32(0.0), np.float32(0.0), np.float32(1.0), np.float32(0.0), np.float32(1.0), np.float32(0.0)]",-2.0,99141.5,12
2025-08-14_08-18-36,8909,"[np.float32(0.0), np.float32(0.0), np.float32(1.0), np.float32(0.0), np.float32(1.0), np.float32(1.0), np.float32(0.0), np.float32(0.0), np.float32(0.0), np.float32(1.0), np.float32(1.0), np.float32(1.0), np.float32(1.0), np.float32(0.0), np.float32(1.0), np.float32(0.0)]",-3.0,99138.5,3
2025-08-14_08-18-36,8910,"[np.float32(1.0), np.float32(0.0), np.float32(1.0), np.float32(0.0), np.float32(0.0), np.float32(0.0), np.float32(0.0), np.float32(0.0), np.float32(1.0), np.float32(0.0), np.float32(0.0), np.float32(0.0), np.float32(0.0), np.float32(1.0), np.float32(0.0), np.float32(0.0)]",1.0,99139.5,21
2025-08-14_08-18-36,8911,"[np.float32(0.0), np.float32(1.0), np.float32(0.0), np.float32(0.0), np.float32(1.0), np.float32(1.0), np.float32(0.0), np.float32(0.0), np.float32(1.0), np.float32(0.0), np.float32(0.0), np.float32(1.0), np.float32(1.0), np.float32(0.0), np.float32(0.0), np.float32(0.0)]",2.0,99141.5,36
2025-08-14_08-18-36,8912,"[np.float32(0.0), np.float32(1.0), np.float32(0.0), np.float32(1.0), np.float32(1.0), np.float32(1.0), np.float32(1.0), np.float32(1.0), np.float32(1.0), np.float32(1.0), np.float32(1.0), np.float32(1.0), np.float32(1.0), np.float32(1.0), np.float32(1.0), np.float32(1.0)]",-1.0,99140.5,5
2025-08-14_08-18-36,8913,"[np.float32(0.0), np.float32(0.0), np.float32(1.0), np.float32(0.0), np.float32(0.0), np.float32(0.0), np.float32(1.0), np.float32(0.0), np.float32(0.0), np.float32(0.0), np.float32(0.0), np.float32(0.0), np.float32(1.0), np.float32(0.0), np.float32(0.0), np.float32(1.0)]",1.0,99141.5,2
2025-08-14_08-18-36,8914,"[np.float32(1.0), np.float32(1.0), np.float32(0.0), np.float32(1.0), np.float32(1.0), np.float32(0.0), np.float32(1.0), np.float32(0.0), np.float32(0.0), np.float32(1.0), np.float32(0.0), np.float32(1.0), np.float32(0.0), np.float32(1.0), np.float32(1.0), np.float32(0.0)]",1.0,99142.5,33
2025-08-14_08-18-36,8915,"[np.float32(0.0), np.float32(1.0), np.float32(1.0), np.float32(1.0), np.float32(0.0), np.float32(1.0), np.float32(0.0), np.float32(1.0), np.float32(0.0), np.float32(1.0), np.float32(1.0), np.float32(1.0), np.float32(1.0), np.float32(1.0), np.float32(0.0), np.float32(0.0)]",-5.0,99137.5,9
2025-08-14_08-18-36,8916,"[np.float32(1.0), np.float32(0.0), np.float32(1.0), np.float32(0.0), np.float32(1.0), np.float32(1.0), np.float32(1.0), np.float32(0.0), np.float32(0.0), np.float32(1.0), np.float32(0.0), np.float32(0.0), np.float32(0.0), np.float32(0.0), np.float32(0.0), np.float32(0.0)]",0.0,99137.5,30
2025-08-14_08-18-36,8917,"[np.float32(0.0), np.float32(1.0), np.float32(1.0), np.float32(0.0), np.float32(0.0), np.float32(1.0), np.float32(0.0), np.float32(1.0), np.float32(1.0), np.float32(0.0), np.float32(0.0), np.float32(1.0), np.float32(0.0), np.float32(0.0), np.float32(0.0), np.float32(0.0)]",3.0,99140.5,26
2025-08-14_08-18-36,8918,"[np.float32(1.0), np.float32(0.0), np.float32(0.0), np.float32(0.0), np.float32(1.0), np.float32(0.0), np.float32(1.0), np.float32(1.0), np.float32(1.0), np.float32(0.0), np.float32(1.0), np.float32(0.0), np.float32(1.0), np.float32(1.0), np.float32(0.0), np.float32(0.0)]",1.0,99141.5,26
2025-08-14_08-18-36,8919,"[np.float32(0.0), np.float32(0.0), np.float32(0.0), np.float32(1.0), np.float32(0.0), np.float32(1.0), np.float32(1.0), np.float32(1.0), np.float32(1.0), np.float32(0.0), np.float32(0.0), np.float32(1.0), np.float32(1.0), np.float32(0.0), np.float32(0.0), np.float32(0.0)]",1.0,99142.5,24
2025-08-14_08-18-36,8920,"[np.float32(0.0), np.float32(1.0), np.float32(0.0), np.float32(1.0), np.float32(0.0), np.float32(0.0), np.float32(1.0), np.float32(1.0), np.float32(1.0), np.float32(1.0), np.float32(1.0), np.float32(0.0), np.float32(0.0), np.float32(1.0), np.float32(0.0), np.float32(0.0)]",3.0,99145.5,4
2025-08-14_08-18-36,8921,"[np.float32(1.0), np.float32(1.0), np.float32(0.0), np.float32(0.0), np.float32(1.0), np.float32(1.0), np.float32(1.0), np.float32(1.0), np.float32(1.0), np.float32(0.0), np.float32(0.0), np.float32(0.0), np.float32(0.0), np.float32(1.0), np.float32(0.0), np.float32(1.0)]",1.0,99146.5,7
2025-08-14_08-18-36,8922,"[np.float32(1.0), np.float32(0.0), np.float32(0.0), np.float32(0.0), np.float32(1.0), np.float32(1.0), np.float32(1.0), np.float32(1.0), np.float32(1.0), np.float32(1.0), np.float32(1.0), np.float32(1.0), np.float32(1.0), np.float32(0.0), np.float32(0.0), np.float32(1.0)]",-3.0,99143.5,24
2025-08-14_08-18-36,8923,"[np.float32(1.0), np.float32(1.0), np.float32(1.0), np.float32(0.0), np.float32(0.0), np.float32(1.0), np.float32(1.0), np.float32(1.0), np.float32(1.0), np.float32(0.0), np.float32(1.0), np.float32(1.0), np.float32(0.0), np.float32(0.0), np.float32(0.0), np.float32(0.0)]",-2.0,99141.5,4
2025-08-14_08-18-36,8924,"[np.float32(0.0), np.float32(0.0), np.float32(0.0), np.float32(1.0), np.float32(0.0), np.float32(1.0), np.float32(1.0), np.float32(1.0), np.float32(1.0), np.float32(0.0), np.float32(0.0), np.float32(1.0), np.float32(0.0), np.float32(1.0), np.float32(1.0), np.float32(0.0)]",3.0,99144.5,30
2025-08-14_08-18-36,8925,"[np.float32(1.0), np.float32(1.0), np.float32(1.0), np.float32(0.0), np.float32(1.0), np.float32(1.0), np.float32(0.0), np.float32(1.0), np.float32(1.0), np.float32(0.0), np.float32(1.0), np.float32(0.0), np.float32(1.0), np.float32(1.0), np.float32(0.0), np.float32(0.0)]",0.0,99144.5,19
2025-08-14_08-18-36,8926,"[np.float32(0.0), np.float32(0.0), np.float32(0.0), np.float32(1.0), np.float32(1.0), np.float32(1.0), np.float32(1.0), np.float32(0.0), np.float32(1.0), np.float32(1.0), np.float32(1.0), np.float32(0.0), np.float32(0.0), np.float32(0.0), np.float32(1.0), np.float32(1.0)]",-1.0,99143.5,20
2025-08-14_08-18-36,8927,"[np.float32(0.0), np.float32(0.0), np.float32(0.0), np.float32(0.0), np.float32(1.0), np.float32(1.0), np.float32(1.0), np.float32(1.0), np.float32(1.0), np.float32(1.0), np.float32(0.0), np.float32(0.0), np.float32(1.0), np.float32(1.0), np.float32(1.0), np.float32(0.0)]",-4.0,99139.5,20
2025-08-14_08-18-36,8928,"[np.float32(0.0), np.float32(1.0), np.float32(0.0), np.float32(0.0), np.float32(0.0), np.float32(1.0), np.float32(1.0), np.float32(1.0), np.float32(1.0), np.float32(1.0), np.float32(0.0), np.float32(1.0), np.float32(1.0), np.float32(0.0), np.float32(0.0), np.float32(0.0)]",0.0,99139.5,15
2025-08-14_08-18-36,8929,"[np.float32(1.0), np.float32(1.0), np.float32(0.0), np.float32(0.0), np.float32(0.0), np.float32(0.0), np.float32(0.0), np.float32(1.0), np.float32(1.0), np.float32(0.0), np.float32(1.0), np.float32(1.0), np.float32(1.0), np.float32(1.0), np.float32(0.0), np.float32(0.0)]",3.0,99142.5,18
2025-08-14_08-18-36,8930,"[np.float32(0.0), np.float32(0.0), np.float32(1.0), np.float32(1.0), np.float32(0.0), np.float32(1.0), np.float32(1.0), np.float32(1.0), np.float32(1.0), np.float32(0.0), np.float32(1.0), np.float32(0.0), np.float32(1.0), np.float32(1.0), np.float32(1.0), np.float32(0.0)]",0.0,99142.5,21
2025-08-14_08-18-36,8931,"[np.float32(0.0), np.float32(1.0), np.float32(0.0), np.float32(0.0), np.float32(1.0), np.float32(0.0), np.float32(0.0), np.float32(1.0), np.float32(1.0), np.float32(1.0), np.float32(1.0), np.float32(0.0), np.float32(0.0), np.float32(1.0), np.float32(0.0), np.float32(0.0)]",0.0,99142.5,8
2025-08-14_08-18-36,8932,"[np.float32(0.0), np.float32(0.0), np.float32(0.0), np.float32(0.0), np.float32(0.0), np.float32(1.0), np.float32(1.0), np.float32(1.0), np.float32(0.0), np.float32(0.0), np.float32(0.0), np.float32(1.0), np.float32(0.0), np.float32(1.0), np.float32(0.0), np.float32(0.0)]",0.0,99142.5,25
2025-08-14_08-18-36,8933,"[np.float32(0.0), np.float32(1.0), np.float32(1.0), np.float32(0.0), np.float32(1.0), np.float32(0.0), np.float32(1.0), np.float32(0.0), np.float32(0.0), np.float32(1.0), np.float32(0.0), np.float32(0.0), np.float32(1.0), np.float32(0.0), np.float32(1.0), np.float32(0.0)]",5.0,99147.5,4
2025-08-14_08-18-36,8934,"[np.float32(0.0), np.float32(0.0), np.float32(1.0), np.float32(0.0), np.float32(1.0), np.float32(0.0), np.float32(1.0), np.float32(1.0), np.float32(0.0), np.float32(0.0), np.float32(0.0), np.float32(1.0), np.float32(0.0), np.float32(0.0), np.float32(0.0), np.float32(1.0)]",-4.0,99143.5,0
2025-08-14_08-18-36,8935,"[np.float32(0.0), np.float32(1.0), np.float32(1.0), np.float32(0.0), np.float32(0.0), np.float32(0.0), np.float32(0.0), np.float32(1.0), np.float32(1.0), np.float32(0.0), np.float32(0.0), np.float32(0.0), np.float32(1.0), np.float32(1.0), np.float32(0.0), np.float32(0.0)]",2.0,99145.5,15
2025-08-14_08-18-36,8936,"[np.float32(1.0), np.float32(0.0), np.float32(0.0), np.float32(1.0), np.float32(1.0), np.float32(1.0), np.float32(1.0), np.float32(1.0), np.float32(1.0), np.float32(1.0), np.float32(1.0), np.float32(1.0), np.float32(0.0), np.float32(0.0), np.float32(0.0), np.float32(0.0)]",0.0,99145.5,30
2025-08-14_08-18-36,8937,"[np.float32(1.0), np.float32(1.0), np.float32(0.0), np.float32(1.0), np.float32(1.0), np.float32(1.0), np.float32(1.0), np.float32(1.0), np.float32(1.0), np.float32(1.0), np.float32(0.0), np.float32(1.0), np.float32(0.0), np.float32(0.0), np.float32(0.0), np.float32(1.0)]",1.0,99146.5,21
2025-08-14_08-18-36,8938,"[np.float32(0.0), np.float32(0.0), np.float32(1.0), np.float32(1.0), np.float32(0.0), np.float32(0.0), np.float32(1.0), np.float32(0.0), np.float32(0.0), np.float32(1.0), np.float32(1.0), np.float32(0.0), np.float32(0.0), np.float32(1.0), np.float32(0.0), np.float32(1.0)]",1.0,99147.5,20
2025-08-14_08-18-36,8939,"[np.float32(0.0), np.float32(0.0), np.float32(1.0), np.float32(1.0), np.float32(0.0), np.float32(1.0), np.float32(1.0), np.float32(1.0), np.float32(0.0), np.float32(0.0), np.float32(0.0), np.float32(0.0), np.float32(1.0), np.float32(1.0), np.float32(1.0), np.float32(1.0)]",-1.0,99146.5,1
2025-08-14_08-18-36,8940,"[np.float32(0.0), np.float32(0.0), np.float32(0.0), np.float32(0.0), np.float32(1.0), np.float32(0.0), np.float32(1.0), np.float32(1.0), np.float32(0.0), np.float32(0.0), np.float32(0.0), np.float32(0.0), np.float32(0.0), np.float32(1.0), np.float32(1.0), np.float32(1.0)]",0.0,99146.5,21
2025-08-14_08-18-36,8941,"[np.float32(0.0), np.float32(1.0), np.float32(0.0), np.float32(0.0), np.float32(0.0), np.float32(0.0), np.float32(1.0), np.float32(1.0), np.float32(1.0), np.float32(0.0), np.float32(1.0), np.float32(0.0), np.float32(0.0), np.float32(0.0), np.float32(1.0), np.float32(0.0)]",0.0,99146.5,27
2025-08-14_08-18-36,8942,"[np.float32(0.0), np.float32(0.0), np.float32(1.0), np.float32(0.0), np.float32(1.0), np.float32(1.0), np.float32(0.0), np.float32(0.0), np.float32(1.0), np.float32(1.0), np.float32(0.0), np.float32(1.0), np.float32(0.0), np.float32(0.0), np.float32(1.0), np.float32(0.0)]",-5.0,99141.5,17
2025-08-14_08-18-36,8943,"[np.float32(0.0), np.float32(1.0), np.float32(1.0), np.float32(0.0), np.float32(0.0), np.float32(0.0), np.float32(1.0), np.float32(0.0), np.float32(1.0), np.float32(0.0), np.float32(1.0), np.float32(0.0), np.float32(0.0), np.float32(0.0), np.float32(1.0), np.float32(0.0)]",0.0,99141.5,23
2025-08-14_08-18-36,8944,"[np.float32(0.0), np.float32(1.0), np.float32(0.0), np.float32(1.0), np.float32(1.0), np.float32(0.0), np.float32(1.0), np.float32(1.0), np.float32(0.0), np.float32(0.0), np.float32(0.0), np.float32(0.0), np.float32(1.0), np.float32(1.0), np.float32(1.0), np.float32(0.0)]",-3.0,99138.5,28
2025-08-14_08-18-36,8945,"[np.float32(0.0), np.float32(1.0), np.float32(0.0), np.float32(1.0), np.float32(0.0), np.float32(1.0), np.float32(0.0), np.float32(1.0), np.float32(1.0), np.float32(0.0), np.float32(1.0), np.float32(1.0), np.float32(0.0), np.float32(0.0), np.float32(1.0), np.float32(0.0)]",3.0,99141.5,36
2025-08-14_08-18-36,8946,"[np.float32(0.0), np.float32(1.0), np.float32(1.0), np.float32(1.0), np.float32(1.0), np.float32(1.0), np.float32(0.0), np.float32(0.0), np.float32(0.0), np.float32(1.0), np.float32(1.0), np.float32(1.0), np.float32(0.0), np.float32(0.0), np.float32(1.0), np.float32(1.0)]",2.0,99143.5,31
2025-08-14_08-18-36,8947,"[np.float32(1.0), np.float32(0.0), np.float32(0.0), np.float32(1.0), np.float32(1.0), np.float32(1.0), np.float32(0.0), np.float32(1.0), np.float32(1.0), np.float32(1.0), np.float32(0.0), np.float32(0.0), np.float32(1.0), np.float32(1.0), np.float32(0.0), np.float32(0.0)]",-5.0,99138.5,11
2025-08-14_08-18-36,8948,"[np.float32(0.0), np.float32(1.0), np.float32(0.0), np.float32(0.0), np.float32(1.0), np.float32(1.0), np.float32(0.0), np.float32(1.0), np.float32(0.0), np.float32(0.0), np.float32(0.0), np.float32(1.0), np.float32(1.0), np.float32(1.0), np.float32(0.0), np.float32(0.0)]",-3.0,99135.5,10
2025-08-14_08-18-36,8949,"[np.float32(1.0), np.float32(0.0), np.float32(0.0), np.float32(1.0), np.float32(1.0), np.float32(0.0), np.float32(0.0), np.float32(0.0), np.float32(1.0), np.float32(1.0), np.float32(0.0), np.float32(0.0), np.float32(0.0), np.float32(0.0), np.float32(0.0), np.float32(1.0)]",-2.0,99133.5,12
2025-08-14_08-18-36,8950,"[np.float32(1.0), np.float32(0.0), np.float32(0.0), np.float32(1.0), np.float32(1.0), np.float32(0.0), np.float32(1.0), np.float32(0.0), np.float32(1.0), np.float32(0.0), np.float32(1.0), np.float32(0.0), np.float32(0.0), np.float32(1.0), np.float32(1.0), np.float32(0.0)]",-1.0,99132.5,14
2025-08-14_08-18-36,8951,"[np.float32(1.0), np.float32(1.0), np.float32(1.0), np.float32(1.0), np.float32(0.0), np.float32(1.0), np.float32(1.0), np.float32(0.0), np.float32(0.0), np.float32(1.0), np.float32(0.0), np.float32(0.0), np.float32(0.0), np.float32(0.0), np.float32(1.0), np.float32(0.0)]",1.0,99133.5,33
2025-08-14_08-18-36,8952,"[np.float32(1.0), np.float32(1.0), np.float32(0.0), np.float32(0.0), np.float32(0.0), np.float32(1.0), np.float32(0.0), np.float32(1.0), np.float32(1.0), np.float32(0.0), np.float32(0.0), np.float32(0.0), np.float32(1.0), np.float32(0.0), np.float32(0.0), np.float32(1.0)]",0.0,99133.5,33
2025-08-14_08-18-36,8953,"[np.float32(0.0), np.float32(0.0), np.float32(1.0), np.float32(0.0), np.float32(0.0), np.float32(1.0), np.float32(0.0), np.float32(1.0), np.float32(1.0), np.float32(1.0), np.float32(0.0), np.float32(0.0), np.float32(0.0), np.float32(1.0), np.float32(0.0), np.float32(0.0)]",1.0,99134.5,30
2025-08-14_08-18-36,8954,"[np.float32(0.0), np.float32(1.0), np.float32(1.0), np.float32(1.0), np.float32(1.0), np.float32(1.0), np.float32(1.0), np.float32(1.0), np.float32(1.0), np.float32(0.0), np.float32(0.0), np.float32(1.0), np.float32(0.0), np.float32(0.0), np.float32(0.0), np.float32(1.0)]",5.0,99139.5,6
2025-08-14_08-18-36,8955,"[np.float32(0.0), np.float32(0.0), np.float32(0.0), np.float32(0.0), np.float32(0.0), np.float32(1.0), np.float32(0.0), np.float32(1.0), np.float32(0.0), np.float32(1.0), np.float32(1.0), np.float32(0.0), np.float32(1.0), np.float32(1.0), np.float32(1.0), np.float32(0.0)]",-2.0,99137.5,33
2025-08-14_08-18-36,8956,"[np.float32(1.0), np.float32(0.0), np.float32(1.0), np.float32(1.0), np.float32(0.0), np.float32(1.0), np.float32(1.0), np.float32(1.0), np.float32(0.0), np.float32(0.0), np.float32(1.0), np.float32(0.0), np.float32(1.0), np.float32(1.0), np.float32(0.0), np.float32(0.0)]",-3.0,99134.5,30
2025-08-14_08-18-36,8957,"[np.float32(0.0), np.float32(1.0), np.float32(1.0), np.float32(0.0), np.float32(0.0), np.float32(0.0), np.float32(1.0), np.float32(1.0), np.float32(1.0), np.float32(1.0), np.float32(0.0), np.float32(0.0), np.float32(0.0), np.float32(1.0), np.float32(1.0), np.float32(0.0)]",0.0,99134.5,11
2025-08-14_08-18-36,8958,"[np.float32(0.0), np.float32(0.0), np.float32(0.0), np.float32(1.0), np.float32(0.0), np.float32(0.0), np.float32(0.0), np.float32(1.0), np.float32(0.0), np.float32(1.0), np.float32(0.0), np.float32(1.0), np.float32(1.0), np.float32(1.0), np.float32(0.0), np.float32(0.0)]",-1.0,99133.5,9
2025-08-14_08-18-36,8959,"[np.float32(1.0), np.float32(1.0), np.float32(0.0), np.float32(0.0), np.float32(1.0), np.float32(0.0), np.float32(0.0), np.float32(1.0), np.float32(0.0), np.float32(0.0), np.float32(1.0), np.float32(0.0), np.float32(0.0), np.float32(0.0), np.float32(1.0), np.float32(1.0)]",-2.0,99131.5,31
2025-08-14_08-18-36,8960,"[np.float32(1.0), np.float32(0.0), np.float32(1.0), np.float32(0.0), np.float32(1.0), np.float32(1.0), np.float32(1.0), np.float32(1.0), np.float32(0.0), np.float32(1.0), np.float32(1.0), np.float32(1.0), np.float32(1.0), np.float32(1.0), np.float32(0.0), np.float32(1.0)]",37.0,99168.5,7
2025-08-14_08-18-36,8961,"[np.float32(0.0), np.float32(0.0), np.float32(1.0), np.float32(0.0), np.float32(0.0), np.float32(0.0), np.float32(0.0), np.float32(0.0), np.float32(1.0), np.float32(1.0), np.float32(0.0), np.float32(1.0), np.float32(0.0), np.float32(1.0), np.float32(1.0), np.float32(1.0)]",-1.0,99167.5,9
2025-08-14_08-18-36,8962,"[np.float32(0.0), np.float32(1.0), np.float32(0.0), np.float32(0.0), np.float32(1.0), np.float32(1.0), np.float32(1.0), np.float32(1.0), np.float32(1.0), np.float32(0.0), np.float32(1.0), np.float32(1.0), np.float32(1.0), np.float32(0.0), np.float32(1.0), np.float32(1.0)]",-1.0,99166.5,13
2025-08-14_08-18-36,8963,"[np.float32(0.0), np.float32(0.0), np.float32(0.0), np.float32(0.0), np.float32(0.0), np.float32(1.0), np.float32(0.0), np.float32(1.0), np.float32(1.0), np.float32(0.0), np.float32(0.0), np.float32(0.0), np.float32(0.0), np.float32(0.0), np.float32(0.0), np.float32(0.0)]",-3.0,99163.5,1
2025-08-14_08-18-36,8964,"[np.float32(1.0), np.float32(1.0), np.float32(0.0), np.float32(1.0), np.float32(1.0), np.float32(0.0), np.float32(1.0), np.float32(1.0), np.float32(0.0), np.float32(0.0), np.float32(0.0), np.float32(0.0), np.float32(0.0), np.float32(0.0), np.float32(0.0), np.float32(0.0)]",3.0,99166.5,17
2025-08-14_08-18-36,8965,"[np.float32(1.0), np.float32(1.0), np.float32(0.0), np.float32(0.0), np.float32(1.0), np.float32(1.0), np.float32(0.0), np.float32(1.0), np.float32(0.0), np.float32(0.0), np.float32(1.0), np.float32(0.0), np.float32(0.0), np.float32(0.0), np.float32(0.0), np.float32(0.0)]",1.0,99167.5,32
2025-08-14_08-18-36,8966,"[np.float32(1.0), np.float32(1.0), np.float32(1.0), np.float32(1.0), np.float32(0.0), np.float32(1.0), np.float32(1.0), np.float32(0.0), np.float32(0.0), np.float32(0.0), np.float32(0.0), np.float32(1.0), np.float32(0.0), np.float32(1.0), np.float32(0.0), np.float32(0.0)]",1.0,99168.5,30
2025-08-14_08-18-36,8967,"[np.float32(1.0), np.float32(0.0), np.float32(1.0), np.float32(1.0), np.float32(0.0), np.float32(0.0), np.float32(1.0), np.float32(1.0), np.float32(1.0), np.float32(0.0), np.float32(0.0), np.float32(0.0), np.float32(0.0), np.float32(1.0), np.float32(1.0), np.float32(1.0)]",-1.0,99167.5,29
2025-08-14_08-18-36,8968,"[np.float32(1.0), np.float32(1.0), np.float32(1.0), np.float32(0.0), np.float32(1.0), np.float32(1.0), np.float32(0.0), np.float32(0.0), np.float32(1.0), np.float32(0.0), np.float32(0.0), np.float32(1.0), np.float32(1.0), np.float32(0.0), np.float32(0.0), np.float32(0.0)]",-1.0,99166.5,31
2025-08-14_08-18-36,8969,"[np.float32(0.0), np.float32(1.0), np.float32(0.0), np.float32(0.0), np.float32(0.0), np.float32(1.0), np.float32(1.0), np.float32(0.0), np.float32(0.0), np.float32(1.0), np.float32(0.0), np.float32(1.0), np.float32(1.0), np.float32(1.0), np.float32(0.0), np.float32(1.0)]",0.0,99166.5,10
2025-08-14_08-18-36,8970,"[np.float32(0.0), np.float32(0.0), np.float32(1.0), np.float32(0.0), np.float32(1.0), np.float32(1.0), np.float32(1.0), np.float32(0.0), np.float32(0.0), np.float32(1.0), np.float32(1.0), np.float32(0.0), np.float32(0.0), np.float32(0.0), np.float32(0.0), np.float32(0.0)]",-1.0,99165.5,35
2025-08-14_08-18-36,8971,"[np.float32(1.0), np.float32(0.0), np.float32(0.0), np.float32(0.0), np.float32(0.0), np.float32(1.0), np.float32(0.0), np.float32(1.0), np.float32(1.0), np.float32(0.0), np.float32(1.0), np.float32(0.0), np.float32(1.0), np.float32(1.0), np.float32(1.0), np.float32(0.0)]",0.0,99165.5,24
2025-08-14_08-18-36,8972,"[np.float32(0.0), np.float32(1.0), np.float32(1.0), np.float32(1.0), np.float32(1.0), np.float32(0.0), np.float32(0.0), np.float32(0.0), np.float32(0.0), np.float32(1.0), np.float32(0.0), np.float32(1.0), np.float32(0.0), np.float32(0.0), np.float32(0.0), np.float32(0.0)]",0.0,99165.5,17
2025-08-14_08-18-36,8973,"[np.float32(0.0), np.float32(0.0), np.float32(1.0), np.float32(0.0), np.float32(0.0), np.float32(0.0), np.float32(1.0), np.float32(1.0), np.float32(0.0), np.float32(0.0), np.float32(1.0), np.float32(0.0), np.float32(1.0), np.float32(0.0), np.float32(0.0), np.float32(0.0)]",-2.0,99163.5,15
2025-08-14_08-18-36,8974,"[np.float32(0.0), np.float32(1.0), np.float32(1.0), np.float32(1.0), np.float32(1.0), np.float32(1.0), np.float32(0.0), np.float32(0.0), np.float32(0.0), np.float32(0.0), np.float32(0.0), np.float32(1.0), np.float32(0.0), np.float32(0.0), np.float32(0.0), np.float32(0.0)]",0.0,99163.5,26
2025-08-14_08-18-36,8975,"[np.float32(0.0), np.float32(0.0), np.float32(0.0), np.float32(1.0), np.float32(1.0), np.float32(0.0), np.float32(1.0), np.float32(1.0), np.float32(0.0), np.float32(0.0), np.float32(1.0), np.float32(1.0), np.float32(0.0), np.float32(1.0), np.float32(0.0), np.float32(0.0)]",-5.0,99158.5,31
2025-08-14_08-18-36,8976,"[np.float32(0.0), np.float32(1.0), np.float32(0.0), np.float32(1.0), np.float32(0.0), np.float32(1.0), np.float32(1.0), np.float32(1.0), np.float32(1.0), np.float32(0.0), np.float32(0.0), np.float32(0.0), np.float32(1.0), np.float32(0.0), np.float32(1.0), np.float32(1.0)]",-1.0,99157.5,9
2025-08-14_08-18-36,8977,"[np.float32(0.0), np.float32(0.0), np.float32(0.0), np.float32(1.0), np.float32(0.0), np.float32(1.0), np.float32(1.0), np.float32(1.0), np.float32(1.0), np.float32(1.0), np.float32(1.0), np.float32(0.0), np.float32(1.0), np.float32(0.0), np.float32(1.0), np.float32(1.0)]",-2.0,99155.5,22
2025-08-14_08-18-36,8978,"[np.float32(1.0), np.float32(0.0), np.float32(0.0), np.float32(0.0), np.float32(0.0), np.float32(0.0), np.float32(1.0), np.float32(0.0), np.float32(0.0), np.float32(0.0), np.float32(1.0), np.float32(1.0), np.float32(1.0), np.float32(0.0), np.float32(0.0), np.float32(0.0)]",0.0,99155.5,27
2025-08-14_08-18-36,8979,"[np.float32(1.0), np.float32(0.0), np.float32(0.0), np.float32(1.0), np.float32(1.0), np.float32(1.0), np.float32(1.0), np.float32(0.0), np.float32(0.0), np.float32(1.0), np.float32(1.0), np.float32(0.0), np.float32(1.0), np.float32(1.0), np.float32(0.0), np.float32(0.0)]",3.0,99158.5,19
2025-08-14_08-18-36,8980,"[np.float32(1.0), np.float32(0.0), np.float32(0.0), np.float32(0.0), np.float32(0.0), np.float32(0.0), np.float32(1.0), np.float32(0.0), np.float32(1.0), np.float32(1.0), np.float32(0.0), np.float32(0.0), np.float32(0.0), np.float32(1.0), np.float32(1.0), np.float32(0.0)]",5.0,99163.5,7
2025-08-14_08-18-36,8981,"[np.float32(0.0), np.float32(1.0), np.float32(0.0), np.float32(1.0), np.float32(0.0), np.float32(1.0), np.float32(0.0), np.float32(0.0), np.float32(0.0), np.float32(1.0), np.float32(0.0), np.float32(0.0), np.float32(1.0), np.float32(1.0), np.float32(0.0), np.float32(0.0)]",38.0,99201.5,7
2025-08-14_08-18-36,8982,"[np.float32(0.0), np.float32(1.0), np.float32(1.0), np.float32(0.0), np.float32(0.0), np.float32(1.0), np.float32(1.0), np.float32(1.0), np.float32(1.0), np.float32(1.0), np.float32(1.0), np.float32(1.0), np.float32(1.0), np.float32(0.0), np.float32(0.0), np.float32(0.0)]",-2.0,99199.5,11
2025-08-14_08-18-36,8983,"[np.float32(0.0), np.float32(1.0), np.float32(1.0), np.float32(1.0), np.float32(0.0), np.float32(1.0), np.float32(0.0), np.float32(1.0), np.float32(0.0), np.float32(0.0), np.float32(1.0), np.float32(1.0), np.float32(0.0), np.float32(0.0), np.float32(0.0), np.float32(0.0)]",-2.0,99197.5,5
2025-08-14_08-18-36,8984,"[np.float32(1.0), np.float32(1.0), np.float32(1.0), np.float32(0.0), np.float32(0.0), np.float32(1.0), np.float32(0.0), np.float32(1.0), np.float32(1.0), np.float32(0.0), np.float32(1.0), np.float32(1.0), np.float32(0.0), np.float32(0.0), np.float32(0.0), np.float32(1.0)]",2.0,99199.5,17
2025-08-14_08-18-36,8985,"[np.float32(0.0), np.float32(0.0), np.float32(0.0), np.float32(1.0), np.float32(0.0), np.float32(1.0), np.float32(1.0), np.float32(1.0), np.float32(1.0), np.float32(0.0), np.float32(0.0), np.float32(0.0), np.float32(1.0), np.float32(1.0), np.float32(0.0), np.float32(0.0)]",0.0,99199.5,27
2025-08-14_08-18-36,8986,"[np.float32(1.0), np.float32(1.0), np.float32(0.0), np.float32(1.0), np.float32(0.0), np.float32(1.0), np.float32(1.0), np.float32(0.0), np.float32(0.0), np.float32(1.0), np.float32(0.0), np.float32(1.0), np.float32(1.0), np.float32(0.0), np.float32(0.0), np.float32(1.0)]",-4.0,99195.5,8
2025-08-14_08-18-36,8987,"[np.float32(1.0), np.float32(1.0), np.float32(1.0), np.float32(0.0), np.float32(0.0), np.float32(1.0), np.float32(1.0), np.float32(0.0), np.float32(1.0), np.float32(0.0), np.float32(0.0), np.float32(0.0), np.float32(1.0), np.float32(1.0), np.float32(1.0), np.float32(0.0)]",-2.0,99193.5,16
2025-08-14_08-18-36,8988,"[np.float32(1.0), np.float32(0.0), np.float32(1.0), np.float32(1.0), np.float32(0.0), np.float32(0.0), np.float32(1.0), np.float32(0.0), np.float32(1.0), np.float32(1.0), np.float32(1.0), np.float32(1.0), np.float32(1.0), np.float32(1.0), np.float32(1.0), np.float32(1.0)]",-1.0,99192.5,26
2025-08-14_08-18-36,8989,"[np.float32(1.0), np.float32(1.0), np.float32(0.0), np.float32(0.0), np.float32(0.0), np.float32(0.0), np.float32(1.0), np.float32(1.0), np.float32(1.0), np.float32(0.0), np.float32(0.0), np.float32(0.0), np.float32(1.0), np.float32(1.0), np.float32(0.0), np.float32(1.0)]",-3.0,99189.5,33
2025-08-14_08-18-36,8990,"[np.float32(1.0), np.float32(1.0), np.float32(0.0), np.float32(0.0), np.float32(0.0), np.float32(1.0), np.float32(1.0), np.float32(1.0), np.float32(0.0), np.float32(0.0), np.float32(0.0), np.float32(0.0), np.float32(0.0), np.float32(1.0), np.float32(0.0), np.float32(0.0)]",-1.0,99188.5,5
2025-08-14_08-18-36,8991,"[np.float32(0.0), np.float32(0.0), np.float32(1.0), np.float32(0.0), np.float32(1.0), np.float32(1.0), np.float32(0.0), np.float32(1.0), np.float32(0.0), np.float32(0.0), np.float32(0.0), np.float32(0.0), np.float32(1.0), np.float32(1.0), np.float32(0.0), np.float32(1.0)]",0.0,99188.5,26
2025-08-14_08-18-36,8992,"[np.float32(0.0), np.float32(1.0), np.float32(0.0), np.float32(0.0), np.float32(1.0), np.float32(0.0), np.float32(1.0), np.float32(1.0), np.float32(1.0), np.float32(0.0), np.float32(0.0), np.float32(0.0), np.float32(0.0), np.float32(1.0), np.float32(0.0), np.float32(1.0)]",3.0,99191.5,15
2025-08-14_08-18-36,8993,"[np.float32(1.0), np.float32(1.0), np.float32(0.0), np.float32(0.0), np.float32(1.0), np.float32(1.0), np.float32(0.0), np.float32(1.0), np.float32(0.0), np.float32(1.0), np.float32(0.0), np.float32(1.0), np.float32(1.0), np.float32(1.0), np.float32(1.0), np.float32(1.0)]",-1.0,99190.5,6
2025-08-14_08-18-36,8994,"[np.float32(0.0), np.float32(1.0), np.float32(0.0), np.float32(1.0), np.float32(0.0), np.float32(1.0), np.float32(0.0), np.float32(1.0), np.float32(0.0), np.float32(1.0), np.float32(0.0), np.float32(1.0), np.float32(1.0), np.float32(1.0), np.float32(0.0), np.float32(0.0)]",-3.0,99187.5,6
2025-08-14_08-18-36,8995,"[np.float32(0.0), np.float32(0.0), np.float32(1.0), np.float32(0.0), np.float32(1.0), np.float32(1.0), np.float32(0.0), np.float32(1.0), np.float32(1.0), np.float32(0.0), np.float32(1.0), np.float32(1.0), np.float32(0.0), np.float32(0.0), np.float32(0.0), np.float32(0.0)]",3.0,99190.5,26
2025-08-14_08-18-36,8996,"[np.float32(1.0), np.float32(1.0), np.float32(0.0), np.float32(0.0), np.float32(0.0), np.float32(1.0), np.float32(0.0), np.float32(1.0), np.float32(1.0), np.float32(1.0), np.float32(0.0), np.float32(1.0), np.float32(0.0), np.float32(0.0), np.float32(0.0), np.float32(1.0)]",2.0,99192.5,36
2025-08-14_08-18-36,8997,"[np.float32(1.0), np.float32(0.0), np.float32(0.0), np.float32(0.0), np.float32(0.0), np.float32(1.0), np.float32(1.0), np.float32(1.0), np.float32(0.0), np.float32(1.0), np.float32(0.0), np.float32(0.0), np.float32(0.0), np.float32(0.0), np.float32(0.0), np.float32(0.0)]",-2.0,99190.5,2
2025-08-14_08-18-36,8998,"[np.float32(1.0), np.float32(0.0), np.float32(1.0), np.float32(1.0), np.float32(1.0), np.float32(0.0), np.float32(1.0), np.float32(1.0), np.float32(0.0), np.float32(0.0), np.float32(0.0), np.float32(1.0), np.float32(1.0), np.float32(1.0), np.float32(1.0), np.float32(0.0)]",-5.0,99185.5,20
2025-08-14_08-18-36,8999,"[np.float32(0.0), np.float32(1.0), np.float32(1.0), np.float32(0.0), np.float32(0.0), np.float32(0.0), np.float32(0.0), np.float32(1.0), np.float32(1.0), np.float32(0.0), np.float32(0.0), np.float32(1.0), np.float32(0.0), np.float32(1.0), np.float32(0.0), np.float32(0.0)]",0.0,99185.5,19
2025-08-14_08-18-36,9000,"[np.float32(0.0), np.float32(1.0), np.float32(0.0), np.float32(1.0), np.float32(0.0), np.float32(0.0), np.float32(0.0), np.float32(1.0), np.float32(0.0), np.float32(1.0), np.float32(1.0), np.float32(0.0), np.float32(1.0), np.float32(1.0), np.float32(0.0), np.float32(0.0)]",37.0,99222.5,7
2025-08-14_08-18-36,9001,"[np.float32(1.0), np.float32(1.0), np.float32(1.0), np.float32(0.0), np.float32(0.0), np.float32(0.0), np.float32(1.0), np.float32(1.0), np.float32(1.0), np.float32(0.0), np.float32(1.0), np.float32(0.0), np.float32(1.0), np.float32(1.0), np.float32(0.0), np.float32(0.0)]",1.0,99342.5,20
2025-08-14_08-18-36,9002,"[np.float32(0.0), np.float32(0.0), np.float32(1.0), np.float32(1.0), np.float32(0.0), np.float32(1.0), np.float32(1.0), np.float32(0.0), np.float32(1.0), np.float32(0.0), np.float32(0.0), np.float32(1.0), np.float32(1.0), np.float32(0.0), np.float32(0.0), np.float32(0.0)]",-2.0,99340.5,2
2025-08-14_08-18-36,9003,"[np.float32(1.0), np.float32(0.0), np.float32(1.0), np.float32(1.0), np.float32(0.0), np.float32(0.0), np.float32(0.0), np.float32(0.0), np.float32(1.0), np.float32(0.0), np.float32(0.0), np.float32(0.0), np.float32(0.0), np.float32(0.0), np.float32(0.0), np.float32(1.0)]",0.0,99340.5,28
2025-08-14_08-18-36,9004,"[np.float32(0.0), np.float32(1.0), np.float32(0.0), np.float32(1.0), np.float32(1.0), np.float32(1.0), np.float32(0.0), np.float32(1.0), np.float32(0.0), np.float32(1.0), np.float32(0.0), np.float32(1.0), np.float32(0.0), np.float32(1.0), np.float32(0.0), np.float32(0.0)]",-1.0,99339.5,2
2025-08-14_08-18-36,9005,"[np.float32(1.0), np.float32(1.0), np.float32(1.0), np.float32(1.0), np.float32(0.0), np.float32(1.0), np.float32(1.0), np.float32(1.0), np.float32(0.0), np.float32(1.0), np.float32(1.0), np.float32(1.0), np.float32(0.0), np.float32(1.0), np.float32(1.0), np.float32(1.0)]",0.0,99339.5,2
2025-08-14_08-18-36,9006,"[np.float32(1.0), np.float32(1.0), np.float32(1.0), np.float32(0.0), np.float32(0.0), np.float32(1.0), np.float32(1.0), np.float32(1.0), np.float32(0.0), np.float32(1.0), np.float32(1.0), np.float32(0.0), np.float32(1.0), np.float32(1.0), np.float32(1.0), np.float32(0.0)]",2.0,99341.5,10
2025-08-14_08-18-36,9007,"[np.float32(1.0), np.float32(0.0), np.float32(0.0), np.float32(1.0), np.float32(1.0), np.float32(0.0), np.float32(0.0), np.float32(0.0), np.float32(1.0), np.float32(0.0), np.float32(0.0), np.float32(0.0), np.float32(0.0), np.float32(1.0), np.float32(0.0), np.float32(0.0)]",1.0,99342.5,28
2025-08-14_08-18-36,9008,"[np.float32(0.0), np.float32(0.0), np.float32(1.0), np.float32(1.0), np.float32(1.0), np.float32(1.0), np.float32(0.0), np.float32(0.0), np.float32(0.0), np.float32(1.0), np.float32(0.0), np.float32(0.0), np.float32(1.0), np.float32(0.0), np.float32(0.0), np.float32(0.0)]",-2.0,99340.5,26
2025-08-14_08-18-36,9009,"[np.float32(0.0), np.float32(0.0), np.float32(0.0), np.float32(0.0), np.float32(0.0), np.float32(1.0), np.float32(0.0), np.float32(0.0), np.float32(0.0), np.float32(0.0), np.float32(1.0), np.float32(1.0), np.float32(0.0), np.float32(1.0), np.float32(0.0), np.float32(1.0)]",1.0,99341.5,12
2025-08-14_08-18-36,9010,"[np.float32(1.0), np.float32(0.0), np.float32(0.0), np.float32(1.0), np.float32(0.0), np.float32(1.0), np.float32(1.0), np.float32(1.0), np.float32(0.0), np.float32(1.0), np.float32(1.0), np.float32(1.0), np.float32(1.0), np.float32(1.0), np.float32(1.0), np.float32(1.0)]",-2.0,99339.5,30
2025-08-14_08-18-36,9011,"[np.float32(0.0), np.float32(0.0), np.float32(1.0), np.float32(1.0), np.float32(0.0), np.float32(1.0), np.float32(1.0), np.float32(1.0), np.float32(1.0), np.float32(1.0), np.float32(1.0), np.float32(0.0), np.float32(0.0), np.float32(0.0), np.float32(1.0), np.float32(0.0)]",2.0,99341.5,5
2025-08-14_08-18-36,9012,"[np.float32(1.0), np.float32(0.0), np.float32(0.0), np.float32(0.0), np.float32(1.0), np.float32(1.0), np.float32(0.0), np.float32(0.0), np.float32(1.0), np.float32(0.0), np.float32(1.0), np.float32(1.0), np.float32(0.0), np.float32(0.0), np.float32(1.0), np.float32(0.0)]",0.0,99341.5,34
2025-08-14_08-18-36,9013,"[np.float32(0.0), np.float32(0.0), np.float32(0.0), np.float32(0.0), np.float32(0.0), np.float32(1.0), np.float32(0.0), np.float32(1.0), np.float32(0.0), np.float32(0.0), np.float32(1.0), np.float32(1.0), np.float32(1.0), np.float32(0.0), np.float32(0.0), np.float32(0.0)]",-3.0,99338.5,31
2025-08-14_08-18-36,9014,"[np.float32(0.0), np.float32(0.0), np.float32(0.0), np.float32(0.0), np.float32(0.0), np.float32(0.0), np.float32(1.0), np.float32(1.0), np.float32(1.0), np.float32(1.0), np.float32(1.0), np.float32(0.0), np.float32(1.0), np.float32(1.0), np.float32(0.0), np.float32(1.0)]",-5.0,99333.5,27
2025-08-14_08-18-36,9015,"[np.float32(1.0), np.float32(1.0), np.float32(1.0), np.float32(0.0), np.float32(0.0), np.float32(1.0), np.float32(1.0), np.float32(0.0), np.float32(0.0), np.float32(1.0), np.float32(1.0), np.float32(0.0), np.float32(0.0), np.float32(1.0), np.float32(1.0), np.float32(0.0)]",1.0,99334.5,19
2025-08-14_08-18-36,9016,"[np.float32(1.0), np.float32(0.0), np.float32(0.0), np.float32(1.0), np.float32(0.0), np.float32(0.0), np.float32(1.0), np.float32(1.0), np.float32(1.0), np.float32(0.0), np.float32(0.0), np.float32(0.0), np.float32(1.0), np.float32(1.0), np.float32(1.0), np.float32(1.0)]",-3.0,99331.5,4
2025-08-14_08-18-36,9017,"[np.float32(0.0), np.float32(0.0), np.float32(0.0), np.float32(1.0), np.float32(0.0), np.float32(0.0), np.float32(0.0), np.float32(0.0), np.float32(1.0), np.float32(0.0), np.float32(0.0), np.float32(1.0), np.float32(0.0), np.float32(1.0), np.float32(0.0), np.float32(0.0)]",4.0,99335.5,27
2025-08-14_08-18-36,9018,"[np.float32(1.0), np.float32(1.0), np.float32(0.0), np.float32(1.0), np.float32(1.0), np.float32(1.0), np.float32(1.0), np.float32(1.0), np.float32(0.0), np.float32(0.0), np.float32(0.0), np.float32(1.0), np.float32(1.0), np.float32(0.0), np.float32(0.0), np.float32(0.0)]",-5.0,99330.5,34
2025-08-14_08-18-36,9019,"[np.float32(1.0), np.float32(1.0), np.float32(0.0), np.float32(0.0), np.float32(1.0), np.float32(0.0), np.float32(1.0), np.float32(1.0), np.float32(0.0), np.float32(1.0), np.float32(1.0), np.float32(0.0), np.float32(1.0), np.float32(0.0), np.float32(0.0), np.float32(1.0)]",1.0,99331.5,16
2025-08-14_08-18-36,9020,"[np.float32(1.0), np.float32(0.0), np.float32(1.0), np.float32(1.0), np.float32(0.0), np.float32(1.0), np.float32(0.0), np.float32(0.0), np.float32(0.0), np.float32(0.0), np.float32(0.0), np.float32(1.0), np.float32(1.0), np.float32(0.0), np.float32(0.0), np.float32(0.0)]",-4.0,99327.5,11
2025-08-14_08-18-36,9021,"[np.float32(1.0), np.float32(1.0), np.float32(0.0), np.float32(0.0), np.float32(1.0), np.float32(1.0), np.float32(0.0), np.float32(0.0), np.float32(1.0), np.float32(0.0), np.float32(0.0), np.float32(1.0), np.float32(0.0), np.float32(0.0), np.float32(0.0), np.float32(0.0)]",-2.0,99325.5,11
2025-08-14_08-18-36,9022,"[np.float32(0.0), np.float32(0.0), np.float32(0.0), np.float32(0.0), np.float32(0.0), np.float32(1.0), np.float32(0.0), np.float32(0.0), np.float32(0.0), np.float32(0.0), np.float32(0.0), np.float32(0.0), np.float32(1.0), np.float32(0.0), np.float32(0.0), np.float32(0.0)]",-2.0,99323.5,4
2025-08-14_08-18-36,9023,"[np.float32(1.0), np.float32(1.0), np.float32(0.0), np.float32(0.0), np.float32(1.0), np.float32(0.0), np.float32(1.0), np.float32(0.0), np.float32(0.0), np.float32(1.0), np.float32(0.0), np.float32(1.0), np.float32(0.0), np.float32(0.0), np.float32(0.0), np.float32(0.0)]",1.0,99324.5,16
2025-08-14_08-18-36,9024,"[np.float32(1.0), np.float32(1.0), np.float32(1.0), np.float32(0.0), np.float32(0.0), np.float32(1.0), np.float32(0.0), np.float32(1.0), np.float32(1.0), np.float32(0.0), np.float32(0.0), np.float32(0.0), np.float32(1.0), np.float32(1.0), np.float32(1.0), np.float32(1.0)]",2.0,99326.5,36
2025-08-14_08-18-36,9025,"[np.float32(1.0), np.float32(0.0), np.float32(1.0), np.float32(1.0), np.float32(0.0), np.float32(0.0), np.float32(0.0), np.float32(0.0), np.float32(1.0), np.float32(0.0), np.float32(0.0), np.float32(0.0), np.float32(1.0), np.float32(0.0), np.float32(0.0), np.float32(1.0)]",1.0,99327.5,27
2025-08-14_08-18-36,9026,"[np.float32(1.0), np.float32(1.0), np.float32(1.0), np.float32(1.0), np.float32(1.0), np.float32(1.0), np.float32(0.0), np.float32(0.0), np.float32(0.0), np.float32(0.0), np.float32(1.0), np.float32(0.0), np.float32(1.0), np.float32(0.0), np.float32(1.0), np.float32(1.0)]",-4.0,99323.5,21
2025-08-14_08-18-36,9027,"[np.float32(1.0), np.float32(0.0), np.float32(1.0), np.float32(0.0), np.float32(0.0), np.float32(0.0), np.float32(1.0), np.float32(0.0), np.float32(1.0), np.float32(0.0), np.float32(0.0), np.float32(0.0), np.float32(1.0), np.float32(0.0), np.float32(0.0), np.float32(1.0)]",-1.0,99322.5,8
2025-08-14_08-18-36,9028,"[np.float32(0.0), np.float32(1.0), np.float32(0.0), np.float32(1.0), np.float32(1.0), np.float32(1.0), np.float32(1.0), np.float32(1.0), np.float32(1.0), np.float32(1.0), np.float32(1.0), np.float32(0.0), np.float32(1.0), np.float32(1.0), np.float32(0.0), np.float32(1.0)]",0.0,99322.5,13
2025-08-14_08-18-36,9029,"[np.float32(0.0), np.float32(1.0), np.float32(1.0), np.float32(1.0), np.float32(0.0), np.float32(1.0), np.float32(0.0), np.float32(0.0), np.float32(0.0), np.float32(0.0), np.float32(0.0), np.float32(0.0), np.float32(1.0), np.float32(1.0), np.float32(1.0), np.float32(0.0)]",0.0,99322.5,8
2025-08-14_08-18-36,9030,"[np.float32(1.0), np.float32(1.0), np.float32(1.0), np.float32(0.0), np.float32(1.0), np.float32(0.0), np.float32(1.0), np.float32(1.0), np.float32(0.0), np.float32(1.0), np.float32(0.0), np.float32(0.0), np.float32(1.0), np.float32(0.0), np.float32(0.0), np.float32(0.0)]",-1.0,99321.5,24
2025-08-14_08-18-36,9031,"[np.float32(0.0), np.float32(0.0), np.float32(1.0), np.float32(0.0), np.float32(0.0), np.float32(0.0), np.float32(1.0), np.float32(1.0), np.float32(1.0), np.float32(0.0), np.float32(0.0), np.float32(1.0), np.float32(0.0), np.float32(1.0), np.float32(1.0), np.float32(0.0)]",2.0,99323.5,33
2025-08-14_08-18-36,9032,"[np.float32(1.0), np.float32(1.0), np.float32(0.0), np.float32(1.0), np.float32(0.0), np.float32(1.0), np.float32(0.0), np.float32(1.0), np.float32(1.0), np.float32(0.0), np.float32(0.0), np.float32(0.0), np.float32(0.0), np.float32(0.0), np.float32(0.0), np.float32(0.0)]",3.0,99326.5,19
2025-08-14_08-18-36,9033,"[np.float32(1.0), np.float32(1.0), np.float32(0.0), np.float32(1.0), np.float32(0.0), np.float32(1.0), np.float32(1.0), np.float32(1.0), np.float32(1.0), np.float32(1.0), np.float32(0.0), np.float32(0.0), np.float32(0.0), np.float32(1.0), np.float32(0.0), np.float32(1.0)]",5.0,99331.5,19
2025-08-14_08-18-36,9034,"[np.float32(1.0), np.float32(1.0), np.float32(0.0), np.float32(0.0), np.float32(0.0), np.float32(1.0), np.float32(0.0), np.float32(0.0), np.float32(0.0), np.float32(0.0), np.float32(0.0), np.float32(0.0), np.float32(0.0), np.float32(0.0), np.float32(1.0), np.float32(0.0)]",1.0,99332.5,11
2025-08-14_08-18-36,9035,"[np.float32(0.0), np.float32(1.0), np.float32(1.0), np.float32(0.0), np.float32(0.0), np.float32(1.0), np.float32(1.0), np.float32(0.0), np.float32(1.0), np.float32(0.0), np.float32(0.0), np.float32(1.0), np.float32(0.0), np.float32(1.0), np.float32(0.0), np.float32(1.0)]",2.0,99334.5,31
2025-08-14_08-18-36,9036,"[np.float32(1.0), np.float32(0.0), np.float32(0.0), np.float32(0.0), np.float32(0.0), np.float32(0.0), np.float32(1.0), np.float32(0.0), np.float32(1.0), np.float32(0.0), np.float32(0.0), np.float32(0.0), np.float32(1.0), np.float32(0.0), np.float32(0.0), np.float32(1.0)]",0.0,99334.5,14
2025-08-14_08-18-36,9037,"[np.float32(1.0), np.float32(1.0), np.float32(1.0), np.float32(1.0), np.float32(1.0), np.float32(1.0), np.float32(0.0), np.float32(1.0), np.float32(1.0), np.float32(0.0), np.float32(0.0), np.float32(0.0), np.float32(1.0), np.float32(0.0), np.float32(0.0), np.float32(0.0)]",0.0,99334.5,26
2025-08-14_08-18-36,9038,"[np.float32(1.0), np.float32(0.0), np.float32(0.0), np.float32(0.0), np.float32(0.0), np.float32(0.0), np.float32(0.0), np.float32(1.0), np.float32(0.0), np.float32(1.0), np.float32(1.0), np.float32(1.0), np.float32(1.0), np.float32(0.0), np.float32(0.0), np.float32(0.0)]",-1.0,99333.5,1
2025-08-14_08-18-36,9039,"[np.float32(0.0), np.float32(1.0), np.float32(0.0), np.float32(0.0), np.float32(0.0), np.float32(0.0), np.float32(1.0), np.float32(1.0), np.float32(0.0), np.float32(0.0), np.float32(1.0), np.float32(1.0), np.float32(1.0), np.float32(0.0), np.float32(0.0), np.float32(0.0)]",2.0,99335.5,8
2025-08-14_08-18-36,9040,"[np.float32(0.0), np.float32(0.0), np.float32(0.0), np.float32(1.0), np.float32(1.0), np.float32(1.0), np.float32(0.0), np.float32(1.0), np.float32(1.0), np.float32(0.0), np.float32(1.0), np.float32(0.0), np.float32(0.0), np.float32(1.0), np.float32(1.0), np.float32(0.0)]",0.0,99335.5,14
2025-08-14_08-18-36,9041,"[np.float32(1.0), np.float32(1.0), np.float32(0.0), np.float32(0.0), np.float32(1.0), np.float32(1.0), np.float32(1.0), np.float32(0.0), np.float32(1.0), np.float32(0.0), np.float32(1.0), np.float32(1.0), np.float32(0.0), np.float32(1.0), np.float32(0.0), np.float32(1.0)]",3.0,99338.5,2
2025-08-14_08-18-36,9042,"[np.float32(0.0), np.float32(0.0), np.float32(1.0), np.float32(1.0), np.float32(1.0), np.float32(0.0), np.float32(0.0), np.float32(1.0), np.float32(1.0), np.float32(1.0), np.float32(1.0), np.float32(0.0), np.float32(0.0), np.float32(0.0), np.float32(0.0), np.float32(0.0)]",0.0,99338.5,15
2025-08-14_08-18-36,9043,"[np.float32(1.0), np.float32(0.0), np.float32(0.0), np.float32(1.0), np.float32(1.0), np.float32(0.0), np.float32(1.0), np.float32(1.0), np.float32(1.0), np.float32(1.0), np.float32(0.0), np.float32(1.0), np.float32(0.0), np.float32(0.0), np.float32(0.0), np.float32(0.0)]",4.0,99342.5,1
2025-08-14_08-18-36,9044,"[np.float32(0.0), np.float32(0.0), np.float32(0.0), np.float32(0.0), np.float32(1.0), np.float32(1.0), np.float32(0.0), np.float32(1.0), np.float32(0.0), np.float32(1.0), np.float32(0.0), np.float32(0.0), np.float32(0.0), np.float32(0.0), np.float32(1.0), np.float32(0.0)]",3.0,99345.5,24
2025-08-14_08-18-36,9045,"[np.float32(1.0), np.float32(0.0), np.float32(1.0), np.float32(0.0), np.float32(1.0), np.float32(1.0), np.float32(0.0), np.float32(0.0), np.float32(0.0), np.float32(1.0), np.float32(0.0), np.float32(0.0), np.float32(0.0), np.float32(0.0), np.float32(0.0), np.float32(1.0)]",-2.0,99343.5,0
2025-08-14_08-18-36,9046,"[np.float32(0.0), np.float32(0.0), np.float32(1.0), np.float32(0.0), np.float32(1.0), np.float32(1.0), np.float32(1.0), np.float32(1.0), np.float32(1.0), np.float32(0.0), np.float32(0.0), np.float32(0.0), np.float32(1.0), np.float32(0.0), np.float32(0.0), np.float32(1.0)]",33.0,99376.5,7
2025-08-14_08-18-36,9047,"[np.float32(0.0), np.float32(1.0), np.float32(1.0), np.float32(0.0), np.float32(0.0), np.float32(0.0), np.float32(1.0), np.float32(1.0), np.float32(1.0), np.float32(1.0), np.float32(1.0), np.float32(0.0), np.float32(1.0), np.float32(1.0), np.float32(0.0), np.float32(1.0)]",3.0,99379.5,2
2025-08-14_08-18-36,9048,"[np.float32(0.0), np.float32(1.0), np.float32(0.0), np.float32(0.0), np.float32(0.0), np.float32(1.0), np.float32(0.0), np.float32(0.0), np.float32(1.0), np.float32(1.0), np.float32(0.0), np.float32(0.0), np.float32(0.0), np.float32(1.0), np.float32(1.0), np.float32(0.0)]",-3.0,99376.5,12
2025-08-14_08-18-36,9049,"[np.float32(0.0), np.float32(0.0), np.float32(0.0), np.float32(1.0), np.float32(0.0), np.float32(0.0), np.float32(1.0), np.float32(1.0), np.float32(0.0), np.float32(0.0), np.float32(0.0), np.float32(1.0), np.float32(1.0), np.float32(0.0), np.float32(0.0), np.float32(0.0)]",0.0,99376.5,5
2025-08-14_08-18-36,9050,"[np.float32(0.0), np.float32(1.0), np.float32(0.0), np.float32(0.0), np.float32(1.0), np.float32(0.0), np.float32(0.0), np.float32(1.0), np.float32(1.0), np.float32(1.0), np.float32(1.0), np.float32(0.0), np.float32(1.0), np.float32(0.0), np.float32(1.0), np.float32(1.0)]",-1.0,99375.5,26
2025-08-14_08-18-36,9051,"[np.float32(0.0), np.float32(0.0), np.float32(1.0), np.float32(0.0), np.float32(1.0), np.float32(1.0), np.float32(1.0), np.float32(0.0), np.float32(0.0), np.float32(0.0), np.float32(1.0), np.float32(0.0), np.float32(0.0), np.float32(0.0), np.float32(1.0), np.float32(0.0)]",-4.0,99371.5,21
2025-08-14_08-18-36,9052,"[np.float32(1.0), np.float32(0.0), np.float32(0.0), np.float32(0.0), np.float32(1.0), np.float32(0.0), np.float32(0.0), np.float32(1.0), np.float32(0.0), np.float32(1.0), np.float32(0.0), np.float32(1.0), np.float32(1.0), np.float32(1.0), np.float32(1.0), np.float32(0.0)]",-3.0,99368.5,2
2025-08-14_08-18-36,9053,"[np.float32(1.0), np.float32(1.0), np.float32(1.0), np.float32(1.0), np.float32(0.0), np.float32(0.0), np.float32(1.0), np.float32(0.0), np.float32(1.0), np.float32(0.0), np.float32(1.0), np.float32(0.0), np.float32(1.0), np.float32(1.0), np.float32(0.0), np.float32(1.0)]",0.0,99368.5,6
2025-08-14_08-18-36,9054,"[np.float32(1.0), np.float32(0.0), np.float32(0.0), np.float32(1.0), np.float32(0.0), np.float32(1.0), np.float32(1.0), np.float32(1.0), np.float32(0.0), np.float32(1.0), np.float32(1.0), np.float32(0.0), np.float32(1.0), np.float32(0.0), np.float32(0.0), np.float32(1.0)]",-2.0,99366.5,29
2025-08-14_08-18-36,9055,"[np.float32(1.0), np.float32(1.0), np.float32(0.0), np.float32(0.0), np.float32(0.0), np.float32(0.0), np.float32(0.0), np.float32(0.0), np.float32(1.0), np.float32(1.0), np.float32(0.0), np.float32(0.0), np.float32(1.0), np.float32(0.0), np.float32(1.0), np.float32(0.0)]",-1.0,99365.5,32
2025-08-14_08-18-36,9056,"[np.float32(0.0), np.float32(1.0), np.float32(1.0), np.float32(0.0), np.float32(0.0), np.float32(0.0), np.float32(1.0), np.float32(1.0), np.float32(0.0), np.float32(1.0), np.float32(1.0), np.float32(1.0), np.float32(0.0), np.float32(1.0), np.float32(0.0), np.float32(1.0)]",-3.0,99362.5,5
2025-08-14_08-18-36,9057,"[np.float32(0.0), np.float32(1.0), np.float32(0.0), np.float32(1.0), np.float32(0.0), np.float32(0.0), np.float32(0.0), np.float32(1.0), np.float32(1.0), np.float32(1.0), np.float32(1.0), np.float32(0.0), np.float32(1.0), np.float32(1.0), np.float32(1.0), np.float32(1.0)]",-1.0,99361.5,32
2025-08-14_08-18-36,9058,"[np.float32(1.0), np.float32(0.0), np.float32(0.0), np.float32(0.0), np.float32(0.0), np.float32(1.0), np.float32(1.0), np.float32(1.0), np.float32(0.0), np.float32(0.0), np.float32(0.0), np.float32(0.0), np.float32(0.0), np.float32(0.0), np.float32(0.0), np.float32(0.0)]",1.0,99362.5,16
2025-08-14_08-18-36,9059,"[np.float32(1.0), np.float32(1.0), np.float32(0.0), np.float32(1.0), np.float32(0.0), np.float32(0.0), np.float32(1.0), np.float32(0.0), np.float32(1.0), np.float32(0.0), np.float32(0.0), np.float32(0.0), np.float32(1.0), np.float32(1.0), np.float32(0.0), np.float32(1.0)]",0.0,99362.5,26
2025-08-14_08-18-36,9060,"[np.float32(0.0), np.float32(1.0), np.float32(1.0), np.float32(1.0), np.float32(1.0), np.float32(1.0), np.float32(0.0), np.float32(1.0), np.float32(1.0), np.float32(0.0), np.float32(0.0), np.float32(0.0), np.float32(1.0), np.float32(0.0), np.float32(0.0), np.float32(0.0)]",-1.0,99361.5,14
2025-08-14_08-18-36,9061,"[np.float32(0.0), np.float32(0.0), np.float32(0.0), np.float32(0.0), np.float32(0.0), np.float32(0.0), np.float32(0.0), np.float32(1.0), np.float32(1.0), np.float32(1.0), np.float32(0.0), np.float32(1.0), np.float32(1.0), np.float32(0.0), np.float32(0.0), np.float32(0.0)]",1.0,99362.5,16
2025-08-14_08-18-36,9062,"[np.float32(0.0), np.float32(1.0), np.float32(1.0), np.float32(1.0), np.float32(0.0), np.float32(0.0), np.float32(1.0), np.float32(1.0), np.float32(1.0), np.float32(0.0), np.float32(0.0), np.float32(1.0), np.float32(0.0), np.float32(0.0), np.float32(0.0), np.float32(0.0)]",-2.0,99360.5,5
2025-08-14_08-18-36,9063,"[np.float32(1.0), np.float32(0.0), np.float32(0.0), np.float32(0.0), np.float32(0.0), np.float32(0.0), np.float32(1.0), np.float32(1.0), np.float32(0.0), np.float32(0.0), np.float32(1.0), np.float32(0.0), np.float32(0.0), np.float32(1.0), np.float32(1.0), np.float32(1.0)]",-1.0,99359.5,10
2025-08-14_08-18-36,9064,"[np.float32(1.0), np.float32(0.0), np.float32(0.0), np.float32(0.0), np.float32(0.0), np.float32(0.0), np.float32(1.0), np.float32(1.0), np.float32(0.0), np.float32(1.0), np.float32(0.0), np.float32(1.0), np.float32(0.0), np.float32(1.0), np.float32(1.0), np.float32(0.0)]",4.0,99363.5,12
2025-08-14_08-18-36,9065,"[np.float32(1.0), np.float32(0.0), np.float32(0.0), np.float32(1.0), np.float32(0.0), np.float32(1.0), np.float32(0.0), np.float32(1.0), np.float32(1.0), np.float32(0.0), np.float32(1.0), np.float32(1.0), np.float32(0.0), np.float32(0.0), np.float32(0.0), np.float32(0.0)]",1.0,99364.5,18
2025-08-14_08-18-36,9066,"[np.float32(1.0), np.float32(0.0), np.float32(1.0), np.float32(0.0), np.float32(1.0), np.float32(0.0), np.float32(1.0), np.float32(0.0), np.float32(0.0), np.float32(0.0), np.float32(0.0), np.float32(0.0), np.float32(0.0), np.float32(1.0), np.float32(1.0), np.float32(0.0)]",1.0,99365.5,1
2025-08-14_08-18-36,9067,"[np.float32(0.0), np.float32(1.0), np.float32(0.0), np.float32(1.0), np.float32(1.0), np.float32(1.0), np.float32(1.0), np.float32(1.0), np.float32(0.0), np.float32(1.0), np.float32(1.0), np.float32(1.0), np.float32(0.0), np.float32(1.0), np.float32(1.0), np.float32(0.0)]",-4.0,99361.5,0
2025-08-14_08-18-36,9068,"[np.float32(0.0), np.float32(1.0), np.float32(0.0), np.float32(1.0), np.float32(0.0), np.float32(0.0), np.float32(1.0), np.float32(0.0), np.float32(1.0), np.float32(1.0), np.float32(0.0), np.float32(0.0), np.float32(0.0), np.float32(0.0), np.float32(1.0), np.float32(0.0)]",4.0,99365.5,31
2025-08-14_08-18-36,9069,"[np.float32(1.0), np.float32(1.0), np.float32(1.0), np.float32(0.0), np.float32(1.0), np.float32(1.0), np.float32(1.0), np.float32(0.0), np.float32(1.0), np.float32(0.0), np.float32(1.0), np.float32(1.0), np.float32(1.0), np.float32(0.0), np.float32(0.0), np.float32(0.0)]",33.0,99398.5,7
2025-08-14_08-18-36,9070,"[np.float32(0.0), np.float32(1.0), np.float32(1.0), np.float32(0.0), np.float32(1.0), np.float32(1.0), np.float32(1.0), np.float32(1.0), np.float32(0.0), np.float32(1.0), np.float32(1.0), np.float32(0.0), np.float32(1.0), np.float32(0.0), np.float32(1.0), np.float32(0.0)]",-1.0,99397.5,6
2025-08-14_08-18-36,9071,"[np.float32(1.0), np.float32(0.0), np.float32(0.0), np.float32(1.0), np.float32(0.0), np.float32(1.0), np.float32(1.0), np.float32(1.0), np.float32(0.0), np.float32(0.0), np.float32(0.0), np.float32(0.0), np.float32(0.0), np.float32(0.0), np.float32(1.0), np.float32(1.0)]",-2.0,99395.5,12
2025-08-14_08-18-36,9072,"[np.float32(1.0), np.float32(0.0), np.float32(0.0), np.float32(1.0), np.float32(0.0), np.float32(1.0), np.float32(0.0), np.float32(0.0), np.float32(0.0), np.float32(0.0), np.float32(1.0), np.float32(1.0), np.float32(1.0), np.float32(0.0), np.float32(0.0), np.float32(0.0)]",-2.0,99393.5,1
2025-08-14_08-18-36,9073,"[np.float32(0.0), np.float32(0.0), np.float32(1.0), np.float32(1.0), np.float32(0.0), np.float32(0.0), np.float32(1.0), np.float32(1.0), np.float32(0.0), np.float32(0.0), np.float32(0.0), np.float32(1.0), np.float32(1.0), np.float32(1.0), np.float32(1.0), np.float32(1.0)]",-4.0,99389.5,32
2025-08-14_08-18-36,9074,"[np.float32(1.0), np.float32(1.0), np.float32(0.0), np.float32(1.0), np.float32(1.0), np.float32(1.0), np.float32(1.0), np.float32(1.0), np.float32(0.0), np.float32(0.0), np.float32(1.0), np.float32(0.0), np.float32(1.0), np.float32(1.0), np.float32(1.0), np.float32(0.0)]",4.0,99393.5,5
2025-08-14_08-18-36,9075,"[np.float32(0.0), np.float32(0.0), np.float32(0.0), np.float32(0.0), np.float32(0.0), np.float32(1.0), np.float32(1.0), np.float32(0.0), np.float32(0.0), np.float32(0.0), np.float32(1.0), np.float32(1.0), np.float32(1.0), np.float32(1.0), np.float32(0.0), np.float32(1.0)]",-1.0,99392.5,17
2025-08-14_08-18-36,9076,"[np.float32(0.0), np.float32(0.0), np.float32(1.0), np.float32(0.0), np.float32(0.0), np.float32(0.0), np.float32(0.0), np.float32(1.0), np.float32(1.0), np.float32(0.0), np.float32(1.0), np.float32(1.0), np.float32(1.0), np.float32(0.0), np.float32(1.0), np.float32(1.0)]",1.0,99393.5,27
2025-08-14_08-18-36,9077,"[np.float32(1.0), np.float32(1.0), np.float32(1.0), np.float32(0.0), np.float32(0.0), np.float32(0.0), np.float32(1.0), np.float32(1.0), np.float32(0.0), np.float32(0.0), np.float32(1.0), np.float32(1.0), np.float32(1.0), np.float32(0.0), np.float32(0.0), np.float32(0.0)]",-1.0,99392.5,32
2025-08-14_08-18-36,9078,"[np.float32(0.0), np.float32(0.0), np.float32(0.0), np.float32(1.0), np.float32(1.0), np.float32(0.0), np.float32(0.0), np.float32(0.0), np.float32(1.0), np.float32(0.0), np.float32(0.0), np.float32(0.0), np.float32(1.0), np.float32(0.0), np.float32(0.0), np.float32(1.0)]",-2.0,99390.5,26
2025-08-14_08-18-36,9079,"[np.float32(0.0), np.float32(1.0), np.float32(1.0), np.float32(1.0), np.float32(1.0), np.float32(0.0), np.float32(0.0), np.float32(0.0), np.float32(1.0), np.float32(0.0), np.float32(0.0), np.float32(0.0), np.float32(1.0), np.float32(1.0), np.float32(1.0), np.float32(1.0)]",0.0,99390.5,10
2025-08-14_08-18-36,9080,"[np.float32(0.0), np.float32(0.0), np.float32(0.0), np.float32(0.0), np.float32(1.0), np.float32(1.0), np.float32(0.0), np.float32(0.0), np.float32(1.0), np.float32(0.0), np.float32(0.0), np.float32(1.0), np.float32(1.0), np.float32(0.0), np.float32(0.0), np.float32(0.0)]",-3.0,99387.5,16
2025-08-14_08-18-36,9081,"[np.float32(1.0), np.float32(0.0), np.float32(0.0), np.float32(0.0), np.float32(0.0), np.float32(1.0), np.float32(1.0), np.float32(1.0), np.float32(1.0), np.float32(0.0), np.float32(1.0), np.float32(1.0), np.float32(0.0), np.float32(0.0), np.float32(0.0), np.float32(1.0)]",2.0,99389.5,32
2025-08-14_08-18-36,9082,"[np.float32(0.0), np.float32(0.0), np.float32(0.0), np.float32(1.0), np.float32(1.0), np.float32(1.0), np.float32(0.0), np.float32(0.0), np.float32(1.0), np.float32(0.0), np.float32(0.0), np.float32(1.0), np.float32(1.0), np.float32(1.0), np.float32(1.0), np.float32(1.0)]",-1.0,99388.5,26
2025-08-14_08-18-36,9083,"[np.float32(0.0), np.float32(0.0), np.float32(0.0), np.float32(0.0), np.float32(0.0), np.float32(0.0), np.float32(0.0), np.float32(1.0), np.float32(1.0), np.float32(1.0), np.float32(1.0), np.float32(1.0), np.float32(0.0), np.float32(0.0), np.float32(0.0), np.float32(0.0)]",-2.0,99386.5,6
2025-08-14_08-18-36,9084,"[np.float32(1.0), np.float32(0.0), np.float32(0.0), np.float32(1.0), np.float32(0.0), np.float32(0.0), np.float32(1.0), np.float32(0.0), np.float32(0.0), np.float32(1.0), np.float32(1.0), np.float32(0.0), np.float32(1.0), np.float32(1.0), np.float32(0.0), np.float32(1.0)]",0.0,99386.5,12
2025-08-14_08-18-36,9085,"[np.float32(1.0), np.float32(1.0), np.float32(1.0), np.float32(1.0), np.float32(1.0), np.float32(1.0), np.float32(0.0), np.float32(0.0), np.float32(1.0), np.float32(1.0), np.float32(0.0), np.float32(1.0), np.float32(0.0), np.float32(0.0), np.float32(1.0), np.float32(0.0)]",-1.0,99385.5,4
2025-08-14_08-18-36,9086,"[np.float32(1.0), np.float32(0.0), np.float32(1.0), np.float32(1.0), np.float32(0.0), np.float32(1.0), np.float32(0.0), np.float32(1.0), np.float32(0.0), np.float32(1.0), np.float32(0.0), np.float32(1.0), np.float32(1.0), np.float32(0.0), np.float32(0.0), np.float32(0.0)]",-4.0,99381.5,5
2025-08-14_08-18-36,9087,"[np.float32(1.0), np.float32(1.0), np.float32(0.0), np.float32(0.0), np.float32(0.0), np.float32(0.0), np.float32(0.0), np.float32(1.0), np.float32(1.0), np.float32(0.0), np.float32(0.0), np.float32(1.0), np.float32(1.0), np.float32(0.0), np.float32(0.0), np.float32(0.0)]",-1.0,99380.5,22
2025-08-14_08-18-36,9088,"[np.float32(1.0), np.float32(0.0), np.float32(1.0), np.float32(0.0), np.float32(1.0), np.float32(1.0), np.float32(0.0), np.float32(1.0), np.float32(1.0), np.float32(0.0), np.float32(0.0), np.float32(1.0), np.float32(0.0), np.float32(1.0), np.float32(0.0), np.float32(1.0)]",3.0,99383.5,32
2025-08-14_08-18-36,9089,"[np.float32(0.0), np.float32(0.0), np.float32(0.0), np.float32(0.0), np.float32(1.0), np.float32(1.0), np.float32(1.0), np.float32(0.0), np.float32(1.0), np.float32(1.0), np.float32(1.0), np.float32(0.0), np.float32(0.0), np.float32(1.0), np.float32(0.0), np.float32(0.0)]",-5.0,99378.5,24
2025-08-14_08-18-36,9090,"[np.float32(0.0), np.float32(1.0), np.float32(0.0), np.float32(1.0), np.float32(0.0), np.float32(1.0), np.float32(0.0), np.float32(1.0), np.float32(0.0), np.float32(0.0), np.float32(0.0), np.float32(0.0), np.float32(1.0), np.float32(1.0), np.float32(1.0), np.float32(1.0)]",2.0,99380.5,13
2025-08-14_08-18-36,9091,"[np.float32(0.0), np.float32(1.0), np.float32(0.0), np.float32(1.0), np.float32(0.0), np.float32(1.0), np.float32(1.0), np.float32(1.0), np.float32(0.0), np.float32(0.0), np.float32(0.0), np.float32(0.0), np.float32(1.0), np.float32(1.0), np.float32(1.0), np.float32(1.0)]",-1.0,99379.5,10
2025-08-14_08-18-36,9092,"[np.float32(0.0), np.float32(0.0), np.float32(0.0), np.float32(0.0), np.float32(0.0), np.float32(1.0), np.float32(0.0), np.float32(0.0), np.float32(1.0), np.float32(0.0), np.float32(1.0), np.float32(0.0), np.float32(0.0), np.float32(1.0), np.float32(0.0), np.float32(1.0)]",0.0,99379.5,21
2025-08-14_08-18-36,9093,"[np.float32(0.0), np.float32(1.0), np.float32(1.0), np.float32(0.0), np.float32(0.0), np.float32(1.0), np.float32(0.0), np.float32(1.0), np.float32(1.0), np.float32(0.0), np.float32(1.0), np.float32(0.0), np.float32(1.0), np.float32(1.0), np.float32(1.0), np.float32(1.0)]",29.0,99408.5,7
2025-08-14_08-18-36,9094,"[np.float32(0.0), np.float32(0.0), np.float32(1.0), np.float32(0.0), np.float32(0.0), np.float32(1.0), np.float32(1.0), np.float32(0.0), np.float32(0.0), np.float32(0.0), np.float32(0.0), np.float32(1.0), np.float32(1.0), np.float32(0.0), np.float32(0.0), np.float32(0.0)]",3.0,99411.5,6
2025-08-14_08-18-36,9095,"[np.float32(1.0), np.float32(0.0), np.float32(0.0), np.float32(0.0), np.float32(0.0), np.float32(0.0), np.float32(1.0), np.float32(1.0), np.float32(1.0), np.float32(0.0), np.float32(1.0), np.float32(0.0), np.float32(1.0), np.float32(0.0), np.float32(1.0), np.float32(0.0)]",2.0,99413.5,11
2025-08-14_08-18-36,9096,"[np.float32(0.0), np.float32(1.0), np.float32(1.0), np.float32(1.0), np.float32(1.0), np.float32(0.0), np.float32(0.0), np.float32(1.0), np.float32(0.0), np.float32(0.0), np.float32(0.0), np.float32(0.0), np.float32(0.0), np.float32(0.0), np.float32(0.0), np.float32(0.0)]",-1.0,99412.5,35
2025-08-14_08-18-36,9097,"[np.float32(1.0), np.float32(0.0), np.float32(0.0), np.float32(0.0), np.float32(0.0), np.float32(1.0), np.float32(0.0), np.float32(1.0), np.float32(1.0), np.float32(0.0), np.float32(0.0), np.float32(0.0), np.float32(1.0), np.float32(0.0), np.float32(0.0), np.float32(1.0)]",-1.0,99411.5,29
2025-08-14_08-18-36,9098,"[np.float32(0.0), np.float32(1.0), np.float32(1.0), np.float32(0.0), np.float32(0.0), np.float32(1.0), np.float32(0.0), np.float32(0.0), np.float32(1.0), np.float32(1.0), np.float32(0.0), np.float32(1.0), np.float32(0.0), np.float32(1.0), np.float32(0.0), np.float32(0.0)]",-1.0,99410.5,7
2025-08-14_08-18-36,9099,"[np.float32(0.0), np.float32(1.0), np.float32(1.0), np.float32(1.0), np.float32(0.0), np.float32(0.0), np.float32(0.0), np.float32(1.0), np.float32(1.0), np.float32(0.0), np.float32(0.0), np.float32(1.0), np.float32(1.0), np.float32(0.0), np.float32(0.0), np.float32(0.0)]",-5.0,99405.5,5
2025-08-14_08-18-36,9100,"[np.float32(0.0), np.float32(1.0), np.float32(1.0), np.float32(0.0), np.float32(1.0), np.float32(1.0), np.float32(0.0), np.float32(0.0), np.float32(1.0), np.float32(0.0), np.float32(0.0), np.float32(0.0), np.float32(1.0), np.float32(0.0), np.float32(1.0), np.float32(0.0)]",0.0,99405.5,31
2025-08-14_08-18-36,9101,"[np.float32(1.0), np.float32(0.0), np.float32(1.0), np.float32(0.0), np.float32(1.0), np.float32(1.0), np.float32(1.0), np.float32(0.0), np.float32(1.0), np.float32(0.0), np.float32(1.0), np.float32(1.0), np.float32(0.0), np.float32(0.0), np.float32(0.0), np.float32(1.0)]",-2.0,99403.5,28
2025-08-14_08-18-36,9102,"[np.float32(0.0), np.float32(1.0), np.float32(0.0), np.float32(0.0), np.float32(1.0), np.float32(0.0), np.float32(0.0), np.float32(1.0), np.float32(0.0), np.float32(1.0), np.float32(0.0), np.float32(1.0), np.float32(0.0), np.float32(1.0), np.float32(1.0), np.float32(1.0)]",-2.0,99401.5,34
2025-08-14_08-18-36,9103,"[np.float32(0.0), np.float32(0.0), np.float32(1.0), np.float32(0.0), np.float32(0.0), np.float32(0.0), np.float32(0.0), np.float32(0.0), np.float32(1.0), np.float32(1.0), np.float32(0.0), np.float32(0.0), np.float32(0.0), np.float32(0.0), np.float32(0.0), np.float32(1.0)]",-1.0,99400.5,17
2025-08-14_08-18-36,9104,"[np.float32(1.0), np.float32(1.0), np.float32(1.0), np.float32(1.0), np.float32(1.0), np.float32(0.0), np.float32(0.0), np.float32(1.0), np.float32(1.0), np.float32(0.0), np.float32(0.0), np.float32(0.0), np.float32(1.0), np.float32(1.0), np.float32(1.0), np.float32(0.0)]",0.0,99400.5,23
2025-08-14_08-18-36,9105,"[np.float32(0.0), np.float32(0.0), np.float32(0.0), np.float32(0.0), np.float32(1.0), np.float32(1.0), np.float32(0.0), np.float32(1.0), np.float32(1.0), np.float32(0.0), np.float32(0.0), np.float32(1.0), np.float32(0.0), np.float32(0.0), np.float32(0.0), np.float32(1.0)]",-4.0,99396.5,2
2025-08-14_08-18-36,9106,"[np.float32(1.0), np.float32(1.0), np.float32(0.0), np.float32(1.0), np.float32(1.0), np.float32(1.0), np.float32(1.0), np.float32(0.0), np.float32(1.0), np.float32(0.0), np.float32(0.0), np.float32(0.0), np.float32(0.0), np.float32(1.0), np.float32(0.0), np.float32(1.0)]",1.0,99397.5,2
2025-08-14_08-18-36,9107,"[np.float32(1.0), np.float32(1.0), np.float32(0.0), np.float32(1.0), np.float32(1.0), np.float32(0.0), np.float32(1.0), np.float32(0.0), np.float32(0.0), np.float32(1.0), np.float32(0.0), np.float32(1.0), np.float32(0.0), np.float32(0.0), np.float32(0.0), np.float32(1.0)]",-1.0,99396.5,14
2025-08-14_08-18-36,9108,"[np.float32(0.0), np.float32(0.0), np.float32(0.0), np.float32(1.0), np.float32(0.0), np.float32(1.0), np.float32(0.0), np.float32(1.0), np.float32(0.0), np.float32(1.0), np.float32(1.0), np.float32(0.0), np.float32(1.0), np.float32(0.0), np.float32(1.0), np.float32(0.0)]",-4.0,99392.5,18
2025-08-14_08-18-36,9109,"[np.float32(1.0), np.float32(0.0), np.float32(1.0), np.float32(0.0), np.float32(0.0), np.float32(1.0), np.float32(1.0), np.float32(0.0), np.float32(0.0), np.float32(1.0), np.float32(0.0), np.float32(0.0), np.float32(0.0), np.float32(1.0), np.float32(1.0), np.float32(1.0)]",-3.0,99389.5,29
2025-08-14_08-18-36,9110,"[np.float32(1.0), np.float32(1.0), np.float32(1.0), np.float32(1.0), np.float32(0.0), np.float32(1.0), np.float32(0.0), np.float32(0.0), np.float32(0.0), np.float32(0.0), np.float32(0.0), np.float32(1.0), np.float32(0.0), np.float32(1.0), np.float32(0.0), np.float32(1.0)]",-1.0,99388.5,2
2025-08-14_08-18-36,9111,"[np.float32(0.0), np.float32(0.0), np.float32(1.0), np.float32(0.0), np.float32(1.0), np.float32(0.0), np.float32(0.0), np.float32(1.0), np.float32(0.0), np.float32(0.0), np.float32(0.0), np.float32(0.0), np.float32(0.0), np.float32(0.0), np.float32(0.0), np.float32(0.0)]",-1.0,99387.5,34
2025-08-14_08-18-36,9112,"[np.float32(0.0), np.float32(0.0), np.float32(0.0), np.float32(0.0), np.float32(0.0), np.float32(1.0), np.float32(1.0), np.float32(1.0), np.float32(1.0), np.float32(0.0), np.float32(0.0), np.float32(0.0), np.float32(0.0), np.float32(0.0), np.float32(0.0), np.float32(0.0)]",1.0,99388.5,29
2025-08-14_08-18-36,9113,"[np.float32(1.0), np.float32(0.0), np.float32(0.0), np.float32(1.0), np.float32(1.0), np.float32(1.0), np.float32(0.0), np.float32(0.0), np.float32(0.0), np.float32(1.0), np.float32(0.0), np.float32(1.0), np.float32(1.0), np.float32(1.0), np.float32(1.0), np.float32(0.0)]",-1.0,99387.5,28
2025-08-14_08-18-36,9114,"[np.float32(0.0), np.float32(1.0), np.float32(1.0), np.float32(1.0), np.float32(0.0), np.float32(1.0), np.float32(1.0), np.float32(1.0), np.float32(1.0), np.float32(0.0), np.float32(0.0), np.float32(0.0), np.float32(1.0), np.float32(0.0), np.float32(0.0), np.float32(1.0)]",0.0,99387.5,33
2025-08-14_08-18-36,9115,"[np.float32(0.0), np.float32(1.0), np.float32(0.0), np.float32(1.0), np.float32(0.0), np.float32(1.0), np.float32(1.0), np.float32(1.0), np.float32(0.0), np.float32(0.0), np.float32(1.0), np.float32(1.0), np.float32(0.0), np.float32(1.0), np.float32(0.0), np.float32(0.0)]",2.0,99389.5,24
2025-08-14_08-18-36,9116,"[np.float32(1.0), np.float32(0.0), np.float32(1.0), np.float32(1.0), np.float32(0.0), np.float32(1.0), np.float32(0.0), np.float32(1.0), np.float32(1.0), np.float32(0.0), np.float32(1.0), np.float32(1.0), np.float32(0.0), np.float32(0.0), np.float32(1.0), np.float32(0.0)]",-1.0,99388.5,15
2025-08-14_08-18-36,9117,"[np.float32(0.0), np.float32(1.0), np.float32(0.0), np.float32(1.0), np.float32(1.0), np.float32(1.0), np.float32(1.0), np.float32(0.0), np.float32(1.0), np.float32(0.0), np.float32(0.0), np.float32(1.0), np.float32(0.0), np.float32(0.0), np.float32(0.0), np.float32(0.0)]",0.0,99388.5,1
2025-08-14_08-18-36,9118,"[np.float32(0.0), np.float32(0.0), np.float32(1.0), np.float32(0.0), np.float32(0.0), np.float32(1.0), np.float32(0.0), np.float32(1.0), np.float32(1.0), np.float32(1.0), np.float32(0.0), np.float32(1.0), np.float32(0.0), np.float32(1.0), np.float32(0.0), np.float32(1.0)]",5.0,99393.5,34
2025-08-14_08-18-36,9119,"[np.float32(0.0), np.float32(1.0), np.float32(1.0), np.float32(1.0), np.float32(1.0), np.float32(0.0), np.float32(1.0), np.float32(0.0), np.float32(0.0), np.float32(1.0), np.float32(1.0), np.float32(1.0), np.float32(0.0), np.float32(0.0), np.float32(1.0), np.float32(1.0)]",0.0,99393.5,16
2025-08-14_08-18-36,9120,"[np.float32(1.0), np.float32(1.0), np.float32(0.0), np.float32(1.0), np.float32(1.0), np.float32(0.0), np.float32(0.0), np.float32(0.0), np.float32(0.0), np.float32(0.0), np.float32(1.0), np.float32(1.0), np.float32(1.0), np.float32(0.0), np.float32(1.0), np.float32(1.0)]",-2.0,99391.5,31
2025-08-14_08-18-36,9121,"[np.float32(1.0), np.float32(0.0), np.float32(1.0), np.float32(0.0), np.float32(1.0), np.float32(0.0), np.float32(1.0), np.float32(1.0), np.float32(1.0), np.float32(1.0), np.float32(0.0), np.float32(0.0), np.float32(1.0), np.float32(0.0), np.float32(0.0), np.float32(0.0)]",-3.0,99388.5,11
2025-08-14_08-18-36,9122,"[np.float32(1.0), np.float32(0.0), np.float32(0.0), np.float32(0.0), np.float32(0.0), np.float32(1.0), np.float32(0.0), np.float32(1.0), np.float32(1.0), np.float32(0.0), np.float32(0.0), np.float32(0.0), np.float32(1.0), np.float32(1.0), np.float32(1.0), np.float32(1.0)]",-2.0,99386.5,15
2025-08-14_08-18-36,9123,"[np.float32(1.0), np.float32(1.0), np.float32(1.0), np.float32(0.0), np.float32(1.0), np.float32(1.0), np.float32(1.0), np.float32(1.0), np.float32(0.0), np.float32(0.0), np.float32(0.0), np.float32(1.0), np.float32(0.0), np.float32(0.0), np.float32(0.0), np.float32(0.0)]",2.0,99388.5,15
2025-08-14_08-18-36,9124,"[np.float32(1.0), np.float32(1.0), np.float32(1.0), np.float32(0.0), np.float32(0.0), np.float32(0.0), np.float32(0.0), np.float32(0.0), np.float32(1.0), np.float32(1.0), np.float32(0.0), np.float32(1.0), np.float32(0.0), np.float32(0.0), np.float32(1.0), np.float32(0.0)]",-2.0,99386.5,1
2025-08-14_08-18-36,9125,"[np.float32(1.0), np.float32(1.0), np.float32(0.0), np.float32(0.0), np.float32(0.0), np.float32(0.0), np.float32(1.0), np.float32(1.0), np.float32(1.0), np.float32(0.0), np.float32(0.0), np.float32(1.0), np.float32(0.0), np.float32(1.0), np.float32(0.0), np.float32(0.0)]",-2.0,99384.5,8
2025-08-14_08-18-36,9126,"[np.float32(1.0), np.float32(1.0), np.float32(0.0), np.float32(0.0), np.float32(1.0), np.float32(1.0), np.float32(0.0), np.float32(1.0), np.float32(1.0), np.float32(1.0), np.float32(0.0), np.float32(1.0), np.float32(0.0), np.float32(0.0), np.float32(0.0), np.float32(1.0)]",-5.0,99379.5,2
2025-08-14_08-18-36,9127,"[np.float32(0.0), np.float32(1.0), np.float32(0.0), np.float32(0.0), np.float32(0.0), np.float32(1.0), np.float32(1.0), np.float32(1.0), np.float32(0.0), np.float32(0.0), np.float32(1.0), np.float32(0.0), np.float32(0.0), np.float32(1.0), np.float32(1.0), np.float32(1.0)]",-3.0,99376.5,34
2025-08-14_08-18-36,9128,"[np.float32(0.0), np.float32(1.0), np.float32(1.0), np.float32(1.0), np.float32(0.0), np.float32(0.0), np.float32(1.0), np.float32(1.0), np.float32(1.0), np.float32(1.0), np.float32(0.0), np.float32(0.0), np.float32(1.0), np.float32(1.0), np.float32(0.0), np.float32(0.0)]",1.0,99377.5,29
2025-08-14_08-18-36,9129,"[np.float32(0.0), np.float32(1.0), np.float32(1.0), np.float32(1.0), np.float32(0.0), np.float32(1.0), np.float32(1.0), np.float32(1.0), np.float32(1.0), np.float32(0.0), np.float32(0.0), np.float32(0.0), np.float32(1.0), np.float32(0.0), np.float32(0.0), np.float32(0.0)]",-1.0,99376.5,25
2025-08-14_08-18-36,9130,"[np.float32(0.0), np.float32(1.0), np.float32(1.0), np.float32(0.0), np.float32(1.0), np.float32(1.0), np.float32(0.0), np.float32(1.0), np.float32(1.0), np.float32(0.0), np.float32(1.0), np.float32(0.0), np.float32(0.0), np.float32(0.0), np.float32(0.0), np.float32(1.0)]",1.0,99377.5,22
2025-08-14_08-18-36,9131,"[np.float32(1.0), np.float32(0.0), np.float32(1.0), np.float32(0.0), np.float32(0.0), np.float32(0.0), np.float32(0.0), np.float32(1.0), np.float32(0.0), np.float32(0.0), np.float32(0.0), np.float32(0.0), np.float32(1.0), np.float32(0.0), np.float32(0.0), np.float32(1.0)]",-2.0,99375.5,15
2025-08-14_08-18-36,9132,"[np.float32(1.0), np.float32(0.0), np.float32(1.0), np.float32(0.0), np.float32(0.0), np.float32(0.0), np.float32(1.0), np.float32(0.0), np.float32(0.0), np.float32(0.0), np.float32(0.0), np.float32(0.0), np.float32(1.0), np.float32(1.0), np.float32(0.0), np.float32(0.0)]",3.0,99378.5,2
2025-08-14_08-18-36,9133,"[np.float32(1.0), np.float32(1.0), np.float32(0.0), np.float32(1.0), np.float32(1.0), np.float32(0.0), np.float32(1.0), np.float32(1.0), np.float32(0.0), np.float32(1.0), np.float32(0.0), np.float32(0.0), np.float32(1.0), np.float32(0.0), np.float32(1.0), np.float32(1.0)]",-2.0,99376.5,24
2025-08-14_08-18-36,9134,"[np.float32(0.0), np.float32(1.0), np.float32(1.0), np.float32(0.0), np.float32(1.0), np.float32(1.0), np.float32(1.0), np.float32(0.0), np.float32(0.0), np.float32(0.0), np.float32(0.0), np.float32(0.0), np.float32(0.0), np.float32(0.0), np.float32(0.0), np.float32(1.0)]",-2.0,99374.5,35
2025-08-14_08-18-36,9135,"[np.float32(0.0), np.float32(0.0), np.float32(0.0), np.float32(0.0), np.float32(1.0), np.float32(1.0), np.float32(0.0), np.float32(1.0), np.float32(0.0), np.float32(0.0), np.float32(1.0), np.float32(1.0), np.float32(1.0), np.float32(1.0), np.float32(0.0), np.float32(1.0)]",0.0,99374.5,32
2025-08-14_08-18-36,9136,"[np.float32(0.0), np.float32(1.0), np.float32(0.0), np.float32(1.0), np.float32(1.0), np.float32(0.0), np.float32(0.0), np.float32(1.0), np.float32(0.0), np.float32(0.0), np.float32(1.0), np.float32(1.0), np.float32(1.0), np.float32(0.0), np.float32(1.0), np.float32(0.0)]",0.0,99374.5,21
2025-08-14_08-18-36,9137,"[np.float32(1.0), np.float32(1.0), np.float32(1.0), np.float32(1.0), np.float32(0.0), np.float32(0.0), np.float32(1.0), np.float32(0.0), np.float32(1.0), np.float32(0.0), np.float32(0.0), np.float32(0.0), np.float32(1.0), np.float32(0.0), np.float32(0.0), np.float32(0.0)]",0.0,99374.5,10
2025-08-14_08-18-36,9138,"[np.float32(0.0), np.float32(0.0), np.float32(1.0), np.float32(0.0), np.float32(1.0), np.float32(1.0), np.float32(0.0), np.float32(0.0), np.float32(1.0), np.float32(1.0), np.float32(0.0), np.float32(0.0), np.float32(1.0), np.float32(0.0), np.float32(0.0), np.float32(0.0)]",1.0,99375.5,10
2025-08-14_08-18-36,9139,"[np.float32(0.0), np.float32(0.0), np.float32(1.0), np.float32(0.0), np.float32(1.0), np.float32(0.0), np.float32(0.0), np.float32(1.0), np.float32(1.0), np.float32(1.0), np.float32(0.0), np.float32(0.0), np.float32(0.0), np.float32(1.0), np.float32(0.0), np.float32(1.0)]",-2.0,99373.5,0
2025-08-14_08-18-36,9140,"[np.float32(1.0), np.float32(0.0), np.float32(1.0), np.float32(1.0), np.float32(0.0), np.float32(0.0), np.float32(1.0), np.float32(1.0), np.float32(0.0), np.float32(0.0), np.float32(0.0), np.float32(1.0), np.float32(1.0), np.float32(0.0), np.float32(0.0), np.float32(1.0)]",-6.0,99367.5,35
2025-08-14_08-18-36,9141,"[np.float32(1.0), np.float32(0.0), np.float32(0.0), np.float32(1.0), np.float32(1.0), np.float32(0.0), np.float32(0.0), np.float32(1.0), np.float32(1.0), np.float32(1.0), np.float32(0.0), np.float32(0.0), np.float32(1.0), np.float32(1.0), np.float32(0.0), np.float32(1.0)]",-5.0,99362.5,11
2025-08-14_08-18-36,9142,"[np.float32(1.0), np.float32(1.0), np.float32(1.0), np.float32(1.0), np.float32(0.0), np.float32(1.0), np.float32(0.0), np.float32(1.0), np.float32(0.0), np.float32(1.0), np.float32(1.0), np.float32(0.0), np.float32(0.0), np.float32(1.0), np.float32(1.0), np.float32(1.0)]",4.0,99366.5,19
2025-08-14_08-18-36,9143,"[np.float32(0.0), np.float32(1.0), np.float32(1.0), np.float32(1.0), np.float32(1.0), np.float32(0.0), np.float32(1.0), np.float32(0.0), np.float32(1.0), np.float32(1.0), np.float32(0.0), np.float32(1.0), np.float32(0.0), np.float32(1.0), np.float32(1.0), np.float32(1.0)]",-3.0,99363.5,32
2025-08-14_08-18-36,9144,"[np.float32(1.0), np.float32(0.0), np.float32(0.0), np.float32(1.0), np.float32(1.0), np.float32(0.0), np.float32(0.0), np.float32(1.0), np.float32(0.0), np.float32(1.0), np.float32(1.0), np.float32(1.0), np.float32(0.0), np.float32(1.0), np.float32(0.0), np.float32(0.0)]",-3.0,99360.5,30
2025-08-14_08-18-36,9145,"[np.float32(1.0), np.float32(0.0), np.float32(0.0), np.float32(0.0), np.float32(0.0), np.float32(0.0), np.float32(0.0), np.float32(0.0), np.float32(1.0), np.float32(0.0), np.float32(0.0), np.float32(1.0), np.float32(0.0), np.float32(0.0), np.float32(0.0), np.float32(0.0)]",5.0,99365.5,30
2025-08-14_08-18-36,9146,"[np.float32(1.0), np.float32(1.0), np.float32(0.0), np.float32(1.0), np.float32(1.0), np.float32(1.0), np.float32(1.0), np.float32(1.0), np.float32(0.0), np.float32(1.0), np.float32(0.0), np.float32(1.0), np.float32(0.0), np.float32(1.0), np.float32(0.0), np.float32(1.0)]",4.0,99369.5,7
2025-08-14_08-18-36,9147,"[np.float32(0.0), np.float32(1.0), np.float32(1.0), np.float32(1.0), np.float32(0.0), np.float32(1.0), np.float32(1.0), np.float32(0.0), np.float32(0.0), np.float32(1.0), np.float32(0.0), np.float32(0.0), np.float32(0.0), np.float32(1.0), np.float32(0.0), np.float32(0.0)]",2.0,99371.5,35
2025-08-14_08-18-36,9148,"[np.float32(1.0), np.float32(0.0), np.float32(0.0), np.float32(0.0), np.float32(0.0), np.float32(0.0), np.float32(0.0), np.float32(1.0), np.float32(1.0), np.float32(0.0), np.float32(1.0), np.float32(0.0), np.float32(1.0), np.float32(0.0), np.float32(0.0), np.float32(0.0)]",0.0,99371.5,19
2025-08-14_08-18-36,9149,"[np.float32(1.0), np.float32(0.0), np.float32(0.0), np.float32(1.0), np.float32(0.0), np.float32(1.0), np.float32(1.0), np.float32(1.0), np.float32(1.0), np.float32(1.0), np.float32(0.0), np.float32(0.0), np.float32(1.0), np.float32(0.0), np.float32(0.0), np.float32(0.0)]",-3.0,99368.5,24
2025-08-14_08-18-36,9150,"[np.float32(1.0), np.float32(0.0), np.float32(1.0), np.float32(1.0), np.float32(0.0), np.float32(1.0), np.float32(1.0), np.float32(0.0), np.float32(1.0), np.float32(0.0), np.float32(1.0), np.float32(0.0), np.float32(0.0), np.float32(1.0), np.float32(1.0), np.float32(1.0)]",0.0,99368.5,20
2025-08-14_08-18-36,9151,"[np.float32(0.0), np.float32(0.0), np.float32(0.0), np.float32(0.0), np.float32(0.0), np.float32(0.0), np.float32(0.0), np.float32(1.0), np.float32(0.0), np.float32(0.0), np.float32(0.0), np.float32(0.0), np.float32(1.0), np.float32(0.0), np.float32(0.0), np.float32(0.0)]",-2.0,99366.5,30
2025-08-14_08-18-36,9152,"[np.float32(0.0), np.float32(1.0), np.float32(1.0), np.float32(0.0), np.float32(1.0), np.float32(1.0), np.float32(0.0), np.float32(0.0), np.float32(1.0), np.float32(0.0), np.float32(1.0), np.float32(1.0), np.float32(1.0), np.float32(1.0), np.float32(0.0), np.float32(0.0)]",4.0,99370.5,35
2025-08-14_08-18-36,9153,"[np.float32(0.0), np.float32(1.0), np.float32(1.0), np.float32(0.0), np.float32(0.0), np.float32(0.0), np.float32(0.0), np.float32(1.0), np.float32(0.0), np.float32(1.0), np.float32(0.0), np.float32(0.0), np.float32(0.0), np.float32(1.0), np.float32(0.0), np.float32(0.0)]",-3.0,99367.5,36
2025-08-14_08-18-36,9154,"[np.float32(1.0), np.float32(0.0), np.float32(0.0), np.float32(1.0), np.float32(1.0), np.float32(1.0), np.float32(0.0), np.float32(0.0), np.float32(0.0), np.float32(0.0), np.float32(0.0), np.float32(1.0), np.float32(1.0), np.float32(1.0), np.float32(1.0), np.float32(1.0)]",-1.0,99366.5,6
2025-08-14_08-18-36,9155,"[np.float32(1.0), np.float32(1.0), np.float32(0.0), np.float32(1.0), np.float32(1.0), np.float32(1.0), np.float32(0.0), np.float32(1.0), np.float32(0.0), np.float32(0.0), np.float32(0.0), np.float32(0.0), np.float32(1.0), np.float32(0.0), np.float32(0.0), np.float32(1.0)]",1.0,99367.5,9
2025-08-14_08-18-36,9156,"[np.float32(1.0), np.float32(1.0), np.float32(0.0), np.float32(0.0), np.float32(0.0), np.float32(1.0), np.float32(0.0), np.float32(1.0), np.float32(0.0), np.float32(0.0), np.float32(0.0), np.float32(1.0), np.float32(1.0), np.float32(1.0), np.float32(1.0), np.float32(0.0)]",2.0,99369.5,33
2025-08-14_08-18-36,9157,"[np.float32(0.0), np.float32(1.0), np.float32(1.0), np.float32(0.0), np.float32(0.0), np.float32(0.0), np.float32(0.0), np.float32(1.0), np.float32(1.0), np.float32(1.0), np.float32(1.0), np.float32(0.0), np.float32(0.0), np.float32(0.0), np.float32(1.0), np.float32(1.0)]",-5.0,99364.5,7
2025-08-14_08-18-36,9158,"[np.float32(1.0), np.float32(0.0), np.float32(1.0), np.float32(0.0), np.float32(1.0), np.float32(0.0), np.float32(0.0), np.float32(1.0), np.float32(1.0), np.float32(0.0), np.float32(0.0), np.float32(0.0), np.float32(0.0), np.float32(0.0), np.float32(1.0), np.float32(0.0)]",-3.0,99361.5,35
2025-08-14_08-18-36,9159,"[np.float32(0.0), np.float32(1.0), np.float32(1.0), np.float32(0.0), np.float32(1.0), np.float32(0.0), np.float32(0.0), np.float32(1.0), np.float32(1.0), np.float32(1.0), np.float32(1.0), np.float32(0.0), np.float32(0.0), np.float32(1.0), np.float32(1.0), np.float32(1.0)]",-1.0,99360.5,6
2025-08-14_08-18-36,9160,"[np.float32(1.0), np.float32(1.0), np.float32(1.0), np.float32(0.0), np.float32(1.0), np.float32(0.0), np.float32(0.0), np.float32(0.0), np.float32(1.0), np.float32(1.0), np.float32(1.0), np.float32(1.0), np.float32(0.0), np.float32(1.0), np.float32(1.0), np.float32(0.0)]",-2.0,99358.5,23
2025-08-14_08-18-36,9161,"[np.float32(0.0), np.float32(0.0), np.float32(0.0), np.float32(1.0), np.float32(1.0), np.float32(0.0), np.float32(1.0), np.float32(1.0), np.float32(0.0), np.float32(0.0), np.float32(0.0), np.float32(0.0), np.float32(1.0), np.float32(0.0), np.float32(1.0), np.float32(0.0)]",-1.0,99357.5,33
2025-08-14_08-18-36,9162,"[np.float32(1.0), np.float32(1.0), np.float32(0.0), np.float32(1.0), np.float32(0.0), np.float32(0.0), np.float32(0.0), np.float32(1.0), np.float32(1.0), np.float32(0.0), np.float32(0.0), np.float32(0.0), np.float32(1.0), np.float32(1.0), np.float32(0.0), np.float32(0.0)]",-2.0,99355.5,14
2025-08-14_08-18-36,9163,"[np.float32(1.0), np.float32(1.0), np.float32(0.0), np.float32(0.0), np.float32(1.0), np.float32(1.0), np.float32(0.0), np.float32(1.0), np.float32(0.0), np.float32(0.0), np.float32(0.0), np.float32(1.0), np.float32(1.0), np.float32(1.0), np.float32(0.0), np.float32(0.0)]",2.0,99357.5,24
2025-08-14_08-18-36,9164,"[np.float32(1.0), np.float32(1.0), np.float32(0.0), np.float32(1.0), np.float32(1.0), np.float32(1.0), np.float32(1.0), np.float32(1.0), np.float32(0.0), np.float32(0.0), np.float32(0.0), np.float32(0.0), np.float32(0.0), np.float32(1.0), np.float32(0.0), np.float32(1.0)]",1.0,99358.5,14
2025-08-14_08-18-36,9165,"[np.float32(0.0), np.float32(0.0), np.float32(1.0), np.float32(0.0), np.float32(1.0), np.float32(1.0), np.float32(1.0), np.float32(1.0), np.float32(1.0), np.float32(0.0), np.float32(0.0), np.float32(1.0), np.float32(0.0), np.float32(0.0), np.float32(0.0), np.float32(0.0)]",-2.0,99356.5,23
2025-08-14_08-18-36,9166,"[np.float32(0.0), np.float32(1.0), np.float32(1.0), np.float32(0.0), np.float32(0.0), np.float32(0.0), np.float32(1.0), np.float32(1.0), np.float32(1.0), np.float32(1.0), np.float32(0.0), np.float32(1.0), np.float32(1.0), np.float32(0.0), np.float32(0.0), np.float32(0.0)]",2.0,99358.5,24
2025-08-14_08-18-36,9167,"[np.float32(0.0), np.float32(0.0), np.float32(1.0), np.float32(1.0), np.float32(1.0), np.float32(1.0), np.float32(0.0), np.float32(1.0), np.float32(1.0), np.float32(1.0), np.float32(0.0), np.float32(0.0), np.float32(0.0), np.float32(0.0), np.float32(0.0), np.float32(0.0)]",-3.0,99355.5,11
2025-08-14_08-18-36,9168,"[np.float32(0.0), np.float32(0.0), np.float32(0.0), np.float32(1.0), np.float32(1.0), np.float32(1.0), np.float32(1.0), np.float32(0.0), np.float32(1.0), np.float32(1.0), np.float32(0.0), np.float32(0.0), np.float32(0.0), np.float32(0.0), np.float32(0.0), np.float32(0.0)]",-1.0,99354.5,8
2025-08-14_08-18-36,9169,"[np.float32(1.0), np.float32(1.0), np.float32(1.0), np.float32(0.0), np.float32(1.0), np.float32(1.0), np.float32(1.0), np.float32(1.0), np.float32(1.0), np.float32(1.0), np.float32(1.0), np.float32(1.0), np.float32(0.0), np.float32(1.0), np.float32(1.0), np.float32(0.0)]",2.0,99356.5,4
2025-08-14_08-18-36,9170,"[np.float32(0.0), np.float32(0.0), np.float32(0.0), np.float32(0.0), np.float32(1.0), np.float32(0.0), np.float32(1.0), np.float32(1.0), np.float32(1.0), np.float32(1.0), np.float32(1.0), np.float32(0.0), np.float32(1.0), np.float32(0.0), np.float32(0.0), np.float32(0.0)]",-1.0,99355.5,32
2025-08-14_08-18-36,9171,"[np.float32(0.0), np.float32(1.0), np.float32(1.0), np.float32(0.0), np.float32(0.0), np.float32(1.0), np.float32(0.0), np.float32(0.0), np.float32(0.0), np.float32(0.0), np.float32(0.0), np.float32(0.0), np.float32(0.0), np.float32(1.0), np.float32(1.0), np.float32(1.0)]",-1.0,99354.5,12
2025-08-14_08-18-36,9172,"[np.float32(1.0), np.float32(1.0), np.float32(1.0), np.float32(0.0), np.float32(0.0), np.float32(0.0), np.float32(0.0), np.float32(0.0), np.float32(1.0), np.float32(1.0), np.float32(0.0), np.float32(1.0), np.float32(1.0), np.float32(1.0), np.float32(1.0), np.float32(0.0)]",1.0,99355.5,4
2025-08-14_08-18-36,9173,"[np.float32(0.0), np.float32(1.0), np.float32(0.0), np.float32(1.0), np.float32(0.0), np.float32(0.0), np.float32(1.0), np.float32(0.0), np.float32(1.0), np.float32(0.0), np.float32(0.0), np.float32(1.0), np.float32(1.0), np.float32(1.0), np.float32(0.0), np.float32(1.0)]",-1.0,99354.5,17
2025-08-14_08-18-36,9174,"[np.float32(0.0), np.float32(0.0), np.float32(0.0), np.float32(1.0), np.float32(0.0), np.float32(1.0), np.float32(1.0), np.float32(1.0), np.float32(0.0), np.float32(1.0), np.float32(0.0), np.float32(1.0), np.float32(1.0), np.float32(0.0), np.float32(1.0), np.float32(1.0)]",-3.0,99351.5,12
2025-08-14_08-18-36,9175,"[np.float32(0.0), np.float32(1.0), np.float32(1.0), np.float32(1.0), np.float32(0.0), np.float32(1.0), np.float32(0.0), np.float32(0.0), np.float32(1.0), np.float32(0.0), np.float32(1.0), np.float32(0.0), np.float32(1.0), np.float32(1.0), np.float32(1.0), np.float32(0.0)]",4.0,99355.5,32
2025-08-14_08-18-36,9176,"[np.float32(0.0), np.float32(1.0), np.float32(1.0), np.float32(0.0), np.float32(1.0), np.float32(1.0), np.float32(0.0), np.float32(0.0), np.float32(0.0), np.float32(1.0), np.float32(1.0), np.float32(1.0), np.float32(1.0), np.float32(1.0), np.float32(0.0), np.float32(0.0)]",1.0,99356.5,12
2025-08-14_08-18-36,9177,"[np.float32(0.0), np.float32(1.0), np.float32(1.0), np.float32(0.0), np.float32(1.0), np.float32(1.0), np.float32(1.0), np.float32(1.0), np.float32(0.0), np.float32(0.0), np.float32(1.0), np.float32(0.0), np.float32(1.0), np.float32(1.0), np.float32(0.0), np.float32(0.0)]",-4.0,99352.5,1
2025-08-14_08-18-36,9178,"[np.float32(1.0), np.float32(0.0), np.float32(0.0), np.float32(1.0), np.float32(0.0), np.float32(0.0), np.float32(1.0), np.float32(0.0), np.float32(0.0), np.float32(1.0), np.float32(0.0), np.float32(1.0), np.float32(1.0), np.float32(1.0), np.float32(0.0), np.float32(1.0)]",-2.0,99350.5,10
2025-08-14_08-18-36,9179,"[np.float32(0.0), np.float32(0.0), np.float32(0.0), np.float32(0.0), np.float32(0.0), np.float32(1.0), np.float32(1.0), np.float32(1.0), np.float32(1.0), np.float32(1.0), np.float32(0.0), np.float32(1.0), np.float32(0.0), np.float32(1.0), np.float32(0.0), np.float32(1.0)]",1.0,99351.5,7
2025-08-14_08-18-36,9180,"[np.float32(0.0), np.float32(1.0), np.float32(0.0), np.float32(0.0), np.float32(1.0), np.float32(0.0), np.float32(1.0), np.float32(1.0), np.float32(1.0), np.float32(0.0), np.float32(0.0), np.float32(1.0), np.float32(0.0), np.float32(1.0), np.float32(0.0), np.float32(0.0)]",1.0,99352.5,9
2025-08-14_08-18-36,9181,"[np.float32(0.0), np.float32(1.0), np.float32(1.0), np.float32(0.0), np.float32(0.0), np.float32(0.0), np.float32(1.0), np.float32(1.0), np.float32(1.0), np.float32(0.0), np.float32(0.0), np.float32(1.0), np.float32(1.0), np.float32(0.0), np.float32(0.0), np.float32(1.0)]",-3.0,99349.5,29
2025-08-14_08-18-36,9182,"[np.float32(0.0), np.float32(0.0), np.float32(0.0), np.float32(1.0), np.float32(1.0), np.float32(0.0), np.float32(0.0), np.float32(1.0), np.float32(0.0), np.float32(0.0), np.float32(1.0), np.float32(1.0), np.float32(1.0), np.float32(0.0), np.float32(1.0), np.float32(0.0)]",-2.0,99347.5,19
2025-08-14_08-18-36,9183,"[np.float32(1.0), np.float32(1.0), np.float32(1.0), np.float32(1.0), np.float32(1.0), np.float32(0.0), np.float32(1.0), np.float32(1.0), np.float32(1.0), np.float32(0.0), np.float32(1.0), np.float32(1.0), np.float32(1.0), np.float32(0.0), np.float32(0.0), np.float32(0.0)]",1.0,99348.5,6
2025-08-14_08-18-36,9184,"[np.float32(1.0), np.float32(0.0), np.float32(1.0), np.float32(0.0), np.float32(0.0), np.float32(1.0), np.float32(0.0), np.float32(1.0), np.float32(1.0), np.float32(0.0), np.float32(1.0), np.float32(0.0), np.float32(1.0), np.float32(1.0), np.float32(0.0), np.float32(0.0)]",-1.0,99347.5,12
2025-08-14_08-18-36,9185,"[np.float32(0.0), np.float32(1.0), np.float32(0.0), np.float32(0.0), np.float32(0.0), np.float32(0.0), np.float32(1.0), np.float32(0.0), np.float32(0.0), np.float32(1.0), np.float32(0.0), np.float32(0.0), np.float32(1.0), np.float32(0.0), np.float32(0.0), np.float32(0.0)]",-2.0,99345.5,20
2025-08-14_08-18-36,9186,"[np.float32(0.0), np.float32(1.0), np.float32(0.0), np.float32(0.0), np.float32(1.0), np.float32(0.0), np.float32(0.0), np.float32(0.0), np.float32(0.0), np.float32(1.0), np.float32(0.0), np.float32(0.0), np.float32(0.0), np.float32(1.0), np.float32(1.0), np.float32(0.0)]",2.0,99347.5,2
2025-08-14_08-18-36,9187,"[np.float32(0.0), np.float32(0.0), np.float32(0.0), np.float32(0.0), np.float32(1.0), np.float32(1.0), np.float32(1.0), np.float32(0.0), np.float32(1.0), np.float32(0.0), np.float32(0.0), np.float32(1.0), np.float32(0.0), np.float32(1.0), np.float32(1.0), np.float32(0.0)]",1.0,99348.5,6
2025-08-14_08-18-36,9188,"[np.float32(0.0), np.float32(0.0), np.float32(1.0), np.float32(1.0), np.float32(1.0), np.float32(0.0), np.float32(0.0), np.float32(1.0), np.float32(1.0), np.float32(1.0), np.float32(0.0), np.float32(1.0), np.float32(1.0), np.float32(1.0), np.float32(1.0), np.float32(0.0)]",-3.0,99345.5,9
2025-08-14_08-18-36,9189,"[np.float32(1.0), np.float32(0.0), np.float32(1.0), np.float32(1.0), np.float32(0.0), np.float32(0.0), np.float32(1.0), np.float32(0.0), np.float32(1.0), np.float32(0.0), np.float32(0.0), np.float32(0.0), np.float32(1.0), np.float32(1.0), np.float32(0.0), np.float32(1.0)]",-1.0,99344.5,18
2025-08-14_08-18-36,9190,"[np.float32(1.0), np.float32(1.0), np.float32(0.0), np.float32(0.0), np.float32(0.0), np.float32(0.0), np.float32(0.0), np.float32(1.0), np.float32(1.0), np.float32(0.0), np.float32(0.0), np.float32(0.0), np.float32(1.0), np.float32(1.0), np.float32(0.0), np.float32(0.0)]",-4.0,99340.5,11
2025-08-14_08-18-36,9191,"[np.float32(1.0), np.float32(1.0), np.float32(1.0), np.float32(1.0), np.float32(0.0), np.float32(1.0), np.float32(0.0), np.float32(0.0), np.float32(1.0), np.float32(0.0), np.float32(0.0), np.float32(0.0), np.float32(0.0), np.float32(1.0), np.float32(0.0), np.float32(1.0)]",4.0,99344.5,25
2025-08-14_08-18-36,9192,"[np.float32(0.0), np.float32(0.0), np.float32(1.0), np.float32(1.0), np.float32(0.0), np.float32(0.0), np.float32(0.0), np.float32(1.0), np.float32(0.0), np.float32(1.0), np.float32(1.0), np.float32(0.0), np.float32(0.0), np.float32(1.0), np.float32(0.0), np.float32(1.0)]",-2.0,99342.5,0
2025-08-14_08-18-36,9193,"[np.float32(0.0), np.float32(1.0), np.float32(1.0), np.float32(1.0), np.float32(1.0), np.float32(1.0), np.float32(1.0), np.float32(0.0), np.float32(0.0), np.float32(0.0), np.float32(0.0), np.float32(0.0), np.float32(1.0), np.float32(1.0), np.float32(1.0), np.float32(0.0)]",0.0,99342.5,28
2025-08-14_08-18-36,9194,"[np.float32(0.0), np.float32(0.0), np.float32(1.0), np.float32(1.0), np.float32(0.0), np.float32(1.0), np.float32(0.0), np.float32(0.0), np.float32(1.0), np.float32(0.0), np.float32(1.0), np.float32(1.0), np.float32(1.0), np.float32(0.0), np.float32(1.0), np.float32(1.0)]",-1.0,99341.5,6
2025-08-14_08-18-36,9195,"[np.float32(1.0), np.float32(0.0), np.float32(0.0), np.float32(1.0), np.float32(0.0), np.float32(1.0), np.float32(0.0), np.float32(0.0), np.float32(0.0), np.float32(1.0), np.float32(0.0), np.float32(0.0), np.float32(1.0), np.float32(1.0), np.float32(1.0), np.float32(1.0)]",0.0,99341.5,16
2025-08-14_08-18-36,9196,"[np.float32(1.0), np.float32(0.0), np.float32(0.0), np.float32(0.0), np.float32(0.0), np.float32(1.0), np.float32(1.0), np.float32(1.0), np.float32(1.0), np.float32(1.0), np.float32(1.0), np.float32(0.0), np.float32(0.0), np.float32(0.0), np.float32(1.0), np.float32(1.0)]",4.0,99345.5,34
2025-08-14_08-18-36,9197,"[np.float32(0.0), np.float32(1.0), np.float32(0.0), np.float32(1.0), np.float32(1.0), np.float32(1.0), np.float32(0.0), np.float32(0.0), np.float32(1.0), np.float32(1.0), np.float32(1.0), np.float32(1.0), np.float32(1.0), np.float32(0.0), np.float32(0.0), np.float32(1.0)]",-3.0,99342.5,24
2025-08-14_08-18-36,9198,"[np.float32(0.0), np.float32(1.0), np.float32(0.0), np.float32(0.0), np.float32(1.0), np.float32(0.0), np.float32(0.0), np.float32(1.0), np.float32(1.0), np.float32(0.0), np.float32(1.0), np.float32(0.0), np.float32(0.0), np.float32(1.0), np.float32(1.0), np.float32(0.0)]",4.0,99346.5,29
2025-08-14_08-18-36,9199,"[np.float32(0.0), np.float32(0.0), np.float32(1.0), np.float32(1.0), np.float32(1.0), np.float32(1.0), np.float32(0.0), np.float32(1.0), np.float32(0.0), np.float32(0.0), np.float32(1.0), np.float32(1.0), np.float32(1.0), np.float32(0.0), np.float32(0.0), np.float32(0.0)]",2.0,99348.5,24
2025-08-14_08-18-36,9200,"[np.float32(0.0), np.float32(1.0), np.float32(0.0), np.float32(0.0), np.float32(0.0), np.float32(1.0), np.float32(0.0), np.float32(1.0), np.float32(1.0), np.float32(1.0), np.float32(0.0), np.float32(1.0), np.float32(0.0), np.float32(0.0), np.float32(0.0), np.float32(1.0)]",3.0,99351.5,24
2025-08-14_08-18-36,9201,"[np.float32(1.0), np.float32(1.0), np.float32(0.0), np.float32(1.0), np.float32(0.0), np.float32(1.0), np.float32(0.0), np.float32(0.0), np.float32(1.0), np.float32(1.0), np.float32(0.0), np.float32(0.0), np.float32(0.0), np.float32(1.0), np.float32(1.0), np.float32(1.0)]",1.0,99352.5,7
2025-08-14_08-18-36,9202,"[np.float32(0.0), np.float32(0.0), np.float32(0.0), np.float32(1.0), np.float32(1.0), np.float32(1.0), np.float32(1.0), np.float32(1.0), np.float32(1.0), np.float32(0.0), np.float32(0.0), np.float32(0.0), np.float32(0.0), np.float32(1.0), np.float32(0.0), np.float32(0.0)]",-2.0,99350.5,16
2025-08-14_08-18-36,9203,"[np.float32(0.0), np.float32(1.0), np.float32(0.0), np.float32(0.0), np.float32(0.0), np.float32(0.0), np.float32(1.0), np.float32(1.0), np.float32(1.0), np.float32(0.0), np.float32(0.0), np.float32(1.0), np.float32(1.0), np.float32(0.0), np.float32(0.0), np.float32(1.0)]",-1.0,99349.5,21
2025-08-14_08-18-36,9204,"[np.float32(1.0), np.float32(1.0), np.float32(1.0), np.float32(0.0), np.float32(0.0), np.float32(0.0), np.float32(1.0), np.float32(1.0), np.float32(1.0), np.float32(1.0), np.float32(1.0), np.float32(0.0), np.float32(0.0), np.float32(0.0), np.float32(0.0), np.float32(0.0)]",-1.0,99348.5,6
2025-08-14_08-18-36,9205,"[np.float32(1.0), np.float32(1.0), np.float32(1.0), np.float32(0.0), np.float32(0.0), np.float32(1.0), np.float32(0.0), np.float32(1.0), np.float32(0.0), np.float32(0.0), np.float32(0.0), np.float32(1.0), np.float32(0.0), np.float32(1.0), np.float32(0.0), np.float32(0.0)]",0.0,99348.5,16
2025-08-14_08-18-36,9206,"[np.float32(0.0), np.float32(0.0), np.float32(0.0), np.float32(1.0), np.float32(1.0), np.float32(0.0), np.float32(1.0), np.float32(0.0), np.float32(1.0), np.float32(0.0), np.float32(1.0), np.float32(1.0), np.float32(0.0), np.float32(1.0), np.float32(1.0), np.float32(1.0)]",2.0,99350.5,29
2025-08-14_08-18-36,9207,"[np.float32(0.0), np.float32(1.0), np.float32(1.0), np.float32(0.0), np.float32(1.0), np.float32(0.0), np.float32(0.0), np.float32(1.0), np.float32(1.0), np.float32(0.0), np.float32(0.0), np.float32(1.0), np.float32(1.0), np.float32(1.0), np.float32(1.0), np.float32(1.0)]",-2.0,99348.5,29
2025-08-14_08-18-36,9208,"[np.float32(1.0), np.float32(1.0), np.float32(0.0), np.float32(1.0), np.float32(0.0), np.float32(1.0), np.float32(1.0), np.float32(1.0), np.float32(1.0), np.float32(0.0), np.float32(0.0), np.float32(0.0), np.float32(1.0), np.float32(1.0), np.float32(0.0), np.float32(1.0)]",-2.0,99346.5,18
2025-08-14_08-18-36,9209,"[np.float32(0.0), np.float32(0.0), np.float32(1.0), np.float32(1.0), np.float32(1.0), np.float32(1.0), np.float32(1.0), np.float32(1.0), np.float32(1.0), np.float32(1.0), np.float32(0.0), np.float32(0.0), np.float32(0.0), np.float32(1.0), np.float32(0.0), np.float32(0.0)]",-2.0,99344.5,33
2025-08-14_08-18-36,9210,"[np.float32(1.0), np.float32(1.0), np.float32(0.0), np.float32(1.0), np.float32(0.0), np.float32(1.0), np.float32(1.0), np.float32(1.0), np.float32(0.0), np.float32(1.0), np.float32(0.0), np.float32(1.0), np.float32(0.0), np.float32(0.0), np.float32(0.0), np.float32(0.0)]",2.0,99346.5,24
2025-08-14_08-18-36,9211,"[np.float32(1.0), np.float32(0.0), np.float32(0.0), np.float32(0.0), np.float32(1.0), np.float32(1.0), np.float32(1.0), np.float32(0.0), np.float32(0.0), np.float32(0.0), np.float32(0.0), np.float32(1.0), np.float32(1.0), np.float32(0.0), np.float32(0.0), np.float32(0.0)]",1.0,99347.5,27
2025-08-14_08-18-36,9212,"[np.float32(0.0), np.float32(1.0), np.float32(0.0), np.float32(0.0), np.float32(1.0), np.float32(1.0), np.float32(0.0), np.float32(1.0), np.float32(0.0), np.float32(0.0), np.float32(0.0), np.float32(0.0), np.float32(1.0), np.float32(1.0), np.float32(1.0), np.float32(1.0)]",-1.0,99346.5,10
2025-08-14_08-18-36,9213,"[np.float32(1.0), np.float32(1.0), np.float32(0.0), np.float32(1.0), np.float32(0.0), np.float32(0.0), np.float32(1.0), np.float32(0.0), np.float32(1.0), np.float32(0.0), np.float32(0.0), np.float32(0.0), np.float32(1.0), np.float32(1.0), np.float32(0.0), np.float32(0.0)]",0.0,99346.5,33
2025-08-14_08-18-36,9214,"[np.float32(0.0), np.float32(0.0), np.float32(1.0), np.float32(0.0), np.float32(1.0), np.float32(1.0), np.float32(1.0), np.float32(1.0), np.float32(0.0), np.float32(1.0), np.float32(1.0), np.float32(1.0), np.float32(0.0), np.float32(0.0), np.float32(0.0), np.float32(0.0)]",-1.0,99345.5,32
2025-08-14_08-18-36,9215,"[np.float32(0.0), np.float32(0.0), np.float32(0.0), np.float32(1.0), np.float32(0.0), np.float32(0.0), np.float32(0.0), np.float32(1.0), np.float32(0.0), np.float32(0.0), np.float32(1.0), np.float32(1.0), np.float32(1.0), np.float32(1.0), np.float32(0.0), np.float32(0.0)]",0.0,99345.5,12
2025-08-14_08-18-36,9216,"[np.float32(1.0), np.float32(1.0), np.float32(0.0), np.float32(0.0), np.float32(0.0), np.float32(1.0), np.float32(1.0), np.float32(1.0), np.float32(1.0), np.float32(0.0), np.float32(0.0), np.float32(0.0), np.float32(0.0), np.float32(1.0), np.float32(0.0), np.float32(1.0)]",-3.0,99342.5,13
2025-08-14_08-18-36,9217,"[np.float32(1.0), np.float32(1.0), np.float32(0.0), np.float32(1.0), np.float32(1.0), np.float32(0.0), np.float32(0.0), np.float32(0.0), np.float32(1.0), np.float32(1.0), np.float32(1.0), np.float32(0.0), np.float32(1.0), np.float32(1.0), np.float32(0.0), np.float32(0.0)]",-1.0,99341.5,34
2025-08-14_08-18-36,9218,"[np.float32(1.0), np.float32(0.0), np.float32(0.0), np.float32(1.0), np.float32(0.0), np.float32(0.0), np.float32(0.0), np.float32(0.0), np.float32(1.0), np.float32(1.0), np.float32(1.0), np.float32(0.0), np.float32(0.0), np.float32(1.0), np.float32(0.0), np.float32(0.0)]",-3.0,99338.5,20
2025-08-14_08-18-36,9219,"[np.float32(0.0), np.float32(1.0), np.float32(1.0), np.float32(1.0), np.float32(0.0), np.float32(0.0), np.float32(1.0), np.float32(0.0), np.float32(0.0), np.float32(1.0), np.float32(0.0), np.float32(1.0), np.float32(1.0), np.float32(1.0), np.float32(0.0), np.float32(1.0)]",-2.0,99336.5,29
2025-08-14_08-18-36,9220,"[np.float32(1.0), np.float32(1.0), np.float32(0.0), np.float32(0.0), np.float32(0.0), np.float32(1.0), np.float32(1.0), np.float32(1.0), np.float32(1.0), np.float32(1.0), np.float32(1.0), np.float32(1.0), np.float32(0.0), np.float32(1.0), np.float32(1.0), np.float32(1.0)]",1.0,99337.5,34
2025-08-14_08-18-36,9221,"[np.float32(0.0), np.float32(0.0), np.float32(1.0), np.float32(0.0), np.float32(0.0), np.float32(1.0), np.float32(1.0), np.float32(0.0), np.float32(1.0), np.float32(1.0), np.float32(0.0), np.float32(0.0), np.float32(1.0), np.float32(1.0), np.float32(0.0), np.float32(1.0)]",-2.0,99335.5,9
2025-08-14_08-18-36,9222,"[np.float32(1.0), np.float32(0.0), np.float32(0.0), np.float32(1.0), np.float32(1.0), np.float32(0.0), np.float32(1.0), np.float32(1.0), np.float32(0.0), np.float32(1.0), np.float32(0.0), np.float32(0.0), np.float32(1.0), np.float32(1.0), np.float32(0.0), np.float32(1.0)]",3.0,99338.5,3
2025-08-14_08-18-36,9223,"[np.float32(0.0), np.float32(1.0), np.float32(1.0), np.float32(0.0), np.float32(0.0), np.float32(1.0), np.float32(0.0), np.float32(0.0), np.float32(0.0), np.float32(0.0), np.float32(0.0), np.float32(0.0), np.float32(0.0), np.float32(0.0), np.float32(0.0), np.float32(0.0)]",3.0,99341.5,0
2025-08-14_08-18-36,9224,"[np.float32(0.0), np.float32(1.0), np.float32(0.0), np.float32(0.0), np.float32(0.0), np.float32(1.0), np.float32(1.0), np.float32(1.0), np.float32(1.0), np.float32(1.0), np.float32(0.0), np.float32(0.0), np.float32(1.0), np.float32(0.0), np.float32(0.0), np.float32(0.0)]",1.0,99342.5,10
2025-08-14_08-18-36,9225,"[np.float32(1.0), np.float32(0.0), np.float32(0.0), np.float32(1.0), np.float32(0.0), np.float32(0.0), np.float32(0.0), np.float32(0.0), np.float32(1.0), np.float32(0.0), np.float32(1.0), np.float32(1.0), np.float32(0.0), np.float32(1.0), np.float32(0.0), np.float32(0.0)]",-4.0,99338.5,13
2025-08-14_08-18-36,9226,"[np.float32(0.0), np.float32(1.0), np.float32(1.0), np.float32(1.0), np.float32(1.0), np.float32(1.0), np.float32(0.0), np.float32(1.0), np.float32(0.0), np.float32(0.0), np.float32(0.0), np.float32(1.0), np.float32(0.0), np.float32(1.0), np.float32(0.0), np.float32(1.0)]",3.0,99341.5,17
2025-08-14_08-18-36,9227,"[np.float32(1.0), np.float32(1.0), np.float32(1.0), np.float32(1.0), np.float32(1.0), np.float32(1.0), np.float32(1.0), np.float32(1.0), np.float32(1.0), np.float32(0.0), np.float32(0.0), np.float32(0.0), np.float32(1.0), np.float32(0.0), np.float32(0.0), np.float32(0.0)]",-1.0,99340.5,27
2025-08-14_08-18-36,9228,"[np.float32(1.0), np.float32(0.0), np.float32(1.0), np.float32(0.0), np.float32(0.0), np.float32(0.0), np.float32(1.0), np.float32(1.0), np.float32(1.0), np.float32(1.0), np.float32(0.0), np.float32(0.0), np.float32(1.0), np.float32(0.0), np.float32(1.0), np.float32(1.0)]",0.0,99340.5,31
2025-08-14_08-18-36,9229,"[np.float32(1.0), np.float32(1.0), np.float32(0.0), np.float32(0.0), np.float32(0.0), np.float32(1.0), np.float32(0.0), np.float32(1.0), np.float32(1.0), np.float32(1.0), np.float32(0.0), np.float32(1.0), np.float32(1.0), np.float32(0.0), np.float32(0.0), np.float32(1.0)]",1.0,99341.5,28
2025-08-14_08-18-36,9230,"[np.float32(0.0), np.float32(0.0), np.float32(1.0), np.float32(0.0), np.float32(0.0), np.float32(1.0), np.float32(0.0), np.float32(0.0), np.float32(1.0), np.float32(1.0), np.float32(1.0), np.float32(1.0), np.float32(0.0), np.float32(0.0), np.float32(1.0), np.float32(0.0)]",1.0,99342.5,8
2025-08-14_08-18-36,9231,"[np.float32(1.0), np.float32(1.0), np.float32(0.0), np.float32(0.0), np.float32(1.0), np.float32(0.0), np.float32(1.0), np.float32(0.0), np.float32(1.0), np.float32(0.0), np.float32(0.0), np.float32(1.0), np.float32(0.0), np.float32(0.0), np.float32(0.0), np.float32(0.0)]",-1.0,99341.5,26
2025-08-14_08-18-36,9232,"[np.float32(1.0), np.float32(1.0), np.float32(0.0), np.float32(0.0), np.float32(1.0), np.float32(1.0), np.float32(1.0), np.float32(0.0), np.float32(0.0), np.float32(0.0), np.float32(1.0), np.float32(1.0), np.float32(0.0), np.float32(1.0), np.float32(0.0), np.float32(1.0)]",-2.0,99339.5,25
2025-08-14_08-18-36,9233,"[np.float32(0.0), np.float32(1.0), np.float32(1.0), np.float32(1.0), np.float32(0.0), np.float32(1.0), np.float32(1.0), np.float32(1.0), np.float32(1.0), np.float32(0.0), np.float32(0.0), np.float32(0.0), np.float32(1.0), np.float32(1.0), np.float32(0.0), np.float32(0.0)]",1.0,99340.5,25
2025-08-14_08-18-36,9234,"[np.float32(1.0), np.float32(0.0), np.float32(0.0), np.float32(1.0), np.float32(1.0), np.float32(1.0), np.float32(0.0), np.float32(1.0), np.float32(1.0), np.float32(1.0), np.float32(0.0), np.float32(1.0), np.float32(0.0), np.float32(1.0), np.float32(0.0), np.float32(0.0)]",2.0,99342.5,28
2025-08-14_08-18-36,9235,"[np.float32(0.0), np.float32(0.0), np.float32(0.0), np.float32(1.0), np.float32(0.0), np.float32(0.0), np.float32(1.0), np.float32(0.0), np.float32(0.0), np.float32(0.0), np.float32(0.0), np.float32(1.0), np.float32(0.0), np.float32(1.0), np.float32(0.0), np.float32(0.0)]",1.0,99343.5,29
2025-08-14_08-18-36,9236,"[np.float32(0.0), np.float32(0.0), np.float32(1.0), np.float32(1.0), np.float32(1.0), np.float32(0.0), np.float32(1.0), np.float32(1.0), np.float32(1.0), np.float32(0.0), np.float32(1.0), np.float32(1.0), np.float32(0.0), np.float32(0.0), np.float32(1.0), np.float32(0.0)]",2.0,99345.5,23
2025-08-14_08-18-36,9237,"[np.float32(1.0), np.float32(0.0), np.float32(0.0), np.float32(0.0), np.float32(1.0), np.float32(0.0), np.float32(1.0), np.float32(1.0), np.float32(0.0), np.float32(0.0), np.float32(0.0), np.float32(0.0), np.float32(1.0), np.float32(1.0), np.float32(0.0), np.float32(1.0)]",-2.0,99343.5,32
2025-08-14_08-18-36,9238,"[np.float32(1.0), np.float32(1.0), np.float32(0.0), np.float32(0.0), np.float32(0.0), np.float32(0.0), np.float32(1.0), np.float32(0.0), np.float32(1.0), np.float32(0.0), np.float32(0.0), np.float32(1.0), np.float32(1.0), np.float32(1.0), np.float32(1.0), np.float32(0.0)]",-3.0,99340.5,16
2025-08-14_08-18-36,9239,"[np.float32(1.0), np.float32(0.0), np.float32(0.0), np.float32(0.0), np.float32(1.0), np.float32(0.0), np.float32(0.0), np.float32(0.0), np.float32(1.0), np.float32(1.0), np.float32(0.0), np.float32(0.0), np.float32(0.0), np.float32(1.0), np.float32(0.0), np.float32(1.0)]",1.0,99341.5,14
2025-08-14_08-18-36,9240,"[np.float32(1.0), np.float32(1.0), np.float32(0.0), np.float32(0.0), np.float32(0.0), np.float32(1.0), np.float32(1.0), np.float32(1.0), np.float32(1.0), np.float32(0.0), np.float32(0.0), np.float32(1.0), np.float32(1.0), np.float32(1.0), np.float32(0.0), np.float32(0.0)]",2.0,99343.5,12
2025-08-14_08-18-36,9241,"[np.float32(0.0), np.float32(0.0), np.float32(1.0), np.float32(1.0), np.float32(0.0), np.float32(1.0), np.float32(1.0), np.float32(1.0), np.float32(1.0), np.float32(1.0), np.float32(0.0), np.float32(0.0), np.float32(0.0), np.float32(1.0), np.float32(1.0), np.float32(1.0)]",-2.0,99341.5,5
2025-08-14_08-18-36,9242,"[np.float32(0.0), np.float32(0.0), np.float32(0.0), np.float32(0.0), np.float32(1.0), np.float32(1.0), np.float32(1.0), np.float32(0.0), np.float32(0.0), np.float32(0.0), np.float32(1.0), np.float32(0.0), np.float32(0.0), np.float32(0.0), np.float32(0.0), np.float32(1.0)]",-3.0,99338.5,28
2025-08-14_08-18-36,9243,"[np.float32(1.0), np.float32(0.0), np.float32(0.0), np.float32(1.0), np.float32(0.0), np.float32(0.0), np.float32(1.0), np.float32(1.0), np.float32(0.0), np.float32(0.0), np.float32(0.0), np.float32(1.0), np.float32(0.0), np.float32(1.0), np.float32(1.0), np.float32(0.0)]",1.0,99339.5,36
2025-08-14_08-18-36,9244,"[np.float32(0.0), np.float32(0.0), np.float32(0.0), np.float32(0.0), np.float32(1.0), np.float32(0.0), np.float32(1.0), np.float32(1.0), np.float32(1.0), np.float32(1.0), np.float32(1.0), np.float32(1.0), np.float32(0.0), np.float32(1.0), np.float32(0.0), np.float32(0.0)]",3.0,99342.5,4
2025-08-14_08-18-36,9245,"[np.float32(0.0), np.float32(0.0), np.float32(0.0), np.float32(0.0), np.float32(0.0), np.float32(1.0), np.float32(1.0), np.float32(0.0), np.float32(1.0), np.float32(1.0), np.float32(0.0), np.float32(0.0), np.float32(0.0), np.float32(1.0), np.float32(0.0), np.float32(1.0)]",-3.0,99339.5,5
2025-08-14_08-18-36,9246,"[np.float32(0.0), np.float32(0.0), np.float32(0.0), np.float32(1.0), np.float32(0.0), np.float32(0.0), np.float32(0.0), np.float32(1.0), np.float32(0.0), np.float32(0.0), np.float32(1.0), np.float32(0.0), np.float32(0.0), np.float32(1.0), np.float32(0.0), np.float32(0.0)]",1.0,99340.5,11
2025-08-14_08-18-36,9247,"[np.float32(1.0), np.float32(1.0), np.float32(0.0), np.float32(0.0), np.float32(0.0), np.float32(0.0), np.float32(1.0), np.float32(0.0), np.float32(1.0), np.float32(1.0), np.float32(0.0), np.float32(1.0), np.float32(0.0), np.float32(0.0), np.float32(0.0), np.float32(1.0)]",1.0,99341.5,30
2025-08-14_08-18-36,9248,"[np.float32(0.0), np.float32(0.0), np.float32(0.0), np.float32(1.0), np.float32(1.0), np.float32(0.0), np.float32(1.0), np.float32(1.0), np.float32(0.0), np.float32(1.0), np.float32(0.0), np.float32(1.0), np.float32(1.0), np.float32(0.0), np.float32(0.0), np.float32(0.0)]",-1.0,99340.5,24
2025-08-14_08-18-36,9249,"[np.float32(1.0), np.float32(0.0), np.float32(0.0), np.float32(1.0), np.float32(0.0), np.float32(1.0), np.float32(0.0), np.float32(1.0), np.float32(1.0), np.float32(1.0), np.float32(0.0), np.float32(1.0), np.float32(0.0), np.float32(1.0), np.float32(1.0), np.float32(0.0)]",-3.0,99337.5,10
2025-08-14_08-18-36,9250,"[np.float32(0.0), np.float32(0.0), np.float32(0.0), np.float32(0.0), np.float32(0.0), np.float32(1.0), np.float32(0.0), np.float32(1.0), np.float32(0.0), np.float32(0.0), np.float32(0.0), np.float32(0.0), np.float32(0.0), np.float32(0.0), np.float32(0.0), np.float32(0.0)]",-2.0,99335.5,1
2025-08-14_08-18-36,9251,"[np.float32(0.0), np.float32(0.0), np.float32(1.0), np.float32(0.0), np.float32(0.0), np.float32(1.0), np.float32(1.0), np.float32(1.0), np.float32(0.0), np.float32(0.0), np.float32(1.0), np.float32(1.0), np.float32(1.0), np.float32(1.0), np.float32(0.0), np.float32(1.0)]",1.0,99336.5,22
2025-08-14_08-18-36,9252,"[np.float32(1.0), np.float32(1.0), np.float32(1.0), np.float32(0.0), np.float32(0.0), np.float32(0.0), np.float32(1.0), np.float32(1.0), np.float32(0.0), np.float32(0.0), np.float32(1.0), np.float32(0.0), np.float32(0.0), np.float32(0.0), np.float32(1.0), np.float32(0.0)]",6.0,99342.5,8
2025-08-14_08-18-36,9253,"[np.float32(0.0), np.float32(0.0), np.float32(0.0), np.float32(1.0), np.float32(0.0), np.float32(0.0), np.float32(0.0), np.float32(1.0), np.float32(0.0), np.float32(0.0), np.float32(0.0), np.float32(1.0), np.float32(1.0), np.float32(0.0), np.float32(0.0), np.float32(0.0)]",1.0,99343.5,13
2025-08-14_08-18-36,9254,"[np.float32(0.0), np.float32(1.0), np.float32(0.0), np.float32(0.0), np.float32(1.0), np.float32(1.0), np.float32(1.0), np.float32(1.0), np.float32(1.0), np.float32(1.0), np.float32(0.0), np.float32(0.0), np.float32(0.0), np.float32(1.0), np.float32(0.0), np.float32(0.0)]",2.0,99345.5,10
2025-08-14_08-18-36,9255,"[np.float32(0.0), np.float32(0.0), np.float32(1.0), np.float32(0.0), np.float32(1.0), np.float32(1.0), np.float32(0.0), np.float32(1.0), np.float32(1.0), np.float32(1.0), np.float32(0.0), np.float32(1.0), np.float32(1.0), np.float32(1.0), np.float32(0.0), np.float32(1.0)]",1.0,99346.5,25
2025-08-14_08-18-36,9256,"[np.float32(0.0), np.float32(0.0), np.float32(0.0), np.float32(1.0), np.float32(1.0), np.float32(1.0), np.float32(0.0), np.float32(1.0), np.float32(1.0), np.float32(1.0), np.float32(0.0), np.float32(0.0), np.float32(0.0), np.float32(1.0), np.float32(0.0), np.float32(1.0)]",2.0,99348.5,15
2025-08-14_08-18-36,9257,"[np.float32(0.0), np.float32(1.0), np.float32(1.0), np.float32(1.0), np.float32(0.0), np.float32(0.0), np.float32(0.0), np.float32(1.0), np.float32(0.0), np.float32(0.0), np.float32(1.0), np.float32(0.0), np.float32(1.0), np.float32(1.0), np.float32(1.0), np.float32(1.0)]",-1.0,99347.5,18
2025-08-14_08-18-36,9258,"[np.float32(1.0), np.float32(0.0), np.float32(1.0), np.float32(0.0), np.float32(0.0), np.float32(1.0), np.float32(1.0), np.float32(0.0), np.float32(0.0), np.float32(1.0), np.float32(0.0), np.float32(0.0), np.float32(0.0), np.float32(1.0), np.float32(0.0), np.float32(0.0)]",-3.0,99344.5,11
2025-08-14_08-18-36,9259,"[np.float32(0.0), np.float32(1.0), np.float32(1.0), np.float32(1.0), np.float32(0.0), np.float32(1.0), np.float32(1.0), np.float32(1.0), np.float32(1.0), np.float32(0.0), np.float32(1.0), np.float32(1.0), np.float32(0.0), np.float32(1.0), np.float32(0.0), np.float32(1.0)]",0.0,99344.5,14
2025-08-14_08-18-36,9260,"[np.float32(1.0), np.float32(0.0), np.float32(1.0), np.float32(0.0), np.float32(0.0), np.float32(0.0), np.float32(1.0), np.float32(1.0), np.float32(0.0), np.float32(0.0), np.float32(1.0), np.float32(0.0), np.float32(1.0), np.float32(1.0), np.float32(0.0), np.float32(0.0)]",-7.0,99337.5,31
2025-08-14_08-18-36,9261,"[np.float32(1.0), np.float32(0.0), np.float32(1.0), np.float32(0.0), np.float32(1.0), np.float32(0.0), np.float32(1.0), np.float32(1.0), np.float32(0.0), np.float32(0.0), np.float32(0.0), np.float32(1.0), np.float32(1.0), np.float32(1.0), np.float32(0.0), np.float32(0.0)]",0.0,99337.5,22
2025-08-14_08-18-36,9262,"[np.float32(1.0), np.float32(1.0), np.float32(0.0), np.float32(0.0), np.float32(0.0), np.float32(1.0), np.float32(0.0), np.float32(1.0), np.float32(0.0), np.float32(1.0), np.float32(1.0), np.float32(0.0), np.float32(1.0), np.float32(0.0), np.float32(1.0), np.float32(1.0)]",1.0,99338.5,19
2025-08-14_08-18-36,9263,"[np.float32(1.0), np.float32(0.0), np.float32(1.0), np.float32(1.0), np.float32(1.0), np.float32(1.0), np.float32(0.0), np.float32(0.0), np.float32(0.0), np.float32(0.0), np.float32(0.0), np.float32(0.0), np.float32(1.0), np.float32(1.0), np.float32(0.0), np.float32(0.0)]",0.0,99338.5,22
2025-08-14_08-18-36,9264,"[np.float32(1.0), np.float32(1.0), np.float32(1.0), np.float32(1.0), np.float32(1.0), np.float32(1.0), np.float32(1.0), np.float32(0.0), np.float32(0.0), np.float32(1.0), np.float32(0.0), np.float32(0.0), np.float32(0.0), np.float32(0.0), np.float32(0.0), np.float32(0.0)]",1.0,99339.5,3
2025-08-14_08-18-36,9265,"[np.float32(1.0), np.float32(0.0), np.float32(0.0), np.float32(0.0), np.float32(0.0), np.float32(0.0), np.float32(1.0), np.float32(0.0), np.float32(0.0), np.float32(0.0), np.float32(1.0), np.float32(0.0), np.float32(1.0), np.float32(1.0), np.float32(0.0), np.float32(1.0)]",-3.0,99336.5,10
2025-08-14_08-18-36,9266,"[np.float32(0.0), np.float32(1.0), np.float32(1.0), np.float32(1.0), np.float32(1.0), np.float32(1.0), np.float32(1.0), np.float32(1.0), np.float32(1.0), np.float32(1.0), np.float32(0.0), np.float32(0.0), np.float32(0.0), np.float32(1.0), np.float32(0.0), np.float32(0.0)]",0.0,99336.5,18
2025-08-14_08-18-36,9267,"[np.float32(1.0), np.float32(1.0), np.float32(0.0), np.float32(1.0), np.float32(0.0), np.float32(1.0), np.float32(1.0), np.float32(0.0), np.float32(1.0), np.float32(0.0), np.float32(0.0), np.float32(1.0), np.float32(1.0), np.float32(0.0), np.float32(0.0), np.float32(0.0)]",-3.0,99333.5,10
2025-08-14_08-18-36,9268,"[np.float32(0.0), np.float32(0.0), np.float32(0.0), np.float32(1.0), np.float32(0.0), np.float32(0.0), np.float32(1.0), np.float32(1.0), np.float32(0.0), np.float32(0.0), np.float32(0.0), np.float32(0.0), np.float32(1.0), np.float32(0.0), np.float32(0.0), np.float32(0.0)]",-2.0,99331.5,31
2025-08-14_08-18-36,9269,"[np.float32(0.0), np.float32(0.0), np.float32(0.0), np.float32(1.0), np.float32(1.0), np.float32(1.0), np.float32(0.0), np.float32(1.0), np.float32(0.0), np.float32(1.0), np.float32(1.0), np.float32(0.0), np.float32(0.0), np.float32(0.0), np.float32(1.0), np.float32(0.0)]",0.0,99331.5,25
2025-08-14_08-18-36,9270,"[np.float32(0.0), np.float32(0.0), np.float32(0.0), np.float32(1.0), np.float32(0.0), np.float32(1.0), np.float32(1.0), np.float32(1.0), np.float32(0.0), np.float32(0.0), np.float32(0.0), np.float32(1.0), np.float32(1.0), np.float32(1.0), np.float32(1.0), np.float32(1.0)]",-1.0,99330.5,22
2025-08-14_08-18-36,9271,"[np.float32(0.0), np.float32(1.0), np.float32(1.0), np.float32(0.0), np.float32(0.0), np.float32(0.0), np.float32(1.0), np.float32(0.0), np.float32(1.0), np.float32(1.0), np.float32(0.0), np.float32(0.0), np.float32(0.0), np.float32(1.0), np.float32(1.0), np.float32(0.0)]",-4.0,99326.5,21
2025-08-14_08-18-36,9272,"[np.float32(0.0), np.float32(1.0), np.float32(0.0), np.float32(0.0), np.float32(0.0), np.float32(0.0), np.float32(1.0), np.float32(1.0), np.float32(1.0), np.float32(1.0), np.float32(0.0), np.float32(0.0), np.float32(1.0), np.float32(1.0), np.float32(0.0), np.float32(0.0)]",1.0,99327.5,2
2025-08-14_08-18-36,9273,"[np.float32(1.0), np.float32(0.0), np.float32(0.0), np.float32(1.0), np.float32(0.0), np.float32(1.0), np.float32(1.0), np.float32(1.0), np.float32(1.0), np.float32(0.0), np.float32(0.0), np.float32(0.0), np.float32(1.0), np.float32(0.0), np.float32(1.0), np.float32(1.0)]",-2.0,99325.5,32
2025-08-14_08-18-36,9274,"[np.float32(0.0), np.float32(1.0), np.float32(1.0), np.float32(0.0), np.float32(0.0), np.float32(0.0), np.float32(1.0), np.float32(1.0), np.float32(1.0), np.float32(1.0), np.float32(0.0), np.float32(0.0), np.float32(1.0), np.float32(0.0), np.float32(1.0), np.float32(1.0)]",0.0,99325.5,1
2025-08-14_08-18-36,9275,"[np.float32(1.0), np.float32(1.0), np.float32(0.0), np.float32(1.0), np.float32(0.0), np.float32(1.0), np.float32(0.0), np.float32(1.0), np.float32(1.0), np.float32(0.0), np.float32(1.0), np.float32(0.0), np.float32(1.0), np.float32(0.0), np.float32(1.0), np.float32(0.0)]",3.0,99328.5,33
2025-08-14_08-18-36,9276,"[np.float32(0.0), np.float32(0.0), np.float32(0.0), np.float32(0.0), np.float32(0.0), np.float32(1.0), np.float32(0.0), np.float32(0.0), np.float32(1.0), np.float32(1.0), np.float32(0.0), np.float32(0.0), np.float32(0.0), np.float32(1.0), np.float32(0.0), np.float32(1.0)]",-2.0,99326.5,2
2025-08-14_08-18-36,9277,"[np.float32(0.0), np.float32(0.0), np.float32(1.0), np.float32(0.0), np.float32(1.0), np.float32(0.0), np.float32(1.0), np.float32(1.0), np.float32(0.0), np.float32(1.0), np.float32(0.0), np.float32(0.0), np.float32(0.0), np.float32(0.0), np.float32(0.0), np.float32(1.0)]",2.0,99328.5,17
2025-08-14_08-18-36,9278,"[np.float32(1.0), np.float32(1.0), np.float32(1.0), np.float32(0.0), np.float32(0.0), np.float32(0.0), np.float32(1.0), np.float32(1.0), np.float32(1.0), np.float32(0.0), np.float32(0.0), np.float32(1.0), np.float32(0.0), np.float32(1.0), np.float32(0.0), np.float32(0.0)]",2.0,99330.5,2
2025-08-14_08-18-36,9279,"[np.float32(0.0), np.float32(0.0), np.float32(0.0), np.float32(1.0), np.float32(1.0), np.float32(1.0), np.float32(0.0), np.float32(1.0), np.float32(1.0), np.float32(1.0), np.float32(1.0), np.float32(1.0), np.float32(0.0), np.float32(1.0), np.float32(1.0), np.float32(1.0)]",0.0,99330.5,32
2025-08-14_08-18-36,9280,"[np.float32(1.0), np.float32(0.0), np.float32(1.0), np.float32(1.0), np.float32(0.0), np.float32(0.0), np.float32(0.0), np.float32(1.0), np.float32(0.0), np.float32(1.0), np.float32(1.0), np.float32(0.0), np.float32(0.0), np.float32(1.0), np.float32(0.0), np.float32(0.0)]",1.0,99331.5,4
2025-08-14_08-18-36,9281,"[np.float32(0.0), np.float32(1.0), np.float32(0.0), np.float32(1.0), np.float32(1.0), np.float32(1.0), np.float32(1.0), np.float32(0.0), np.float32(1.0), np.float32(1.0), np.float32(0.0), np.float32(1.0), np.float32(1.0), np.float32(1.0), np.float32(0.0), np.float32(0.0)]",-3.0,99328.5,24
2025-08-14_08-18-36,9282,"[np.float32(1.0), np.float32(0.0), np.float32(0.0), np.float32(0.0), np.float32(1.0), np.float32(1.0), np.float32(1.0), np.float32(1.0), np.float32(1.0), np.float32(0.0), np.float32(0.0), np.float32(0.0), np.float32(1.0), np.float32(1.0), np.float32(0.0), np.float32(0.0)]",2.0,99330.5,18
2025-08-14_08-18-36,9283,"[np.float32(1.0), np.float32(1.0), np.float32(1.0), np.float32(0.0), np.float32(1.0), np.float32(0.0), np.float32(1.0), np.float32(0.0), np.float32(1.0), np.float32(0.0), np.float32(0.0), np.float32(0.0), np.float32(1.0), np.float32(0.0), np.float32(1.0), np.float32(1.0)]",3.0,99333.5,8
2025-08-14_08-18-36,9284,"[np.float32(0.0), np.float32(0.0), np.float32(1.0), np.float32(1.0), np.float32(0.0), np.float32(0.0), np.float32(0.0), np.float32(0.0), np.float32(0.0), np.float32(1.0), np.float32(1.0), np.float32(0.0), np.float32(1.0), np.float32(0.0), np.float32(0.0), np.float32(0.0)]",0.0,99333.5,25
2025-08-14_08-18-36,9285,"[np.float32(0.0), np.float32(1.0), np.float32(0.0), np.float32(1.0), np.float32(1.0), np.float32(1.0), np.float32(0.0), np.float32(1.0), np.float32(0.0), np.float32(1.0), np.float32(1.0), np.float32(0.0), np.float32(0.0), np.float32(0.0), np.float32(0.0), np.float32(1.0)]",-1.0,99332.5,5
2025-08-14_08-18-36,9286,"[np.float32(1.0), np.float32(1.0), np.float32(1.0), np.float32(1.0), np.float32(0.0), np.float32(0.0), np.float32(1.0), np.float32(0.0), np.float32(1.0), np.float32(1.0), np.float32(0.0), np.float32(1.0), np.float32(0.0), np.float32(1.0), np.float32(0.0), np.float32(1.0)]",0.0,99332.5,21
2025-08-14_08-18-36,9287,"[np.float32(0.0), np.float32(1.0), np.float32(1.0), np.float32(0.0), np.float32(0.0), np.float32(1.0), np.float32(1.0), np.float32(1.0), np.float32(1.0), np.float32(0.0), np.float32(0.0), np.float32(1.0), np.float32(0.0), np.float32(1.0), np.float32(0.0), np.float32(0.0)]",-3.0,99329.5,11
2025-08-14_08-18-36,9288,"[np.float32(1.0), np.float32(0.0), np.float32(1.0), np.float32(0.0), np.float32(0.0), np.float32(1.0), np.float32(1.0), np.float32(1.0), np.float32(0.0), np.float32(0.0), np.float32(1.0), np.float32(1.0), np.float32(0.0), np.float32(1.0), np.float32(0.0), np.float32(0.0)]",-3.0,99326.5,10
2025-08-14_08-18-36,9289,"[np.float32(0.0), np.float32(1.0), np.float32(1.0), np.float32(1.0), np.float32(0.0), np.float32(0.0), np.float32(1.0), np.float32(1.0), np.float32(1.0), np.float32(1.0), np.float32(0.0), np.float32(1.0), np.float32(1.0), np.float32(1.0), np.float32(0.0), np.float32(0.0)]",-2.0,99324.5,9
2025-08-14_08-18-36,9290,"[np.float32(0.0), np.float32(1.0), np.float32(1.0), np.float32(0.0), np.float32(0.0), np.float32(1.0), np.float32(0.0), np.float32(1.0), np.float32(1.0), np.float32(0.0), np.float32(0.0), np.float32(1.0), np.float32(1.0), np.float32(1.0), np.float32(1.0), np.float32(1.0)]",-2.0,99322.5,12
2025-08-14_08-18-36,9291,"[np.float32(0.0), np.float32(0.0), np.float32(1.0), np.float32(0.0), np.float32(0.0), np.float32(1.0), np.float32(0.0), np.float32(1.0), np.float32(0.0), np.float32(0.0), np.float32(0.0), np.float32(1.0), np.float32(0.0), np.float32(1.0), np.float32(1.0), np.float32(0.0)]",2.0,99324.5,19
2025-08-14_08-18-36,9292,"[np.float32(0.0), np.float32(1.0), np.float32(0.0), np.float32(0.0), np.float32(1.0), np.float32(0.0), np.float32(1.0), np.float32(1.0), np.float32(0.0), np.float32(0.0), np.float32(0.0), np.float32(1.0), np.float32(1.0), np.float32(1.0), np.float32(1.0), np.float32(0.0)]",-6.0,99318.5,31
2025-08-14_08-18-36,9293,"[np.float32(1.0), np.float32(0.0), np.float32(0.0), np.float32(0.0), np.float32(0.0), np.float32(1.0), np.float32(0.0), np.float32(1.0), np.float32(1.0), np.float32(0.0), np.float32(0.0), np.float32(0.0), np.float32(0.0), np.float32(0.0), np.float32(0.0), np.float32(1.0)]",0.0,99318.5,16
2025-08-14_08-18-36,9294,"[np.float32(0.0), np.float32(1.0), np.float32(1.0), np.float32(1.0), np.float32(1.0), np.float32(1.0), np.float32(1.0), np.float32(1.0), np.float32(0.0), np.float32(1.0), np.float32(0.0), np.float32(0.0), np.float32(1.0), np.float32(1.0), np.float32(1.0), np.float32(1.0)]",-2.0,99316.5,21
2025-08-14_08-18-36,9295,"[np.float32(1.0), np.float32(0.0), np.float32(1.0), np.float32(1.0), np.float32(0.0), np.float32(0.0), np.float32(0.0), np.float32(1.0), np.float32(0.0), np.float32(0.0), np.float32(1.0), np.float32(0.0), np.float32(1.0), np.float32(1.0), np.float32(0.0), np.float32(0.0)]",-2.0,99314.5,4
2025-08-14_08-18-36,9296,"[np.float32(0.0), np.float32(1.0), np.float32(1.0), np.float32(1.0), np.float32(1.0), np.float32(1.0), np.float32(1.0), np.float32(0.0), np.float32(1.0), np.float32(1.0), np.float32(1.0), np.float32(0.0), np.float32(0.0), np.float32(1.0), np.float32(0.0), np.float32(1.0)]",1.0,99315.5,10
2025-08-14_08-18-36,9297,"[np.float32(0.0), np.float32(1.0), np.float32(0.0), np.float32(0.0), np.float32(1.0), np.float32(1.0), np.float32(1.0), np.float32(0.0), np.float32(0.0), np.float32(0.0), np.float32(0.0), np.float32(1.0), np.float32(0.0), np.float32(0.0), np.float32(0.0), np.float32(1.0)]",1.0,99316.5,10
2025-08-14_08-18-36,9298,"[np.float32(1.0), np.float32(1.0), np.float32(0.0), np.float32(0.0), np.float32(1.0), np.float32(0.0), np.float32(0.0), np.float32(0.0), np.float32(0.0), np.float32(0.0), np.float32(1.0), np.float32(1.0), np.float32(1.0), np.float32(0.0), np.float32(0.0), np.float32(0.0)]",1.0,99317.5,15
2025-08-14_08-18-36,9299,"[np.float32(1.0), np.float32(1.0), np.float32(1.0), np.float32(0.0), np.float32(1.0), np.float32(0.0), np.float32(0.0), np.float32(0.0), np.float32(0.0), np.float32(1.0), np.float32(1.0), np.float32(1.0), np.float32(1.0), np.float32(1.0), np.float32(0.0), np.float32(0.0)]",3.0,99320.5,2
2025-08-14_08-18-36,9300,"[np.float32(0.0), np.float32(1.0), np.float32(1.0), np.float32(1.0), np.float32(0.0), np.float32(1.0), np.float32(0.0), np.float32(1.0), np.float32(1.0), np.float32(1.0), np.float32(1.0), np.float32(0.0), np.float32(1.0), np.float32(1.0), np.float32(0.0), np.float32(1.0)]",-4.0,99316.5,10
2025-08-14_08-18-36,9301,"[np.float32(1.0), np.float32(0.0), np.float32(1.0), np.float32(0.0), np.float32(1.0), np.float32(0.0), np.float32(0.0), np.float32(1.0), np.float32(0.0), np.float32(0.0), np.float32(0.0), np.float32(0.0), np.float32(1.0), np.float32(1.0), np.float32(0.0), np.float32(1.0)]",0.0,99316.5,1
2025-08-14_08-18-36,9302,"[np.float32(0.0), np.float32(1.0), np.float32(0.0), np.float32(1.0), np.float32(0.0), np.float32(1.0), np.float32(1.0), np.float32(1.0), np.float32(1.0), np.float32(0.0), np.float32(1.0), np.float32(0.0), np.float32(0.0), np.float32(1.0), np.float32(0.0), np.float32(1.0)]",-4.0,99312.5,36
2025-08-14_08-18-36,9303,"[np.float32(1.0), np.float32(1.0), np.float32(1.0), np.float32(0.0), np.float32(0.0), np.float32(1.0), np.float32(1.0), np.float32(1.0), np.float32(0.0), np.float32(1.0), np.float32(1.0), np.float32(0.0), np.float32(0.0), np.float32(1.0), np.float32(0.0), np.float32(0.0)]",1.0,99313.5,8
2025-08-14_08-18-36,9304,"[np.float32(1.0), np.float32(0.0), np.float32(0.0), np.float32(1.0), np.float32(1.0), np.float32(0.0), np.float32(0.0), np.float32(1.0), np.float32(0.0), np.float32(0.0), np.float32(0.0), np.float32(1.0), np.float32(1.0), np.float32(1.0), np.float32(0.0), np.float32(0.0)]",-1.0,99312.5,22
2025-08-14_08-18-36,9305,"[np.float32(0.0), np.float32(0.0), np.float32(1.0), np.float32(0.0), np.float32(0.0), np.float32(1.0), np.float32(1.0), np.float32(1.0), np.float32(0.0), np.float32(0.0), np.float32(0.0), np.float32(0.0), np.float32(0.0), np.float32(0.0), np.float32(0.0), np.float32(0.0)]",-1.0,99311.5,5
2025-08-14_08-18-36,9306,"[np.float32(1.0), np.float32(1.0), np.float32(0.0), np.float32(0.0), np.float32(1.0), np.float32(1.0), np.float32(1.0), np.float32(0.0), np.float32(1.0), np.float32(1.0), np.float32(0.0), np.float32(1.0), np.float32(0.0), np.float32(1.0), np.float32(0.0), np.float32(0.0)]",-2.0,99309.5,16
2025-08-14_08-18-36,9307,"[np.float32(0.0), np.float32(1.0), np.float32(0.0), np.float32(1.0), np.float32(1.0), np.float32(1.0), np.float32(1.0), np.float32(0.0), np.float32(0.0), np.float32(1.0), np.float32(0.0), np.float32(0.0), np.float32(1.0), np.float32(0.0), np.float32(1.0), np.float32(0.0)]",-2.0,99307.5,29
2025-08-14_08-18-36,9308,"[np.float32(0.0), np.float32(1.0), np.float32(0.0), np.float32(1.0), np.float32(0.0), np.float32(1.0), np.float32(0.0), np.float32(0.0), np.float32(0.0), np.float32(1.0), np.float32(0.0), np.float32(1.0), np.float32(0.0), np.float32(1.0), np.float32(0.0), np.float32(1.0)]",-1.0,99306.5,12
2025-08-14_08-18-36,9309,"[np.float32(1.0), np.float32(1.0), np.float32(0.0), np.float32(0.0), np.float32(0.0), np.float32(0.0), np.float32(1.0), np.float32(0.0), np.float32(1.0), np.float32(0.0), np.float32(1.0), np.float32(0.0), np.float32(1.0), np.float32(1.0), np.float32(0.0), np.float32(1.0)]",-3.0,99303.5,10
2025-08-14_08-18-36,9310,"[np.float32(0.0), np.float32(1.0), np.float32(1.0), np.float32(0.0), np.float32(1.0), np.float32(0.0), np.float32(1.0), np.float32(0.0), np.float32(0.0), np.float32(0.0), np.float32(1.0), np.float32(0.0), np.float32(1.0), np.float32(1.0), np.float32(0.0), np.float32(1.0)]",-6.0,99297.5,33
2025-08-14_08-18-36,9311,"[np.float32(1.0), np.float32(1.0), np.float32(0.0), np.float32(1.0), np.float32(1.0), np.float32(1.0), np.float32(0.0), np.float32(1.0), np.float32(0.0), np.float32(0.0), np.float32(0.0), np.float32(0.0), np.float32(1.0), np.float32(1.0), np.float32(1.0), np.float32(0.0)]",-2.0,99295.5,2
2025-08-14_08-18-36,9312,"[np.float32(1.0), np.float32(0.0), np.float32(1.0), np.float32(0.0), np.float32(1.0), np.float32(1.0), np.float32(1.0), np.float32(1.0), np.float32(1.0), np.float32(0.0), np.float32(0.0), np.float32(0.0), np.float32(0.0), np.float32(0.0), np.float32(1.0), np.float32(0.0)]",-1.0,99294.5,26
2025-08-14_08-18-36,9313,"[np.float32(0.0), np.float32(0.0), np.float32(1.0), np.float32(1.0), np.float32(0.0), np.float32(1.0), np.float32(1.0), np.float32(1.0), np.float32(1.0), np.float32(1.0), np.float32(0.0), np.float32(0.0), np.float32(1.0), np.float32(1.0), np.float32(0.0), np.float32(0.0)]",38.0,99332.5,7
2025-08-14_08-18-36,9314,"[np.float32(1.0), np.float32(0.0), np.float32(1.0), np.float32(1.0), np.float32(1.0), np.float32(0.0), np.float32(1.0), np.float32(0.0), np.float32(1.0), np.float32(1.0), np.float32(0.0), np.float32(1.0), np.float32(1.0), np.float32(1.0), np.float32(0.0), np.float32(0.0)]",-4.0,99328.5,14
2025-08-14_08-18-36,9315,"[np.float32(0.0), np.float32(0.0), np.float32(0.0), np.float32(0.0), np.float32(0.0), np.float32(0.0), np.float32(1.0), np.float32(1.0), np.float32(1.0), np.float32(1.0), np.float32(1.0), np.float32(1.0), np.float32(1.0), np.float32(0.0), np.float32(0.0), np.float32(0.0)]",-1.0,99327.5,28
2025-08-14_08-18-36,9316,"[np.float32(1.0), np.float32(1.0), np.float32(1.0), np.float32(1.0), np.float32(1.0), np.float32(0.0), np.float32(0.0), np.float32(0.0), np.float32(0.0), np.float32(1.0), np.float32(0.0), np.float32(0.0), np.float32(1.0), np.float32(0.0), np.float32(0.0), np.float32(1.0)]",1.0,99328.5,16
2025-08-14_08-18-36,9317,"[np.float32(1.0), np.float32(0.0), np.float32(1.0), np.float32(0.0), np.float32(1.0), np.float32(1.0), np.float32(1.0), np.float32(1.0), np.float32(1.0), np.float32(0.0), np.float32(1.0), np.float32(0.0), np.float32(0.0), np.float32(0.0), np.float32(0.0), np.float32(0.0)]",4.0,99332.5,14
2025-08-14_08-18-36,9318,"[np.float32(1.0), np.float32(0.0), np.float32(0.0), np.float32(0.0), np.float32(0.0), np.float32(1.0), np.float32(0.0), np.float32(1.0), np.float32(0.0), np.float32(0.0), np.float32(1.0), np.float32(1.0), np.float32(1.0), np.float32(0.0), np.float32(1.0), np.float32(0.0)]",-3.0,99329.5,25
2025-08-14_08-18-36,9319,"[np.float32(1.0), np.float32(1.0), np.float32(0.0), np.float32(0.0), np.float32(1.0), np.float32(0.0), np.float32(0.0), np.float32(1.0), np.float32(1.0), np.float32(0.0), np.float32(1.0), np.float32(1.0), np.float32(0.0), np.float32(1.0), np.float32(1.0), np.float32(0.0)]",1.0,99330.5,2
2025-08-14_08-18-36,9320,"[np.float32(1.0), np.float32(1.0), np.float32(0.0), np.float32(0.0), np.float32(0.0), np.float32(1.0), np.float32(0.0), np.float32(1.0), np.float32(1.0), np.float32(0.0), np.float32(1.0), np.float32(1.0), np.float32(1.0), np.float32(1.0), np.float32(0.0), np.float32(1.0)]",-5.0,99325.5,13
2025-08-14_08-18-36,9321,"[np.float32(1.0), np.float32(1.0), np.float32(0.0), np.float32(1.0), np.float32(1.0), np.float32(0.0), np.float32(0.0), np.float32(1.0), np.float32(1.0), np.float32(0.0), np.float32(0.0), np.float32(0.0), np.float32(0.0), np.float32(1.0), np.float32(0.0), np.float32(1.0)]",4.0,99329.5,15
2025-08-14_08-18-36,9322,"[np.float32(0.0), np.float32(1.0), np.float32(0.0), np.float32(0.0), np.float32(0.0), np.float32(0.0), np.float32(0.0), np.float32(0.0), np.float32(1.0), np.float32(0.0), np.float32(0.0), np.float32(1.0), np.float32(1.0), np.float32(0.0), np.float32(1.0), np.float32(0.0)]",-2.0,99327.5,21
2025-08-14_08-18-36,9323,"[np.float32(0.0), np.float32(0.0), np.float32(0.0), np.float32(0.0), np.float32(1.0), np.float32(0.0), np.float32(1.0), np.float32(1.0), np.float32(1.0), np.float32(0.0), np.float32(1.0), np.float32(0.0), np.float32(0.0), np.float32(1.0), np.float32(1.0), np.float32(0.0)]",1.0,99328.5,12
2025-08-14_08-18-36,9324,"[np.float32(1.0), np.float32(0.0), np.float32(0.0), np.float32(0.0), np.float32(1.0), np.float32(1.0), np.float32(1.0), np.float32(0.0), np.float32(1.0), np.float32(0.0), np.float32(1.0), np.float32(0.0), np.float32(1.0), np.float32(1.0), np.float32(0.0), np.float32(0.0)]",-1.0,99327.5,30
2025-08-14_08-18-36,9325,"[np.float32(1.0), np.float32(1.0), np.float32(1.0), np.float32(1.0), np.float32(0.0), np.float32(0.0), np.float32(1.0), np.float32(1.0), np.float32(1.0), np.float32(1.0), np.float32(0.0), np.float32(0.0), np.float32(0.0), np.float32(0.0), np.float32(0.0), np.float32(0.0)]",2.0,99329.5,34
2025-08-14_08-18-36,9326,"[np.float32(0.0), np.float32(1.0), np.float32(0.0), np.float32(0.0), np.float32(1.0), np.float32(1.0), np.float32(1.0), np.float32(1.0), np.float32(0.0), np.float32(0.0), np.float32(1.0), np.float32(1.0), np.float32(1.0), np.float32(1.0), np.float32(0.0), np.float32(0.0)]",-4.0,99325.5,27
2025-08-14_08-18-36,9327,"[np.float32(0.0), np.float32(1.0), np.float32(0.0), np.float32(0.0), np.float32(1.0), np.float32(1.0), np.float32(0.0), np.float32(0.0), np.float32(1.0), np.float32(0.0), np.float32(0.0), np.float32(0.0), np.float32(1.0), np.float32(0.0), np.float32(0.0), np.float32(1.0)]",-4.0,99321.5,19
2025-08-14_08-18-36,9328,"[np.float32(0.0), np.float32(1.0), np.float32(0.0), np.float32(1.0), np.float32(1.0), np.float32(0.0), np.float32(1.0), np.float32(1.0), np.float32(1.0), np.float32(1.0), np.float32(1.0), np.float32(0.0), np.float32(1.0), np.float32(0.0), np.float32(1.0), np.float32(0.0)]",-2.0,99319.5,25
2025-08-14_08-18-36,9329,"[np.float32(0.0), np.float32(0.0), np.float32(1.0), np.float32(0.0), np.float32(1.0), np.float32(0.0), np.float32(1.0), np.float32(1.0), np.float32(0.0), np.float32(0.0), np.float32(0.0), np.float32(0.0), np.float32(1.0), np.float32(1.0), np.float32(0.0), np.float32(1.0)]",-5.0,99314.5,36
2025-08-14_08-18-36,9330,"[np.float32(0.0), np.float32(1.0), np.float32(0.0), np.float32(0.0), np.float32(0.0), np.float32(1.0), np.float32(1.0), np.float32(1.0), np.float32(0.0), np.float32(0.0), np.float32(0.0), np.float32(1.0), np.float32(1.0), np.float32(1.0), np.float32(0.0), np.float32(1.0)]",-3.0,99311.5,10
2025-08-14_08-18-36,9331,"[np.float32(1.0), np.float32(1.0), np.float32(1.0), np.float32(0.0), np.float32(1.0), np.float32(1.0), np.float32(1.0), np.float32(0.0), np.float32(1.0), np.float32(0.0), np.float32(1.0), np.float32(0.0), np.float32(1.0), np.float32(1.0), np.float32(0.0), np.float32(0.0)]",-1.0,99310.5,6
2025-08-14_08-18-36,9332,"[np.float32(1.0), np.float32(1.0), np.float32(1.0), np.float32(1.0), np.float32(1.0), np.float32(1.0), np.float32(0.0), np.float32(1.0), np.float32(1.0), np.float32(0.0), np.float32(1.0), np.float32(0.0), np.float32(1.0), np.float32(0.0), np.float32(0.0), np.float32(0.0)]",2.0,99312.5,29
2025-08-14_08-18-36,9333,"[np.float32(0.0), np.float32(0.0), np.float32(1.0), np.float32(0.0), np.float32(0.0), np.float32(0.0), np.float32(1.0), np.float32(0.0), np.float32(1.0), np.float32(1.0), np.float32(0.0), np.float32(1.0), np.float32(1.0), np.float32(1.0), np.float32(0.0), np.float32(1.0)]",-2.0,99310.5,15
2025-08-14_08-18-36,9334,"[np.float32(1.0), np.float32(1.0), np.float32(1.0), np.float32(0.0), np.float32(1.0), np.float32(0.0), np.float32(0.0), np.float32(1.0), np.float32(1.0), np.float32(0.0), np.float32(0.0), np.float32(1.0), np.float32(0.0), np.float32(1.0), np.float32(1.0), np.float32(0.0)]",-5.0,99305.5,1
2025-08-14_08-18-36,9335,"[np.float32(1.0), np.float32(0.0), np.float32(0.0), np.float32(1.0), np.float32(0.0), np.float32(1.0), np.float32(1.0), np.float32(1.0), np.float32(0.0), np.float32(0.0), np.float32(1.0), np.float32(1.0), np.float32(0.0), np.float32(0.0), np.float32(0.0), np.float32(1.0)]",-3.0,99302.5,16
2025-08-14_08-18-36,9336,"[np.float32(0.0), np.float32(0.0), np.float32(0.0), np.float32(0.0), np.float32(0.0), np.float32(1.0), np.float32(0.0), np.float32(0.0), np.float32(1.0), np.float32(1.0), np.float32(0.0), np.float32(0.0), np.float32(1.0), np.float32(0.0), np.float32(0.0), np.float32(0.0)]",-4.0,99298.5,8
2025-08-14_08-18-36,9337,"[np.float32(0.0), np.float32(1.0), np.float32(1.0), np.float32(0.0), np.float32(0.0), np.float32(0.0), np.float32(0.0), np.float32(0.0), np.float32(1.0), np.float32(0.0), np.float32(1.0), np.float32(0.0), np.float32(0.0), np.float32(0.0), np.float32(0.0), np.float32(0.0)]",1.0,99299.5,33
2025-08-14_08-18-36,9338,"[np.float32(0.0), np.float32(1.0), np.float32(0.0), np.float32(0.0), np.float32(0.0), np.float32(0.0), np.float32(0.0), np.float32(1.0), np.float32(0.0), np.float32(1.0), np.float32(0.0), np.float32(0.0), np.float32(0.0), np.float32(1.0), np.float32(0.0), np.float32(0.0)]",-4.0,99295.5,27
2025-08-14_08-18-36,9339,"[np.float32(1.0), np.float32(1.0), np.float32(0.0), np.float32(1.0), np.float32(0.0), np.float32(1.0), np.float32(0.0), np.float32(1.0), np.float32(1.0), np.float32(0.0), np.float32(0.0), np.float32(0.0), np.float32(0.0), np.float32(0.0), np.float32(1.0), np.float32(1.0)]",-1.0,99294.5,15
2025-08-14_08-18-36,9340,"[np.float32(1.0), np.float32(1.0), np.float32(0.0), np.float32(0.0), np.float32(0.0), np.float32(1.0), np.float32(0.0), np.float32(1.0), np.float32(1.0), np.float32(0.0), np.float32(0.0), np.float32(0.0), np.float32(1.0), np.float32(1.0), np.float32(1.0), np.float32(1.0)]",1.0,99295.5,36
2025-08-14_08-18-36,9341,"[np.float32(0.0), np.float32(0.0), np.float32(1.0), np.float32(0.0), np.float32(0.0), np.float32(1.0), np.float32(1.0), np.float32(1.0), np.float32(0.0), np.float32(1.0), np.float32(1.0), np.float32(1.0), np.float32(1.0), np.float32(0.0), np.float32(1.0), np.float32(0.0)]",-2.0,99293.5,28
2025-08-14_08-18-36,9342,"[np.float32(0.0), np.float32(0.0), np.float32(1.0), np.float32(0.0), np.float32(0.0), np.float32(0.0), np.float32(1.0), np.float32(1.0), np.float32(1.0), np.float32(0.0), np.float32(0.0), np.float32(0.0), np.float32(0.0), np.float32(0.0), np.float32(1.0), np.float32(0.0)]",1.0,99294.5,5
2025-08-14_08-18-36,9343,"[np.float32(1.0), np.float32(0.0), np.float32(1.0), np.float32(0.0), np.float32(1.0), np.float32(0.0), np.float32(1.0), np.float32(0.0), np.float32(1.0), np.float32(0.0), np.float32(1.0), np.float32(0.0), np.float32(0.0), np.float32(1.0), np.float32(0.0), np.float32(0.0)]",3.0,99297.5,5
2025-08-14_08-18-36,9344,"[np.float32(0.0), np.float32(0.0), np.float32(0.0), np.float32(1.0), np.float32(0.0), np.float32(1.0), np.float32(1.0), np.float32(0.0), np.float32(1.0), np.float32(1.0), np.float32(0.0), np.float32(0.0), np.float32(1.0), np.float32(1.0), np.float32(0.0), np.float32(1.0)]",-3.0,99294.5,11
2025-08-14_08-18-36,9345,"[np.float32(0.0), np.float32(0.0), np.float32(1.0), np.float32(1.0), np.float32(1.0), np.float32(1.0), np.float32(1.0), np.float32(1.0), np.float32(1.0), np.float32(0.0), np.float32(0.0), np.float32(1.0), np.float32(0.0), np.float32(1.0), np.float32(0.0), np.float32(0.0)]",1.0,99295.5,22
2025-08-14_08-18-36,9346,"[np.float32(1.0), np.float32(1.0), np.float32(0.0), np.float32(0.0), np.float32(1.0), np.float32(0.0), np.float32(1.0), np.float32(0.0), np.float32(1.0), np.float32(1.0), np.float32(1.0), np.float32(0.0), np.float32(1.0), np.float32(0.0), np.float32(0.0), np.float32(1.0)]",-1.0,99294.5,28
2025-08-14_08-18-36,9347,"[np.float32(0.0), np.float32(1.0), np.float32(1.0), np.float32(1.0), np.float32(0.0), np.float32(0.0), np.float32(0.0), np.float32(1.0), np.float32(1.0), np.float32(0.0), np.float32(1.0), np.float32(0.0), np.float32(0.0), np.float32(1.0), np.float32(1.0), np.float32(1.0)]",1.0,99295.5,24
2025-08-14_08-18-36,9348,"[np.float32(1.0), np.float32(0.0), np.float32(1.0), np.float32(0.0), np.float32(1.0), np.float32(1.0), np.float32(0.0), np.float32(0.0), np.float32(0.0), np.float32(1.0), np.float32(0.0), np.float32(0.0), np.float32(0.0), np.float32(1.0), np.float32(0.0), np.float32(0.0)]",-2.0,99293.5,20
2025-08-14_08-18-36,9349,"[np.float32(0.0), np.float32(0.0), np.float32(1.0), np.float32(0.0), np.float32(0.0), np.float32(0.0), np.float32(0.0), np.float32(1.0), np.float32(1.0), np.float32(0.0), np.float32(1.0), np.float32(0.0), np.float32(0.0), np.float32(0.0), np.float32(0.0), np.float32(1.0)]",-3.0,99290.5,12
2025-08-14_08-18-36,9350,"[np.float32(0.0), np.float32(1.0), np.float32(0.0), np.float32(1.0), np.float32(1.0), np.float32(1.0), np.float32(1.0), np.float32(0.0), np.float32(0.0), np.float32(0.0), np.float32(0.0), np.float32(0.0), np.float32(1.0), np.float32(0.0), np.float32(0.0), np.float32(1.0)]",-5.0,99285.5,36
2025-08-14_08-18-36,9351,"[np.float32(0.0), np.float32(1.0), np.float32(0.0), np.float32(0.0), np.float32(1.0), np.float32(1.0), np.float32(0.0), np.float32(1.0), np.float32(1.0), np.float32(0.0), np.float32(1.0), np.float32(0.0), np.float32(0.0), np.float32(1.0), np.float32(0.0), np.float32(1.0)]",-1.0,99284.5,8
2025-08-14_08-18-36,9352,"[np.float32(0.0), np.float32(0.0), np.float32(1.0), np.float32(0.0), np.float32(0.0), np.float32(1.0), np.float32(1.0), np.float32(1.0), np.float32(0.0), np.float32(0.0), np.float32(0.0), np.float32(0.0), np.float32(1.0), np.float32(1.0), np.float32(0.0), np.float32(0.0)]",-1.0,99283.5,6
2025-08-14_08-18-36,9353,"[np.float32(0.0), np.float32(1.0), np.float32(1.0), np.float32(1.0), np.float32(1.0), np.float32(1.0), np.float32(1.0), np.float32(1.0), np.float32(1.0), np.float32(0.0), np.float32(1.0), np.float32(0.0), np.float32(0.0), np.float32(0.0), np.float32(1.0), np.float32(1.0)]",1.0,99284.5,33
2025-08-14_08-18-36,9354,"[np.float32(0.0), np.float32(0.0), np.float32(0.0), np.float32(0.0), np.float32(1.0), np.float32(1.0), np.float32(1.0), np.float32(0.0), np.float32(1.0), np.float32(1.0), np.float32(1.0), np.float32(1.0), np.float32(0.0), np.float32(1.0), np.float32(0.0), np.float32(0.0)]",0.0,99284.5,9
2025-08-14_08-18-36,9355,"[np.float32(1.0), np.float32(0.0), np.float32(0.0), np.float32(0.0), np.float32(1.0), np.float32(1.0), np.float32(1.0), np.float32(1.0), np.float32(0.0), np.float32(1.0), np.float32(0.0), np.float32(1.0), np.float32(1.0), np.float32(0.0), np.float32(0.0), np.float32(1.0)]",-2.0,99282.5,23
2025-08-14_08-18-36,9356,"[np.float32(0.0), np.float32(1.0), np.float32(1.0), np.float32(1.0), np.float32(1.0), np.float32(1.0), np.float32(1.0), np.float32(1.0), np.float32(0.0), np.float32(1.0), np.float32(1.0), np.float32(0.0), np.float32(1.0), np.float32(0.0), np.float32(1.0), np.float32(0.0)]",1.0,99283.5,4
2025-08-14_08-18-36,9357,"[np.float32(0.0), np.float32(0.0), np.float32(0.0), np.float32(1.0), np.float32(1.0), np.float32(1.0), np.float32(0.0), np.float32(1.0), np.float32(0.0), np.float32(1.0), np.float32(0.0), np.float32(0.0), np.float32(1.0), np.float32(1.0), np.float32(0.0), np.float32(0.0)]",-2.0,99281.5,14
2025-08-14_08-18-36,9358,"[np.float32(1.0), np.float32(1.0), np.float32(0.0), np.float32(1.0), np.float32(0.0), np.float32(1.0), np.float32(1.0), np.float32(0.0), np.float32(0.0), np.float32(1.0), np.float32(1.0), np.float32(0.0), np.float32(0.0), np.float32(0.0), np.float32(1.0), np.float32(0.0)]",5.0,99286.5,11
2025-08-14_08-18-36,9359,"[np.float32(0.0), np.float32(1.0), np.float32(1.0), np.float32(1.0), np.float32(0.0), np.float32(1.0), np.float32(1.0), np.float32(1.0), np.float32(1.0), np.float32(0.0), np.float32(0.0), np.float32(1.0), np.float32(1.0), np.float32(1.0), np.float32(0.0), np.float32(0.0)]",0.0,99286.5,27
2025-08-14_08-18-36,9360,"[np.float32(1.0), np.float32(1.0), np.float32(0.0), np.float32(0.0), np.float32(1.0), np.float32(0.0), np.float32(1.0), np.float32(1.0), np.float32(1.0), np.float32(0.0), np.float32(1.0), np.float32(1.0), np.float32(0.0), np.float32(0.0), np.float32(0.0), np.float32(1.0)]",4.0,99290.5,6
2025-08-14_08-18-36,9361,"[np.float32(1.0), np.float32(0.0), np.float32(0.0), np.float32(1.0), np.float32(0.0), np.float32(0.0), np.float32(0.0), np.float32(0.0), np.float32(1.0), np.float32(1.0), np.float32(0.0), np.float32(0.0), np.float32(1.0), np.float32(0.0), np.float32(0.0), np.float32(0.0)]",-5.0,99285.5,0
2025-08-14_08-18-36,9362,"[np.float32(0.0), np.float32(0.0), np.float32(1.0), np.float32(0.0), np.float32(0.0), np.float32(1.0), np.float32(0.0), np.float32(1.0), np.float32(1.0), np.float32(0.0), np.float32(1.0), np.float32(0.0), np.float32(0.0), np.float32(1.0), np.float32(0.0), np.float32(1.0)]",2.0,99287.5,17
2025-08-14_08-18-36,9363,"[np.float32(0.0), np.float32(1.0), np.float32(0.0), np.float32(1.0), np.float32(0.0), np.float32(1.0), np.float32(1.0), np.float32(1.0), np.float32(1.0), np.float32(0.0), np.float32(0.0), np.float32(1.0), np.float32(1.0), np.float32(0.0), np.float32(1.0), np.float32(0.0)]",2.0,99289.5,36
2025-08-14_08-18-36,9364,"[np.float32(0.0), np.float32(0.0), np.float32(1.0), np.float32(1.0), np.float32(1.0), np.float32(1.0), np.float32(1.0), np.float32(1.0), np.float32(1.0), np.float32(0.0), np.float32(0.0), np.float32(1.0), np.float32(0.0), np.float32(0.0), np.float32(0.0), np.float32(0.0)]",-1.0,99288.5,26
2025-08-14_08-18-36,9365,"[np.float32(1.0), np.float32(0.0), np.float32(1.0), np.float32(1.0), np.float32(1.0), np.float32(0.0), np.float32(0.0), np.float32(0.0), np.float32(1.0), np.float32(0.0), np.float32(0.0), np.float32(1.0), np.float32(1.0), np.float32(0.0), np.float32(0.0), np.float32(1.0)]",-2.0,99286.5,16
2025-08-14_08-18-36,9366,"[np.float32(1.0), np.float32(1.0), np.float32(1.0), np.float32(1.0), np.float32(0.0), np.float32(0.0), np.float32(0.0), np.float32(1.0), np.float32(1.0), np.float32(1.0), np.float32(0.0), np.float32(0.0), np.float32(0.0), np.float32(0.0), np.float32(0.0), np.float32(0.0)]",0.0,99286.5,4
2025-08-14_08-18-36,9367,"[np.float32(1.0), np.float32(0.0), np.float32(1.0), np.float32(0.0), np.float32(1.0), np.float32(0.0), np.float32(1.0), np.float32(0.0), np.float32(0.0), np.float32(0.0), np.float32(0.0), np.float32(0.0), np.float32(1.0), np.float32(1.0), np.float32(1.0), np.float32(1.0)]",2.0,99288.5,1
2025-08-14_08-18-36,9368,"[np.float32(0.0), np.float32(1.0), np.float32(1.0), np.float32(0.0), np.float32(1.0), np.float32(1.0), np.float32(1.0), np.float32(0.0), np.float32(0.0), np.float32(1.0), np.float32(1.0), np.float32(0.0), np.float32(1.0), np.float32(1.0), np.float32(0.0), np.float32(0.0)]",3.0,99291.5,8
2025-08-14_08-18-36,9369,"[np.float32(0.0), np.float32(1.0), np.float32(0.0), np.float32(0.0), np.float32(0.0), np.float32(0.0), np.float32(1.0), np.float32(1.0), np.float32(1.0), np.float32(0.0), np.float32(0.0), np.float32(1.0), np.float32(0.0), np.float32(1.0), np.float32(0.0), np.float32(0.0)]",-1.0,99290.5,17
2025-08-14_08-18-36,9370,"[np.float32(1.0), np.float32(0.0), np.float32(0.0), np.float32(0.0), np.float32(1.0), np.float32(0.0), np.float32(1.0), np.float32(1.0), np.float32(0.0), np.float32(0.0), np.float32(0.0), np.float32(0.0), np.float32(1.0), np.float32(0.0), np.float32(0.0), np.float32(0.0)]",-2.0,99288.5,24
2025-08-14_08-18-36,9371,"[np.float32(0.0), np.float32(1.0), np.float32(1.0), np.float32(1.0), np.float32(1.0), np.float32(0.0), np.float32(0.0), np.float32(0.0), np.float32(1.0), np.float32(0.0), np.float32(0.0), np.float32(1.0), np.float32(1.0), np.float32(1.0), np.float32(0.0), np.float32(1.0)]",-3.0,99285.5,11
2025-08-14_08-18-36,9372,"[np.float32(1.0), np.float32(1.0), np.float32(0.0), np.float32(0.0), np.float32(0.0), np.float32(0.0), np.float32(1.0), np.float32(1.0), np.float32(1.0), np.float32(0.0), np.float32(0.0), np.float32(1.0), np.float32(0.0), np.float32(0.0), np.float32(0.0), np.float32(0.0)]",-1.0,99284.5,16
2025-08-14_08-18-36,9373,"[np.float32(0.0), np.float32(0.0), np.float32(1.0), np.float32(1.0), np.float32(0.0), np.float32(0.0), np.float32(0.0), np.float32(0.0), np.float32(1.0), np.float32(0.0), np.float32(1.0), np.float32(1.0), np.float32(1.0), np.float32(1.0), np.float32(1.0), np.float32(0.0)]",-3.0,99281.5,6
2025-08-14_08-18-36,9374,"[np.float32(0.0), np.float32(1.0), np.float32(1.0), np.float32(0.0), np.float32(0.0), np.float32(1.0), np.float32(1.0), np.float32(1.0), np.float32(0.0), np.float32(0.0), np.float32(0.0), np.float32(1.0), np.float32(0.0), np.float32(1.0), np.float32(0.0), np.float32(0.0)]",0.0,99281.5,30
2025-08-14_08-18-36,9375,"[np.float32(1.0), np.float32(0.0), np.float32(0.0), np.float32(0.0), np.float32(0.0), np.float32(1.0), np.float32(1.0), np.float32(1.0), np.float32(0.0), np.float32(0.0), np.float32(0.0), np.float32(1.0), np.float32(0.0), np.float32(0.0), np.float32(0.0), np.float32(0.0)]",2.0,99283.5,36
2025-08-14_08-18-36,9376,"[np.float32(0.0), np.float32(1.0), np.float32(1.0), np.float32(0.0), np.float32(0.0), np.float32(1.0), np.float32(1.0), np.float32(0.0), np.float32(0.0), np.float32(1.0), np.float32(1.0), np.float32(1.0), np.float32(0.0), np.float32(1.0), np.float32(1.0), np.float32(1.0)]",0.0,99283.5,31
2025-08-14_08-18-36,9377,"[np.float32(0.0), np.float32(1.0), np.float32(1.0), np.float32(0.0), np.float32(0.0), np.float32(0.0), np.float32(1.0), np.float32(0.0), np.float32(1.0), np.float32(1.0), np.float32(1.0), np.float32(0.0), np.float32(1.0), np.float32(1.0), np.float32(1.0), np.float32(0.0)]",4.0,99287.5,26
2025-08-14_08-18-36,9378,"[np.float32(0.0), np.float32(0.0), np.float32(0.0), np.float32(1.0), np.float32(1.0), np.float32(0.0), np.float32(1.0), np.float32(1.0), np.float32(0.0), np.float32(1.0), np.float32(1.0), np.float32(0.0), np.float32(1.0), np.float32(0.0), np.float32(1.0), np.float32(1.0)]",-6.0,99281.5,32
2025-08-14_08-18-36,9379,"[np.float32(1.0), np.float32(1.0), np.float32(0.0), np.float32(0.0), np.float32(1.0), np.float32(0.0), np.float32(1.0), np.float32(1.0), np.float32(1.0), np.float32(0.0), np.float32(0.0), np.float32(0.0), np.float32(0.0), np.float32(0.0), np.float32(0.0), np.float32(1.0)]",1.0,99282.5,34
2025-08-14_08-18-36,9380,"[np.float32(1.0), np.float32(0.0), np.float32(1.0), np.float32(0.0), np.float32(1.0), np.float32(1.0), np.float32(0.0), np.float32(1.0), np.float32(0.0), np.float32(0.0), np.float32(0.0), np.float32(0.0), np.float32(0.0), np.float32(1.0), np.float32(0.0), np.float32(0.0)]",3.0,99285.5,12
2025-08-14_08-18-36,9381,"[np.float32(1.0), np.float32(0.0), np.float32(1.0), np.float32(0.0), np.float32(1.0), np.float32(1.0), np.float32(0.0), np.float32(1.0), np.float32(1.0), np.float32(0.0), np.float32(0.0), np.float32(1.0), np.float32(1.0), np.float32(1.0), np.float32(0.0), np.float32(0.0)]",1.0,99286.5,26
2025-08-14_08-18-36,9382,"[np.float32(1.0), np.float32(1.0), np.float32(1.0), np.float32(0.0), np.float32(1.0), np.float32(1.0), np.float32(0.0), np.float32(1.0), np.float32(1.0), np.float32(0.0), np.float32(1.0), np.float32(1.0), np.float32(1.0), np.float32(1.0), np.float32(0.0), np.float32(0.0)]",1.0,99287.5,2
2025-08-14_08-18-36,9383,"[np.float32(0.0), np.float32(0.0), np.float32(0.0), np.float32(0.0), np.float32(1.0), np.float32(1.0), np.float32(1.0), np.float32(1.0), np.float32(1.0), np.float32(0.0), np.float32(0.0), np.float32(0.0), np.float32(1.0), np.float32(1.0), np.float32(1.0), np.float32(1.0)]",-1.0,99286.5,19
2025-08-14_08-18-36,9384,"[np.float32(0.0), np.float32(0.0), np.float32(1.0), np.float32(0.0), np.float32(0.0), np.float32(1.0), np.float32(1.0), np.float32(1.0), np.float32(0.0), np.float32(1.0), np.float32(0.0), np.float32(1.0), np.float32(1.0), np.float32(0.0), np.float32(0.0), np.float32(0.0)]",1.0,99287.5,21
2025-08-14_08-18-36,9385,"[np.float32(0.0), np.float32(1.0), np.float32(1.0), np.float32(0.0), np.float32(0.0), np.float32(0.0), np.float32(1.0), np.float32(1.0), np.float32(0.0), np.float32(0.0), np.float32(0.0), np.float32(1.0), np.float32(1.0), np.float32(0.0), np.float32(1.0), np.float32(1.0)]",-1.0,99286.5,4
2025-08-14_08-18-36,9386,"[np.float32(0.0), np.float32(0.0), np.float32(1.0), np.float32(1.0), np.float32(0.0), np.float32(0.0), np.float32(1.0), np.float32(1.0), np.float32(0.0), np.float32(1.0), np.float32(1.0), np.float32(1.0), np.float32(0.0), np.float32(1.0), np.float32(0.0), np.float32(0.0)]",0.0,99286.5,10
2025-08-14_08-18-36,9387,"[np.float32(1.0), np.float32(1.0), np.float32(1.0), np.float32(1.0), np.float32(1.0), np.float32(1.0), np.float32(1.0), np.float32(0.0), np.float32(1.0), np.float32(1.0), np.float32(0.0), np.float32(1.0), np.float32(1.0), np.float32(1.0), np.float32(1.0), np.float32(1.0)]",1.0,99287.5,27
2025-08-14_08-18-36,9388,"[np.float32(1.0), np.float32(0.0), np.float32(1.0), np.float32(0.0), np.float32(1.0), np.float32(0.0), np.float32(1.0), np.float32(0.0), np.float32(0.0), np.float32(1.0), np.float32(0.0), np.float32(0.0), np.float32(1.0), np.float32(1.0), np.float32(0.0), np.float32(1.0)]",-1.0,99286.5,8
2025-08-14_08-18-36,9389,"[np.float32(0.0), np.float32(0.0), np.float32(0.0), np.float32(1.0), np.float32(1.0), np.float32(1.0), np.float32(1.0), np.float32(0.0), np.float32(0.0), np.float32(0.0), np.float32(0.0), np.float32(1.0), np.float32(0.0), np.float32(0.0), np.float32(1.0), np.float32(0.0)]",2.0,99288.5,30
2025-08-14_08-18-36,9390,"[np.float32(1.0), np.float32(1.0), np.float32(1.0), np.float32(0.0), np.float32(0.0), np.float32(0.0), np.float32(1.0), np.float32(1.0), np.float32(0.0), np.float32(0.0), np.float32(1.0), np.float32(1.0), np.float32(1.0), np.float32(0.0), np.float32(0.0), np.float32(0.0)]",2.0,99290.5,2
2025-08-14_08-18-36,9391,"[np.float32(1.0), np.float32(1.0), np.float32(0.0), np.float32(0.0), np.float32(0.0), np.float32(1.0), np.float32(1.0), np.float32(0.0), np.float32(0.0), np.float32(0.0), np.float32(0.0), np.float32(1.0), np.float32(0.0), np.float32(0.0), np.float32(1.0), np.float32(0.0)]",2.0,99292.5,6
2025-08-14_08-18-36,9392,"[np.float32(0.0), np.float32(1.0), np.float32(1.0), np.float32(1.0), np.float32(1.0), np.float32(1.0), np.float32(1.0), np.float32(0.0), np.float32(1.0), np.float32(0.0), np.float32(1.0), np.float32(1.0), np.float32(0.0), np.float32(0.0), np.float32(0.0), np.float32(1.0)]",0.0,99292.5,27
2025-08-14_08-18-36,9393,"[np.float32(1.0), np.float32(1.0), np.float32(0.0), np.float32(1.0), np.float32(0.0), np.float32(1.0), np.float32(1.0), np.float32(1.0), np.float32(1.0), np.float32(1.0), np.float32(0.0), np.float32(0.0), np.float32(1.0), np.float32(0.0), np.float32(0.0), np.float32(0.0)]",-1.0,99291.5,4
2025-08-14_08-18-36,9394,"[np.float32(1.0), np.float32(0.0), np.float32(0.0), np.float32(0.0), np.float32(0.0), np.float32(0.0), np.float32(1.0), np.float32(1.0), np.float32(0.0), np.float32(0.0), np.float32(1.0), np.float32(1.0), np.float32(1.0), np.float32(1.0), np.float32(0.0), np.float32(0.0)]",-4.0,99287.5,13
2025-08-14_08-18-36,9395,"[np.float32(0.0), np.float32(0.0), np.float32(1.0), np.float32(0.0), np.float32(1.0), np.float32(0.0), np.float32(0.0), np.float32(1.0), np.float32(1.0), np.float32(1.0), np.float32(0.0), np.float32(1.0), np.float32(0.0), np.float32(1.0), np.float32(1.0), np.float32(0.0)]",1.0,99288.5,19
2025-08-14_08-18-36,9396,"[np.float32(1.0), np.float32(1.0), np.float32(1.0), np.float32(0.0), np.float32(1.0), np.float32(1.0), np.float32(0.0), np.float32(1.0), np.float32(1.0), np.float32(0.0), np.float32(1.0), np.float32(1.0), np.float32(1.0), np.float32(0.0), np.float32(1.0), np.float32(0.0)]",-4.0,99284.5,3
2025-08-14_08-18-36,9397,"[np.float32(0.0), np.float32(0.0), np.float32(0.0), np.float32(1.0), np.float32(1.0), np.float32(1.0), np.float32(0.0), np.float32(1.0), np.float32(0.0), np.float32(1.0), np.float32(1.0), np.float32(0.0), np.float32(1.0), np.float32(1.0), np.float32(1.0), np.float32(0.0)]",-2.0,99282.5,31
2025-08-14_08-18-36,9398,"[np.float32(0.0), np.float32(1.0), np.float32(0.0), np.float32(1.0), np.float32(1.0), np.float32(1.0), np.float32(1.0), np.float32(0.0), np.float32(0.0), np.float32(0.0), np.float32(0.0), np.float32(1.0), np.float32(1.0), np.float32(0.0), np.float32(1.0), np.float32(0.0)]",0.0,99282.5,30
2025-08-14_08-18-36,9399,"[np.float32(1.0), np.float32(1.0), np.float32(0.0), np.float32(0.0), np.float32(1.0), np.float32(1.0), np.float32(0.0), np.float32(0.0), np.float32(1.0), np.float32(0.0), np.float32(1.0), np.float32(1.0), np.float32(1.0), np.float32(1.0), np.float32(1.0), np.float32(1.0)]",-1.0,99281.5,5
2025-08-14_08-18-36,9400,"[np.float32(1.0), np.float32(0.0), np.float32(1.0), np.float32(1.0), np.float32(1.0), np.float32(1.0), np.float32(0.0), np.float32(1.0), np.float32(1.0), np.float32(1.0), np.float32(0.0), np.float32(0.0), np.float32(0.0), np.float32(1.0), np.float32(1.0), np.float32(0.0)]",0.0,99281.5,4
2025-08-14_08-18-36,9401,"[np.float32(0.0), np.float32(0.0), np.float32(1.0), np.float32(0.0), np.float32(0.0), np.float32(0.0), np.float32(1.0), np.float32(1.0), np.float32(1.0), np.float32(1.0), np.float32(0.0), np.float32(1.0), np.float32(1.0), np.float32(0.0), np.float32(0.0), np.float32(0.0)]",-2.0,99279.5,20
2025-08-14_08-18-36,9402,"[np.float32(0.0), np.float32(0.0), np.float32(1.0), np.float32(0.0), np.float32(0.0), np.float32(0.0), np.float32(0.0), np.float32(1.0), np.float32(1.0), np.float32(1.0), np.float32(0.0), np.float32(0.0), np.float32(0.0), np.float32(0.0), np.float32(0.0), np.float32(0.0)]",1.0,99280.5,26
2025-08-14_08-18-36,9403,"[np.float32(1.0), np.float32(0.0), np.float32(0.0), np.float32(0.0), np.float32(0.0), np.float32(0.0), np.float32(0.0), np.float32(1.0), np.float32(1.0), np.float32(0.0), np.float32(1.0), np.float32(1.0), np.float32(1.0), np.float32(0.0), np.float32(1.0), np.float32(0.0)]",-1.0,99279.5,11
2025-08-14_08-18-36,9404,"[np.float32(0.0), np.float32(0.0), np.float32(0.0), np.float32(1.0), np.float32(0.0), np.float32(0.0), np.float32(1.0), np.float32(1.0), np.float32(1.0), np.float32(1.0), np.float32(1.0), np.float32(0.0), np.float32(1.0), np.float32(1.0), np.float32(0.0), np.float32(0.0)]",0.0,99279.5,15
2025-08-14_08-18-36,9405,"[np.float32(0.0), np.float32(1.0), np.float32(1.0), np.float32(0.0), np.float32(0.0), np.float32(0.0), np.float32(0.0), np.float32(1.0), np.float32(1.0), np.float32(1.0), np.float32(0.0), np.float32(0.0), np.float32(0.0), np.float32(0.0), np.float32(1.0), np.float32(1.0)]",3.0,99282.5,28
2025-08-14_08-18-36,9406,"[np.float32(1.0), np.float32(0.0), np.float32(1.0), np.float32(0.0), np.float32(0.0), np.float32(1.0), np.float32(1.0), np.float32(1.0), np.float32(1.0), np.float32(0.0), np.float32(1.0), np.float32(1.0), np.float32(0.0), np.float32(0.0), np.float32(0.0), np.float32(0.0)]",-1.0,99281.5,16
2025-08-14_08-18-36,9407,"[np.float32(0.0), np.float32(0.0), np.float32(0.0), np.float32(1.0), np.float32(1.0), np.float32(1.0), np.float32(1.0), np.float32(1.0), np.float32(0.0), np.float32(1.0), np.float32(0.0), np.float32(1.0), np.float32(1.0), np.float32(1.0), np.float32(1.0), np.float32(1.0)]",2.0,99283.5,1
2025-08-14_08-18-36,9408,"[np.float32(1.0), np.float32(1.0), np.float32(0.0), np.float32(0.0), np.float32(1.0), np.float32(0.0), np.float32(1.0), np.float32(0.0), np.float32(0.0), np.float32(1.0), np.float32(0.0), np.float32(1.0), np.float32(0.0), np.float32(1.0), np.float32(1.0), np.float32(0.0)]",-3.0,99280.5,0
2025-08-14_08-18-36,9409,"[np.float32(0.0), np.float32(0.0), np.float32(0.0), np.float32(0.0), np.float32(1.0), np.float32(1.0), np.float32(1.0), np.float32(1.0), np.float32(0.0), np.float32(0.0), np.float32(0.0), np.float32(1.0), np.float32(1.0), np.float32(0.0), np.float32(0.0), np.float32(0.0)]",-1.0,99279.5,4
2025-08-14_08-18-36,9410,"[np.float32(1.0), np.float32(1.0), np.float32(1.0), np.float32(1.0), np.float32(0.0), np.float32(0.0), np.float32(0.0), np.float32(0.0), np.float32(0.0), np.float32(1.0), np.float32(0.0), np.float32(1.0), np.float32(0.0), np.float32(0.0), np.float32(1.0), np.float32(0.0)]",0.0,99279.5,34
2025-08-14_08-18-36,9411,"[np.float32(0.0), np.float32(0.0), np.float32(1.0), np.float32(0.0), np.float32(0.0), np.float32(1.0), np.float32(0.0), np.float32(1.0), np.float32(1.0), np.float32(1.0), np.float32(1.0), np.float32(1.0), np.float32(0.0), np.float32(1.0), np.float32(1.0), np.float32(1.0)]",-4.0,99275.5,3
2025-08-14_08-18-36,9412,"[np.float32(0.0), np.float32(1.0), np.float32(0.0), np.float32(0.0), np.float32(0.0), np.float32(0.0), np.float32(0.0), np.float32(1.0), np.float32(0.0), np.float32(1.0), np.float32(1.0), np.float32(1.0), np.float32(0.0), np.float32(1.0), np.float32(0.0), np.float32(0.0)]",2.0,99277.5,35
2025-08-14_08-18-36,9413,"[np.float32(0.0), np.float32(1.0), np.float32(0.0), np.float32(0.0), np.float32(0.0), np.float32(1.0), np.float32(1.0), np.float32(1.0), np.float32(1.0), np.float32(0.0), np.float32(0.0), np.float32(0.0), np.float32(0.0), np.float32(0.0), np.float32(0.0), np.float32(0.0)]",-2.0,99275.5,16
2025-08-14_08-18-36,9414,"[np.float32(0.0), np.float32(1.0), np.float32(0.0), np.float32(0.0), np.float32(1.0), np.float32(0.0), np.float32(0.0), np.float32(1.0), np.float32(1.0), np.float32(1.0), np.float32(0.0), np.float32(0.0), np.float32(0.0), np.float32(1.0), np.float32(1.0), np.float32(0.0)]",1.0,99276.5,24
2025-08-14_08-18-36,9415,"[np.float32(0.0), np.float32(0.0), np.float32(0.0), np.float32(1.0), np.float32(1.0), np.float32(1.0), np.float32(0.0), np.float32(1.0), np.float32(1.0), np.float32(1.0), np.float32(0.0), np.float32(1.0), np.float32(0.0), np.float32(0.0), np.float32(1.0), np.float32(1.0)]",4.0,99280.5,31
2025-08-14_08-18-36,9416,"[np.float32(1.0), np.float32(1.0), np.float32(1.0), np.float32(0.0), np.float32(0.0), np.float32(1.0), np.float32(0.0), np.float32(1.0), np.float32(1.0), np.float32(1.0), np.float32(0.0), np.float32(1.0), np.float32(0.0), np.float32(1.0), np.float32(1.0), np.float32(1.0)]",2.0,99282.5,21
2025-08-14_08-18-36,9417,"[np.float32(0.0), np.float32(1.0), np.float32(1.0), np.float32(1.0), np.float32(1.0), np.float32(1.0), np.float32(1.0), np.float32(1.0), np.float32(1.0), np.float32(0.0), np.float32(0.0), np.float32(1.0), np.float32(1.0), np.float32(1.0), np.float32(0.0), np.float32(0.0)]",1.0,99283.5,4
2025-08-14_08-18-36,9418,"[np.float32(1.0), np.float32(0.0), np.float32(0.0), np.float32(0.0), np.float32(0.0), np.float32(1.0), np.float32(0.0), np.float32(0.0), np.float32(0.0), np.float32(0.0), np.float32(1.0), np.float32(0.0), np.float32(0.0), np.float32(1.0), np.float32(0.0), np.float32(1.0)]",3.0,99286.5,26
2025-08-14_08-18-36,9419,"[np.float32(1.0), np.float32(0.0), np.float32(1.0), np.float32(0.0), np.float32(1.0), np.float32(0.0), np.float32(1.0), np.float32(1.0), np.float32(1.0), np.float32(0.0), np.float32(1.0), np.float32(0.0), np.float32(0.0), np.float32(1.0), np.float32(0.0), np.float32(1.0)]",-2.0,99284.5,36
2025-08-14_08-18-36,9420,"[np.float32(1.0), np.float32(1.0), np.float32(0.0), np.float32(0.0), np.float32(1.0), np.float32(0.0), np.float32(1.0), np.float32(1.0), np.float32(1.0), np.float32(0.0), np.float32(0.0), np.float32(0.0), np.float32(1.0), np.float32(0.0), np.float32(1.0), np.float32(0.0)]",0.0,99284.5,36
2025-08-14_08-18-36,9421,"[np.float32(0.0), np.float32(0.0), np.float32(1.0), np.float32(0.0), np.float32(0.0), np.float32(1.0), np.float32(0.0), np.float32(1.0), np.float32(0.0), np.float32(1.0), np.float32(1.0), np.float32(0.0), np.float32(1.0), np.float32(0.0), np.float32(1.0), np.float32(0.0)]",3.0,99287.5,24
2025-08-14_08-18-36,9422,"[np.float32(0.0), np.float32(1.0), np.float32(1.0), np.float32(0.0), np.float32(0.0), np.float32(1.0), np.float32(1.0), np.float32(1.0), np.float32(1.0), np.float32(0.0), np.float32(1.0), np.float32(1.0), np.float32(0.0), np.float32(1.0), np.float32(1.0), np.float32(1.0)]",0.0,99287.5,21
2025-08-14_08-18-36,9423,"[np.float32(1.0), np.float32(1.0), np.float32(1.0), np.float32(1.0), np.float32(0.0), np.float32(0.0), np.float32(1.0), np.float32(0.0), np.float32(0.0), np.float32(0.0), np.float32(1.0), np.float32(1.0), np.float32(1.0), np.float32(1.0), np.float32(0.0), np.float32(1.0)]",0.0,99287.5,17
2025-08-14_08-18-36,9424,"[np.float32(1.0), np.float32(0.0), np.float32(0.0), np.float32(0.0), np.float32(0.0), np.float32(0.0), np.float32(1.0), np.float32(1.0), np.float32(1.0), np.float32(1.0), np.float32(0.0), np.float32(1.0), np.float32(0.0), np.float32(1.0), np.float32(0.0), np.float32(0.0)]",-2.0,99285.5,23
2025-08-14_08-18-36,9425,"[np.float32(1.0), np.float32(1.0), np.float32(1.0), np.float32(1.0), np.float32(0.0), np.float32(1.0), np.float32(1.0), np.float32(1.0), np.float32(0.0), np.float32(1.0), np.float32(1.0), np.float32(0.0), np.float32(1.0), np.float32(1.0), np.float32(1.0), np.float32(1.0)]",-4.0,99281.5,30
2025-08-14_08-18-36,9426,"[np.float32(1.0), np.float32(0.0), np.float32(1.0), np.float32(1.0), np.float32(0.0), np.float32(1.0), np.float32(1.0), np.float32(1.0), np.float32(0.0), np.float32(0.0), np.float32(1.0), np.float32(1.0), np.float32(0.0), np.float32(0.0), np.float32(1.0), np.float32(0.0)]",1.0,99282.5,16
2025-08-14_08-18-36,9427,"[np.float32(0.0), np.float32(1.0), np.float32(0.0), np.float32(1.0), np.float32(0.0), np.float32(1.0), np.float32(1.0), np.float32(0.0), np.float32(1.0), np.float32(0.0), np.float32(0.0), np.float32(0.0), np.float32(1.0), np.float32(1.0), np.float32(1.0), np.float32(0.0)]",-1.0,99281.5,23
2025-08-14_08-18-36,9428,"[np.float32(1.0), np.float32(0.0), np.float32(0.0), np.float32(1.0), np.float32(1.0), np.float32(0.0), np.float32(1.0), np.float32(0.0), np.float32(1.0), np.float32(0.0), np.float32(0.0), np.float32(0.0), np.float32(0.0), np.float32(0.0), np.float32(0.0), np.float32(0.0)]",2.0,99283.5,11
2025-08-14_08-18-36,9429,"[np.float32(0.0), np.float32(1.0), np.float32(0.0), np.float32(0.0), np.float32(0.0), np.float32(0.0), np.float32(0.0), np.float32(1.0), np.float32(0.0), np.float32(0.0), np.float32(0.0), np.float32(0.0), np.float32(0.0), np.float32(0.0), np.float32(1.0), np.float32(0.0)]",2.0,99285.5,10
2025-08-14_08-18-36,9430,"[np.float32(1.0), np.float32(0.0), np.float32(0.0), np.float32(0.0), np.float32(0.0), np.float32(1.0), np.float32(0.0), np.float32(1.0), np.float32(1.0), np.float32(0.0), np.float32(0.0), np.float32(1.0), np.float32(1.0), np.float32(1.0), np.float32(0.0), np.float32(0.0)]",-4.0,99281.5,2
2025-08-14_08-18-36,9431,"[np.float32(1.0), np.float32(0.0), np.float32(1.0), np.float32(0.0), np.float32(1.0), np.float32(0.0), np.float32(1.0), np.float32(1.0), np.float32(0.0), np.float32(0.0), np.float32(0.0), np.float32(0.0), np.float32(1.0), np.float32(0.0), np.float32(1.0), np.float32(0.0)]",2.0,99283.5,18
2025-08-14_08-18-36,9432,"[np.float32(0.0), np.float32(0.0), np.float32(0.0), np.float32(0.0), np.float32(1.0), np.float32(0.0), np.float32(1.0), np.float32(1.0), np.float32(0.0), np.float32(1.0), np.float32(0.0), np.float32(1.0), np.float32(0.0), np.float32(1.0), np.float32(1.0), np.float32(0.0)]",4.0,99287.5,4
2025-08-14_08-18-36,9433,"[np.float32(0.0), np.float32(1.0), np.float32(0.0), np.float32(1.0), np.float32(1.0), np.float32(0.0), np.float32(1.0), np.float32(1.0), np.float32(0.0), np.float32(1.0), np.float32(1.0), np.float32(1.0), np.float32(1.0), np.float32(1.0), np.float32(0.0), np.float32(1.0)]",4.0,99291.5,15
2025-08-14_08-18-36,9434,"[np.float32(1.0), np.float32(1.0), np.float32(0.0), np.float32(0.0), np.float32(0.0), np.float32(1.0), np.float32(1.0), np.float32(1.0), np.float32(0.0), np.float32(0.0), np.float32(0.0), np.float32(0.0), np.float32(1.0), np.float32(1.0), np.float32(1.0), np.float32(1.0)]",-1.0,99290.5,3
2025-08-14_08-18-36,9435,"[np.float32(0.0), np.float32(1.0), np.float32(0.0), np.float32(0.0), np.float32(0.0), np.float32(1.0), np.float32(1.0), np.float32(0.0), np.float32(0.0), np.float32(1.0), np.float32(1.0), np.float32(1.0), np.float32(0.0), np.float32(1.0), np.float32(0.0), np.float32(1.0)]",0.0,99290.5,10
2025-08-14_08-18-36,9436,"[np.float32(1.0), np.float32(1.0), np.float32(1.0), np.float32(0.0), np.float32(1.0), np.float32(1.0), np.float32(0.0), np.float32(1.0), np.float32(1.0), np.float32(0.0), np.float32(0.0), np.float32(0.0), np.float32(1.0), np.float32(0.0), np.float32(1.0), np.float32(1.0)]",-3.0,99287.5,9
2025-08-14_08-18-36,9437,"[np.float32(1.0), np.float32(0.0), np.float32(1.0), np.float32(0.0), np.float32(0.0), np.float32(0.0), np.float32(1.0), np.float32(1.0), np.float32(1.0), np.float32(1.0), np.float32(1.0), np.float32(0.0), np.float32(1.0), np.float32(0.0), np.float32(0.0), np.float32(0.0)]",0.0,99287.5,20
2025-08-14_08-18-36,9438,"[np.float32(0.0), np.float32(0.0), np.float32(1.0), np.float32(0.0), np.float32(0.0), np.float32(1.0), np.float32(0.0), np.float32(1.0), np.float32(1.0), np.float32(0.0), np.float32(0.0), np.float32(0.0), np.float32(0.0), np.float32(0.0), np.float32(0.0), np.float32(0.0)]",3.0,99290.5,30
2025-08-14_08-18-36,9439,"[np.float32(1.0), np.float32(1.0), np.float32(0.0), np.float32(0.0), np.float32(0.0), np.float32(0.0), np.float32(0.0), np.float32(0.0), np.float32(0.0), np.float32(1.0), np.float32(0.0), np.float32(0.0), np.float32(1.0), np.float32(1.0), np.float32(0.0), np.float32(0.0)]",-3.0,99287.5,8
2025-08-14_08-18-36,9440,"[np.float32(0.0), np.float32(1.0), np.float32(0.0), np.float32(0.0), np.float32(1.0), np.float32(0.0), np.float32(0.0), np.float32(0.0), np.float32(0.0), np.float32(0.0), np.float32(0.0), np.float32(1.0), np.float32(1.0), np.float32(0.0), np.float32(0.0), np.float32(0.0)]",1.0,99288.5,18
2025-08-14_08-18-36,9441,"[np.float32(1.0), np.float32(0.0), np.float32(1.0), np.float32(0.0), np.float32(0.0), np.float32(0.0), np.float32(1.0), np.float32(0.0), np.float32(0.0), np.float32(1.0), np.float32(1.0), np.float32(0.0), np.float32(0.0), np.float32(0.0), np.float32(1.0), np.float32(1.0)]",-2.0,99286.5,24
2025-08-14_08-18-36,9442,"[np.float32(1.0), np.float32(1.0), np.float32(0.0), np.float32(0.0), np.float32(0.0), np.float32(1.0), np.float32(1.0), np.float32(1.0), np.float32(1.0), np.float32(1.0), np.float32(1.0), np.float32(0.0), np.float32(0.0), np.float32(0.0), np.float32(0.0), np.float32(0.0)]",0.0,99286.5,4
2025-08-14_08-18-36,9443,"[np.float32(0.0), np.float32(0.0), np.float32(1.0), np.float32(0.0), np.float32(1.0), np.float32(0.0), np.float32(0.0), np.float32(0.0), np.float32(1.0), np.float32(0.0), np.float32(0.0), np.float32(1.0), np.float32(1.0), np.float32(0.0), np.float32(0.0), np.float32(1.0)]",-1.0,99285.5,3
2025-08-14_08-18-36,9444,"[np.float32(0.0), np.float32(1.0), np.float32(0.0), np.float32(0.0), np.float32(1.0), np.float32(1.0), np.float32(1.0), np.float32(1.0), np.float32(1.0), np.float32(1.0), np.float32(1.0), np.float32(1.0), np.float32(0.0), np.float32(1.0), np.float32(0.0), np.float32(0.0)]",1.0,99286.5,21
2025-08-14_08-18-36,9445,"[np.float32(0.0), np.float32(0.0), np.float32(0.0), np.float32(1.0), np.float32(0.0), np.float32(0.0), np.float32(1.0), np.float32(1.0), np.float32(1.0), np.float32(0.0), np.float32(1.0), np.float32(0.0), np.float32(1.0), np.float32(0.0), np.float32(1.0), np.float32(0.0)]",-1.0,99285.5,16
2025-08-14_08-18-36,9446,"[np.float32(0.0), np.float32(0.0), np.float32(0.0), np.float32(1.0), np.float32(1.0), np.float32(1.0), np.float32(1.0), np.float32(0.0), np.float32(0.0), np.float32(0.0), np.float32(0.0), np.float32(1.0), np.float32(1.0), np.float32(1.0), np.float32(0.0), np.float32(0.0)]",-5.0,99280.5,34
2025-08-14_08-18-36,9447,"[np.float32(0.0), np.float32(1.0), np.float32(0.0), np.float32(1.0), np.float32(0.0), np.float32(1.0), np.float32(0.0), np.float32(0.0), np.float32(1.0), np.float32(0.0), np.float32(1.0), np.float32(0.0), np.float32(0.0), np.float32(1.0), np.float32(1.0), np.float32(1.0)]",7.0,99287.5,35
2025-08-14_08-18-36,9448,"[np.float32(0.0), np.float32(1.0), np.float32(1.0), np.float32(1.0), np.float32(1.0), np.float32(1.0), np.float32(1.0), np.float32(0.0), np.float32(1.0), np.float32(1.0), np.float32(0.0), np.float32(0.0), np.float32(1.0), np.float32(0.0), np.float32(0.0), np.float32(0.0)]",0.0,99287.5,26
2025-08-14_08-18-36,9449,"[np.float32(1.0), np.float32(1.0), np.float32(1.0), np.float32(1.0), np.float32(0.0), np.float32(1.0), np.float32(1.0), np.float32(1.0), np.float32(0.0), np.float32(1.0), np.float32(1.0), np.float32(1.0), np.float32(0.0), np.float32(1.0), np.float32(1.0), np.float32(0.0)]",3.0,99290.5,22
2025-08-14_08-18-36,9450,"[np.float32(1.0), np.float32(1.0), np.float32(0.0), np.float32(1.0), np.float32(0.0), np.float32(1.0), np.float32(0.0), np.float32(1.0), np.float32(1.0), np.float32(0.0), np.float32(1.0), np.float32(0.0), np.float32(1.0), np.float32(1.0), np.float32(0.0), np.float32(0.0)]",-5.0,99285.5,9
2025-08-14_08-18-36,9451,"[np.float32(1.0), np.float32(1.0), np.float32(1.0), np.float32(0.0), np.float32(0.0), np.float32(0.0), np.float32(0.0), np.float32(1.0), np.float32(1.0), np.float32(0.0), np.float32(1.0), np.float32(0.0), np.float32(1.0), np.float32(0.0), np.float32(0.0), np.float32(0.0)]",-2.0,99283.5,13
2025-08-14_08-18-36,9452,"[np.float32(1.0), np.float32(0.0), np.float32(0.0), np.float32(1.0), np.float32(1.0), np.float32(1.0), np.float32(0.0), np.float32(1.0), np.float32(1.0), np.float32(1.0), np.float32(0.0), np.float32(1.0), np.float32(0.0), np.float32(0.0), np.float32(1.0), np.float32(0.0)]",0.0,99283.5,9
2025-08-14_08-18-36,9453,"[np.float32(1.0), np.float32(1.0), np.float32(0.0), np.float32(0.0), np.float32(1.0), np.float32(0.0), np.float32(0.0), np.float32(1.0), np.float32(1.0), np.float32(0.0), np.float32(0.0), np.float32(0.0), np.float32(0.0), np.float32(1.0), np.float32(0.0), np.float32(1.0)]",1.0,99284.5,28
2025-08-14_08-18-36,9454,"[np.float32(0.0), np.float32(0.0), np.float32(0.0), np.float32(1.0), np.float32(0.0), np.float32(1.0), np.float32(1.0), np.float32(1.0), np.float32(0.0), np.float32(0.0), np.float32(0.0), np.float32(1.0), np.float32(0.0), np.float32(1.0), np.float32(0.0), np.float32(0.0)]",3.0,99287.5,12
2025-08-14_08-18-36,9455,"[np.float32(1.0), np.float32(0.0), np.float32(0.0), np.float32(1.0), np.float32(0.0), np.float32(1.0), np.float32(1.0), np.float32(1.0), np.float32(1.0), np.float32(1.0), np.float32(0.0), np.float32(1.0), np.float32(1.0), np.float32(0.0), np.float32(0.0), np.float32(0.0)]",1.0,99288.5,36
2025-08-14_08-18-36,9456,"[np.float32(0.0), np.float32(1.0), np.float32(0.0), np.float32(1.0), np.float32(0.0), np.float32(1.0), np.float32(0.0), np.float32(0.0), np.float32(1.0), np.float32(1.0), np.float32(0.0), np.float32(0.0), np.float32(1.0), np.float32(0.0), np.float32(1.0), np.float32(0.0)]",5.0,99293.5,31
2025-08-14_08-18-36,9457,"[np.float32(1.0), np.float32(1.0), np.float32(1.0), np.float32(0.0), np.float32(1.0), np.float32(0.0), np.float32(0.0), np.float32(0.0), np.float32(0.0), np.float32(1.0), np.float32(1.0), np.float32(1.0), np.float32(1.0), np.float32(1.0), np.float32(1.0), np.float32(0.0)]",0.0,99293.5,5
2025-08-14_08-18-36,9458,"[np.float32(0.0), np.float32(0.0), np.float32(1.0), np.float32(1.0), np.float32(0.0), np.float32(1.0), np.float32(1.0), np.float32(0.0), np.float32(1.0), np.float32(1.0), np.float32(1.0), np.float32(1.0), np.float32(0.0), np.float32(0.0), np.float32(0.0), np.float32(1.0)]",1.0,99294.5,35
2025-08-14_08-18-36,9459,"[np.float32(0.0), np.float32(1.0), np.float32(1.0), np.float32(0.0), np.float32(1.0), np.float32(1.0), np.float32(0.0), np.float32(0.0), np.float32(0.0), np.float32(1.0), np.float32(0.0), np.float32(1.0), np.float32(0.0), np.float32(0.0), np.float32(0.0), np.float32(0.0)]",-1.0,99293.5,25
2025-08-14_08-18-36,9460,"[np.float32(0.0), np.float32(0.0), np.float32(0.0), np.float32(0.0), np.float32(0.0), np.float32(0.0), np.float32(1.0), np.float32(1.0), np.float32(0.0), np.float32(1.0), np.float32(0.0), np.float32(0.0), np.float32(1.0), np.float32(0.0), np.float32(0.0), np.float32(1.0)]",-2.0,99291.5,21
2025-08-14_08-18-36,9461,"[np.float32(1.0), np.float32(0.0), np.float32(0.0), np.float32(1.0), np.float32(0.0), np.float32(1.0), np.float32(1.0), np.float32(1.0), np.float32(0.0), np.float32(1.0), np.float32(0.0), np.float32(1.0), np.float32(1.0), np.float32(1.0), np.float32(0.0), np.float32(1.0)]",-4.0,99287.5,10
2025-08-14_08-18-36,9462,"[np.float32(1.0), np.float32(1.0), np.float32(1.0), np.float32(0.0), np.float32(0.0), np.float32(0.0), np.float32(1.0), np.float32(1.0), np.float32(1.0), np.float32(0.0), np.float32(1.0), np.float32(0.0), np.float32(1.0), np.float32(0.0), np.float32(1.0), np.float32(1.0)]",0.0,99287.5,36
2025-08-14_08-18-36,9463,"[np.float32(0.0), np.float32(0.0), np.float32(1.0), np.float32(0.0), np.float32(1.0), np.float32(0.0), np.float32(0.0), np.float32(0.0), np.float32(0.0), np.float32(0.0), np.float32(0.0), np.float32(0.0), np.float32(0.0), np.float32(0.0), np.float32(0.0), np.float32(0.0)]",-2.0,99285.5,27
2025-08-14_08-18-36,9464,"[np.float32(0.0), np.float32(0.0), np.float32(0.0), np.float32(0.0), np.float32(0.0), np.float32(0.0), np.float32(1.0), np.float32(1.0), np.float32(1.0), np.float32(1.0), np.float32(1.0), np.float32(0.0), np.float32(1.0), np.float32(0.0), np.float32(0.0), np.float32(1.0)]",-4.0,99281.5,30
2025-08-14_08-18-36,9465,"[np.float32(0.0), np.float32(0.0), np.float32(0.0), np.float32(1.0), np.float32(0.0), np.float32(1.0), np.float32(0.0), np.float32(0.0), np.float32(0.0), np.float32(0.0), np.float32(0.0), np.float32(0.0), np.float32(1.0), np.float32(1.0), np.float32(0.0), np.float32(1.0)]",-2.0,99279.5,14
2025-08-14_08-18-36,9466,"[np.float32(1.0), np.float32(0.0), np.float32(0.0), np.float32(0.0), np.float32(0.0), np.float32(0.0), np.float32(0.0), np.float32(1.0), np.float32(0.0), np.float32(0.0), np.float32(1.0), np.float32(1.0), np.float32(0.0), np.float32(0.0), np.float32(0.0), np.float32(1.0)]",0.0,99279.5,32
2025-08-14_08-18-36,9467,"[np.float32(0.0), np.float32(1.0), np.float32(0.0), np.float32(1.0), np.float32(0.0), np.float32(1.0), np.float32(1.0), np.float32(1.0), np.float32(1.0), np.float32(0.0), np.float32(0.0), np.float32(0.0), np.float32(0.0), np.float32(0.0), np.float32(0.0), np.float32(0.0)]",-1.0,99278.5,1
2025-08-14_08-18-36,9468,"[np.float32(0.0), np.float32(0.0), np.float32(0.0), np.float32(1.0), np.float32(0.0), np.float32(1.0), np.float32(0.0), np.float32(1.0), np.float32(1.0), np.float32(0.0), np.float32(1.0), np.float32(0.0), np.float32(0.0), np.float32(1.0), np.float32(0.0), np.float32(1.0)]",-4.0,99274.5,8
2025-08-14_08-18-36,9469,"[np.float32(0.0), np.float32(1.0), np.float32(0.0), np.float32(1.0), np.float32(1.0), np.float32(0.0), np.float32(1.0), np.float32(0.0), np.float32(0.0), np.float32(1.0), np.float32(0.0), np.float32(1.0), np.float32(1.0), np.float32(0.0), np.float32(0.0), np.float32(1.0)]",2.0,99276.5,31
2025-08-14_08-18-36,9470,"[np.float32(0.0), np.float32(1.0), np.float32(0.0), np.float32(0.0), np.float32(0.0), np.float32(0.0), np.float32(1.0), np.float32(1.0), np.float32(0.0), np.float32(0.0), np.float32(0.0), np.float32(1.0), np.float32(1.0), np.float32(0.0), np.float32(0.0), np.float32(0.0)]",-2.0,99274.5,23
2025-08-14_08-18-36,9471,"[np.float32(1.0), np.float32(1.0), np.float32(0.0), np.float32(1.0), np.float32(0.0), np.float32(0.0), np.float32(0.0), np.float32(1.0), np.float32(1.0), np.float32(0.0), np.float32(1.0), np.float32(0.0), np.float32(1.0), np.float32(1.0), np.float32(1.0), np.float32(0.0)]",1.0,99275.5,19
2025-08-14_08-18-36,9472,"[np.float32(0.0), np.float32(1.0), np.float32(0.0), np.float32(0.0), np.float32(1.0), np.float32(1.0), np.float32(0.0), np.float32(0.0), np.float32(1.0), np.float32(0.0), np.float32(1.0), np.float32(0.0), np.float32(0.0), np.float32(0.0), np.float32(1.0), np.float32(0.0)]",-4.0,99271.5,18
2025-08-14_08-18-36,9473,"[np.float32(0.0), np.float32(0.0), np.float32(0.0), np.float32(1.0), np.float32(0.0), np.float32(0.0), np.float32(1.0), np.float32(1.0), np.float32(1.0), np.float32(0.0), np.float32(0.0), np.float32(0.0), np.float32(0.0), np.float32(0.0), np.float32(0.0), np.float32(0.0)]",1.0,99272.5,35
2025-08-14_08-18-36,9474,"[np.float32(1.0), np.float32(0.0), np.float32(1.0), np.float32(0.0), np.float32(1.0), np.float32(0.0), np.float32(0.0), np.float32(1.0), np.float32(0.0), np.float32(1.0), np.float32(0.0), np.float32(1.0), np.float32(1.0), np.float32(1.0), np.float32(0.0), np.float32(0.0)]",3.0,99275.5,21
2025-08-14_08-18-36,9475,"[np.float32(1.0), np.float32(0.0), np.float32(1.0), np.float32(0.0), np.float32(1.0), np.float32(1.0), np.float32(1.0), np.float32(0.0), np.float32(0.0), np.float32(1.0), np.float32(1.0), np.float32(0.0), np.float32(0.0), np.float32(1.0), np.float32(1.0), np.float32(1.0)]",1.0,99276.5,11
2025-08-14_08-18-36,9476,"[np.float32(0.0), np.float32(1.0), np.float32(1.0), np.float32(0.0), np.float32(1.0), np.float32(1.0), np.float32(0.0), np.float32(0.0), np.float32(0.0), np.float32(1.0), np.float32(0.0), np.float32(0.0), np.float32(0.0), np.float32(0.0), np.float32(0.0), np.float32(0.0)]",0.0,99276.5,1
2025-08-14_08-18-36,9477,"[np.float32(1.0), np.float32(1.0), np.float32(1.0), np.float32(1.0), np.float32(0.0), np.float32(0.0), np.float32(1.0), np.float32(1.0), np.float32(0.0), np.float32(0.0), np.float32(0.0), np.float32(0.0), np.float32(1.0), np.float32(0.0), np.float32(0.0), np.float32(0.0)]",0.0,99276.5,1
2025-08-14_08-18-36,9478,"[np.float32(0.0), np.float32(0.0), np.float32(1.0), np.float32(0.0), np.float32(0.0), np.float32(1.0), np.float32(1.0), np.float32(1.0), np.float32(1.0), np.float32(1.0), np.float32(1.0), np.float32(1.0), np.float32(1.0), np.float32(1.0), np.float32(0.0), np.float32(0.0)]",0.0,99276.5,30
2025-08-14_08-18-36,9479,"[np.float32(1.0), np.float32(1.0), np.float32(0.0), np.float32(0.0), np.float32(0.0), np.float32(0.0), np.float32(0.0), np.float32(1.0), np.float32(1.0), np.float32(1.0), np.float32(0.0), np.float32(1.0), np.float32(0.0), np.float32(0.0), np.float32(0.0), np.float32(1.0)]",-5.0,99271.5,2
2025-08-14_08-18-36,9480,"[np.float32(0.0), np.float32(0.0), np.float32(1.0), np.float32(1.0), np.float32(1.0), np.float32(1.0), np.float32(0.0), np.float32(1.0), np.float32(0.0), np.float32(0.0), np.float32(1.0), np.float32(1.0), np.float32(1.0), np.float32(1.0), np.float32(1.0), np.float32(0.0)]",-6.0,99265.5,31
2025-08-14_08-18-36,9481,"[np.float32(1.0), np.float32(0.0), np.float32(0.0), np.float32(1.0), np.float32(0.0), np.float32(1.0), np.float32(0.0), np.float32(0.0), np.float32(0.0), np.float32(0.0), np.float32(0.0), np.float32(1.0), np.float32(1.0), np.float32(0.0), np.float32(0.0), np.float32(0.0)]",-3.0,99262.5,28
2025-08-14_08-18-36,9482,"[np.float32(1.0), np.float32(0.0), np.float32(0.0), np.float32(1.0), np.float32(0.0), np.float32(1.0), np.float32(1.0), np.float32(1.0), np.float32(1.0), np.float32(0.0), np.float32(1.0), np.float32(1.0), np.float32(1.0), np.float32(0.0), np.float32(1.0), np.float32(0.0)]",2.0,99264.5,21
2025-08-14_08-18-36,9483,"[np.float32(0.0), np.float32(1.0), np.float32(0.0), np.float32(1.0), np.float32(0.0), np.float32(0.0), np.float32(1.0), np.float32(1.0), np.float32(1.0), np.float32(0.0), np.float32(1.0), np.float32(1.0), np.float32(0.0), np.float32(0.0), np.float32(1.0), np.float32(1.0)]",-1.0,99263.5,26
2025-08-14_08-18-36,9484,"[np.float32(1.0), np.float32(1.0), np.float32(1.0), np.float32(0.0), np.float32(1.0), np.float32(0.0), np.float32(1.0), np.float32(1.0), np.float32(0.0), np.float32(0.0), np.float32(0.0), np.float32(0.0), np.float32(0.0), np.float32(0.0), np.float32(1.0), np.float32(1.0)]",-6.0,99257.5,35
2025-08-14_08-18-36,9485,"[np.float32(1.0), np.float32(1.0), np.float32(0.0), np.float32(1.0), np.float32(0.0), np.float32(1.0), np.float32(0.0), np.float32(1.0), np.float32(0.0), np.float32(0.0), np.float32(0.0), np.float32(1.0), np.float32(1.0), np.float32(0.0), np.float32(0.0), np.float32(0.0)]",-3.0,99254.5,28
2025-08-14_08-18-36,9486,"[np.float32(0.0), np.float32(0.0), np.float32(0.0), np.float32(1.0), np.float32(0.0), np.float32(1.0), np.float32(1.0), np.float32(1.0), np.float32(1.0), np.float32(0.0), np.float32(0.0), np.float32(0.0), np.float32(1.0), np.float32(1.0), np.float32(1.0), np.float32(1.0)]",-1.0,99253.5,1
2025-08-14_08-18-36,9487,"[np.float32(0.0), np.float32(1.0), np.float32(0.0), np.float32(0.0), np.float32(1.0), np.float32(0.0), np.float32(0.0), np.float32(0.0), np.float32(0.0), np.float32(1.0), np.float32(0.0), np.float32(1.0), np.float32(1.0), np.float32(0.0), np.float32(0.0), np.float32(1.0)]",-4.0,99249.5,29
2025-08-14_08-18-36,9488,"[np.float32(0.0), np.float32(0.0), np.float32(0.0), np.float32(1.0), np.float32(1.0), np.float32(1.0), np.float32(1.0), np.float32(0.0), np.float32(1.0), np.float32(0.0), np.float32(1.0), np.float32(0.0), np.float32(0.0), np.float32(0.0), np.float32(1.0), np.float32(1.0)]",-1.0,99248.5,7
2025-08-14_08-18-36,9489,"[np.float32(1.0), np.float32(0.0), np.float32(0.0), np.float32(1.0), np.float32(1.0), np.float32(1.0), np.float32(0.0), np.float32(1.0), np.float32(1.0), np.float32(1.0), np.float32(1.0), np.float32(1.0), np.float32(1.0), np.float32(0.0), np.float32(0.0), np.float32(0.0)]",-1.0,99247.5,9
2025-08-14_08-18-36,9490,"[np.float32(1.0), np.float32(0.0), np.float32(0.0), np.float32(1.0), np.float32(1.0), np.float32(1.0), np.float32(1.0), np.float32(0.0), np.float32(0.0), np.float32(1.0), np.float32(0.0), np.float32(0.0), np.float32(1.0), np.float32(1.0), np.float32(1.0), np.float32(0.0)]",-2.0,99245.5,34
2025-08-14_08-18-36,9491,"[np.float32(1.0), np.float32(1.0), np.float32(1.0), np.float32(1.0), np.float32(1.0), np.float32(0.0), np.float32(1.0), np.float32(1.0), np.float32(0.0), np.float32(1.0), np.float32(0.0), np.float32(1.0), np.float32(1.0), np.float32(0.0), np.float32(1.0), np.float32(0.0)]",4.0,99249.5,16
2025-08-14_08-18-36,9492,"[np.float32(0.0), np.float32(1.0), np.float32(1.0), np.float32(0.0), np.float32(0.0), np.float32(1.0), np.float32(0.0), np.float32(1.0), np.float32(0.0), np.float32(0.0), np.float32(0.0), np.float32(0.0), np.float32(1.0), np.float32(0.0), np.float32(1.0), np.float32(0.0)]",-1.0,99248.5,17
2025-08-14_08-18-36,9493,"[np.float32(0.0), np.float32(0.0), np.float32(0.0), np.float32(0.0), np.float32(0.0), np.float32(1.0), np.float32(1.0), np.float32(0.0), np.float32(1.0), np.float32(1.0), np.float32(1.0), np.float32(1.0), np.float32(0.0), np.float32(1.0), np.float32(0.0), np.float32(0.0)]",-1.0,99247.5,1
2025-08-14_08-18-36,9494,"[np.float32(0.0), np.float32(1.0), np.float32(1.0), np.float32(1.0), np.float32(0.0), np.float32(0.0), np.float32(1.0), np.float32(1.0), np.float32(1.0), np.float32(1.0), np.float32(0.0), np.float32(0.0), np.float32(1.0), np.float32(1.0), np.float32(0.0), np.float32(0.0)]",38.0,99285.5,7
2025-08-14_08-18-36,9495,"[np.float32(1.0), np.float32(0.0), np.float32(0.0), np.float32(0.0), np.float32(0.0), np.float32(1.0), np.float32(0.0), np.float32(0.0), np.float32(1.0), np.float32(0.0), np.float32(1.0), np.float32(1.0), np.float32(0.0), np.float32(0.0), np.float32(0.0), np.float32(1.0)]",2.0,99287.5,29
2025-08-14_08-18-36,9496,"[np.float32(0.0), np.float32(1.0), np.float32(0.0), np.float32(1.0), np.float32(0.0), np.float32(1.0), np.float32(1.0), np.float32(1.0), np.float32(1.0), np.float32(0.0), np.float32(0.0), np.float32(0.0), np.float32(0.0), np.float32(0.0), np.float32(0.0), np.float32(1.0)]",0.0,99287.5,26
2025-08-14_08-18-36,9497,"[np.float32(0.0), np.float32(0.0), np.float32(1.0), np.float32(0.0), np.float32(1.0), np.float32(1.0), np.float32(0.0), np.float32(0.0), np.float32(0.0), np.float32(0.0), np.float32(1.0), np.float32(0.0), np.float32(1.0), np.float32(1.0), np.float32(1.0), np.float32(1.0)]",-1.0,99286.5,18
2025-08-14_08-18-36,9498,"[np.float32(0.0), np.float32(1.0), np.float32(1.0), np.float32(0.0), np.float32(0.0), np.float32(1.0), np.float32(1.0), np.float32(0.0), np.float32(0.0), np.float32(1.0), np.float32(0.0), np.float32(0.0), np.float32(0.0), np.float32(1.0), np.float32(0.0), np.float32(0.0)]",-1.0,99285.5,15
2025-08-14_08-18-36,9499,"[np.float32(0.0), np.float32(0.0), np.float32(0.0), np.float32(0.0), np.float32(0.0), np.float32(0.0), np.float32(0.0), np.float32(1.0), np.float32(0.0), np.float32(1.0), np.float32(1.0), np.float32(0.0), np.float32(1.0), np.float32(1.0), np.float32(0.0), np.float32(1.0)]",0.0,99285.5,18
2025-08-14_08-18-36,9500,"[np.float32(1.0), np.float32(1.0), np.float32(0.0), np.float32(0.0), np.float32(1.0), np.float32(0.0), np.float32(1.0), np.float32(1.0), np.float32(1.0), np.float32(1.0), np.float32(0.0), np.float32(1.0), np.float32(0.0), np.float32(1.0), np.float32(0.0), np.float32(1.0)]",3.0,99288.5,1
2025-08-14_08-18-36,9501,"[np.float32(0.0), np.float32(1.0), np.float32(1.0), np.float32(1.0), np.float32(1.0), np.float32(1.0), np.float32(1.0), np.float32(1.0), np.float32(1.0), np.float32(1.0), np.float32(0.0), np.float32(0.0), np.float32(1.0), np.float32(1.0), np.float32(0.0), np.float32(1.0)]",0.0,99288.5,29
2025-08-14_08-18-36,9502,"[np.float32(0.0), np.float32(1.0), np.float32(1.0), np.float32(1.0), np.float32(0.0), np.float32(0.0), np.float32(0.0), np.float32(1.0), np.float32(1.0), np.float32(0.0), np.float32(1.0), np.float32(0.0), np.float32(0.0), np.float32(1.0), np.float32(0.0), np.float32(1.0)]",2.0,99290.5,2
2025-08-14_08-18-36,9503,"[np.float32(1.0), np.float32(0.0), np.float32(1.0), np.float32(1.0), np.float32(0.0), np.float32(0.0), np.float32(1.0), np.float32(1.0), np.float32(0.0), np.float32(0.0), np.float32(0.0), np.float32(0.0), np.float32(0.0), np.float32(0.0), np.float32(0.0), np.float32(1.0)]",-4.0,99286.5,28
2025-08-14_08-18-36,9504,"[np.float32(0.0), np.float32(0.0), np.float32(0.0), np.float32(1.0), np.float32(0.0), np.float32(1.0), np.float32(1.0), np.float32(0.0), np.float32(1.0), np.float32(1.0), np.float32(0.0), np.float32(0.0), np.float32(0.0), np.float32(0.0), np.float32(1.0), np.float32(0.0)]",-1.0,99285.5,22
2025-08-14_08-18-36,9505,"[np.float32(1.0), np.float32(1.0), np.float32(0.0), np.float32(1.0), np.float32(1.0), np.float32(0.0), np.float32(0.0), np.float32(1.0), np.float32(0.0), np.float32(1.0), np.float32(1.0), np.float32(0.0), np.float32(1.0), np.float32(0.0), np.float32(0.0), np.float32(1.0)]",-7.0,99278.5,30
2025-08-14_08-18-36,9506,"[np.float32(1.0), np.float32(1.0), np.float32(1.0), np.float32(1.0), np.float32(0.0), np.float32(1.0), np.float32(0.0), np.float32(1.0), np.float32(0.0), np.float32(1.0), np.float32(0.0), np.float32(0.0), np.float32(1.0), np.float32(0.0), np.float32(1.0), np.float32(0.0)]",3.0,99281.5,24
2025-08-14_08-18-36,9507,"[np.float32(1.0), np.float32(0.0), np.float32(0.0), np.float32(1.0), np.float32(0.0), np.float32(1.0), np.float32(0.0), np.float32(0.0), np.float32(1.0), np.float32(0.0), np.float32(0.0), np.float32(1.0), np.float32(0.0), np.float32(1.0), np.float32(0.0), np.float32(1.0)]",-4.0,99277.5,4
2025-08-14_08-18-36,9508,"[np.float32(0.0), np.float32(1.0), np.float32(1.0), np.float32(0.0), np.float32(0.0), np.float32(1.0), np.float32(1.0), np.float32(1.0), np.float32(1.0), np.float32(0.0), np.float32(0.0), np.float32(0.0), np.float32(0.0), np.float32(0.0), np.float32(0.0), np.float32(1.0)]",-2.0,99275.5,11
2025-08-14_08-18-36,9509,"[np.float32(0.0), np.float32(1.0), np.float32(0.0), np.float32(1.0), np.float32(1.0), np.float32(0.0), np.float32(0.0), np.float32(1.0), np.float32(0.0), np.float32(0.0), np.float32(1.0), np.float32(0.0), np.float32(0.0), np.float32(1.0), np.float32(1.0), np.float32(1.0)]",3.0,99278.5,20
2025-08-14_08-18-36,9510,"[np.float32(0.0), np.float32(1.0), np.float32(0.0), np.float32(0.0), np.float32(1.0), np.float32(1.0), np.float32(0.0), np.float32(1.0), np.float32(1.0), np.float32(1.0), np.float32(0.0), np.float32(0.0), np.float32(1.0), np.float32(1.0), np.float32(0.0), np.float32(1.0)]",1.0,99279.5,29
2025-08-14_08-18-36,9511,"[np.float32(0.0), np.float32(1.0), np.float32(0.0), np.float32(0.0), np.float32(1.0), np.float32(1.0), np.float32(1.0), np.float32(1.0), np.float32(0.0), np.float32(1.0), np.float32(0.0), np.float32(1.0), np.float32(1.0), np.float32(1.0), np.float32(0.0), np.float32(0.0)]",-4.0,99275.5,27
2025-08-14_08-18-36,9512,"[np.float32(0.0), np.float32(0.0), np.float32(0.0), np.float32(1.0), np.float32(0.0), np.float32(1.0), np.float32(1.0), np.float32(1.0), np.float32(0.0), np.float32(0.0), np.float32(0.0), np.float32(0.0), np.float32(0.0), np.float32(1.0), np.float32(0.0), np.float32(1.0)]",2.0,99277.5,7
2025-08-14_08-18-36,9513,"[np.float32(1.0), np.float32(1.0), np.float32(0.0), np.float32(0.0), np.float32(0.0), np.float32(0.0), np.float32(1.0), np.float32(1.0), np.float32(1.0), np.float32(0.0), np.float32(0.0), np.float32(0.0), np.float32(0.0), np.float32(1.0), np.float32(1.0), np.float32(0.0)]",1.0,99278.5,25
2025-08-14_08-18-36,9514,"[np.float32(1.0), np.float32(1.0), np.float32(1.0), np.float32(1.0), np.float32(0.0), np.float32(1.0), np.float32(0.0), np.float32(0.0), np.float32(1.0), np.float32(0.0), np.float32(1.0), np.float32(0.0), np.float32(1.0), np.float32(0.0), np.float32(0.0), np.float32(1.0)]",-5.0,99273.5,10
2025-08-14_08-18-36,9515,"[np.float32(0.0), np.float32(1.0), np.float32(0.0), np.float32(0.0), np.float32(1.0), np.float32(0.0), np.float32(1.0), np.float32(1.0), np.float32(0.0), np.float32(0.0), np.float32(1.0), np.float32(0.0), np.float32(1.0), np.float32(1.0), np.float32(0.0), np.float32(0.0)]",-4.0,99269.5,25
2025-08-14_08-18-36,9516,"[np.float32(1.0), np.float32(1.0), np.float32(1.0), np.float32(0.0), np.float32(0.0), np.float32(0.0), np.float32(0.0), np.float32(0.0), np.float32(1.0), np.float32(1.0), np.float32(1.0), np.float32(0.0), np.float32(0.0), np.float32(0.0), np.float32(0.0), np.float32(1.0)]",3.0,99272.5,26
2025-08-14_08-18-36,9517,"[np.float32(0.0), np.float32(0.0), np.float32(1.0), np.float32(1.0), np.float32(0.0), np.float32(1.0), np.float32(0.0), np.float32(0.0), np.float32(0.0), np.float32(1.0), np.float32(0.0), np.float32(1.0), np.float32(1.0), np.float32(1.0), np.float32(0.0), np.float32(0.0)]",-5.0,99267.5,5
2025-08-14_08-18-36,9518,"[np.float32(1.0), np.float32(1.0), np.float32(0.0), np.float32(1.0), np.float32(0.0), np.float32(1.0), np.float32(1.0), np.float32(1.0), np.float32(0.0), np.float32(1.0), np.float32(0.0), np.float32(0.0), np.float32(0.0), np.float32(0.0), np.float32(0.0), np.float32(0.0)]",-2.0,99265.5,8
2025-08-14_08-18-36,9519,"[np.float32(0.0), np.float32(1.0), np.float32(1.0), np.float32(1.0), np.float32(0.0), np.float32(1.0), np.float32(1.0), np.float32(1.0), np.float32(1.0), np.float32(1.0), np.float32(0.0), np.float32(0.0), np.float32(0.0), np.float32(1.0), np.float32(1.0), np.float32(0.0)]",0.0,99265.5,11
2025-08-14_08-18-36,9520,"[np.float32(1.0), np.float32(1.0), np.float32(0.0), np.float32(0.0), np.float32(1.0), np.float32(1.0), np.float32(1.0), np.float32(1.0), np.float32(0.0), np.float32(1.0), np.float32(1.0), np.float32(1.0), np.float32(1.0), np.float32(0.0), np.float32(0.0), np.float32(1.0)]",-4.0,99261.5,33
2025-08-14_08-18-36,9521,"[np.float32(0.0), np.float32(1.0), np.float32(1.0), np.float32(0.0), np.float32(0.0), np.float32(0.0), np.float32(1.0), np.float32(1.0), np.float32(0.0), np.float32(1.0), np.float32(1.0), np.float32(1.0), np.float32(0.0), np.float32(1.0), np.float32(1.0), np.float32(0.0)]",0.0,99261.5,21
2025-08-14_08-18-36,9522,"[np.float32(1.0), np.float32(0.0), np.float32(1.0), np.float32(0.0), np.float32(1.0), np.float32(0.0), np.float32(0.0), np.float32(0.0), np.float32(0.0), np.float32(0.0), np.float32(0.0), np.float32(1.0), np.float32(0.0), np.float32(1.0), np.float32(0.0), np.float32(0.0)]",2.0,99263.5,2
2025-08-14_08-18-36,9523,"[np.float32(1.0), np.float32(1.0), np.float32(1.0), np.float32(0.0), np.float32(0.0), np.float32(1.0), np.float32(1.0), np.float32(0.0), np.float32(1.0), np.float32(1.0), np.float32(0.0), np.float32(1.0), np.float32(0.0), np.float32(1.0), np.float32(0.0), np.float32(0.0)]",1.0,99264.5,21
2025-08-14_08-18-36,9524,"[np.float32(1.0), np.float32(1.0), np.float32(0.0), np.float32(0.0), np.float32(0.0), np.float32(0.0), np.float32(0.0), np.float32(0.0), np.float32(1.0), np.float32(1.0), np.float32(1.0), np.float32(0.0), np.float32(0.0), np.float32(1.0), np.float32(0.0), np.float32(0.0)]",5.0,99269.5,35
2025-08-14_08-18-36,9525,"[np.float32(0.0), np.float32(1.0), np.float32(1.0), np.float32(0.0), np.float32(0.0), np.float32(1.0), np.float32(1.0), np.float32(0.0), np.float32(0.0), np.float32(1.0), np.float32(0.0), np.float32(0.0), np.float32(1.0), np.float32(0.0), np.float32(0.0), np.float32(0.0)]",-2.0,99267.5,33
2025-08-14_08-18-36,9526,"[np.float32(0.0), np.float32(1.0), np.float32(1.0), np.float32(1.0), np.float32(0.0), np.float32(0.0), np.float32(1.0), np.float32(0.0), np.float32(1.0), np.float32(0.0), np.float32(0.0), np.float32(0.0), np.float32(1.0), np.float32(0.0), np.float32(1.0), np.float32(1.0)]",0.0,99267.5,27
2025-08-14_08-18-36,9527,"[np.float32(1.0), np.float32(0.0), np.float32(1.0), np.float32(1.0), np.float32(1.0), np.float32(1.0), np.float32(0.0), np.float32(0.0), np.float32(0.0), np.float32(0.0), np.float32(1.0), np.float32(1.0), np.float32(0.0), np.float32(1.0), np.float32(0.0), np.float32(0.0)]",-1.0,99266.5,17
2025-08-14_08-18-36,9528,"[np.float32(1.0), np.float32(1.0), np.float32(1.0), np.float32(0.0), np.float32(0.0), np.float32(1.0), np.float32(0.0), np.float32(0.0), np.float32(1.0), np.float32(0.0), np.float32(0.0), np.float32(1.0), np.float32(0.0), np.float32(0.0), np.float32(0.0), np.float32(0.0)]",3.0,99269.5,24
2025-08-14_08-18-36,9529,"[np.float32(1.0), np.float32(1.0), np.float32(1.0), np.float32(1.0), np.float32(0.0), np.float32(0.0), np.float32(0.0), np.float32(1.0), np.float32(1.0), np.float32(1.0), np.float32(1.0), np.float32(0.0), np.float32(1.0), np.float32(1.0), np.float32(1.0), np.float32(0.0)]",-1.0,99268.5,30
2025-08-14_08-18-36,9530,"[np.float32(1.0), np.float32(0.0), np.float32(0.0), np.float32(1.0), np.float32(1.0), np.float32(0.0), np.float32(1.0), np.float32(0.0), np.float32(0.0), np.float32(0.0), np.float32(1.0), np.float32(0.0), np.float32(1.0), np.float32(0.0), np.float32(1.0), np.float32(1.0)]",-3.0,99265.5,36
2025-08-14_08-18-36,9531,"[np.float32(0.0), np.float32(0.0), np.float32(1.0), np.float32(0.0), np.float32(0.0), np.float32(0.0), np.float32(0.0), np.float32(0.0), np.float32(1.0), np.float32(0.0), np.float32(0.0), np.float32(1.0), np.float32(1.0), np.float32(1.0), np.float32(0.0), np.float32(0.0)]",3.0,99268.5,30
2025-08-14_08-18-36,9532,"[np.float32(0.0), np.float32(1.0), np.float32(0.0), np.float32(0.0), np.float32(0.0), np.float32(0.0), np.float32(1.0), np.float32(1.0), np.float32(1.0), np.float32(0.0), np.float32(0.0), np.float32(0.0), np.float32(1.0), np.float32(1.0), np.float32(0.0), np.float32(1.0)]",-2.0,99266.5,8
2025-08-14_08-18-36,9533,"[np.float32(1.0), np.float32(0.0), np.float32(1.0), np.float32(1.0), np.float32(1.0), np.float32(0.0), np.float32(0.0), np.float32(1.0), np.float32(1.0), np.float32(0.0), np.float32(0.0), np.float32(0.0), np.float32(0.0), np.float32(1.0), np.float32(1.0), np.float32(0.0)]",1.0,99267.5,7
2025-08-14_08-18-36,9534,"[np.float32(1.0), np.float32(1.0), np.float32(0.0), np.float32(1.0), np.float32(0.0), np.float32(0.0), np.float32(0.0), np.float32(1.0), np.float32(0.0), np.float32(0.0), np.float32(0.0), np.float32(0.0), np.float32(1.0), np.float32(1.0), np.float32(0.0), np.float32(0.0)]",1.0,99268.5,3
2025-08-14_08-18-36,9535,"[np.float32(0.0), np.float32(0.0), np.float32(1.0), np.float32(0.0), np.float32(0.0), np.float32(1.0), np.float32(1.0), np.float32(1.0), np.float32(1.0), np.float32(0.0), np.float32(0.0), np.float32(1.0), np.float32(0.0), np.float32(0.0), np.float32(1.0), np.float32(0.0)]",-2.0,99266.5,31
2025-08-14_08-18-36,9536,"[np.float32(1.0), np.float32(1.0), np.float32(1.0), np.float32(0.0), np.float32(1.0), np.float32(1.0), np.float32(1.0), np.float32(1.0), np.float32(0.0), np.float32(1.0), np.float32(0.0), np.float32(1.0), np.float32(1.0), np.float32(0.0), np.float32(0.0), np.float32(0.0)]",2.0,99268.5,4
2025-08-14_08-18-36,9537,"[np.float32(1.0), np.float32(1.0), np.float32(0.0), np.float32(1.0), np.float32(1.0), np.float32(0.0), np.float32(1.0), np.float32(1.0), np.float32(1.0), np.float32(0.0), np.float32(0.0), np.float32(1.0), np.float32(1.0), np.float32(1.0), np.float32(1.0), np.float32(0.0)]",2.0,99270.5,21
2025-08-14_08-18-36,9538,"[np.float32(0.0), np.float32(1.0), np.float32(1.0), np.float32(0.0), np.float32(0.0), np.float32(1.0), np.float32(1.0), np.float32(1.0), np.float32(0.0), np.float32(1.0), np.float32(1.0), np.float32(1.0), np.float32(1.0), np.float32(1.0), np.float32(0.0), np.float32(0.0)]",2.0,99272.5,24
2025-08-14_08-18-36,9539,"[np.float32(1.0), np.float32(0.0), np.float32(1.0), np.float32(0.0), np.float32(0.0), np.float32(0.0), np.float32(1.0), np.float32(0.0), np.float32(1.0), np.float32(0.0), np.float32(0.0), np.float32(1.0), np.float32(1.0), np.float32(0.0), np.float32(1.0), np.float32(1.0)]",-1.0,99271.5,18
2025-08-14_08-18-36,9540,"[np.float32(0.0), np.float32(0.0), np.float32(0.0), np.float32(0.0), np.float32(1.0), np.float32(0.0), np.float32(0.0), np.float32(1.0), np.float32(0.0), np.float32(0.0), np.float32(0.0), np.float32(1.0), np.float32(1.0), np.float32(0.0), np.float32(0.0), np.float32(0.0)]",-2.0,99269.5,5
2025-08-14_08-18-36,9541,"[np.float32(1.0), np.float32(1.0), np.float32(0.0), np.float32(0.0), np.float32(1.0), np.float32(0.0), np.float32(0.0), np.float32(0.0), np.float32(1.0), np.float32(0.0), np.float32(0.0), np.float32(1.0), np.float32(1.0), np.float32(1.0), np.float32(0.0), np.float32(1.0)]",-4.0,99265.5,11
2025-08-14_08-18-36,9542,"[np.float32(0.0), np.float32(0.0), np.float32(1.0), np.float32(1.0), np.float32(1.0), np.float32(1.0), np.float32(1.0), np.float32(0.0), np.float32(0.0), np.float32(1.0), np.float32(0.0), np.float32(0.0), np.float32(0.0), np.float32(1.0), np.float32(0.0), np.float32(0.0)]",3.0,99268.5,2
2025-08-14_08-18-36,9543,"[np.float32(0.0), np.float32(1.0), np.float32(0.0), np.float32(0.0), np.float32(0.0), np.float32(1.0), np.float32(1.0), np.float32(1.0), np.float32(1.0), np.float32(0.0), np.float32(0.0), np.float32(0.0), np.float32(1.0), np.float32(0.0), np.float32(0.0), np.float32(1.0)]",3.0,99271.5,20
2025-08-14_08-18-36,9544,"[np.float32(1.0), np.float32(0.0), np.float32(1.0), np.float32(0.0), np.float32(0.0), np.float32(1.0), np.float32(0.0), np.float32(1.0), np.float32(1.0), np.float32(1.0), np.float32(1.0), np.float32(0.0), np.float32(0.0), np.float32(1.0), np.float32(1.0), np.float32(0.0)]",1.0,99272.5,24
2025-08-14_08-18-36,9545,"[np.float32(0.0), np.float32(1.0), np.float32(0.0), np.float32(0.0), np.float32(0.0), np.float32(0.0), np.float32(1.0), np.float32(1.0), np.float32(1.0), np.float32(0.0), np.float32(0.0), np.float32(1.0), np.float32(1.0), np.float32(1.0), np.float32(1.0), np.float32(1.0)]",-1.0,99271.5,26
2025-08-14_08-18-36,9546,"[np.float32(0.0), np.float32(0.0), np.float32(1.0), np.float32(1.0), np.float32(1.0), np.float32(1.0), np.float32(0.0), np.float32(1.0), np.float32(1.0), np.float32(0.0), np.float32(1.0), np.float32(0.0), np.float32(0.0), np.float32(0.0), np.float32(0.0), np.float32(0.0)]",0.0,99271.5,2
2025-08-14_08-18-36,9547,"[np.float32(0.0), np.float32(1.0), np.float32(1.0), np.float32(0.0), np.float32(0.0), np.float32(1.0), np.float32(1.0), np.float32(1.0), np.float32(1.0), np.float32(1.0), np.float32(0.0), np.float32(1.0), np.float32(1.0), np.float32(1.0), np.float32(0.0), np.float32(0.0)]",0.0,99271.5,36
2025-08-14_08-18-36,9548,"[np.float32(1.0), np.float32(1.0), np.float32(0.0), np.float32(0.0), np.float32(1.0), np.float32(0.0), np.float32(0.0), np.float32(1.0), np.float32(1.0), np.float32(0.0), np.float32(1.0), np.float32(1.0), np.float32(0.0), np.float32(0.0), np.float32(1.0), np.float32(1.0)]",-2.0,99269.5,3
2025-08-14_08-18-36,9549,"[np.float32(1.0), np.float32(1.0), np.float32(1.0), np.float32(0.0), np.float32(1.0), np.float32(1.0), np.float32(0.0), np.float32(0.0), np.float32(1.0), np.float32(0.0), np.float32(0.0), np.float32(0.0), np.float32(0.0), np.float32(1.0), np.float32(0.0), np.float32(1.0)]",-1.0,99268.5,21
2025-08-14_08-18-36,9550,"[np.float32(0.0), np.float32(1.0), np.float32(0.0), np.float32(0.0), np.float32(0.0), np.float32(1.0), np.float32(1.0), np.float32(1.0), np.float32(0.0), np.float32(1.0), np.float32(1.0), np.float32(0.0), np.float32(0.0), np.float32(0.0), np.float32(0.0), np.float32(1.0)]",-1.0,99267.5,9
2025-08-14_08-18-36,9551,"[np.float32(0.0), np.float32(1.0), np.float32(0.0), np.float32(0.0), np.float32(1.0), np.float32(1.0), np.float32(0.0), np.float32(1.0), np.float32(1.0), np.float32(1.0), np.float32(1.0), np.float32(0.0), np.float32(0.0), np.float32(1.0), np.float32(0.0), np.float32(0.0)]",-3.0,99264.5,3
2025-08-14_08-18-36,9552,"[np.float32(1.0), np.float32(0.0), np.float32(0.0), np.float32(0.0), np.float32(0.0), np.float32(1.0), np.float32(0.0), np.float32(0.0), np.float32(0.0), np.float32(0.0), np.float32(0.0), np.float32(0.0), np.float32(0.0), np.float32(0.0), np.float32(0.0), np.float32(0.0)]",-2.0,99262.5,10
2025-08-14_08-18-36,9553,"[np.float32(1.0), np.float32(1.0), np.float32(0.0), np.float32(1.0), np.float32(0.0), np.float32(1.0), np.float32(1.0), np.float32(1.0), np.float32(1.0), np.float32(1.0), np.float32(0.0), np.float32(1.0), np.float32(1.0), np.float32(1.0), np.float32(1.0), np.float32(0.0)]",-2.0,99260.5,5
2025-08-14_08-18-36,9554,"[np.float32(1.0), np.float32(0.0), np.float32(0.0), np.float32(1.0), np.float32(1.0), np.float32(0.0), np.float32(0.0), np.float32(1.0), np.float32(0.0), np.float32(1.0), np.float32(0.0), np.float32(1.0), np.float32(1.0), np.float32(1.0), np.float32(1.0), np.float32(0.0)]",1.0,99261.5,25
2025-08-14_08-18-36,9555,"[np.float32(1.0), np.float32(1.0), np.float32(1.0), np.float32(1.0), np.float32(0.0), np.float32(1.0), np.float32(0.0), np.float32(1.0), np.float32(1.0), np.float32(0.0), np.float32(0.0), np.float32(0.0), np.float32(0.0), np.float32(1.0), np.float32(1.0), np.float32(0.0)]",0.0,99261.5,31
2025-08-14_08-18-36,9556,"[np.float32(0.0), np.float32(0.0), np.float32(0.0), np.float32(1.0), np.float32(1.0), np.float32(1.0), np.float32(0.0), np.float32(1.0), np.float32(1.0), np.float32(1.0), np.float32(0.0), np.float32(0.0), np.float32(1.0), np.float32(0.0), np.float32(0.0), np.float32(0.0)]",-5.0,99256.5,0
2025-08-14_08-18-36,9557,"[np.float32(0.0), np.float32(1.0), np.float32(0.0), np.float32(0.0), np.float32(0.0), np.float32(1.0), np.float32(0.0), np.float32(1.0), np.float32(0.0), np.float32(1.0), np.float32(0.0), np.float32(1.0), np.float32(0.0), np.float32(1.0), np.float32(0.0), np.float32(1.0)]",-2.0,99254.5,36
2025-08-14_08-18-36,9558,"[np.float32(0.0), np.float32(1.0), np.float32(0.0), np.float32(1.0), np.float32(1.0), np.float32(1.0), np.float32(0.0), np.float32(1.0), np.float32(1.0), np.float32(0.0), np.float32(1.0), np.float32(1.0), np.float32(1.0), np.float32(0.0), np.float32(0.0), np.float32(0.0)]",0.0,99254.5,31
2025-08-14_08-18-36,9559,"[np.float32(1.0), np.float32(1.0), np.float32(0.0), np.float32(0.0), np.float32(1.0), np.float32(1.0), np.float32(0.0), np.float32(0.0), np.float32(1.0), np.float32(0.0), np.float32(0.0), np.float32(0.0), np.float32(0.0), np.float32(1.0), np.float32(0.0), np.float32(1.0)]",-3.0,99251.5,11
2025-08-14_08-18-36,9560,"[np.float32(1.0), np.float32(0.0), np.float32(0.0), np.float32(1.0), np.float32(1.0), np.float32(0.0), np.float32(1.0), np.float32(1.0), np.float32(1.0), np.float32(1.0), np.float32(0.0), np.float32(0.0), np.float32(0.0), np.float32(1.0), np.float32(1.0), np.float32(0.0)]",3.0,99254.5,1
2025-08-14_08-18-36,9561,"[np.float32(0.0), np.float32(1.0), np.float32(0.0), np.float32(1.0), np.float32(0.0), np.float32(1.0), np.float32(1.0), np.float32(1.0), np.float32(0.0), np.float32(0.0), np.float32(0.0), np.float32(1.0), np.float32(0.0), np.float32(1.0), np.float32(1.0), np.float32(0.0)]",-5.0,99249.5,14
2025-08-14_08-18-36,9562,"[np.float32(1.0), np.float32(1.0), np.float32(0.0), np.float32(0.0), np.float32(0.0), np.float32(0.0), np.float32(0.0), np.float32(1.0), np.float32(0.0), np.float32(0.0), np.float32(0.0), np.float32(1.0), np.float32(0.0), np.float32(1.0), np.float32(0.0), np.float32(1.0)]",-1.0,99248.5,36
2025-08-14_08-18-36,9563,"[np.float32(1.0), np.float32(1.0), np.float32(1.0), np.float32(1.0), np.float32(1.0), np.float32(1.0), np.float32(1.0), np.float32(1.0), np.float32(1.0), np.float32(1.0), np.float32(0.0), np.float32(1.0), np.float32(0.0), np.float32(1.0), np.float32(0.0), np.float32(1.0)]",2.0,99250.5,9
2025-08-14_08-18-36,9564,"[np.float32(0.0), np.float32(1.0), np.float32(1.0), np.float32(0.0), np.float32(1.0), np.float32(0.0), np.float32(0.0), np.float32(1.0), np.float32(0.0), np.float32(0.0), np.float32(0.0), np.float32(0.0), np.float32(1.0), np.float32(1.0), np.float32(0.0), np.float32(1.0)]",-4.0,99246.5,23
2025-08-14_08-18-36,9565,"[np.float32(0.0), np.float32(0.0), np.float32(1.0), np.float32(0.0), np.float32(1.0), np.float32(0.0), np.float32(1.0), np.float32(0.0), np.float32(0.0), np.float32(0.0), np.float32(0.0), np.float32(1.0), np.float32(0.0), np.float32(0.0), np.float32(1.0), np.float32(0.0)]",2.0,99248.5,16
2025-08-14_08-18-36,9566,"[np.float32(1.0), np.float32(0.0), np.float32(1.0), np.float32(1.0), np.float32(1.0), np.float32(0.0), np.float32(0.0), np.float32(1.0), np.float32(1.0), np.float32(0.0), np.float32(0.0), np.float32(1.0), np.float32(1.0), np.float32(0.0), np.float32(0.0), np.float32(0.0)]",-4.0,99244.5,8
2025-08-14_08-18-36,9567,"[np.float32(1.0), np.float32(1.0), np.float32(0.0), np.float32(1.0), np.float32(1.0), np.float32(0.0), np.float32(1.0), np.float32(1.0), np.float32(1.0), np.float32(0.0), np.float32(1.0), np.float32(0.0), np.float32(1.0), np.float32(0.0), np.float32(0.0), np.float32(0.0)]",0.0,99244.5,9
2025-08-14_08-18-36,9568,"[np.float32(0.0), np.float32(0.0), np.float32(0.0), np.float32(1.0), np.float32(0.0), np.float32(0.0), np.float32(1.0), np.float32(1.0), np.float32(0.0), np.float32(0.0), np.float32(0.0), np.float32(0.0), np.float32(0.0), np.float32(0.0), np.float32(1.0), np.float32(0.0)]",4.0,99248.5,5
2025-08-14_08-18-36,9569,"[np.float32(0.0), np.float32(1.0), np.float32(0.0), np.float32(0.0), np.float32(1.0), np.float32(0.0), np.float32(0.0), np.float32(1.0), np.float32(0.0), np.float32(0.0), np.float32(0.0), np.float32(0.0), np.float32(1.0), np.float32(1.0), np.float32(0.0), np.float32(0.0)]",2.0,99250.5,2
2025-08-14_08-18-36,9570,"[np.float32(1.0), np.float32(1.0), np.float32(1.0), np.float32(1.0), np.float32(0.0), np.float32(0.0), np.float32(1.0), np.float32(0.0), np.float32(0.0), np.float32(0.0), np.float32(0.0), np.float32(0.0), np.float32(1.0), np.float32(1.0), np.float32(1.0), np.float32(1.0)]",-2.0,99248.5,28
2025-08-14_08-18-36,9571,"[np.float32(1.0), np.float32(0.0), np.float32(0.0), np.float32(0.0), np.float32(1.0), np.float32(0.0), np.float32(0.0), np.float32(1.0), np.float32(0.0), np.float32(0.0), np.float32(0.0), np.float32(0.0), np.float32(1.0), np.float32(1.0), np.float32(1.0), np.float32(0.0)]",4.0,99252.5,16
2025-08-14_08-18-36,9572,"[np.float32(0.0), np.float32(1.0), np.float32(1.0), np.float32(0.0), np.float32(0.0), np.float32(1.0), np.float32(1.0), np.float32(1.0), np.float32(1.0), np.float32(1.0), np.float32(0.0), np.float32(0.0), np.float32(1.0), np.float32(0.0), np.float32(0.0), np.float32(0.0)]",-2.0,99250.5,1
2025-08-14_08-18-36,9573,"[np.float32(1.0), np.float32(1.0), np.float32(1.0), np.float32(0.0), np.float32(0.0), np.float32(1.0), np.float32(0.0), np.float32(0.0), np.float32(0.0), np.float32(0.0), np.float32(0.0), np.float32(0.0), np.float32(0.0), np.float32(1.0), np.float32(0.0), np.float32(0.0)]",-1.0,99249.5,27
2025-08-14_08-18-36,9574,"[np.float32(1.0), np.float32(1.0), np.float32(0.0), np.float32(1.0), np.float32(1.0), np.float32(1.0), np.float32(0.0), np.float32(1.0), np.float32(1.0), np.float32(0.0), np.float32(0.0), np.float32(0.0), np.float32(0.0), np.float32(1.0), np.float32(0.0), np.float32(1.0)]",3.0,99252.5,19
2025-08-14_08-18-36,9575,"[np.float32(0.0), np.float32(1.0), np.float32(0.0), np.float32(1.0), np.float32(0.0), np.float32(1.0), np.float32(1.0), np.float32(1.0), np.float32(1.0), np.float32(0.0), np.float32(1.0), np.float32(1.0), np.float32(1.0), np.float32(0.0), np.float32(0.0), np.float32(0.0)]",1.0,99253.5,24
2025-08-14_08-18-36,9576,"[np.float32(0.0), np.float32(0.0), np.float32(1.0), np.float32(0.0), np.float32(0.0), np.float32(1.0), np.float32(0.0), np.float32(1.0), np.float32(1.0), np.float32(0.0), np.float32(0.0), np.float32(0.0), np.float32(0.0), np.float32(0.0), np.float32(1.0), np.float32(0.0)]",0.0,99253.5,10
2025-08-14_08-18-36,9577,"[np.float32(1.0), np.float32(1.0), np.float32(1.0), np.float32(1.0), np.float32(0.0), np.float32(1.0), np.float32(0.0), np.float32(0.0), np.float32(0.0), np.float32(0.0), np.float32(1.0), np.float32(1.0), np.float32(1.0), np.float32(0.0), np.float32(1.0), np.float32(0.0)]",3.0,99256.5,36
2025-08-14_08-18-36,9578,"[np.float32(0.0), np.float32(0.0), np.float32(1.0), np.float32(1.0), np.float32(0.0), np.float32(1.0), np.float32(1.0), np.float32(1.0), np.float32(1.0), np.float32(1.0), np.float32(1.0), np.float32(0.0), np.float32(0.0), np.float32(0.0), np.float32(0.0), np.float32(1.0)]",1.0,99257.5,28
2025-08-14_08-18-36,9579,"[np.float32(0.0), np.float32(0.0), np.float32(1.0), np.float32(1.0), np.float32(1.0), np.float32(1.0), np.float32(1.0), np.float32(1.0), np.float32(1.0), np.float32(1.0), np.float32(0.0), np.float32(1.0), np.float32(0.0), np.float32(0.0), np.float32(0.0), np.float32(0.0)]",1.0,99258.5,28
2025-08-14_08-18-36,9580,"[np.float32(1.0), np.float32(0.0), np.float32(0.0), np.float32(0.0), np.float32(1.0), np.float32(0.0), np.float32(0.0), np.float32(1.0), np.float32(1.0), np.float32(0.0), np.float32(0.0), np.float32(1.0), np.float32(0.0), np.float32(1.0), np.float32(0.0), np.float32(1.0)]",4.0,99262.5,15
2025-08-14_08-18-36,9581,"[np.float32(1.0), np.float32(0.0), np.float32(0.0), np.float32(0.0), np.float32(0.0), np.float32(0.0), np.float32(0.0), np.float32(0.0), np.float32(1.0), np.float32(0.0), np.float32(1.0), np.float32(1.0), np.float32(1.0), np.float32(0.0), np.float32(0.0), np.float32(0.0)]",-3.0,99259.5,19
2025-08-14_08-18-36,9582,"[np.float32(1.0), np.float32(1.0), np.float32(1.0), np.float32(1.0), np.float32(0.0), np.float32(1.0), np.float32(0.0), np.float32(1.0), np.float32(0.0), np.float32(0.0), np.float32(0.0), np.float32(0.0), np.float32(1.0), np.float32(0.0), np.float32(0.0), np.float32(0.0)]",2.0,99261.5,23
2025-08-14_08-18-36,9583,"[np.float32(1.0), np.float32(0.0), np.float32(0.0), np.float32(0.0), np.float32(0.0), np.float32(0.0), np.float32(0.0), np.float32(1.0), np.float32(1.0), np.float32(1.0), np.float32(0.0), np.float32(0.0), np.float32(0.0), np.float32(0.0), np.float32(0.0), np.float32(0.0)]",-1.0,99260.5,15
2025-08-14_08-18-36,9584,"[np.float32(0.0), np.float32(0.0), np.float32(1.0), np.float32(0.0), np.float32(1.0), np.float32(0.0), np.float32(1.0), np.float32(1.0), np.float32(1.0), np.float32(1.0), np.float32(1.0), np.float32(0.0), np.float32(1.0), np.float32(0.0), np.float32(1.0), np.float32(0.0)]",4.0,99264.5,8
2025-08-14_08-18-36,9585,"[np.float32(0.0), np.float32(0.0), np.float32(1.0), np.float32(1.0), np.float32(0.0), np.float32(0.0), np.float32(1.0), np.float32(0.0), np.float32(0.0), np.float32(1.0), np.float32(0.0), np.float32(0.0), np.float32(1.0), np.float32(1.0), np.float32(1.0), np.float32(0.0)]",-2.0,99262.5,27
2025-08-14_08-18-36,9586,"[np.float32(1.0), np.float32(1.0), np.float32(0.0), np.float32(1.0), np.float32(1.0), np.float32(1.0), np.float32(0.0), np.float32(1.0), np.float32(1.0), np.float32(1.0), np.float32(0.0), np.float32(0.0), np.float32(1.0), np.float32(1.0), np.float32(1.0), np.float32(0.0)]",1.0,99263.5,33
2025-08-14_08-18-36,9587,"[np.float32(0.0), np.float32(1.0), np.float32(1.0), np.float32(0.0), np.float32(0.0), np.float32(1.0), np.float32(1.0), np.float32(1.0), np.float32(1.0), np.float32(0.0), np.float32(1.0), np.float32(0.0), np.float32(0.0), np.float32(0.0), np.float32(1.0), np.float32(1.0)]",1.0,99264.5,35
2025-08-14_08-18-36,9588,"[np.float32(0.0), np.float32(1.0), np.float32(0.0), np.float32(0.0), np.float32(0.0), np.float32(0.0), np.float32(0.0), np.float32(1.0), np.float32(1.0), np.float32(0.0), np.float32(1.0), np.float32(0.0), np.float32(0.0), np.float32(1.0), np.float32(0.0), np.float32(1.0)]",5.0,99269.5,17
2025-08-14_08-18-36,9589,"[np.float32(0.0), np.float32(1.0), np.float32(0.0), np.float32(1.0), np.float32(0.0), np.float32(0.0), np.float32(0.0), np.float32(1.0), np.float32(1.0), np.float32(0.0), np.float32(0.0), np.float32(0.0), np.float32(1.0), np.float32(1.0), np.float32(0.0), np.float32(0.0)]",-3.0,99266.5,36
2025-08-14_08-18-36,9590,"[np.float32(0.0), np.float32(1.0), np.float32(0.0), np.float32(0.0), np.float32(0.0), np.float32(1.0), np.float32(0.0), np.float32(1.0), np.float32(0.0), np.float32(1.0), np.float32(0.0), np.float32(1.0), np.float32(1.0), np.float32(1.0), np.float32(0.0), np.float32(0.0)]",-2.0,99264.5,10
2025-08-14_08-18-36,9591,"[np.float32(0.0), np.float32(0.0), np.float32(0.0), np.float32(1.0), np.float32(1.0), np.float32(1.0), np.float32(1.0), np.float32(1.0), np.float32(1.0), np.float32(1.0), np.float32(1.0), np.float32(0.0), np.float32(1.0), np.float32(1.0), np.float32(0.0), np.float32(0.0)]",-5.0,99259.5,0
2025-08-14_08-18-36,9592,"[np.float32(1.0), np.float32(0.0), np.float32(0.0), np.float32(1.0), np.float32(1.0), np.float32(1.0), np.float32(0.0), np.float32(1.0), np.float32(1.0), np.float32(0.0), np.float32(0.0), np.float32(1.0), np.float32(0.0), np.float32(1.0), np.float32(0.0), np.float32(0.0)]",-1.0,99258.5,16
2025-08-14_08-18-36,9593,"[np.float32(0.0), np.float32(1.0), np.float32(0.0), np.float32(0.0), np.float32(1.0), np.float32(0.0), np.float32(1.0), np.float32(0.0), np.float32(0.0), np.float32(0.0), np.float32(1.0), np.float32(1.0), np.float32(0.0), np.float32(1.0), np.float32(0.0), np.float32(1.0)]",-2.0,99256.5,33
2025-08-14_08-18-36,9594,"[np.float32(0.0), np.float32(1.0), np.float32(0.0), np.float32(1.0), np.float32(1.0), np.float32(0.0), np.float32(1.0), np.float32(0.0), np.float32(1.0), np.float32(1.0), np.float32(1.0), np.float32(1.0), np.float32(1.0), np.float32(1.0), np.float32(1.0), np.float32(0.0)]",2.0,99258.5,5
2025-08-14_08-18-36,9595,"[np.float32(0.0), np.float32(0.0), np.float32(0.0), np.float32(1.0), np.float32(1.0), np.float32(0.0), np.float32(1.0), np.float32(0.0), np.float32(0.0), np.float32(0.0), np.float32(1.0), np.float32(1.0), np.float32(1.0), np.float32(0.0), np.float32(0.0), np.float32(0.0)]",-1.0,99257.5,14
2025-08-14_08-18-36,9596,"[np.float32(0.0), np.float32(1.0), np.float32(0.0), np.float32(0.0), np.float32(0.0), np.float32(1.0), np.float32(0.0), np.float32(0.0), np.float32(0.0), np.float32(1.0), np.float32(1.0), np.float32(0.0), np.float32(0.0), np.float32(1.0), np.float32(0.0), np.float32(0.0)]",-3.0,99254.5,6
2025-08-14_08-18-36,9597,"[np.float32(1.0), np.float32(1.0), np.float32(1.0), np.float32(0.0), np.float32(0.0), np.float32(0.0), np.float32(1.0), np.float32(1.0), np.float32(1.0), np.float32(1.0), np.float32(1.0), np.float32(0.0), np.float32(1.0), np.float32(1.0), np.float32(1.0), np.float32(0.0)]",0.0,99254.5,35
2025-08-14_08-18-36,9598,"[np.float32(1.0), np.float32(1.0), np.float32(1.0), np.float32(0.0), np.float32(1.0), np.float32(0.0), np.float32(1.0), np.float32(0.0), np.float32(0.0), np.float32(1.0), np.float32(1.0), np.float32(0.0), np.float32(0.0), np.float32(1.0), np.float32(1.0), np.float32(0.0)]",1.0,99255.5,13
2025-08-14_08-18-36,9599,"[np.float32(0.0), np.float32(1.0), np.float32(1.0), np.float32(0.0), np.float32(0.0), np.float32(1.0), np.float32(0.0), np.float32(0.0), np.float32(1.0), np.float32(0.0), np.float32(1.0), np.float32(0.0), np.float32(1.0), np.float32(1.0), np.float32(0.0), np.float32(0.0)]",-2.0,99253.5,11
2025-08-14_08-18-36,9600,"[np.float32(1.0), np.float32(1.0), np.float32(1.0), np.float32(1.0), np.float32(1.0), np.float32(1.0), np.float32(1.0), np.float32(1.0), np.float32(1.0), np.float32(0.0), np.float32(0.0), np.float32(0.0), np.float32(1.0), np.float32(1.0), np.float32(0.0), np.float32(1.0)]",0.0,99253.5,6
2025-08-14_08-18-36,9601,"[np.float32(0.0), np.float32(0.0), np.float32(0.0), np.float32(1.0), np.float32(1.0), np.float32(1.0), np.float32(1.0), np.float32(1.0), np.float32(0.0), np.float32(1.0), np.float32(1.0), np.float32(0.0), np.float32(0.0), np.float32(0.0), np.float32(1.0), np.float32(0.0)]",5.0,99258.5,5
2025-08-14_08-18-36,9602,"[np.float32(1.0), np.float32(1.0), np.float32(0.0), np.float32(1.0), np.float32(1.0), np.float32(1.0), np.float32(0.0), np.float32(1.0), np.float32(1.0), np.float32(1.0), np.float32(0.0), np.float32(0.0), np.float32(1.0), np.float32(1.0), np.float32(0.0), np.float32(0.0)]",-3.0,99255.5,36
2025-08-14_08-18-36,9603,"[np.float32(0.0), np.float32(1.0), np.float32(1.0), np.float32(1.0), np.float32(1.0), np.float32(0.0), np.float32(1.0), np.float32(1.0), np.float32(0.0), np.float32(1.0), np.float32(1.0), np.float32(1.0), np.float32(0.0), np.float32(1.0), np.float32(0.0), np.float32(0.0)]",2.0,99257.5,10
2025-08-14_08-18-36,9604,"[np.float32(1.0), np.float32(1.0), np.float32(0.0), np.float32(1.0), np.float32(0.0), np.float32(0.0), np.float32(1.0), np.float32(0.0), np.float32(1.0), np.float32(1.0), np.float32(0.0), np.float32(0.0), np.float32(1.0), np.float32(1.0), np.float32(0.0), np.float32(0.0)]",-1.0,99256.5,33
2025-08-14_08-18-36,9605,"[np.float32(0.0), np.float32(0.0), np.float32(0.0), np.float32(0.0), np.float32(0.0), np.float32(1.0), np.float32(0.0), np.float32(0.0), np.float32(0.0), np.float32(0.0), np.float32(0.0), np.float32(0.0), np.float32(1.0), np.float32(1.0), np.float32(1.0), np.float32(1.0)]",0.0,99256.5,27
2025-08-14_08-18-36,9606,"[np.float32(0.0), np.float32(0.0), np.float32(1.0), np.float32(0.0), np.float32(0.0), np.float32(1.0), np.float32(0.0), np.float32(0.0), np.float32(1.0), np.float32(1.0), np.float32(0.0), np.float32(1.0), np.float32(0.0), np.float32(1.0), np.float32(0.0), np.float32(0.0)]",-4.0,99252.5,8
2025-08-14_08-18-36,9607,"[np.float32(0.0), np.float32(0.0), np.float32(1.0), np.float32(0.0), np.float32(1.0), np.float32(1.0), np.float32(1.0), np.float32(1.0), np.float32(0.0), np.float32(0.0), np.float32(1.0), np.float32(0.0), np.float32(1.0), np.float32(0.0), np.float32(0.0), np.float32(1.0)]",-1.0,99251.5,22
2025-08-14_08-18-36,9608,"[np.float32(0.0), np.float32(0.0), np.float32(0.0), np.float32(1.0), np.float32(0.0), np.float32(1.0), np.float32(1.0), np.float32(1.0), np.float32(1.0), np.float32(1.0), np.float32(1.0), np.float32(1.0), np.float32(1.0), np.float32(0.0), np.float32(0.0), np.float32(1.0)]",-2.0,99249.5,28
2025-08-14_08-18-36,9609,"[np.float32(1.0), np.float32(0.0), np.float32(0.0), np.float32(0.0), np.float32(0.0), np.float32(1.0), np.float32(0.0), np.float32(1.0), np.float32(0.0), np.float32(1.0), np.float32(1.0), np.float32(1.0), np.float32(1.0), np.float32(1.0), np.float32(1.0), np.float32(0.0)]",4.0,99253.5,21
2025-08-14_08-18-36,9610,"[np.float32(0.0), np.float32(0.0), np.float32(0.0), np.float32(0.0), np.float32(1.0), np.float32(1.0), np.float32(0.0), np.float32(1.0), np.float32(1.0), np.float32(1.0), np.float32(1.0), np.float32(0.0), np.float32(0.0), np.float32(1.0), np.float32(1.0), np.float32(0.0)]",0.0,99253.5,20
2025-08-14_08-18-36,9611,"[np.float32(1.0), np.float32(1.0), np.float32(1.0), np.float32(0.0), np.float32(0.0), np.float32(1.0), np.float32(1.0), np.float32(1.0), np.float32(1.0), np.float32(1.0), np.float32(1.0), np.float32(0.0), np.float32(0.0), np.float32(0.0), np.float32(0.0), np.float32(1.0)]",-4.0,99249.5,0
2025-08-14_08-18-36,9612,"[np.float32(0.0), np.float32(1.0), np.float32(1.0), np.float32(0.0), np.float32(0.0), np.float32(0.0), np.float32(0.0), np.float32(1.0), np.float32(1.0), np.float32(0.0), np.float32(0.0), np.float32(0.0), np.float32(0.0), np.float32(1.0), np.float32(0.0), np.float32(0.0)]",0.0,99249.5,12
2025-08-14_08-18-36,9613,"[np.float32(0.0), np.float32(0.0), np.float32(0.0), np.float32(1.0), np.float32(0.0), np.float32(0.0), np.float32(0.0), np.float32(1.0), np.float32(0.0), np.float32(1.0), np.float32(1.0), np.float32(0.0), np.float32(1.0), np.float32(1.0), np.float32(1.0), np.float32(0.0)]",-4.0,99245.5,34
2025-08-14_08-18-36,9614,"[np.float32(0.0), np.float32(1.0), np.float32(1.0), np.float32(1.0), np.float32(1.0), np.float32(1.0), np.float32(1.0), np.float32(0.0), np.float32(1.0), np.float32(0.0), np.float32(0.0), np.float32(0.0), np.float32(0.0), np.float32(0.0), np.float32(0.0), np.float32(0.0)]",-1.0,99244.5,13
2025-08-14_08-18-36,9615,"[np.float32(0.0), np.float32(1.0), np.float32(1.0), np.float32(1.0), np.float32(0.0), np.float32(0.0), np.float32(0.0), np.float32(1.0), np.float32(1.0), np.float32(1.0), np.float32(0.0), np.float32(1.0), np.float32(1.0), np.float32(1.0), np.float32(0.0), np.float32(0.0)]",1.0,99245.5,13
2025-08-14_08-18-36,9616,"[np.float32(0.0), np.float32(1.0), np.float32(0.0), np.float32(0.0), np.float32(0.0), np.float32(1.0), np.float32(0.0), np.float32(0.0), np.float32(1.0), np.float32(1.0), np.float32(1.0), np.float32(1.0), np.float32(0.0), np.float32(0.0), np.float32(1.0), np.float32(1.0)]",0.0,99245.5,13
2025-08-14_08-18-36,9617,"[np.float32(1.0), np.float32(1.0), np.float32(0.0), np.float32(0.0), np.float32(0.0), np.float32(1.0), np.float32(0.0), np.float32(1.0), np.float32(0.0), np.float32(0.0), np.float32(1.0), np.float32(1.0), np.float32(0.0), np.float32(0.0), np.float32(0.0), np.float32(0.0)]",-4.0,99241.5,4
2025-08-14_08-18-36,9618,"[np.float32(1.0), np.float32(0.0), np.float32(1.0), np.float32(0.0), np.float32(1.0), np.float32(0.0), np.float32(0.0), np.float32(0.0), np.float32(1.0), np.float32(1.0), np.float32(0.0), np.float32(0.0), np.float32(0.0), np.float32(1.0), np.float32(1.0), np.float32(0.0)]",3.0,99244.5,4
2025-08-14_08-18-36,9619,"[np.float32(1.0), np.float32(0.0), np.float32(1.0), np.float32(0.0), np.float32(0.0), np.float32(1.0), np.float32(1.0), np.float32(1.0), np.float32(1.0), np.float32(1.0), np.float32(0.0), np.float32(1.0), np.float32(0.0), np.float32(0.0), np.float32(0.0), np.float32(1.0)]",-2.0,99242.5,23
2025-08-14_08-18-36,9620,"[np.float32(0.0), np.float32(1.0), np.float32(0.0), np.float32(1.0), np.float32(1.0), np.float32(0.0), np.float32(0.0), np.float32(1.0), np.float32(1.0), np.float32(0.0), np.float32(0.0), np.float32(1.0), np.float32(1.0), np.float32(1.0), np.float32(0.0), np.float32(0.0)]",0.0,99242.5,24
2025-08-14_08-18-36,9621,"[np.float32(1.0), np.float32(1.0), np.float32(1.0), np.float32(1.0), np.float32(1.0), np.float32(1.0), np.float32(1.0), np.float32(0.0), np.float32(1.0), np.float32(0.0), np.float32(0.0), np.float32(0.0), np.float32(1.0), np.float32(0.0), np.float32(1.0), np.float32(0.0)]",-1.0,99241.5,6
2025-08-14_08-18-36,9622,"[np.float32(1.0), np.float32(1.0), np.float32(0.0), np.float32(0.0), np.float32(0.0), np.float32(1.0), np.float32(0.0), np.float32(0.0), np.float32(1.0), np.float32(1.0), np.float32(1.0), np.float32(1.0), np.float32(0.0), np.float32(1.0), np.float32(0.0), np.float32(0.0)]",5.0,99246.5,25
2025-08-14_08-18-36,9623,"[np.float32(0.0), np.float32(1.0), np.float32(0.0), np.float32(0.0), np.float32(1.0), np.float32(1.0), np.float32(0.0), np.float32(0.0), np.float32(1.0), np.float32(1.0), np.float32(1.0), np.float32(1.0), np.float32(0.0), np.float32(0.0), np.float32(0.0), np.float32(0.0)]",0.0,99246.5,2
2025-08-14_08-18-36,9624,"[np.float32(1.0), np.float32(0.0), np.float32(1.0), np.float32(1.0), np.float32(0.0), np.float32(0.0), np.float32(1.0), np.float32(1.0), np.float32(1.0), np.float32(0.0), np.float32(1.0), np.float32(1.0), np.float32(0.0), np.float32(1.0), np.float32(1.0), np.float32(0.0)]",3.0,99249.5,3
2025-08-14_08-18-36,9625,"[np.float32(0.0), np.float32(1.0), np.float32(0.0), np.float32(1.0), np.float32(0.0), np.float32(1.0), np.float32(0.0), np.float32(0.0), np.float32(1.0), np.float32(0.0), np.float32(0.0), np.float32(1.0), np.float32(0.0), np.float32(1.0), np.float32(0.0), np.float32(0.0)]",4.0,99253.5,26
2025-08-14_08-18-36,9626,"[np.float32(1.0), np.float32(1.0), np.float32(1.0), np.float32(0.0), np.float32(0.0), np.float32(1.0), np.float32(1.0), np.float32(1.0), np.float32(1.0), np.float32(0.0), np.float32(1.0), np.float32(0.0), np.float32(1.0), np.float32(0.0), np.float32(1.0), np.float32(0.0)]",0.0,99253.5,10
2025-08-14_08-18-36,9627,"[np.float32(0.0), np.float32(0.0), np.float32(1.0), np.float32(0.0), np.float32(0.0), np.float32(1.0), np.float32(0.0), np.float32(0.0), np.float32(1.0), np.float32(0.0), np.float32(0.0), np.float32(0.0), np.float32(0.0), np.float32(0.0), np.float32(0.0), np.float32(1.0)]",4.0,99257.5,31
2025-08-14_08-18-36,9628,"[np.float32(1.0), np.float32(1.0), np.float32(0.0), np.float32(0.0), np.float32(0.0), np.float32(0.0), np.float32(1.0), np.float32(1.0), np.float32(1.0), np.float32(1.0), np.float32(0.0), np.float32(1.0), np.float32(1.0), np.float32(1.0), np.float32(0.0), np.float32(1.0)]",-5.0,99252.5,8
2025-08-14_08-18-36,9629,"[np.float32(0.0), np.float32(1.0), np.float32(0.0), np.float32(0.0), np.float32(0.0), np.float32(1.0), np.float32(0.0), np.float32(0.0), np.float32(1.0), np.float32(0.0), np.float32(1.0), np.float32(1.0), np.float32(1.0), np.float32(0.0), np.float32(0.0), np.float32(0.0)]",1.0,99253.5,31
2025-08-14_08-18-36,9630,"[np.float32(1.0), np.float32(0.0), np.float32(1.0), np.float32(1.0), np.float32(1.0), np.float32(0.0), np.float32(1.0), np.float32(1.0), np.float32(0.0), np.float32(0.0), np.float32(0.0), np.float32(0.0), np.float32(0.0), np.float32(1.0), np.float32(1.0), np.float32(1.0)]",-4.0,99249.5,28
2025-08-14_08-18-36,9631,"[np.float32(0.0), np.float32(0.0), np.float32(1.0), np.float32(1.0), np.float32(1.0), np.float32(0.0), np.float32(1.0), np.float32(1.0), np.float32(1.0), np.float32(1.0), np.float32(0.0), np.float32(1.0), np.float32(1.0), np.float32(0.0), np.float32(0.0), np.float32(1.0)]",-3.0,99246.5,5
2025-08-14_08-18-36,9632,"[np.float32(1.0), np.float32(1.0), np.float32(0.0), np.float32(1.0), np.float32(1.0), np.float32(1.0), np.float32(1.0), np.float32(0.0), np.float32(0.0), np.float32(1.0), np.float32(0.0), np.float32(1.0), np.float32(0.0), np.float32(0.0), np.float32(1.0), np.float32(0.0)]",3.0,99249.5,1
2025-08-14_08-18-36,9633,"[np.float32(1.0), np.float32(1.0), np.float32(1.0), np.float32(0.0), np.float32(1.0), np.float32(0.0), np.float32(1.0), np.float32(1.0), np.float32(0.0), np.float32(0.0), np.float32(0.0), np.float32(0.0), np.float32(0.0), np.float32(0.0), np.float32(1.0), np.float32(1.0)]",2.0,99251.5,17
2025-08-14_08-18-36,9634,"[np.float32(1.0), np.float32(1.0), np.float32(1.0), np.float32(1.0), np.float32(0.0), np.float32(1.0), np.float32(1.0), np.float32(0.0), np.float32(1.0), np.float32(0.0), np.float32(0.0), np.float32(1.0), np.float32(0.0), np.float32(0.0), np.float32(1.0), np.float32(0.0)]",-5.0,99246.5,17
2025-08-14_08-18-36,9635,"[np.float32(0.0), np.float32(1.0), np.float32(0.0), np.float32(0.0), np.float32(0.0), np.float32(0.0), np.float32(1.0), np.float32(0.0), np.float32(0.0), np.float32(0.0), np.float32(0.0), np.float32(0.0), np.float32(0.0), np.float32(0.0), np.float32(1.0), np.float32(0.0)]",0.0,99246.5,9
2025-08-14_08-18-36,9636,"[np.float32(1.0), np.float32(1.0), np.float32(0.0), np.float32(0.0), np.float32(0.0), np.float32(0.0), np.float32(0.0), np.float32(0.0), np.float32(0.0), np.float32(1.0), np.float32(1.0), np.float32(1.0), np.float32(1.0), np.float32(1.0), np.float32(0.0), np.float32(0.0)]",1.0,99247.5,12
2025-08-14_08-18-36,9637,"[np.float32(0.0), np.float32(0.0), np.float32(1.0), np.float32(0.0), np.float32(0.0), np.float32(0.0), np.float32(1.0), np.float32(1.0), np.float32(1.0), np.float32(1.0), np.float32(0.0), np.float32(0.0), np.float32(1.0), np.float32(0.0), np.float32(0.0), np.float32(0.0)]",-3.0,99244.5,35
2025-08-14_08-18-36,9638,"[np.float32(0.0), np.float32(0.0), np.float32(0.0), np.float32(1.0), np.float32(1.0), np.float32(1.0), np.float32(0.0), np.float32(0.0), np.float32(1.0), np.float32(0.0), np.float32(0.0), np.float32(0.0), np.float32(1.0), np.float32(0.0), np.float32(1.0), np.float32(0.0)]",1.0,99245.5,29
2025-08-14_08-18-36,9639,"[np.float32(0.0), np.float32(0.0), np.float32(1.0), np.float32(0.0), np.float32(0.0), np.float32(0.0), np.float32(1.0), np.float32(1.0), np.float32(0.0), np.float32(1.0), np.float32(1.0), np.float32(0.0), np.float32(1.0), np.float32(1.0), np.float32(0.0), np.float32(1.0)]",0.0,99245.5,32
2025-08-14_08-18-36,9640,"[np.float32(1.0), np.float32(1.0), np.float32(1.0), np.float32(1.0), np.float32(0.0), np.float32(1.0), np.float32(0.0), np.float32(1.0), np.float32(1.0), np.float32(0.0), np.float32(1.0), np.float32(0.0), np.float32(1.0), np.float32(0.0), np.float32(0.0), np.float32(1.0)]",-1.0,99244.5,28
2025-08-14_08-18-36,9641,"[np.float32(1.0), np.float32(0.0), np.float32(0.0), np.float32(1.0), np.float32(0.0), np.float32(1.0), np.float32(0.0), np.float32(1.0), np.float32(1.0), np.float32(1.0), np.float32(1.0), np.float32(0.0), np.float32(1.0), np.float32(0.0), np.float32(0.0), np.float32(1.0)]",4.0,99248.5,34
2025-08-14_08-18-36,9642,"[np.float32(0.0), np.float32(1.0), np.float32(1.0), np.float32(0.0), np.float32(0.0), np.float32(1.0), np.float32(1.0), np.float32(1.0), np.float32(1.0), np.float32(0.0), np.float32(1.0), np.float32(0.0), np.float32(1.0), np.float32(0.0), np.float32(1.0), np.float32(0.0)]",3.0,99251.5,24
2025-08-14_08-18-36,9643,"[np.float32(1.0), np.float32(1.0), np.float32(0.0), np.float32(0.0), np.float32(0.0), np.float32(1.0), np.float32(1.0), np.float32(1.0), np.float32(1.0), np.float32(0.0), np.float32(0.0), np.float32(1.0), np.float32(1.0), np.float32(1.0), np.float32(0.0), np.float32(0.0)]",-1.0,99250.5,9
2025-08-14_08-18-36,9644,"[np.float32(1.0), np.float32(1.0), np.float32(0.0), np.float32(0.0), np.float32(1.0), np.float32(1.0), np.float32(0.0), np.float32(1.0), np.float32(0.0), np.float32(0.0), np.float32(0.0), np.float32(0.0), np.float32(0.0), np.float32(0.0), np.float32(0.0), np.float32(1.0)]",4.0,99254.5,17
2025-08-14_08-18-36,9645,"[np.float32(0.0), np.float32(0.0), np.float32(1.0), np.float32(0.0), np.float32(1.0), np.float32(1.0), np.float32(1.0), np.float32(1.0), np.float32(1.0), np.float32(1.0), np.float32(0.0), np.float32(0.0), np.float32(1.0), np.float32(1.0), np.float32(0.0), np.float32(1.0)]",-5.0,99249.5,23
2025-08-14_08-18-36,9646,"[np.float32(0.0), np.float32(0.0), np.float32(1.0), np.float32(0.0), np.float32(0.0), np.float32(1.0), np.float32(0.0), np.float32(1.0), np.float32(0.0), np.float32(0.0), np.float32(1.0), np.float32(0.0), np.float32(0.0), np.float32(1.0), np.float32(0.0), np.float32(0.0)]",2.0,99251.5,0
2025-08-14_08-18-36,9647,"[np.float32(0.0), np.float32(0.0), np.float32(1.0), np.float32(0.0), np.float32(1.0), np.float32(1.0), np.float32(1.0), np.float32(1.0), np.float32(1.0), np.float32(1.0), np.float32(1.0), np.float32(1.0), np.float32(0.0), np.float32(1.0), np.float32(0.0), np.float32(0.0)]",3.0,99254.5,18
2025-08-14_08-18-36,9648,"[np.float32(1.0), np.float32(1.0), np.float32(1.0), np.float32(1.0), np.float32(0.0), np.float32(0.0), np.float32(1.0), np.float32(0.0), np.float32(1.0), np.float32(1.0), np.float32(1.0), np.float32(0.0), np.float32(1.0), np.float32(0.0), np.float32(1.0), np.float32(1.0)]",-1.0,99253.5,25
2025-08-14_08-18-36,9649,"[np.float32(0.0), np.float32(1.0), np.float32(0.0), np.float32(1.0), np.float32(0.0), np.float32(0.0), np.float32(0.0), np.float32(1.0), np.float32(1.0), np.float32(0.0), np.float32(0.0), np.float32(0.0), np.float32(1.0), np.float32(1.0), np.float32(1.0), np.float32(1.0)]",-3.0,99250.5,2
2025-08-14_08-18-36,9650,"[np.float32(0.0), np.float32(0.0), np.float32(0.0), np.float32(0.0), np.float32(0.0), np.float32(1.0), np.float32(1.0), np.float32(1.0), np.float32(0.0), np.float32(1.0), np.float32(1.0), np.float32(0.0), np.float32(1.0), np.float32(1.0), np.float32(0.0), np.float32(1.0)]",-3.0,99247.5,0
2025-08-14_08-18-36,9651,"[np.float32(1.0), np.float32(1.0), np.float32(1.0), np.float32(1.0), np.float32(0.0), np.float32(0.0), np.float32(0.0), np.float32(1.0), np.float32(0.0), np.float32(0.0), np.float32(1.0), np.float32(0.0), np.float32(1.0), np.float32(1.0), np.float32(0.0), np.float32(1.0)]",-5.0,99242.5,36
2025-08-14_08-18-36,9652,"[np.float32(0.0), np.float32(1.0), np.float32(0.0), np.float32(1.0), np.float32(1.0), np.float32(1.0), np.float32(1.0), np.float32(1.0), np.float32(1.0), np.float32(0.0), np.float32(0.0), np.float32(1.0), np.float32(0.0), np.float32(1.0), np.float32(0.0), np.float32(1.0)]",0.0,99242.5,20
2025-08-14_08-18-36,9653,"[np.float32(1.0), np.float32(1.0), np.float32(0.0), np.float32(0.0), np.float32(1.0), np.float32(0.0), np.float32(0.0), np.float32(1.0), np.float32(0.0), np.float32(0.0), np.float32(1.0), np.float32(1.0), np.float32(1.0), np.float32(0.0), np.float32(0.0), np.float32(0.0)]",0.0,99242.5,12
2025-08-14_08-18-36,9654,"[np.float32(1.0), np.float32(0.0), np.float32(0.0), np.float32(1.0), np.float32(1.0), np.float32(1.0), np.float32(1.0), np.float32(1.0), np.float32(1.0), np.float32(1.0), np.float32(1.0), np.float32(0.0), np.float32(0.0), np.float32(0.0), np.float32(1.0), np.float32(1.0)]",1.0,99243.5,7
2025-08-14_08-18-36,9655,"[np.float32(1.0), np.float32(0.0), np.float32(0.0), np.float32(0.0), np.float32(0.0), np.float32(0.0), np.float32(0.0), np.float32(0.0), np.float32(0.0), np.float32(0.0), np.float32(1.0), np.float32(0.0), np.float32(0.0), np.float32(1.0), np.float32(1.0), np.float32(1.0)]",0.0,99243.5,25
2025-08-14_08-18-36,9656,"[np.float32(1.0), np.float32(1.0), np.float32(0.0), np.float32(1.0), np.float32(0.0), np.float32(0.0), np.float32(0.0), np.float32(1.0), np.float32(0.0), np.float32(0.0), np.float32(0.0), np.float32(1.0), np.float32(1.0), np.float32(1.0), np.float32(0.0), np.float32(0.0)]",4.0,99247.5,18
2025-08-14_08-18-36,9657,"[np.float32(1.0), np.float32(1.0), np.float32(0.0), np.float32(0.0), np.float32(1.0), np.float32(1.0), np.float32(0.0), np.float32(1.0), np.float32(1.0), np.float32(0.0), np.float32(1.0), np.float32(1.0), np.float32(1.0), np.float32(0.0), np.float32(0.0), np.float32(0.0)]",1.0,99248.5,32
2025-08-14_08-18-36,9658,"[np.float32(0.0), np.float32(1.0), np.float32(1.0), np.float32(1.0), np.float32(0.0), np.float32(0.0), np.float32(1.0), np.float32(1.0), np.float32(1.0), np.float32(1.0), np.float32(0.0), np.float32(0.0), np.float32(0.0), np.float32(1.0), np.float32(0.0), np.float32(1.0)]",-2.0,99246.5,24
2025-08-14_08-18-36,9659,"[np.float32(1.0), np.float32(0.0), np.float32(0.0), np.float32(1.0), np.float32(0.0), np.float32(0.0), np.float32(1.0), np.float32(1.0), np.float32(0.0), np.float32(0.0), np.float32(0.0), np.float32(0.0), np.float32(0.0), np.float32(1.0), np.float32(0.0), np.float32(0.0)]",-2.0,99244.5,24
2025-08-14_08-18-36,9660,"[np.float32(1.0), np.float32(1.0), np.float32(0.0), np.float32(0.0), np.float32(1.0), np.float32(1.0), np.float32(0.0), np.float32(0.0), np.float32(1.0), np.float32(0.0), np.float32(0.0), np.float32(0.0), np.float32(1.0), np.float32(1.0), np.float32(0.0), np.float32(1.0)]",-1.0,99243.5,21
2025-08-14_08-18-36,9661,"[np.float32(1.0), np.float32(1.0), np.float32(1.0), np.float32(1.0), np.float32(1.0), np.float32(0.0), np.float32(1.0), np.float32(0.0), np.float32(1.0), np.float32(1.0), np.float32(0.0), np.float32(0.0), np.float32(0.0), np.float32(1.0), np.float32(0.0), np.float32(1.0)]",3.0,99246.5,34
2025-08-14_08-18-36,9662,"[np.float32(0.0), np.float32(1.0), np.float32(0.0), np.float32(0.0), np.float32(0.0), np.float32(0.0), np.float32(1.0), np.float32(1.0), np.float32(1.0), np.float32(1.0), np.float32(1.0), np.float32(1.0), np.float32(1.0), np.float32(0.0), np.float32(0.0), np.float32(1.0)]",-3.0,99243.5,36
2025-08-14_08-18-36,9663,"[np.float32(0.0), np.float32(1.0), np.float32(1.0), np.float32(1.0), np.float32(1.0), np.float32(1.0), np.float32(1.0), np.float32(0.0), np.float32(0.0), np.float32(1.0), np.float32(0.0), np.float32(0.0), np.float32(0.0), np.float32(0.0), np.float32(0.0), np.float32(0.0)]",-1.0,99242.5,29
2025-08-14_08-18-36,9664,"[np.float32(1.0), np.float32(1.0), np.float32(1.0), np.float32(1.0), np.float32(0.0), np.float32(0.0), np.float32(0.0), np.float32(1.0), np.float32(1.0), np.float32(0.0), np.float32(1.0), np.float32(0.0), np.float32(0.0), np.float32(0.0), np.float32(1.0), np.float32(0.0)]",2.0,99244.5,30
2025-08-14_08-18-36,9665,"[np.float32(0.0), np.float32(1.0), np.float32(1.0), np.float32(1.0), np.float32(0.0), np.float32(1.0), np.float32(1.0), np.float32(0.0), np.float32(1.0), np.float32(1.0), np.float32(1.0), np.float32(1.0), np.float32(1.0), np.float32(1.0), np.float32(1.0), np.float32(1.0)]",0.0,99244.5,2
2025-08-14_08-18-36,9666,"[np.float32(0.0), np.float32(0.0), np.float32(1.0), np.float32(0.0), np.float32(1.0), np.float32(0.0), np.float32(0.0), np.float32(0.0), np.float32(0.0), np.float32(0.0), np.float32(0.0), np.float32(1.0), np.float32(0.0), np.float32(1.0), np.float32(0.0), np.float32(1.0)]",0.0,99244.5,36
2025-08-14_08-18-36,9667,"[np.float32(0.0), np.float32(1.0), np.float32(0.0), np.float32(1.0), np.float32(1.0), np.float32(0.0), np.float32(1.0), np.float32(0.0), np.float32(1.0), np.float32(0.0), np.float32(1.0), np.float32(0.0), np.float32(1.0), np.float32(1.0), np.float32(0.0), np.float32(0.0)]",1.0,99245.5,15
2025-08-14_08-18-36,9668,"[np.float32(0.0), np.float32(0.0), np.float32(1.0), np.float32(1.0), np.float32(1.0), np.float32(0.0), np.float32(1.0), np.float32(1.0), np.float32(0.0), np.float32(0.0), np.float32(0.0), np.float32(1.0), np.float32(0.0), np.float32(0.0), np.float32(1.0), np.float32(1.0)]",2.0,99247.5,12
2025-08-14_08-18-36,9669,"[np.float32(1.0), np.float32(1.0), np.float32(1.0), np.float32(0.0), np.float32(1.0), np.float32(1.0), np.float32(1.0), np.float32(1.0), np.float32(0.0), np.float32(0.0), np.float32(1.0), np.float32(1.0), np.float32(1.0), np.float32(1.0), np.float32(0.0), np.float32(0.0)]",-1.0,99246.5,9
2025-08-14_08-18-36,9670,"[np.float32(1.0), np.float32(0.0), np.float32(1.0), np.float32(1.0), np.float32(0.0), np.float32(1.0), np.float32(1.0), np.float32(1.0), np.float32(1.0), np.float32(0.0), np.float32(1.0), np.float32(1.0), np.float32(1.0), np.float32(1.0), np.float32(1.0), np.float32(1.0)]",2.0,99248.5,32
2025-08-14_08-18-36,9671,"[np.float32(1.0), np.float32(0.0), np.float32(1.0), np.float32(0.0), np.float32(1.0), np.float32(0.0), np.float32(0.0), np.float32(0.0), np.float32(0.0), np.float32(0.0), np.float32(1.0), np.float32(0.0), np.float32(1.0), np.float32(0.0), np.float32(0.0), np.float32(0.0)]",1.0,99249.5,16
2025-08-14_08-18-36,9672,"[np.float32(1.0), np.float32(0.0), np.float32(1.0), np.float32(1.0), np.float32(0.0), np.float32(0.0), np.float32(1.0), np.float32(0.0), np.float32(1.0), np.float32(1.0), np.float32(1.0), np.float32(1.0), np.float32(0.0), np.float32(0.0), np.float32(0.0), np.float32(0.0)]",2.0,99251.5,32
2025-08-14_08-18-36,9673,"[np.float32(1.0), np.float32(1.0), np.float32(0.0), np.float32(0.0), np.float32(1.0), np.float32(1.0), np.float32(0.0), np.float32(1.0), np.float32(1.0), np.float32(1.0), np.float32(1.0), np.float32(1.0), np.float32(0.0), np.float32(0.0), np.float32(0.0), np.float32(0.0)]",1.0,99252.5,25
2025-08-14_08-18-36,9674,"[np.float32(0.0), np.float32(1.0), np.float32(1.0), np.float32(0.0), np.float32(0.0), np.float32(0.0), np.float32(1.0), np.float32(0.0), np.float32(1.0), np.float32(1.0), np.float32(0.0), np.float32(0.0), np.float32(1.0), np.float32(1.0), np.float32(1.0), np.float32(1.0)]",-6.0,99246.5,23
2025-08-14_08-18-36,9675,"[np.float32(0.0), np.float32(0.0), np.float32(1.0), np.float32(0.0), np.float32(0.0), np.float32(1.0), np.float32(1.0), np.float32(1.0), np.float32(1.0), np.float32(0.0), np.float32(1.0), np.float32(0.0), np.float32(1.0), np.float32(0.0), np.float32(1.0), np.float32(0.0)]",1.0,99247.5,5
2025-08-14_08-18-36,9676,"[np.float32(0.0), np.float32(0.0), np.float32(0.0), np.float32(0.0), np.float32(0.0), np.float32(1.0), np.float32(1.0), np.float32(1.0), np.float32(0.0), np.float32(0.0), np.float32(0.0), np.float32(0.0), np.float32(0.0), np.float32(0.0), np.float32(0.0), np.float32(0.0)]",0.0,99247.5,8
2025-08-14_08-18-36,9677,"[np.float32(0.0), np.float32(0.0), np.float32(0.0), np.float32(0.0), np.float32(1.0), np.float32(1.0), np.float32(0.0), np.float32(0.0), np.float32(1.0), np.float32(1.0), np.float32(0.0), np.float32(0.0), np.float32(1.0), np.float32(1.0), np.float32(1.0), np.float32(0.0)]",1.0,99248.5,35
2025-08-14_08-18-36,9678,"[np.float32(1.0), np.float32(1.0), np.float32(0.0), np.float32(1.0), np.float32(0.0), np.float32(1.0), np.float32(0.0), np.float32(1.0), np.float32(1.0), np.float32(1.0), np.float32(0.0), np.float32(0.0), np.float32(0.0), np.float32(1.0), np.float32(0.0), np.float32(1.0)]",-2.0,99246.5,9
2025-08-14_08-18-36,9679,"[np.float32(1.0), np.float32(1.0), np.float32(0.0), np.float32(0.0), np.float32(0.0), np.float32(0.0), np.float32(0.0), np.float32(1.0), np.float32(0.0), np.float32(0.0), np.float32(0.0), np.float32(1.0), np.float32(0.0), np.float32(0.0), np.float32(0.0), np.float32(1.0)]",0.0,99246.5,1
2025-08-14_08-18-36,9680,"[np.float32(0.0), np.float32(1.0), np.float32(0.0), np.float32(0.0), np.float32(0.0), np.float32(0.0), np.float32(1.0), np.float32(1.0), np.float32(0.0), np.float32(1.0), np.float32(0.0), np.float32(1.0), np.float32(1.0), np.float32(1.0), np.float32(1.0), np.float32(1.0)]",0.0,99246.5,18
2025-08-14_08-18-36,9681,"[np.float32(1.0), np.float32(1.0), np.float32(0.0), np.float32(0.0), np.float32(0.0), np.float32(1.0), np.float32(1.0), np.float32(0.0), np.float32(1.0), np.float32(0.0), np.float32(0.0), np.float32(0.0), np.float32(1.0), np.float32(1.0), np.float32(0.0), np.float32(1.0)]",2.0,99248.5,31
2025-08-14_08-18-36,9682,"[np.float32(1.0), np.float32(0.0), np.float32(1.0), np.float32(1.0), np.float32(0.0), np.float32(0.0), np.float32(1.0), np.float32(1.0), np.float32(1.0), np.float32(0.0), np.float32(1.0), np.float32(0.0), np.float32(0.0), np.float32(1.0), np.float32(0.0), np.float32(0.0)]",0.0,99248.5,8
2025-08-14_08-18-36,9683,"[np.float32(1.0), np.float32(0.0), np.float32(1.0), np.float32(0.0), np.float32(0.0), np.float32(0.0), np.float32(0.0), np.float32(0.0), np.float32(0.0), np.float32(1.0), np.float32(0.0), np.float32(0.0), np.float32(1.0), np.float32(1.0), np.float32(0.0), np.float32(0.0)]",-5.0,99243.5,11
2025-08-14_08-18-36,9684,"[np.float32(0.0), np.float32(1.0), np.float32(1.0), np.float32(0.0), np.float32(0.0), np.float32(1.0), np.float32(0.0), np.float32(0.0), np.float32(0.0), np.float32(0.0), np.float32(0.0), np.float32(1.0), np.float32(1.0), np.float32(1.0), np.float32(1.0), np.float32(1.0)]",-1.0,99242.5,31
2025-08-14_08-18-36,9685,"[np.float32(0.0), np.float32(1.0), np.float32(0.0), np.float32(1.0), np.float32(0.0), np.float32(1.0), np.float32(1.0), np.float32(1.0), np.float32(0.0), np.float32(1.0), np.float32(1.0), np.float32(1.0), np.float32(0.0), np.float32(0.0), np.float32(1.0), np.float32(1.0)]",3.0,99245.5,13
2025-08-14_08-18-36,9686,"[np.float32(0.0), np.float32(1.0), np.float32(1.0), np.float32(0.0), np.float32(0.0), np.float32(1.0), np.float32(0.0), np.float32(1.0), np.float32(1.0), np.float32(1.0), np.float32(0.0), np.float32(0.0), np.float32(0.0), np.float32(1.0), np.float32(1.0), np.float32(0.0)]",-3.0,99242.5,17
2025-08-14_08-18-36,9687,"[np.float32(0.0), np.float32(1.0), np.float32(1.0), np.float32(0.0), np.float32(1.0), np.float32(0.0), np.float32(0.0), np.float32(0.0), np.float32(1.0), np.float32(1.0), np.float32(0.0), np.float32(0.0), np.float32(1.0), np.float32(1.0), np.float32(1.0), np.float32(0.0)]",-2.0,99240.5,27
2025-08-14_08-18-36,9688,"[np.float32(0.0), np.float32(0.0), np.float32(0.0), np.float32(1.0), np.float32(0.0), np.float32(1.0), np.float32(0.0), np.float32(1.0), np.float32(1.0), np.float32(0.0), np.float32(1.0), np.float32(1.0), np.float32(0.0), np.float32(0.0), np.float32(1.0), np.float32(0.0)]",1.0,99241.5,17
2025-08-14_08-18-36,9689,"[np.float32(1.0), np.float32(1.0), np.float32(1.0), np.float32(0.0), np.float32(0.0), np.float32(0.0), np.float32(1.0), np.float32(0.0), np.float32(0.0), np.float32(1.0), np.float32(0.0), np.float32(1.0), np.float32(1.0), np.float32(0.0), np.float32(0.0), np.float32(0.0)]",0.0,99241.5,2
2025-08-14_08-18-36,9690,"[np.float32(0.0), np.float32(1.0), np.float32(1.0), np.float32(1.0), np.float32(0.0), np.float32(0.0), np.float32(1.0), np.float32(0.0), np.float32(0.0), np.float32(1.0), np.float32(0.0), np.float32(1.0), np.float32(1.0), np.float32(1.0), np.float32(0.0), np.float32(1.0)]",-1.0,99240.5,19
2025-08-14_08-18-36,9691,"[np.float32(1.0), np.float32(0.0), np.float32(0.0), np.float32(0.0), np.float32(1.0), np.float32(0.0), np.float32(1.0), np.float32(0.0), np.float32(1.0), np.float32(1.0), np.float32(1.0), np.float32(0.0), np.float32(1.0), np.float32(1.0), np.float32(0.0), np.float32(1.0)]",40.0,99280.5,7
2025-08-14_08-18-36,9692,"[np.float32(0.0), np.float32(0.0), np.float32(0.0), np.float32(0.0), np.float32(1.0), np.float32(1.0), np.float32(0.0), np.float32(1.0), np.float32(1.0), np.float32(1.0), np.float32(0.0), np.float32(1.0), np.float32(0.0), np.float32(0.0), np.float32(0.0), np.float32(0.0)]",-1.0,99279.5,26
2025-08-14_08-18-36,9693,"[np.float32(1.0), np.float32(1.0), np.float32(1.0), np.float32(1.0), np.float32(0.0), np.float32(1.0), np.float32(1.0), np.float32(0.0), np.float32(0.0), np.float32(0.0), np.float32(1.0), np.float32(0.0), np.float32(0.0), np.float32(0.0), np.float32(0.0), np.float32(0.0)]",-1.0,99278.5,0
2025-08-14_08-18-36,9694,"[np.float32(0.0), np.float32(1.0), np.float32(0.0), np.float32(0.0), np.float32(1.0), np.float32(1.0), np.float32(1.0), np.float32(1.0), np.float32(1.0), np.float32(0.0), np.float32(0.0), np.float32(1.0), np.float32(0.0), np.float32(1.0), np.float32(1.0), np.float32(0.0)]",2.0,99280.5,27
2025-08-14_08-18-36,9695,"[np.float32(1.0), np.float32(1.0), np.float32(0.0), np.float32(0.0), np.float32(1.0), np.float32(1.0), np.float32(0.0), np.float32(0.0), np.float32(1.0), np.float32(0.0), np.float32(1.0), np.float32(0.0), np.float32(0.0), np.float32(1.0), np.float32(0.0), np.float32(0.0)]",3.0,99283.5,28
2025-08-14_08-18-36,9696,"[np.float32(1.0), np.float32(1.0), np.float32(0.0), np.float32(0.0), np.float32(0.0), np.float32(0.0), np.float32(1.0), np.float32(0.0), np.float32(0.0), np.float32(1.0), np.float32(1.0), np.float32(0.0), np.float32(0.0), np.float32(1.0), np.float32(1.0), np.float32(0.0)]",4.0,99287.5,7
2025-08-14_08-18-36,9697,"[np.float32(1.0), np.float32(0.0), np.float32(1.0), np.float32(0.0), np.float32(1.0), np.float32(1.0), np.float32(0.0), np.float32(1.0), np.float32(1.0), np.float32(1.0), np.float32(1.0), np.float32(0.0), np.float32(1.0), np.float32(1.0), np.float32(0.0), np.float32(1.0)]",2.0,99289.5,26
2025-08-14_08-18-36,9698,"[np.float32(1.0), np.float32(0.0), np.float32(0.0), np.float32(0.0), np.float32(1.0), np.float32(1.0), np.float32(0.0), np.float32(0.0), np.float32(0.0), np.float32(1.0), np.float32(0.0), np.float32(1.0), np.float32(1.0), np.float32(1.0), np.float32(0.0), np.float32(0.0)]",-3.0,99286.5,14
2025-08-14_08-18-36,9699,"[np.float32(0.0), np.float32(1.0), np.float32(1.0), np.float32(1.0), np.float32(1.0), np.float32(0.0), np.float32(1.0), np.float32(1.0), np.float32(0.0), np.float32(0.0), np.float32(1.0), np.float32(1.0), np.float32(1.0), np.float32(1.0), np.float32(1.0), np.float32(0.0)]",-1.0,99285.5,9
2025-08-14_08-18-36,9700,"[np.float32(0.0), np.float32(0.0), np.float32(1.0), np.float32(1.0), np.float32(1.0), np.float32(0.0), np.float32(1.0), np.float32(1.0), np.float32(0.0), np.float32(0.0), np.float32(0.0), np.float32(1.0), np.float32(1.0), np.float32(1.0), np.float32(1.0), np.float32(1.0)]",-2.0,99283.5,27
2025-08-14_08-18-36,9701,"[np.float32(0.0), np.float32(0.0), np.float32(1.0), np.float32(1.0), np.float32(1.0), np.float32(0.0), np.float32(1.0), np.float32(1.0), np.float32(0.0), np.float32(1.0), np.float32(0.0), np.float32(1.0), np.float32(0.0), np.float32(1.0), np.float32(1.0), np.float32(0.0)]",-2.0,99281.5,14
2025-08-14_08-18-36,9702,"[np.float32(0.0), np.float32(1.0), np.float32(0.0), np.float32(0.0), np.float32(1.0), np.float32(0.0), np.float32(1.0), np.float32(1.0), np.float32(1.0), np.float32(0.0), np.float32(0.0), np.float32(0.0), np.float32(1.0), np.float32(1.0), np.float32(1.0), np.float32(0.0)]",2.0,99283.5,4
2025-08-14_08-18-36,9703,"[np.float32(1.0), np.float32(1.0), np.float32(0.0), np.float32(1.0), np.float32(0.0), np.float32(0.0), np.float32(1.0), np.float32(1.0), np.float32(1.0), np.float32(0.0), np.float32(1.0), np.float32(1.0), np.float32(0.0), np.float32(0.0), np.float32(0.0), np.float32(0.0)]",0.0,99283.5,30
2025-08-14_08-18-36,9704,"[np.float32(0.0), np.float32(1.0), np.float32(1.0), np.float32(1.0), np.float32(0.0), np.float32(0.0), np.float32(1.0), np.float32(1.0), np.float32(0.0), np.float32(1.0), np.float32(1.0), np.float32(0.0), np.float32(1.0), np.float32(0.0), np.float32(1.0), np.float32(1.0)]",0.0,99283.5,6
2025-08-14_08-18-36,9705,"[np.float32(0.0), np.float32(1.0), np.float32(1.0), np.float32(1.0), np.float32(0.0), np.float32(0.0), np.float32(1.0), np.float32(0.0), np.float32(0.0), np.float32(1.0), np.float32(0.0), np.float32(1.0), np.float32(1.0), np.float32(1.0), np.float32(0.0), np.float32(0.0)]",-3.0,99280.5,36
2025-08-14_08-18-36,9706,"[np.float32(0.0), np.float32(0.0), np.float32(0.0), np.float32(0.0), np.float32(0.0), np.float32(1.0), np.float32(0.0), np.float32(1.0), np.float32(0.0), np.float32(0.0), np.float32(1.0), np.float32(0.0), np.float32(0.0), np.float32(0.0), np.float32(1.0), np.float32(0.0)]",1.0,99281.5,35
2025-08-14_08-18-36,9707,"[np.float32(1.0), np.float32(0.0), np.float32(0.0), np.float32(0.0), np.float32(1.0), np.float32(0.0), np.float32(1.0), np.float32(0.0), np.float32(1.0), np.float32(0.0), np.float32(0.0), np.float32(1.0), np.float32(0.0), np.float32(1.0), np.float32(1.0), np.float32(0.0)]",1.0,99282.5,15
2025-08-14_08-18-36,9708,"[np.float32(0.0), np.float32(1.0), np.float32(1.0), np.float32(0.0), np.float32(0.0), np.float32(1.0), np.float32(1.0), np.float32(1.0), np.float32(0.0), np.float32(0.0), np.float32(0.0), np.float32(0.0), np.float32(1.0), np.float32(0.0), np.float32(0.0), np.float32(1.0)]",-2.0,99280.5,13
2025-08-14_08-18-36,9709,"[np.float32(0.0), np.float32(1.0), np.float32(1.0), np.float32(1.0), np.float32(0.0), np.float32(1.0), np.float32(0.0), np.float32(1.0), np.float32(1.0), np.float32(0.0), np.float32(0.0), np.float32(1.0), np.float32(0.0), np.float32(1.0), np.float32(0.0), np.float32(1.0)]",1.0,99281.5,30
2025-08-14_08-18-36,9710,"[np.float32(0.0), np.float32(1.0), np.float32(0.0), np.float32(0.0), np.float32(0.0), np.float32(1.0), np.float32(0.0), np.float32(1.0), np.float32(1.0), np.float32(1.0), np.float32(1.0), np.float32(0.0), np.float32(0.0), np.float32(0.0), np.float32(1.0), np.float32(1.0)]",2.0,99283.5,29
2025-08-14_08-18-36,9711,"[np.float32(1.0), np.float32(0.0), np.float32(0.0), np.float32(1.0), np.float32(1.0), np.float32(0.0), np.float32(1.0), np.float32(0.0), np.float32(0.0), np.float32(0.0), np.float32(0.0), np.float32(1.0), np.float32(1.0), np.float32(0.0), np.float32(0.0), np.float32(0.0)]",-2.0,99281.5,14
2025-08-14_08-18-36,9712,"[np.float32(0.0), np.float32(1.0), np.float32(1.0), np.float32(1.0), np.float32(1.0), np.float32(0.0), np.float32(0.0), np.float32(1.0), np.float32(0.0), np.float32(1.0), np.float32(0.0), np.float32(0.0), np.float32(0.0), np.float32(0.0), np.float32(0.0), np.float32(1.0)]",0.0,99281.5,7
2025-08-14_08-18-36,9713,"[np.float32(0.0), np.float32(0.0), np.float32(1.0), np.float32(0.0), np.float32(0.0), np.float32(0.0), np.float32(1.0), np.float32(1.0), np.float32(0.0), np.float32(0.0), np.float32(0.0), np.float32(0.0), np.float32(1.0), np.float32(0.0), np.float32(0.0), np.float32(1.0)]",-2.0,99279.5,5
2025-08-14_08-18-36,9714,"[np.float32(1.0), np.float32(0.0), np.float32(1.0), np.float32(0.0), np.float32(0.0), np.float32(0.0), np.float32(0.0), np.float32(1.0), np.float32(0.0), np.float32(0.0), np.float32(0.0), np.float32(1.0), np.float32(0.0), np.float32(0.0), np.float32(1.0), np.float32(1.0)]",-4.0,99275.5,2
2025-08-14_08-18-36,9715,"[np.float32(1.0), np.float32(0.0), np.float32(0.0), np.float32(1.0), np.float32(1.0), np.float32(1.0), np.float32(1.0), np.float32(1.0), np.float32(1.0), np.float32(0.0), np.float32(0.0), np.float32(0.0), np.float32(0.0), np.float32(1.0), np.float32(0.0), np.float32(0.0)]",-3.0,99272.5,6
2025-08-14_08-18-36,9716,"[np.float32(1.0), np.float32(0.0), np.float32(1.0), np.float32(0.0), np.float32(0.0), np.float32(0.0), np.float32(1.0), np.float32(1.0), np.float32(1.0), np.float32(0.0), np.float32(0.0), np.float32(0.0), np.float32(1.0), np.float32(1.0), np.float32(0.0), np.float32(0.0)]",1.0,99273.5,4
2025-08-14_08-18-36,9717,"[np.float32(0.0), np.float32(0.0), np.float32(0.0), np.float32(0.0), np.float32(0.0), np.float32(1.0), np.float32(0.0), np.float32(0.0), np.float32(0.0), np.float32(0.0), np.float32(1.0), np.float32(1.0), np.float32(1.0), np.float32(0.0), np.float32(1.0), np.float32(0.0)]",31.0,99304.5,7
2025-08-14_08-18-36,9718,"[np.float32(1.0), np.float32(0.0), np.float32(0.0), np.float32(1.0), np.float32(0.0), np.float32(1.0), np.float32(0.0), np.float32(1.0), np.float32(1.0), np.float32(1.0), np.float32(0.0), np.float32(0.0), np.float32(1.0), np.float32(0.0), np.float32(0.0), np.float32(1.0)]",-1.0,99303.5,30
2025-08-14_08-18-36,9719,"[np.float32(0.0), np.float32(1.0), np.float32(0.0), np.float32(1.0), np.float32(1.0), np.float32(1.0), np.float32(1.0), np.float32(1.0), np.float32(1.0), np.float32(0.0), np.float32(0.0), np.float32(0.0), np.float32(1.0), np.float32(1.0), np.float32(0.0), np.float32(0.0)]",-2.0,99301.5,6
2025-08-14_08-18-36,9720,"[np.float32(0.0), np.float32(1.0), np.float32(1.0), np.float32(0.0), np.float32(0.0), np.float32(0.0), np.float32(1.0), np.float32(0.0), np.float32(0.0), np.float32(0.0), np.float32(0.0), np.float32(1.0), np.float32(0.0), np.float32(0.0), np.float32(1.0), np.float32(0.0)]",-1.0,99300.5,26
2025-08-14_08-18-36,9721,"[np.float32(1.0), np.float32(1.0), np.float32(1.0), np.float32(1.0), np.float32(1.0), np.float32(1.0), np.float32(1.0), np.float32(1.0), np.float32(0.0), np.float32(0.0), np.float32(0.0), np.float32(1.0), np.float32(1.0), np.float32(1.0), np.float32(1.0), np.float32(0.0)]",0.0,99300.5,2
2025-08-14_08-18-36,9722,"[np.float32(1.0), np.float32(1.0), np.float32(0.0), np.float32(0.0), np.float32(0.0), np.float32(1.0), np.float32(1.0), np.float32(1.0), np.float32(0.0), np.float32(1.0), np.float32(0.0), np.float32(0.0), np.float32(1.0), np.float32(0.0), np.float32(1.0), np.float32(0.0)]",-1.0,99299.5,33
2025-08-14_08-18-36,9723,"[np.float32(0.0), np.float32(1.0), np.float32(1.0), np.float32(0.0), np.float32(1.0), np.float32(0.0), np.float32(1.0), np.float32(1.0), np.float32(0.0), np.float32(0.0), np.float32(0.0), np.float32(1.0), np.float32(0.0), np.float32(1.0), np.float32(0.0), np.float32(1.0)]",-3.0,99296.5,33
2025-08-14_08-18-36,9724,"[np.float32(0.0), np.float32(0.0), np.float32(1.0), np.float32(1.0), np.float32(1.0), np.float32(1.0), np.float32(0.0), np.float32(1.0), np.float32(0.0), np.float32(0.0), np.float32(1.0), np.float32(0.0), np.float32(1.0), np.float32(1.0), np.float32(0.0), np.float32(0.0)]",-1.0,99295.5,5
2025-08-14_08-18-36,9725,"[np.float32(0.0), np.float32(1.0), np.float32(0.0), np.float32(0.0), np.float32(0.0), np.float32(0.0), np.float32(0.0), np.float32(1.0), np.float32(1.0), np.float32(1.0), np.float32(0.0), np.float32(0.0), np.float32(1.0), np.float32(0.0), np.float32(0.0), np.float32(0.0)]",-2.0,99293.5,27
2025-08-14_08-18-36,9726,"[np.float32(1.0), np.float32(0.0), np.float32(0.0), np.float32(0.0), np.float32(1.0), np.float32(1.0), np.float32(1.0), np.float32(1.0), np.float32(1.0), np.float32(1.0), np.float32(0.0), np.float32(0.0), np.float32(0.0), np.float32(0.0), np.float32(0.0), np.float32(0.0)]",-2.0,99291.5,8
2025-08-14_08-18-36,9727,"[np.float32(1.0), np.float32(0.0), np.float32(1.0), np.float32(0.0), np.float32(0.0), np.float32(1.0), np.float32(0.0), np.float32(0.0), np.float32(1.0), np.float32(0.0), np.float32(1.0), np.float32(0.0), np.float32(0.0), np.float32(0.0), np.float32(0.0), np.float32(0.0)]",-3.0,99288.5,1
2025-08-14_08-18-36,9728,"[np.float32(1.0), np.float32(1.0), np.float32(0.0), np.float32(0.0), np.float32(1.0), np.float32(0.0), np.float32(1.0), np.float32(0.0), np.float32(0.0), np.float32(0.0), np.float32(0.0), np.float32(1.0), np.float32(1.0), np.float32(0.0), np.float32(0.0), np.float32(0.0)]",-4.0,99284.5,34
2025-08-14_08-18-36,9729,"[np.float32(0.0), np.float32(1.0), np.float32(0.0), np.float32(0.0), np.float32(0.0), np.float32(1.0), np.float32(1.0), np.float32(0.0), np.float32(1.0), np.float32(1.0), np.float32(1.0), np.float32(0.0), np.float32(1.0), np.float32(1.0), np.float32(1.0), np.float32(0.0)]",-6.0,99278.5,14
2025-08-14_08-18-36,9730,"[np.float32(1.0), np.float32(0.0), np.float32(1.0), np.float32(1.0), np.float32(0.0), np.float32(1.0), np.float32(0.0), np.float32(1.0), np.float32(1.0), np.float32(1.0), np.float32(0.0), np.float32(0.0), np.float32(1.0), np.float32(0.0), np.float32(0.0), np.float32(0.0)]",-4.0,99274.5,12
2025-08-14_08-18-36,9731,"[np.float32(0.0), np.float32(1.0), np.float32(1.0), np.float32(1.0), np.float32(0.0), np.float32(0.0), np.float32(0.0), np.float32(0.0), np.float32(1.0), np.float32(0.0), np.float32(1.0), np.float32(0.0), np.float32(0.0), np.float32(1.0), np.float32(0.0), np.float32(0.0)]",4.0,99278.5,28
2025-08-14_08-18-36,9732,"[np.float32(1.0), np.float32(0.0), np.float32(0.0), np.float32(1.0), np.float32(0.0), np.float32(0.0), np.float32(0.0), np.float32(1.0), np.float32(1.0), np.float32(0.0), np.float32(1.0), np.float32(0.0), np.float32(1.0), np.float32(0.0), np.float32(1.0), np.float32(1.0)]",-1.0,99277.5,21
2025-08-14_08-18-36,9733,"[np.float32(1.0), np.float32(0.0), np.float32(0.0), np.float32(0.0), np.float32(0.0), np.float32(1.0), np.float32(1.0), np.float32(0.0), np.float32(1.0), np.float32(0.0), np.float32(1.0), np.float32(1.0), np.float32(0.0), np.float32(1.0), np.float32(1.0), np.float32(0.0)]",0.0,99277.5,24
2025-08-14_08-18-36,9734,"[np.float32(1.0), np.float32(0.0), np.float32(1.0), np.float32(1.0), np.float32(1.0), np.float32(1.0), np.float32(0.0), np.float32(1.0), np.float32(0.0), np.float32(1.0), np.float32(0.0), np.float32(0.0), np.float32(0.0), np.float32(1.0), np.float32(1.0), np.float32(0.0)]",0.0,99277.5,36
2025-08-14_08-18-36,9735,"[np.float32(0.0), np.float32(1.0), np.float32(0.0), np.float32(1.0), np.float32(1.0), np.float32(0.0), np.float32(0.0), np.float32(1.0), np.float32(1.0), np.float32(0.0), np.float32(1.0), np.float32(1.0), np.float32(1.0), np.float32(1.0), np.float32(1.0), np.float32(1.0)]",32.0,99309.5,7
2025-08-14_08-18-36,9736,"[np.float32(1.0), np.float32(0.0), np.float32(0.0), np.float32(1.0), np.float32(1.0), np.float32(0.0), np.float32(1.0), np.float32(1.0), np.float32(0.0), np.float32(0.0), np.float32(0.0), np.float32(1.0), np.float32(1.0), np.float32(1.0), np.float32(1.0), np.float32(0.0)]",39.0,99348.5,7
2025-08-14_08-18-36,9737,"[np.float32(1.0), np.float32(1.0), np.float32(0.0), np.float32(0.0), np.float32(0.0), np.float32(1.0), np.float32(0.0), np.float32(1.0), np.float32(0.0), np.float32(1.0), np.float32(0.0), np.float32(0.0), np.float32(1.0), np.float32(1.0), np.float32(1.0), np.float32(0.0)]",-1.0,99347.5,29
2025-08-14_08-18-36,9738,"[np.float32(1.0), np.float32(1.0), np.float32(1.0), np.float32(0.0), np.float32(0.0), np.float32(1.0), np.float32(0.0), np.float32(0.0), np.float32(0.0), np.float32(1.0), np.float32(0.0), np.float32(1.0), np.float32(1.0), np.float32(0.0), np.float32(1.0), np.float32(1.0)]",-2.0,99345.5,12
2025-08-14_08-18-36,9739,"[np.float32(0.0), np.float32(1.0), np.float32(0.0), np.float32(1.0), np.float32(1.0), np.float32(1.0), np.float32(0.0), np.float32(1.0), np.float32(1.0), np.float32(0.0), np.float32(1.0), np.float32(0.0), np.float32(1.0), np.float32(0.0), np.float32(1.0), np.float32(1.0)]",0.0,99345.5,27
2025-08-14_08-18-36,9740,"[np.float32(0.0), np.float32(0.0), np.float32(0.0), np.float32(1.0), np.float32(0.0), np.float32(1.0), np.float32(1.0), np.float32(1.0), np.float32(0.0), np.float32(1.0), np.float32(0.0), np.float32(0.0), np.float32(1.0), np.float32(1.0), np.float32(0.0), np.float32(1.0)]",-2.0,99343.5,12
2025-08-14_08-18-36,9741,"[np.float32(1.0), np.float32(0.0), np.float32(0.0), np.float32(0.0), np.float32(0.0), np.float32(1.0), np.float32(0.0), np.float32(0.0), np.float32(0.0), np.float32(0.0), np.float32(0.0), np.float32(1.0), np.float32(1.0), np.float32(1.0), np.float32(1.0), np.float32(1.0)]",-4.0,99339.5,8
2025-08-14_08-18-36,9742,"[np.float32(0.0), np.float32(1.0), np.float32(1.0), np.float32(1.0), np.float32(0.0), np.float32(1.0), np.float32(1.0), np.float32(0.0), np.float32(0.0), np.float32(1.0), np.float32(0.0), np.float32(0.0), np.float32(1.0), np.float32(1.0), np.float32(0.0), np.float32(0.0)]",0.0,99339.5,3
2025-08-14_08-18-36,9743,"[np.float32(0.0), np.float32(0.0), np.float32(0.0), np.float32(0.0), np.float32(0.0), np.float32(0.0), np.float32(1.0), np.float32(1.0), np.float32(0.0), np.float32(0.0), np.float32(0.0), np.float32(1.0), np.float32(1.0), np.float32(1.0), np.float32(0.0), np.float32(0.0)]",-2.0,99337.5,8
2025-08-14_08-18-36,9744,"[np.float32(1.0), np.float32(1.0), np.float32(1.0), np.float32(0.0), np.float32(1.0), np.float32(0.0), np.float32(0.0), np.float32(1.0), np.float32(0.0), np.float32(0.0), np.float32(0.0), np.float32(0.0), np.float32(0.0), np.float32(1.0), np.float32(0.0), np.float32(0.0)]",-2.0,99335.5,30
2025-08-14_08-18-36,9745,"[np.float32(1.0), np.float32(1.0), np.float32(1.0), np.float32(0.0), np.float32(1.0), np.float32(1.0), np.float32(1.0), np.float32(0.0), np.float32(0.0), np.float32(0.0), np.float32(1.0), np.float32(0.0), np.float32(1.0), np.float32(1.0), np.float32(0.0), np.float32(0.0)]",-2.0,99333.5,23
2025-08-14_08-18-36,9746,"[np.float32(0.0), np.float32(1.0), np.float32(0.0), np.float32(1.0), np.float32(1.0), np.float32(0.0), np.float32(0.0), np.float32(1.0), np.float32(0.0), np.float32(0.0), np.float32(1.0), np.float32(0.0), np.float32(1.0), np.float32(0.0), np.float32(0.0), np.float32(1.0)]",1.0,99334.5,23
2025-08-14_08-18-36,9747,"[np.float32(1.0), np.float32(1.0), np.float32(1.0), np.float32(0.0), np.float32(0.0), np.float32(0.0), np.float32(1.0), np.float32(1.0), np.float32(1.0), np.float32(1.0), np.float32(1.0), np.float32(0.0), np.float32(1.0), np.float32(0.0), np.float32(1.0), np.float32(0.0)]",0.0,99334.5,32
2025-08-14_08-18-36,9748,"[np.float32(0.0), np.float32(0.0), np.float32(0.0), np.float32(0.0), np.float32(0.0), np.float32(0.0), np.float32(0.0), np.float32(1.0), np.float32(0.0), np.float32(1.0), np.float32(0.0), np.float32(0.0), np.float32(1.0), np.float32(0.0), np.float32(0.0), np.float32(0.0)]",0.0,99334.5,10
2025-08-14_08-18-36,9749,"[np.float32(0.0), np.float32(0.0), np.float32(1.0), np.float32(1.0), np.float32(0.0), np.float32(0.0), np.float32(1.0), np.float32(0.0), np.float32(1.0), np.float32(0.0), np.float32(0.0), np.float32(1.0), np.float32(1.0), np.float32(0.0), np.float32(1.0), np.float32(1.0)]",-3.0,99331.5,20
2025-08-14_08-18-36,9750,"[np.float32(1.0), np.float32(1.0), np.float32(0.0), np.float32(1.0), np.float32(1.0), np.float32(0.0), np.float32(0.0), np.float32(1.0), np.float32(0.0), np.float32(1.0), np.float32(0.0), np.float32(0.0), np.float32(1.0), np.float32(1.0), np.float32(0.0), np.float32(0.0)]",-1.0,99330.5,23
2025-08-14_08-18-36,9751,"[np.float32(0.0), np.float32(1.0), np.float32(0.0), np.float32(0.0), np.float32(0.0), np.float32(0.0), np.float32(0.0), np.float32(1.0), np.float32(1.0), np.float32(0.0), np.float32(1.0), np.float32(1.0), np.float32(1.0), np.float32(1.0), np.float32(0.0), np.float32(0.0)]",2.0,99332.5,32
2025-08-14_08-18-36,9752,"[np.float32(0.0), np.float32(0.0), np.float32(1.0), np.float32(0.0), np.float32(0.0), np.float32(1.0), np.float32(0.0), np.float32(0.0), np.float32(0.0), np.float32(1.0), np.float32(1.0), np.float32(0.0), np.float32(0.0), np.float32(0.0), np.float32(1.0), np.float32(0.0)]",-3.0,99329.5,6
2025-08-14_08-18-36,9753,"[np.float32(0.0), np.float32(0.0), np.float32(1.0), np.float32(1.0), np.float32(0.0), np.float32(1.0), np.float32(0.0), np.float32(0.0), np.float32(0.0), np.float32(0.0), np.float32(1.0), np.float32(0.0), np.float32(1.0), np.float32(0.0), np.float32(0.0), np.float32(0.0)]",-1.0,99328.5,0
2025-08-14_08-18-36,9754,"[np.float32(1.0), np.float32(1.0), np.float32(0.0), np.float32(0.0), np.float32(0.0), np.float32(1.0), np.float32(0.0), np.float32(1.0), np.float32(1.0), np.float32(0.0), np.float32(0.0), np.float32(0.0), np.float32(0.0), np.float32(1.0), np.float32(0.0), np.float32(1.0)]",3.0,99331.5,25
2025-08-14_08-18-36,9755,"[np.float32(0.0), np.float32(1.0), np.float32(1.0), np.float32(0.0), np.float32(0.0), np.float32(0.0), np.float32(1.0), np.float32(1.0), np.float32(1.0), np.float32(1.0), np.float32(1.0), np.float32(1.0), np.float32(1.0), np.float32(1.0), np.float32(1.0), np.float32(0.0)]",-1.0,99330.5,6
2025-08-14_08-18-36,9756,"[np.float32(1.0), np.float32(0.0), np.float32(1.0), np.float32(0.0), np.float32(1.0), np.float32(0.0), np.float32(0.0), np.float32(0.0), np.float32(0.0), np.float32(1.0), np.float32(1.0), np.float32(0.0), np.float32(1.0), np.float32(1.0), np.float32(1.0), np.float32(0.0)]",2.0,99332.5,4
2025-08-14_08-18-36,9757,"[np.float32(0.0), np.float32(1.0), np.float32(1.0), np.float32(1.0), np.float32(0.0), np.float32(1.0), np.float32(1.0), np.float32(1.0), np.float32(0.0), np.float32(0.0), np.float32(0.0), np.float32(0.0), np.float32(1.0), np.float32(0.0), np.float32(1.0), np.float32(1.0)]",-4.0,99328.5,12
2025-08-14_08-18-36,9758,"[np.float32(0.0), np.float32(1.0), np.float32(1.0), np.float32(1.0), np.float32(1.0), np.float32(0.0), np.float32(1.0), np.float32(1.0), np.float32(1.0), np.float32(1.0), np.float32(0.0), np.float32(1.0), np.float32(0.0), np.float32(1.0), np.float32(0.0), np.float32(1.0)]",4.0,99332.5,4
2025-08-14_08-18-36,9759,"[np.float32(1.0), np.float32(0.0), np.float32(1.0), np.float32(0.0), np.float32(0.0), np.float32(0.0), np.float32(0.0), np.float32(1.0), np.float32(0.0), np.float32(1.0), np.float32(1.0), np.float32(0.0), np.float32(1.0), np.float32(0.0), np.float32(0.0), np.float32(0.0)]",-1.0,99331.5,1
2025-08-14_08-18-36,9760,"[np.float32(1.0), np.float32(0.0), np.float32(0.0), np.float32(0.0), np.float32(1.0), np.float32(0.0), np.float32(0.0), np.float32(0.0), np.float32(0.0), np.float32(0.0), np.float32(0.0), np.float32(0.0), np.float32(0.0), np.float32(0.0), np.float32(1.0), np.float32(0.0)]",-3.0,99328.5,35
2025-08-14_08-18-36,9761,"[np.float32(0.0), np.float32(0.0), np.float32(1.0), np.float32(0.0), np.float32(1.0), np.float32(1.0), np.float32(1.0), np.float32(0.0), np.float32(1.0), np.float32(0.0), np.float32(0.0), np.float32(0.0), np.float32(1.0), np.float32(0.0), np.float32(0.0), np.float32(1.0)]",-2.0,99326.5,35
2025-08-14_08-18-36,9762,"[np.float32(1.0), np.float32(0.0), np.float32(1.0), np.float32(0.0), np.float32(0.0), np.float32(1.0), np.float32(1.0), np.float32(1.0), np.float32(0.0), np.float32(1.0), np.float32(1.0), np.float32(1.0), np.float32(0.0), np.float32(0.0), np.float32(0.0), np.float32(0.0)]",1.0,99327.5,36
2025-08-14_08-18-36,9763,"[np.float32(1.0), np.float32(1.0), np.float32(1.0), np.float32(0.0), np.float32(0.0), np.float32(0.0), np.float32(1.0), np.float32(1.0), np.float32(0.0), np.float32(1.0), np.float32(0.0), np.float32(1.0), np.float32(1.0), np.float32(1.0), np.float32(0.0), np.float32(1.0)]",-3.0,99324.5,32
2025-08-14_08-18-36,9764,"[np.float32(0.0), np.float32(1.0), np.float32(0.0), np.float32(1.0), np.float32(0.0), np.float32(0.0), np.float32(0.0), np.float32(1.0), np.float32(1.0), np.float32(0.0), np.float32(0.0), np.float32(1.0), np.float32(0.0), np.float32(0.0), np.float32(0.0), np.float32(1.0)]",-2.0,99322.5,11
2025-08-14_08-18-36,9765,"[np.float32(1.0), np.float32(1.0), np.float32(1.0), np.float32(0.0), np.float32(1.0), np.float32(1.0), np.float32(1.0), np.float32(1.0), np.float32(0.0), np.float32(1.0), np.float32(0.0), np.float32(1.0), np.float32(1.0), np.float32(1.0), np.float32(1.0), np.float32(0.0)]",1.0,99323.5,15
2025-08-14_08-18-36,9766,"[np.float32(0.0), np.float32(1.0), np.float32(0.0), np.float32(1.0), np.float32(0.0), np.float32(0.0), np.float32(0.0), np.float32(1.0), np.float32(0.0), np.float32(0.0), np.float32(0.0), np.float32(1.0), np.float32(0.0), np.float32(1.0), np.float32(0.0), np.float32(0.0)]",0.0,99323.5,26
2025-08-14_08-18-36,9767,"[np.float32(0.0), np.float32(1.0), np.float32(1.0), np.float32(1.0), np.float32(1.0), np.float32(1.0), np.float32(1.0), np.float32(1.0), np.float32(1.0), np.float32(0.0), np.float32(0.0), np.float32(0.0), np.float32(0.0), np.float32(1.0), np.float32(0.0), np.float32(1.0)]",2.0,99325.5,2
2025-08-14_08-18-36,9768,"[np.float32(0.0), np.float32(0.0), np.float32(0.0), np.float32(1.0), np.float32(0.0), np.float32(0.0), np.float32(0.0), np.float32(1.0), np.float32(0.0), np.float32(1.0), np.float32(1.0), np.float32(1.0), np.float32(0.0), np.float32(0.0), np.float32(1.0), np.float32(0.0)]",2.0,99327.5,33
2025-08-14_08-18-36,9769,"[np.float32(1.0), np.float32(0.0), np.float32(0.0), np.float32(0.0), np.float32(0.0), np.float32(1.0), np.float32(1.0), np.float32(1.0), np.float32(0.0), np.float32(0.0), np.float32(1.0), np.float32(0.0), np.float32(1.0), np.float32(0.0), np.float32(0.0), np.float32(1.0)]",0.0,99327.5,32
2025-08-14_08-18-36,9770,"[np.float32(1.0), np.float32(1.0), np.float32(1.0), np.float32(0.0), np.float32(1.0), np.float32(0.0), np.float32(0.0), np.float32(1.0), np.float32(1.0), np.float32(1.0), np.float32(0.0), np.float32(0.0), np.float32(1.0), np.float32(1.0), np.float32(0.0), np.float32(1.0)]",0.0,99327.5,13
2025-08-14_08-18-36,9771,"[np.float32(1.0), np.float32(0.0), np.float32(1.0), np.float32(0.0), np.float32(0.0), np.float32(1.0), np.float32(0.0), np.float32(1.0), np.float32(1.0), np.float32(0.0), np.float32(1.0), np.float32(0.0), np.float32(1.0), np.float32(1.0), np.float32(1.0), np.float32(0.0)]",1.0,99328.5,22
2025-08-14_08-18-36,9772,"[np.float32(0.0), np.float32(1.0), np.float32(1.0), np.float32(1.0), np.float32(1.0), np.float32(1.0), np.float32(1.0), np.float32(0.0), np.float32(1.0), np.float32(1.0), np.float32(0.0), np.float32(1.0), np.float32(1.0), np.float32(0.0), np.float32(0.0), np.float32(0.0)]",-1.0,99327.5,13
2025-08-14_08-18-36,9773,"[np.float32(0.0), np.float32(0.0), np.float32(1.0), np.float32(1.0), np.float32(1.0), np.float32(1.0), np.float32(0.0), np.float32(0.0), np.float32(1.0), np.float32(1.0), np.float32(0.0), np.float32(0.0), np.float32(1.0), np.float32(1.0), np.float32(0.0), np.float32(0.0)]",38.0,99365.5,7
2025-08-14_08-18-36,9774,"[np.float32(0.0), np.float32(0.0), np.float32(1.0), np.float32(0.0), np.float32(1.0), np.float32(0.0), np.float32(0.0), np.float32(1.0), np.float32(1.0), np.float32(0.0), np.float32(1.0), np.float32(0.0), np.float32(0.0), np.float32(0.0), np.float32(1.0), np.float32(0.0)]",-3.0,99362.5,21
2025-08-14_08-18-36,9775,"[np.float32(0.0), np.float32(0.0), np.float32(1.0), np.float32(0.0), np.float32(0.0), np.float32(1.0), np.float32(0.0), np.float32(0.0), np.float32(1.0), np.float32(0.0), np.float32(0.0), np.float32(1.0), np.float32(1.0), np.float32(0.0), np.float32(0.0), np.float32(0.0)]",-3.0,99359.5,14
2025-08-14_08-18-36,9776,"[np.float32(0.0), np.float32(1.0), np.float32(1.0), np.float32(0.0), np.float32(1.0), np.float32(1.0), np.float32(0.0), np.float32(1.0), np.float32(1.0), np.float32(0.0), np.float32(1.0), np.float32(0.0), np.float32(1.0), np.float32(1.0), np.float32(0.0), np.float32(0.0)]",-3.0,99356.5,10
2025-08-14_08-18-36,9777,"[np.float32(0.0), np.float32(1.0), np.float32(1.0), np.float32(1.0), np.float32(0.0), np.float32(0.0), np.float32(0.0), np.float32(0.0), np.float32(1.0), np.float32(0.0), np.float32(0.0), np.float32(1.0), np.float32(1.0), np.float32(1.0), np.float32(1.0), np.float32(0.0)]",2.0,99358.5,29
2025-08-14_08-18-36,9778,"[np.float32(1.0), np.float32(0.0), np.float32(1.0), np.float32(1.0), np.float32(1.0), np.float32(1.0), np.float32(0.0), np.float32(1.0), np.float32(1.0), np.float32(0.0), np.float32(1.0), np.float32(1.0), np.float32(0.0), np.float32(0.0), np.float32(0.0), np.float32(1.0)]",0.0,99358.5,33
2025-08-14_08-18-36,9779,"[np.float32(1.0), np.float32(0.0), np.float32(0.0), np.float32(0.0), np.float32(0.0), np.float32(0.0), np.float32(1.0), np.float32(0.0), np.float32(1.0), np.float32(0.0), np.float32(0.0), np.float32(0.0), np.float32(1.0), np.float32(0.0), np.float32(1.0), np.float32(1.0)]",0.0,99358.5,11
2025-08-14_08-18-36,9780,"[np.float32(1.0), np.float32(0.0), np.float32(0.0), np.float32(1.0), np.float32(0.0), np.float32(0.0), np.float32(0.0), np.float32(1.0), np.float32(1.0), np.float32(1.0), np.float32(0.0), np.float32(1.0), np.float32(0.0), np.float32(1.0), np.float32(0.0), np.float32(1.0)]",3.0,99361.5,31
2025-08-14_08-18-36,9781,"[np.float32(0.0), np.float32(0.0), np.float32(1.0), np.float32(0.0), np.float32(1.0), np.float32(1.0), np.float32(1.0), np.float32(1.0), np.float32(1.0), np.float32(1.0), np.float32(1.0), np.float32(0.0), np.float32(0.0), np.float32(1.0), np.float32(0.0), np.float32(0.0)]",-4.0,99357.5,27
2025-08-14_08-18-36,9782,"[np.float32(0.0), np.float32(0.0), np.float32(1.0), np.float32(0.0), np.float32(0.0), np.float32(1.0), np.float32(1.0), np.float32(1.0), np.float32(1.0), np.float32(1.0), np.float32(1.0), np.float32(1.0), np.float32(1.0), np.float32(0.0), np.float32(0.0), np.float32(0.0)]",-3.0,99354.5,11
2025-08-14_08-18-36,9783,"[np.float32(0.0), np.float32(1.0), np.float32(0.0), np.float32(0.0), np.float32(1.0), np.float32(1.0), np.float32(0.0), np.float32(1.0), np.float32(0.0), np.float32(1.0), np.float32(1.0), np.float32(1.0), np.float32(1.0), np.float32(1.0), np.float32(0.0), np.float32(0.0)]",2.0,99356.5,18
2025-08-14_08-18-36,9784,"[np.float32(1.0), np.float32(1.0), np.float32(1.0), np.float32(1.0), np.float32(0.0), np.float32(0.0), np.float32(0.0), np.float32(1.0), np.float32(1.0), np.float32(0.0), np.float32(0.0), np.float32(1.0), np.float32(0.0), np.float32(1.0), np.float32(0.0), np.float32(1.0)]",4.0,99360.5,18
2025-08-14_08-18-36,9785,"[np.float32(1.0), np.float32(0.0), np.float32(1.0), np.float32(0.0), np.float32(0.0), np.float32(0.0), np.float32(1.0), np.float32(1.0), np.float32(1.0), np.float32(1.0), np.float32(1.0), np.float32(1.0), np.float32(0.0), np.float32(1.0), np.float32(0.0), np.float32(0.0)]",-4.0,99356.5,0
2025-08-14_08-18-36,9786,"[np.float32(1.0), np.float32(1.0), np.float32(0.0), np.float32(1.0), np.float32(0.0), np.float32(1.0), np.float32(1.0), np.float32(0.0), np.float32(1.0), np.float32(0.0), np.float32(1.0), np.float32(0.0), np.float32(1.0), np.float32(1.0), np.float32(1.0), np.float32(0.0)]",0.0,99356.5,36
2025-08-14_08-18-36,9787,"[np.float32(1.0), np.float32(0.0), np.float32(1.0), np.float32(0.0), np.float32(0.0), np.float32(1.0), np.float32(1.0), np.float32(1.0), np.float32(1.0), np.float32(0.0), np.float32(1.0), np.float32(0.0), np.float32(0.0), np.float32(0.0), np.float32(1.0), np.float32(0.0)]",0.0,99356.5,2
2025-08-14_08-18-36,9788,"[np.float32(0.0), np.float32(0.0), np.float32(1.0), np.float32(0.0), np.float32(0.0), np.float32(0.0), np.float32(1.0), np.float32(1.0), np.float32(0.0), np.float32(1.0), np.float32(1.0), np.float32(1.0), np.float32(1.0), np.float32(0.0), np.float32(0.0), np.float32(0.0)]",-1.0,99355.5,1
2025-08-14_08-18-36,9789,"[np.float32(0.0), np.float32(1.0), np.float32(0.0), np.float32(1.0), np.float32(1.0), np.float32(1.0), np.float32(0.0), np.float32(1.0), np.float32(0.0), np.float32(1.0), np.float32(1.0), np.float32(0.0), np.float32(1.0), np.float32(1.0), np.float32(1.0), np.float32(0.0)]",0.0,99355.5,28
2025-08-14_08-18-36,9790,"[np.float32(0.0), np.float32(1.0), np.float32(0.0), np.float32(1.0), np.float32(1.0), np.float32(1.0), np.float32(1.0), np.float32(1.0), np.float32(0.0), np.float32(0.0), np.float32(1.0), np.float32(0.0), np.float32(0.0), np.float32(1.0), np.float32(0.0), np.float32(1.0)]",-2.0,99353.5,10
2025-08-14_08-18-36,9791,"[np.float32(1.0), np.float32(1.0), np.float32(0.0), np.float32(0.0), np.float32(0.0), np.float32(0.0), np.float32(0.0), np.float32(1.0), np.float32(1.0), np.float32(1.0), np.float32(1.0), np.float32(0.0), np.float32(0.0), np.float32(1.0), np.float32(1.0), np.float32(0.0)]",-3.0,99350.5,0
2025-08-14_08-18-36,9792,"[np.float32(0.0), np.float32(0.0), np.float32(0.0), np.float32(1.0), np.float32(0.0), np.float32(1.0), np.float32(0.0), np.float32(1.0), np.float32(0.0), np.float32(0.0), np.float32(0.0), np.float32(1.0), np.float32(1.0), np.float32(0.0), np.float32(0.0), np.float32(0.0)]",-3.0,99347.5,0
2025-08-14_08-18-36,9793,"[np.float32(1.0), np.float32(0.0), np.float32(0.0), np.float32(1.0), np.float32(0.0), np.float32(0.0), np.float32(1.0), np.float32(1.0), np.float32(1.0), np.float32(0.0), np.float32(1.0), np.float32(1.0), np.float32(1.0), np.float32(0.0), np.float32(0.0), np.float32(1.0)]",1.0,99348.5,3
2025-08-14_08-18-36,9794,"[np.float32(0.0), np.float32(0.0), np.float32(0.0), np.float32(0.0), np.float32(1.0), np.float32(1.0), np.float32(0.0), np.float32(0.0), np.float32(1.0), np.float32(0.0), np.float32(0.0), np.float32(1.0), np.float32(0.0), np.float32(1.0), np.float32(0.0), np.float32(0.0)]",3.0,99351.5,12
2025-08-14_08-18-36,9795,"[np.float32(0.0), np.float32(1.0), np.float32(1.0), np.float32(1.0), np.float32(1.0), np.float32(0.0), np.float32(1.0), np.float32(1.0), np.float32(1.0), np.float32(0.0), np.float32(0.0), np.float32(0.0), np.float32(0.0), np.float32(0.0), np.float32(0.0), np.float32(0.0)]",0.0,99351.5,31
2025-08-14_08-18-36,9796,"[np.float32(0.0), np.float32(1.0), np.float32(1.0), np.float32(0.0), np.float32(1.0), np.float32(1.0), np.float32(1.0), np.float32(0.0), np.float32(1.0), np.float32(0.0), np.float32(1.0), np.float32(0.0), np.float32(1.0), np.float32(0.0), np.float32(1.0), np.float32(0.0)]",-1.0,99350.5,23
2025-08-14_08-18-36,9797,"[np.float32(1.0), np.float32(0.0), np.float32(1.0), np.float32(1.0), np.float32(1.0), np.float32(1.0), np.float32(1.0), np.float32(0.0), np.float32(1.0), np.float32(0.0), np.float32(1.0), np.float32(1.0), np.float32(0.0), np.float32(1.0), np.float32(0.0), np.float32(1.0)]",-1.0,99349.5,11
2025-08-14_08-18-36,9798,"[np.float32(1.0), np.float32(1.0), np.float32(0.0), np.float32(1.0), np.float32(0.0), np.float32(1.0), np.float32(1.0), np.float32(0.0), np.float32(1.0), np.float32(0.0), np.float32(0.0), np.float32(1.0), np.float32(0.0), np.float32(1.0), np.float32(1.0), np.float32(1.0)]",-3.0,99346.5,13
2025-08-14_08-18-36,9799,"[np.float32(0.0), np.float32(1.0), np.float32(0.0), np.float32(1.0), np.float32(0.0), np.float32(0.0), np.float32(1.0), np.float32(1.0), np.float32(1.0), np.float32(0.0), np.float32(0.0), np.float32(0.0), np.float32(0.0), np.float32(1.0), np.float32(1.0), np.float32(0.0)]",1.0,99347.5,23
2025-08-14_08-18-36,9800,"[np.float32(0.0), np.float32(1.0), np.float32(1.0), np.float32(0.0), np.float32(0.0), np.float32(0.0), np.float32(1.0), np.float32(1.0), np.float32(1.0), np.float32(1.0), np.float32(1.0), np.float32(0.0), np.float32(0.0), np.float32(1.0), np.float32(1.0), np.float32(1.0)]",1.0,99348.5,13
2025-08-14_08-18-36,9801,"[np.float32(1.0), np.float32(0.0), np.float32(0.0), np.float32(1.0), np.float32(0.0), np.float32(0.0), np.float32(1.0), np.float32(1.0), np.float32(1.0), np.float32(0.0), np.float32(0.0), np.float32(1.0), np.float32(0.0), np.float32(0.0), np.float32(0.0), np.float32(1.0)]",-4.0,99344.5,4
2025-08-14_08-18-36,9802,"[np.float32(1.0), np.float32(1.0), np.float32(0.0), np.float32(0.0), np.float32(1.0), np.float32(0.0), np.float32(0.0), np.float32(0.0), np.float32(0.0), np.float32(0.0), np.float32(0.0), np.float32(1.0), np.float32(1.0), np.float32(0.0), np.float32(0.0), np.float32(0.0)]",-3.0,99341.5,22
2025-08-14_08-18-36,9803,"[np.float32(1.0), np.float32(0.0), np.float32(1.0), np.float32(0.0), np.float32(0.0), np.float32(0.0), np.float32(1.0), np.float32(1.0), np.float32(1.0), np.float32(0.0), np.float32(1.0), np.float32(0.0), np.float32(0.0), np.float32(1.0), np.float32(1.0), np.float32(1.0)]",-3.0,99338.5,31
2025-08-14_08-18-36,9804,"[np.float32(0.0), np.float32(1.0), np.float32(1.0), np.float32(0.0), np.float32(1.0), np.float32(1.0), np.float32(0.0), np.float32(1.0), np.float32(1.0), np.float32(0.0), np.float32(1.0), np.float32(1.0), np.float32(0.0), np.float32(0.0), np.float32(0.0), np.float32(0.0)]",1.0,99339.5,2
2025-08-14_08-18-36,9805,"[np.float32(0.0), np.float32(1.0), np.float32(1.0), np.float32(1.0), np.float32(0.0), np.float32(0.0), np.float32(0.0), np.float32(0.0), np.float32(0.0), np.float32(1.0), np.float32(0.0), np.float32(1.0), np.float32(1.0), np.float32(1.0), np.float32(0.0), np.float32(0.0)]",1.0,99340.5,25
2025-08-14_08-18-36,9806,"[np.float32(0.0), np.float32(0.0), np.float32(1.0), np.float32(1.0), np.float32(1.0), np.float32(0.0), np.float32(1.0), np.float32(1.0), np.float32(1.0), np.float32(1.0), np.float32(1.0), np.float32(0.0), np.float32(0.0), np.float32(0.0), np.float32(0.0), np.float32(1.0)]",2.0,99342.5,20
2025-08-14_08-18-36,9807,"[np.float32(0.0), np.float32(0.0), np.float32(1.0), np.float32(1.0), np.float32(0.0), np.float32(1.0), np.float32(1.0), np.float32(1.0), np.float32(1.0), np.float32(1.0), np.float32(0.0), np.float32(0.0), np.float32(0.0), np.float32(1.0), np.float32(1.0), np.float32(1.0)]",1.0,99343.5,13
2025-08-14_08-18-36,9808,"[np.float32(0.0), np.float32(1.0), np.float32(0.0), np.float32(1.0), np.float32(1.0), np.float32(1.0), np.float32(1.0), np.float32(1.0), np.float32(1.0), np.float32(0.0), np.float32(0.0), np.float32(0.0), np.float32(1.0), np.float32(0.0), np.float32(1.0), np.float32(0.0)]",-2.0,99341.5,20
2025-08-14_08-18-36,9809,"[np.float32(0.0), np.float32(1.0), np.float32(0.0), np.float32(1.0), np.float32(1.0), np.float32(1.0), np.float32(0.0), np.float32(0.0), np.float32(1.0), np.float32(1.0), np.float32(1.0), np.float32(1.0), np.float32(1.0), np.float32(1.0), np.float32(1.0), np.float32(0.0)]",-1.0,99340.5,21
2025-08-14_08-18-36,9810,"[np.float32(0.0), np.float32(1.0), np.float32(1.0), np.float32(1.0), np.float32(0.0), np.float32(0.0), np.float32(1.0), np.float32(0.0), np.float32(1.0), np.float32(0.0), np.float32(0.0), np.float32(1.0), np.float32(1.0), np.float32(0.0), np.float32(1.0), np.float32(1.0)]",-2.0,99338.5,20
2025-08-14_08-18-36,9811,"[np.float32(0.0), np.float32(1.0), np.float32(0.0), np.float32(1.0), np.float32(0.0), np.float32(1.0), np.float32(1.0), np.float32(1.0), np.float32(1.0), np.float32(0.0), np.float32(0.0), np.float32(0.0), np.float32(0.0), np.float32(1.0), np.float32(1.0), np.float32(0.0)]",0.0,99338.5,8
2025-08-14_08-18-36,9812,"[np.float32(0.0), np.float32(0.0), np.float32(0.0), np.float32(0.0), np.float32(0.0), np.float32(0.0), np.float32(1.0), np.float32(0.0), np.float32(1.0), np.float32(0.0), np.float32(0.0), np.float32(1.0), np.float32(0.0), np.float32(0.0), np.float32(1.0), np.float32(1.0)]",-2.0,99336.5,32
2025-08-14_08-18-36,9813,"[np.float32(1.0), np.float32(1.0), np.float32(0.0), np.float32(0.0), np.float32(1.0), np.float32(0.0), np.float32(0.0), np.float32(1.0), np.float32(1.0), np.float32(0.0), np.float32(0.0), np.float32(1.0), np.float32(0.0), np.float32(0.0), np.float32(1.0), np.float32(1.0)]",-3.0,99333.5,25
2025-08-14_08-18-36,9814,"[np.float32(1.0), np.float32(1.0), np.float32(1.0), np.float32(1.0), np.float32(1.0), np.float32(1.0), np.float32(1.0), np.float32(0.0), np.float32(1.0), np.float32(1.0), np.float32(1.0), np.float32(0.0), np.float32(0.0), np.float32(0.0), np.float32(0.0), np.float32(0.0)]",2.0,99335.5,35
2025-08-14_08-18-36,9815,"[np.float32(1.0), np.float32(0.0), np.float32(0.0), np.float32(0.0), np.float32(1.0), np.float32(1.0), np.float32(0.0), np.float32(1.0), np.float32(1.0), np.float32(0.0), np.float32(0.0), np.float32(1.0), np.float32(0.0), np.float32(1.0), np.float32(1.0), np.float32(0.0)]",3.0,99338.5,24
2025-08-14_08-18-36,9816,"[np.float32(0.0), np.float32(1.0), np.float32(1.0), np.float32(0.0), np.float32(1.0), np.float32(0.0), np.float32(1.0), np.float32(0.0), np.float32(0.0), np.float32(0.0), np.float32(1.0), np.float32(1.0), np.float32(1.0), np.float32(1.0), np.float32(0.0), np.float32(1.0)]",-4.0,99334.5,31
2025-08-14_08-18-36,9817,"[np.float32(0.0), np.float32(1.0), np.float32(1.0), np.float32(1.0), np.float32(0.0), np.float32(0.0), np.float32(1.0), np.float32(1.0), np.float32(1.0), np.float32(1.0), np.float32(0.0), np.float32(0.0), np.float32(1.0), np.float32(1.0), np.float32(1.0), np.float32(1.0)]",0.0,99334.5,16
2025-08-14_08-18-36,9818,"[np.float32(0.0), np.float32(1.0), np.float32(0.0), np.float32(0.0), np.float32(0.0), np.float32(0.0), np.float32(0.0), np.float32(0.0), np.float32(1.0), np.float32(0.0), np.float32(0.0), np.float32(0.0), np.float32(1.0), np.float32(1.0), np.float32(1.0), np.float32(0.0)]",-5.0,99329.5,9
2025-08-14_08-18-36,9819,"[np.float32(1.0), np.float32(0.0), np.float32(0.0), np.float32(0.0), np.float32(1.0), np.float32(0.0), np.float32(1.0), np.float32(0.0), np.float32(1.0), np.float32(0.0), np.float32(1.0), np.float32(1.0), np.float32(1.0), np.float32(1.0), np.float32(0.0), np.float32(0.0)]",0.0,99329.5,21
2025-08-14_08-18-36,9820,"[np.float32(1.0), np.float32(0.0), np.float32(0.0), np.float32(1.0), np.float32(1.0), np.float32(0.0), np.float32(1.0), np.float32(1.0), np.float32(1.0), np.float32(0.0), np.float32(0.0), np.float32(1.0), np.float32(0.0), np.float32(0.0), np.float32(0.0), np.float32(0.0)]",0.0,99329.5,11
2025-08-14_08-18-36,9821,"[np.float32(0.0), np.float32(0.0), np.float32(0.0), np.float32(1.0), np.float32(1.0), np.float32(0.0), np.float32(1.0), np.float32(1.0), np.float32(1.0), np.float32(0.0), np.float32(0.0), np.float32(0.0), np.float32(1.0), np.float32(0.0), np.float32(1.0), np.float32(0.0)]",-2.0,99327.5,4
2025-08-14_08-18-36,9822,"[np.float32(0.0), np.float32(1.0), np.float32(1.0), np.float32(0.0), np.float32(1.0), np.float32(0.0), np.float32(1.0), np.float32(0.0), np.float32(0.0), np.float32(0.0), np.float32(1.0), np.float32(1.0), np.float32(0.0), np.float32(1.0), np.float32(0.0), np.float32(0.0)]",1.0,99328.5,5
2025-08-14_08-18-36,9823,"[np.float32(0.0), np.float32(1.0), np.float32(0.0), np.float32(1.0), np.float32(1.0), np.float32(1.0), np.float32(0.0), np.float32(1.0), np.float32(0.0), np.float32(0.0), np.float32(0.0), np.float32(0.0), np.float32(1.0), np.float32(0.0), np.float32(1.0), np.float32(1.0)]",-4.0,99324.5,0
2025-08-14_08-18-36,9824,"[np.float32(1.0), np.float32(1.0), np.float32(0.0), np.float32(0.0), np.float32(0.0), np.float32(1.0), np.float32(0.0), np.float32(0.0), np.float32(1.0), np.float32(0.0), np.float32(1.0), np.float32(0.0), np.float32(1.0), np.float32(1.0), np.float32(0.0), np.float32(0.0)]",3.0,99327.5,25
2025-08-14_08-18-36,9825,"[np.float32(0.0), np.float32(1.0), np.float32(1.0), np.float32(0.0), np.float32(1.0), np.float32(1.0), np.float32(1.0), np.float32(0.0), np.float32(1.0), np.float32(1.0), np.float32(0.0), np.float32(1.0), np.float32(0.0), np.float32(0.0), np.float32(0.0), np.float32(0.0)]",-1.0,99326.5,29
2025-08-14_08-18-36,9826,"[np.float32(1.0), np.float32(1.0), np.float32(0.0), np.float32(0.0), np.float32(1.0), np.float32(0.0), np.float32(1.0), np.float32(0.0), np.float32(0.0), np.float32(1.0), np.float32(0.0), np.float32(0.0), np.float32(1.0), np.float32(1.0), np.float32(0.0), np.float32(1.0)]",-3.0,99323.5,35
2025-08-14_08-18-36,9827,"[np.float32(0.0), np.float32(1.0), np.float32(0.0), np.float32(0.0), np.float32(0.0), np.float32(0.0), np.float32(0.0), np.float32(0.0), np.float32(0.0), np.float32(0.0), np.float32(1.0), np.float32(1.0), np.float32(0.0), np.float32(0.0), np.float32(0.0), np.float32(1.0)]",-4.0,99319.5,19
2025-08-14_08-18-36,9828,"[np.float32(1.0), np.float32(1.0), np.float32(1.0), np.float32(0.0), np.float32(1.0), np.float32(1.0), np.float32(0.0), np.float32(1.0), np.float32(1.0), np.float32(0.0), np.float32(0.0), np.float32(0.0), np.float32(0.0), np.float32(0.0), np.float32(1.0), np.float32(0.0)]",1.0,99320.5,18
2025-08-14_08-18-36,9829,"[np.float32(1.0), np.float32(0.0), np.float32(0.0), np.float32(1.0), np.float32(0.0), np.float32(0.0), np.float32(1.0), np.float32(1.0), np.float32(0.0), np.float32(0.0), np.float32(1.0), np.float32(0.0), np.float32(0.0), np.float32(1.0), np.float32(0.0), np.float32(0.0)]",-4.0,99316.5,31
2025-08-14_08-18-36,9830,"[np.float32(1.0), np.float32(0.0), np.float32(0.0), np.float32(0.0), np.float32(0.0), np.float32(1.0), np.float32(0.0), np.float32(0.0), np.float32(1.0), np.float32(1.0), np.float32(0.0), np.float32(1.0), np.float32(1.0), np.float32(0.0), np.float32(1.0), np.float32(1.0)]",-3.0,99313.5,5
2025-08-14_08-18-36,9831,"[np.float32(1.0), np.float32(0.0), np.float32(1.0), np.float32(0.0), np.float32(1.0), np.float32(0.0), np.float32(1.0), np.float32(0.0), np.float32(1.0), np.float32(1.0), np.float32(1.0), np.float32(1.0), np.float32(1.0), np.float32(1.0), np.float32(0.0), np.float32(1.0)]",-3.0,99310.5,22
2025-08-14_08-18-36,9832,"[np.float32(1.0), np.float32(0.0), np.float32(1.0), np.float32(0.0), np.float32(0.0), np.float32(1.0), np.float32(1.0), np.float32(1.0), np.float32(1.0), np.float32(1.0), np.float32(1.0), np.float32(1.0), np.float32(0.0), np.float32(1.0), np.float32(0.0), np.float32(1.0)]",-5.0,99305.5,11
2025-08-14_08-18-36,9833,"[np.float32(1.0), np.float32(0.0), np.float32(0.0), np.float32(1.0), np.float32(0.0), np.float32(0.0), np.float32(1.0), np.float32(0.0), np.float32(1.0), np.float32(1.0), np.float32(0.0), np.float32(0.0), np.float32(1.0), np.float32(1.0), np.float32(0.0), np.float32(0.0)]",-4.0,99301.5,0
2025-08-14_08-18-36,9834,"[np.float32(1.0), np.float32(0.0), np.float32(0.0), np.float32(1.0), np.float32(0.0), np.float32(1.0), np.float32(0.0), np.float32(0.0), np.float32(0.0), np.float32(1.0), np.float32(1.0), np.float32(0.0), np.float32(0.0), np.float32(1.0), np.float32(1.0), np.float32(0.0)]",0.0,99301.5,1
2025-08-14_08-18-36,9835,"[np.float32(1.0), np.float32(0.0), np.float32(1.0), np.float32(1.0), np.float32(1.0), np.float32(0.0), np.float32(0.0), np.float32(1.0), np.float32(0.0), np.float32(1.0), np.float32(0.0), np.float32(0.0), np.float32(1.0), np.float32(0.0), np.float32(1.0), np.float32(1.0)]",-7.0,99294.5,35
2025-08-14_08-18-36,9836,"[np.float32(1.0), np.float32(0.0), np.float32(1.0), np.float32(0.0), np.float32(1.0), np.float32(0.0), np.float32(1.0), np.float32(1.0), np.float32(0.0), np.float32(0.0), np.float32(1.0), np.float32(0.0), np.float32(0.0), np.float32(1.0), np.float32(1.0), np.float32(1.0)]",-1.0,99293.5,26
2025-08-14_08-18-36,9837,"[np.float32(0.0), np.float32(0.0), np.float32(0.0), np.float32(1.0), np.float32(1.0), np.float32(0.0), np.float32(1.0), np.float32(0.0), np.float32(1.0), np.float32(1.0), np.float32(1.0), np.float32(0.0), np.float32(1.0), np.float32(1.0), np.float32(1.0), np.float32(0.0)]",1.0,99294.5,1
2025-08-14_08-18-36,9838,"[np.float32(1.0), np.float32(0.0), np.float32(1.0), np.float32(1.0), np.float32(1.0), np.float32(1.0), np.float32(1.0), np.float32(1.0), np.float32(1.0), np.float32(0.0), np.float32(0.0), np.float32(0.0), np.float32(1.0), np.float32(0.0), np.float32(0.0), np.float32(0.0)]",-2.0,99292.5,10
2025-08-14_08-18-36,9839,"[np.float32(1.0), np.float32(0.0), np.float32(0.0), np.float32(0.0), np.float32(0.0), np.float32(0.0), np.float32(0.0), np.float32(0.0), np.float32(0.0), np.float32(0.0), np.float32(0.0), np.float32(1.0), np.float32(1.0), np.float32(1.0), np.float32(0.0), np.float32(1.0)]",0.0,99292.5,36
2025-08-14_08-18-36,9840,"[np.float32(0.0), np.float32(1.0), np.float32(1.0), np.float32(1.0), np.float32(1.0), np.float32(0.0), np.float32(0.0), np.float32(0.0), np.float32(1.0), np.float32(1.0), np.float32(0.0), np.float32(1.0), np.float32(1.0), np.float32(1.0), np.float32(0.0), np.float32(0.0)]",37.0,99329.5,7
2025-08-14_08-18-36,9841,"[np.float32(1.0), np.float32(0.0), np.float32(0.0), np.float32(0.0), np.float32(0.0), np.float32(1.0), np.float32(1.0), np.float32(1.0), np.float32(1.0), np.float32(1.0), np.float32(0.0), np.float32(0.0), np.float32(0.0), np.float32(1.0), np.float32(0.0), np.float32(1.0)]",0.0,99329.5,9
2025-08-14_08-18-36,9842,"[np.float32(0.0), np.float32(1.0), np.float32(1.0), np.float32(0.0), np.float32(1.0), np.float32(0.0), np.float32(1.0), np.float32(0.0), np.float32(1.0), np.float32(1.0), np.float32(0.0), np.float32(0.0), np.float32(1.0), np.float32(1.0), np.float32(1.0), np.float32(0.0)]",-1.0,99328.5,35
2025-08-14_08-18-36,9843,"[np.float32(0.0), np.float32(1.0), np.float32(0.0), np.float32(0.0), np.float32(0.0), np.float32(0.0), np.float32(1.0), np.float32(0.0), np.float32(0.0), np.float32(0.0), np.float32(1.0), np.float32(1.0), np.float32(1.0), np.float32(1.0), np.float32(0.0), np.float32(0.0)]",-1.0,99327.5,24
2025-08-14_08-18-36,9844,"[np.float32(0.0), np.float32(1.0), np.float32(0.0), np.float32(1.0), np.float32(1.0), np.float32(1.0), np.float32(0.0), np.float32(1.0), np.float32(1.0), np.float32(0.0), np.float32(0.0), np.float32(0.0), np.float32(1.0), np.float32(1.0), np.float32(1.0), np.float32(0.0)]",1.0,99328.5,22
2025-08-14_08-18-36,9845,"[np.float32(1.0), np.float32(1.0), np.float32(0.0), np.float32(1.0), np.float32(1.0), np.float32(1.0), np.float32(1.0), np.float32(1.0), np.float32(1.0), np.float32(1.0), np.float32(1.0), np.float32(0.0), np.float32(1.0), np.float32(1.0), np.float32(0.0), np.float32(1.0)]",-3.0,99325.5,6
2025-08-14_08-18-36,9846,"[np.float32(1.0), np.float32(1.0), np.float32(0.0), np.float32(0.0), np.float32(0.0), np.float32(1.0), np.float32(0.0), np.float32(0.0), np.float32(0.0), np.float32(1.0), np.float32(0.0), np.float32(1.0), np.float32(0.0), np.float32(0.0), np.float32(1.0), np.float32(0.0)]",-4.0,99321.5,2
2025-08-14_08-18-36,9847,"[np.float32(0.0), np.float32(0.0), np.float32(0.0), np.float32(0.0), np.float32(0.0), np.float32(0.0), np.float32(0.0), np.float32(1.0), np.float32(0.0), np.float32(0.0), np.float32(0.0), np.float32(1.0), np.float32(0.0), np.float32(1.0), np.float32(1.0), np.float32(1.0)]",-2.0,99319.5,5
2025-08-14_08-18-36,9848,"[np.float32(0.0), np.float32(0.0), np.float32(0.0), np.float32(0.0), np.float32(0.0), np.float32(1.0), np.float32(0.0), np.float32(0.0), np.float32(0.0), np.float32(0.0), np.float32(0.0), np.float32(0.0), np.float32(0.0), np.float32(1.0), np.float32(1.0), np.float32(0.0)]",-3.0,99316.5,14
2025-08-14_08-18-36,9849,"[np.float32(1.0), np.float32(0.0), np.float32(1.0), np.float32(0.0), np.float32(0.0), np.float32(0.0), np.float32(0.0), np.float32(0.0), np.float32(1.0), np.float32(0.0), np.float32(0.0), np.float32(0.0), np.float32(0.0), np.float32(0.0), np.float32(0.0), np.float32(1.0)]",-2.0,99314.5,0
2025-08-14_08-18-36,9850,"[np.float32(0.0), np.float32(0.0), np.float32(1.0), np.float32(0.0), np.float32(0.0), np.float32(1.0), np.float32(1.0), np.float32(1.0), np.float32(0.0), np.float32(0.0), np.float32(0.0), np.float32(1.0), np.float32(0.0), np.float32(1.0), np.float32(1.0), np.float32(0.0)]",2.0,99316.5,15
2025-08-14_08-18-36,9851,"[np.float32(0.0), np.float32(1.0), np.float32(0.0), np.float32(1.0), np.float32(1.0), np.float32(1.0), np.float32(1.0), np.float32(1.0), np.float32(1.0), np.float32(0.0), np.float32(1.0), np.float32(1.0), np.float32(0.0), np.float32(0.0), np.float32(0.0), np.float32(0.0)]",-2.0,99314.5,25
2025-08-14_08-18-36,9852,"[np.float32(1.0), np.float32(0.0), np.float32(0.0), np.float32(0.0), np.float32(1.0), np.float32(1.0), np.float32(1.0), np.float32(1.0), np.float32(0.0), np.float32(0.0), np.float32(0.0), np.float32(0.0), np.float32(1.0), np.float32(0.0), np.float32(0.0), np.float32(0.0)]",-4.0,99310.5,29
2025-08-14_08-18-36,9853,"[np.float32(0.0), np.float32(0.0), np.float32(0.0), np.float32(1.0), np.float32(1.0), np.float32(1.0), np.float32(0.0), np.float32(1.0), np.float32(1.0), np.float32(0.0), np.float32(1.0), np.float32(1.0), np.float32(0.0), np.float32(1.0), np.float32(0.0), np.float32(1.0)]",-1.0,99309.5,2
2025-08-14_08-18-36,9854,"[np.float32(0.0), np.float32(1.0), np.float32(0.0), np.float32(0.0), np.float32(0.0), np.float32(1.0), np.float32(1.0), np.float32(1.0), np.float32(1.0), np.float32(0.0), np.float32(0.0), np.float32(1.0), np.float32(1.0), np.float32(0.0), np.float32(0.0), np.float32(0.0)]",-4.0,99305.5,14
2025-08-14_08-18-36,9855,"[np.float32(0.0), np.float32(0.0), np.float32(0.0), np.float32(0.0), np.float32(1.0), np.float32(0.0), np.float32(1.0), np.float32(1.0), np.float32(1.0), np.float32(0.0), np.float32(0.0), np.float32(0.0), np.float32(1.0), np.float32(1.0), np.float32(1.0), np.float32(0.0)]",-2.0,99303.5,17
2025-08-14_08-18-36,9856,"[np.float32(0.0), np.float32(1.0), np.float32(1.0), np.float32(1.0), np.float32(0.0), np.float32(1.0), np.float32(1.0), np.float32(0.0), np.float32(1.0), np.float32(0.0), np.float32(1.0), np.float32(1.0), np.float32(0.0), np.float32(1.0), np.float32(1.0), np.float32(0.0)]",1.0,99304.5,12
2025-08-14_08-18-36,9857,"[np.float32(1.0), np.float32(1.0), np.float32(0.0), np.float32(1.0), np.float32(0.0), np.float32(1.0), np.float32(1.0), np.float32(1.0), np.float32(1.0), np.float32(1.0), np.float32(1.0), np.float32(0.0), np.float32(0.0), np.float32(1.0), np.float32(0.0), np.float32(1.0)]",4.0,99308.5,29
2025-08-14_08-18-36,9858,"[np.float32(0.0), np.float32(1.0), np.float32(1.0), np.float32(0.0), np.float32(1.0), np.float32(1.0), np.float32(1.0), np.float32(0.0), np.float32(1.0), np.float32(0.0), np.float32(1.0), np.float32(0.0), np.float32(0.0), np.float32(1.0), np.float32(0.0), np.float32(0.0)]",-4.0,99304.5,13
2025-08-14_08-18-36,9859,"[np.float32(1.0), np.float32(1.0), np.float32(0.0), np.float32(1.0), np.float32(0.0), np.float32(0.0), np.float32(1.0), np.float32(0.0), np.float32(0.0), np.float32(1.0), np.float32(0.0), np.float32(1.0), np.float32(1.0), np.float32(1.0), np.float32(0.0), np.float32(1.0)]",-4.0,99300.5,30
2025-08-14_08-18-36,9860,"[np.float32(0.0), np.float32(1.0), np.float32(1.0), np.float32(0.0), np.float32(1.0), np.float32(0.0), np.float32(1.0), np.float32(0.0), np.float32(1.0), np.float32(1.0), np.float32(0.0), np.float32(1.0), np.float32(1.0), np.float32(1.0), np.float32(0.0), np.float32(0.0)]",2.0,99302.5,3
2025-08-14_08-18-36,9861,"[np.float32(1.0), np.float32(1.0), np.float32(0.0), np.float32(1.0), np.float32(0.0), np.float32(0.0), np.float32(1.0), np.float32(0.0), np.float32(0.0), np.float32(1.0), np.float32(1.0), np.float32(1.0), np.float32(0.0), np.float32(1.0), np.float32(0.0), np.float32(1.0)]",4.0,99306.5,1
2025-08-14_08-18-36,9862,"[np.float32(1.0), np.float32(1.0), np.float32(1.0), np.float32(1.0), np.float32(0.0), np.float32(0.0), np.float32(1.0), np.float32(0.0), np.float32(1.0), np.float32(1.0), np.float32(0.0), np.float32(0.0), np.float32(1.0), np.float32(0.0), np.float32(1.0), np.float32(0.0)]",1.0,99307.5,27
2025-08-14_08-18-36,9863,"[np.float32(0.0), np.float32(1.0), np.float32(0.0), np.float32(0.0), np.float32(0.0), np.float32(1.0), np.float32(1.0), np.float32(1.0), np.float32(1.0), np.float32(1.0), np.float32(1.0), np.float32(1.0), np.float32(0.0), np.float32(1.0), np.float32(1.0), np.float32(0.0)]",3.0,99310.5,33
2025-08-14_08-18-36,9864,"[np.float32(1.0), np.float32(0.0), np.float32(0.0), np.float32(0.0), np.float32(0.0), np.float32(1.0), np.float32(1.0), np.float32(0.0), np.float32(0.0), np.float32(0.0), np.float32(0.0), np.float32(0.0), np.float32(1.0), np.float32(1.0), np.float32(0.0), np.float32(0.0)]",-2.0,99308.5,11
2025-08-14_08-18-36,9865,"[np.float32(0.0), np.float32(1.0), np.float32(1.0), np.float32(0.0), np.float32(0.0), np.float32(1.0), np.float32(1.0), np.float32(0.0), np.float32(1.0), np.float32(0.0), np.float32(0.0), np.float32(0.0), np.float32(1.0), np.float32(0.0), np.float32(1.0), np.float32(0.0)]",-4.0,99304.5,3
2025-08-14_08-18-36,9866,"[np.float32(1.0), np.float32(1.0), np.float32(1.0), np.float32(0.0), np.float32(0.0), np.float32(0.0), np.float32(0.0), np.float32(1.0), np.float32(0.0), np.float32(1.0), np.float32(1.0), np.float32(0.0), np.float32(1.0), np.float32(0.0), np.float32(0.0), np.float32(0.0)]",-3.0,99301.5,12
2025-08-14_08-18-36,9867,"[np.float32(0.0), np.float32(0.0), np.float32(1.0), np.float32(0.0), np.float32(1.0), np.float32(1.0), np.float32(1.0), np.float32(0.0), np.float32(1.0), np.float32(1.0), np.float32(0.0), np.float32(0.0), np.float32(1.0), np.float32(1.0), np.float32(1.0), np.float32(0.0)]",-2.0,99299.5,18
2025-08-14_08-18-36,9868,"[np.float32(1.0), np.float32(1.0), np.float32(1.0), np.float32(0.0), np.float32(0.0), np.float32(0.0), np.float32(0.0), np.float32(1.0), np.float32(0.0), np.float32(0.0), np.float32(1.0), np.float32(0.0), np.float32(1.0), np.float32(1.0), np.float32(1.0), np.float32(1.0)]",-2.0,99297.5,12
2025-08-14_08-18-36,9869,"[np.float32(1.0), np.float32(1.0), np.float32(0.0), np.float32(1.0), np.float32(1.0), np.float32(0.0), np.float32(0.0), np.float32(0.0), np.float32(0.0), np.float32(1.0), np.float32(1.0), np.float32(0.0), np.float32(1.0), np.float32(0.0), np.float32(0.0), np.float32(0.0)]",0.0,99297.5,23
2025-08-14_08-18-36,9870,"[np.float32(0.0), np.float32(1.0), np.float32(1.0), np.float32(1.0), np.float32(0.0), np.float32(1.0), np.float32(1.0), np.float32(0.0), np.float32(1.0), np.float32(0.0), np.float32(0.0), np.float32(0.0), np.float32(1.0), np.float32(1.0), np.float32(0.0), np.float32(1.0)]",0.0,99297.5,0
2025-08-14_08-18-36,9871,"[np.float32(0.0), np.float32(1.0), np.float32(1.0), np.float32(0.0), np.float32(0.0), np.float32(0.0), np.float32(1.0), np.float32(1.0), np.float32(0.0), np.float32(0.0), np.float32(0.0), np.float32(1.0), np.float32(0.0), np.float32(1.0), np.float32(0.0), np.float32(0.0)]",1.0,99298.5,20
2025-08-14_08-18-36,9872,"[np.float32(1.0), np.float32(0.0), np.float32(0.0), np.float32(0.0), np.float32(1.0), np.float32(0.0), np.float32(0.0), np.float32(0.0), np.float32(1.0), np.float32(0.0), np.float32(1.0), np.float32(0.0), np.float32(1.0), np.float32(0.0), np.float32(1.0), np.float32(1.0)]",0.0,99298.5,16
2025-08-14_08-18-36,9873,"[np.float32(0.0), np.float32(1.0), np.float32(1.0), np.float32(0.0), np.float32(0.0), np.float32(0.0), np.float32(1.0), np.float32(0.0), np.float32(0.0), np.float32(0.0), np.float32(1.0), np.float32(1.0), np.float32(0.0), np.float32(1.0), np.float32(1.0), np.float32(1.0)]",0.0,99298.5,14
2025-08-14_08-18-36,9874,"[np.float32(0.0), np.float32(0.0), np.float32(0.0), np.float32(1.0), np.float32(1.0), np.float32(1.0), np.float32(0.0), np.float32(1.0), np.float32(1.0), np.float32(1.0), np.float32(0.0), np.float32(0.0), np.float32(1.0), np.float32(1.0), np.float32(1.0), np.float32(0.0)]",-1.0,99297.5,32
2025-08-14_08-18-36,9875,"[np.float32(0.0), np.float32(1.0), np.float32(0.0), np.float32(1.0), np.float32(0.0), np.float32(1.0), np.float32(0.0), np.float32(1.0), np.float32(0.0), np.float32(0.0), np.float32(1.0), np.float32(1.0), np.float32(1.0), np.float32(0.0), np.float32(0.0), np.float32(0.0)]",-3.0,99294.5,25
2025-08-14_08-18-36,9876,"[np.float32(1.0), np.float32(1.0), np.float32(1.0), np.float32(1.0), np.float32(0.0), np.float32(0.0), np.float32(0.0), np.float32(0.0), np.float32(0.0), np.float32(0.0), np.float32(0.0), np.float32(0.0), np.float32(0.0), np.float32(1.0), np.float32(0.0), np.float32(0.0)]",-1.0,99293.5,20
2025-08-14_08-18-36,9877,"[np.float32(0.0), np.float32(1.0), np.float32(0.0), np.float32(1.0), np.float32(0.0), np.float32(0.0), np.float32(0.0), np.float32(1.0), np.float32(0.0), np.float32(0.0), np.float32(1.0), np.float32(0.0), np.float32(1.0), np.float32(1.0), np.float32(0.0), np.float32(0.0)]",-1.0,99292.5,3
2025-08-14_08-18-36,9878,"[np.float32(1.0), np.float32(0.0), np.float32(1.0), np.float32(1.0), np.float32(1.0), np.float32(0.0), np.float32(0.0), np.float32(1.0), np.float32(1.0), np.float32(1.0), np.float32(0.0), np.float32(0.0), np.float32(1.0), np.float32(0.0), np.float32(0.0), np.float32(0.0)]",-1.0,99291.5,27
2025-08-14_08-18-36,9879,"[np.float32(1.0), np.float32(0.0), np.float32(1.0), np.float32(0.0), np.float32(1.0), np.float32(1.0), np.float32(1.0), np.float32(0.0), np.float32(0.0), np.float32(0.0), np.float32(1.0), np.float32(0.0), np.float32(1.0), np.float32(1.0), np.float32(0.0), np.float32(0.0)]",-3.0,99288.5,15
2025-08-14_08-18-36,9880,"[np.float32(0.0), np.float32(1.0), np.float32(1.0), np.float32(0.0), np.float32(0.0), np.float32(0.0), np.float32(1.0), np.float32(1.0), np.float32(1.0), np.float32(1.0), np.float32(1.0), np.float32(0.0), np.float32(1.0), np.float32(1.0), np.float32(0.0), np.float32(1.0)]",3.0,99291.5,22
2025-08-14_08-18-36,9881,"[np.float32(0.0), np.float32(0.0), np.float32(1.0), np.float32(0.0), np.float32(0.0), np.float32(0.0), np.float32(0.0), np.float32(1.0), np.float32(0.0), np.float32(1.0), np.float32(0.0), np.float32(1.0), np.float32(0.0), np.float32(1.0), np.float32(0.0), np.float32(0.0)]",1.0,99292.5,25
2025-08-14_08-18-36,9882,"[np.float32(1.0), np.float32(1.0), np.float32(1.0), np.float32(0.0), np.float32(0.0), np.float32(1.0), np.float32(1.0), np.float32(0.0), np.float32(0.0), np.float32(1.0), np.float32(0.0), np.float32(0.0), np.float32(0.0), np.float32(0.0), np.float32(0.0), np.float32(0.0)]",1.0,99293.5,19
2025-08-14_08-18-36,9883,"[np.float32(1.0), np.float32(1.0), np.float32(1.0), np.float32(0.0), np.float32(0.0), np.float32(1.0), np.float32(0.0), np.float32(1.0), np.float32(0.0), np.float32(0.0), np.float32(0.0), np.float32(1.0), np.float32(0.0), np.float32(0.0), np.float32(0.0), np.float32(1.0)]",0.0,99293.5,33
2025-08-14_08-18-36,9884,"[np.float32(0.0), np.float32(0.0), np.float32(0.0), np.float32(0.0), np.float32(0.0), np.float32(0.0), np.float32(1.0), np.float32(1.0), np.float32(0.0), np.float32(0.0), np.float32(0.0), np.float32(0.0), np.float32(0.0), np.float32(1.0), np.float32(0.0), np.float32(0.0)]",0.0,99293.5,35
2025-08-14_08-18-36,9885,"[np.float32(1.0), np.float32(0.0), np.float32(0.0), np.float32(0.0), np.float32(1.0), np.float32(1.0), np.float32(1.0), np.float32(1.0), np.float32(0.0), np.float32(0.0), np.float32(1.0), np.float32(0.0), np.float32(0.0), np.float32(1.0), np.float32(0.0), np.float32(1.0)]",-1.0,99292.5,34
2025-08-14_08-18-36,9886,"[np.float32(1.0), np.float32(1.0), np.float32(1.0), np.float32(0.0), np.float32(0.0), np.float32(0.0), np.float32(0.0), np.float32(1.0), np.float32(1.0), np.float32(1.0), np.float32(1.0), np.float32(0.0), np.float32(1.0), np.float32(1.0), np.float32(0.0), np.float32(1.0)]",-3.0,99289.5,10
2025-08-14_08-18-36,9887,"[np.float32(0.0), np.float32(0.0), np.float32(0.0), np.float32(1.0), np.float32(0.0), np.float32(1.0), np.float32(0.0), np.float32(1.0), np.float32(1.0), np.float32(0.0), np.float32(0.0), np.float32(1.0), np.float32(0.0), np.float32(0.0), np.float32(1.0), np.float32(1.0)]",-7.0,99282.5,4
2025-08-14_08-18-36,9888,"[np.float32(1.0), np.float32(0.0), np.float32(0.0), np.float32(0.0), np.float32(0.0), np.float32(0.0), np.float32(1.0), np.float32(1.0), np.float32(1.0), np.float32(1.0), np.float32(0.0), np.float32(1.0), np.float32(1.0), np.float32(1.0), np.float32(0.0), np.float32(0.0)]",-2.0,99280.5,31
2025-08-14_08-18-36,9889,"[np.float32(1.0), np.float32(1.0), np.float32(0.0), np.float32(1.0), np.float32(0.0), np.float32(1.0), np.float32(0.0), np.float32(1.0), np.float32(0.0), np.float32(1.0), np.float32(0.0), np.float32(0.0), np.float32(1.0), np.float32(0.0), np.float32(0.0), np.float32(0.0)]",-2.0,99278.5,4
2025-08-14_08-18-36,9890,"[np.float32(0.0), np.float32(0.0), np.float32(1.0), np.float32(0.0), np.float32(1.0), np.float32(0.0), np.float32(0.0), np.float32(1.0), np.float32(1.0), np.float32(0.0), np.float32(1.0), np.float32(1.0), np.float32(1.0), np.float32(1.0), np.float32(0.0), np.float32(1.0)]",2.0,99280.5,26
2025-08-14_08-18-36,9891,"[np.float32(1.0), np.float32(1.0), np.float32(0.0), np.float32(1.0), np.float32(1.0), np.float32(1.0), np.float32(0.0), np.float32(1.0), np.float32(1.0), np.float32(0.0), np.float32(0.0), np.float32(0.0), np.float32(1.0), np.float32(0.0), np.float32(0.0), np.float32(1.0)]",3.0,99283.5,17
2025-08-14_08-18-36,9892,"[np.float32(0.0), np.float32(0.0), np.float32(1.0), np.float32(0.0), np.float32(1.0), np.float32(0.0), np.float32(0.0), np.float32(1.0), np.float32(1.0), np.float32(0.0), np.float32(1.0), np.float32(0.0), np.float32(1.0), np.float32(0.0), np.float32(0.0), np.float32(0.0)]",-1.0,99282.5,15
2025-08-14_08-18-36,9893,"[np.float32(1.0), np.float32(0.0), np.float32(0.0), np.float32(0.0), np.float32(0.0), np.float32(0.0), np.float32(1.0), np.float32(1.0), np.float32(1.0), np.float32(0.0), np.float32(1.0), np.float32(0.0), np.float32(1.0), np.float32(1.0), np.float32(0.0), np.float32(0.0)]",1.0,99283.5,14
2025-08-14_08-18-36,9894,"[np.float32(1.0), np.float32(1.0), np.float32(0.0), np.float32(0.0), np.float32(0.0), np.float32(0.0), np.float32(0.0), np.float32(1.0), np.float32(1.0), np.float32(0.0), np.float32(0.0), np.float32(0.0), np.float32(0.0), np.float32(0.0), np.float32(0.0), np.float32(1.0)]",0.0,99283.5,1
2025-08-14_08-18-36,9895,"[np.float32(0.0), np.float32(0.0), np.float32(1.0), np.float32(0.0), np.float32(0.0), np.float32(0.0), np.float32(1.0), np.float32(1.0), np.float32(1.0), np.float32(0.0), np.float32(0.0), np.float32(1.0), np.float32(1.0), np.float32(0.0), np.float32(1.0), np.float32(0.0)]",-4.0,99279.5,35
2025-08-14_08-18-36,9896,"[np.float32(1.0), np.float32(1.0), np.float32(1.0), np.float32(1.0), np.float32(0.0), np.float32(0.0), np.float32(1.0), np.float32(1.0), np.float32(1.0), np.float32(0.0), np.float32(1.0), np.float32(0.0), np.float32(0.0), np.float32(1.0), np.float32(0.0), np.float32(1.0)]",0.0,99279.5,22
2025-08-14_08-18-36,9897,"[np.float32(1.0), np.float32(0.0), np.float32(1.0), np.float32(0.0), np.float32(0.0), np.float32(0.0), np.float32(1.0), np.float32(0.0), np.float32(0.0), np.float32(0.0), np.float32(1.0), np.float32(1.0), np.float32(0.0), np.float32(0.0), np.float32(0.0), np.float32(0.0)]",-3.0,99276.5,19
2025-08-14_08-18-36,9898,"[np.float32(1.0), np.float32(0.0), np.float32(0.0), np.float32(1.0), np.float32(0.0), np.float32(1.0), np.float32(1.0), np.float32(0.0), np.float32(1.0), np.float32(0.0), np.float32(1.0), np.float32(1.0), np.float32(0.0), np.float32(0.0), np.float32(0.0), np.float32(0.0)]",-2.0,99274.5,24
2025-08-14_08-18-36,9899,"[np.float32(0.0), np.float32(1.0), np.float32(1.0), np.float32(0.0), np.float32(1.0), np.float32(0.0), np.float32(0.0), np.float32(1.0), np.float32(1.0), np.float32(0.0), np.float32(1.0), np.float32(1.0), np.float32(0.0), np.float32(1.0), np.float32(0.0), np.float32(1.0)]",-3.0,99271.5,25
2025-08-14_08-18-36,9900,"[np.float32(0.0), np.float32(0.0), np.float32(0.0), np.float32(1.0), np.float32(0.0), np.float32(1.0), np.float32(0.0), np.float32(1.0), np.float32(0.0), np.float32(1.0), np.float32(0.0), np.float32(1.0), np.float32(0.0), np.float32(1.0), np.float32(1.0), np.float32(0.0)]",-2.0,99269.5,26
2025-08-14_08-18-36,9901,"[np.float32(1.0), np.float32(0.0), np.float32(0.0), np.float32(1.0), np.float32(0.0), np.float32(1.0), np.float32(1.0), np.float32(0.0), np.float32(0.0), np.float32(1.0), np.float32(0.0), np.float32(0.0), np.float32(0.0), np.float32(0.0), np.float32(0.0), np.float32(0.0)]",0.0,99269.5,13
2025-08-14_08-18-36,9902,"[np.float32(0.0), np.float32(1.0), np.float32(0.0), np.float32(1.0), np.float32(1.0), np.float32(0.0), np.float32(1.0), np.float32(1.0), np.float32(1.0), np.float32(0.0), np.float32(0.0), np.float32(1.0), np.float32(0.0), np.float32(0.0), np.float32(0.0), np.float32(0.0)]",3.0,99272.5,9
2025-08-14_08-18-36,9903,"[np.float32(0.0), np.float32(1.0), np.float32(1.0), np.float32(1.0), np.float32(0.0), np.float32(0.0), np.float32(0.0), np.float32(0.0), np.float32(0.0), np.float32(1.0), np.float32(1.0), np.float32(0.0), np.float32(1.0), np.float32(1.0), np.float32(0.0), np.float32(1.0)]",-3.0,99269.5,3
2025-08-14_08-18-36,9904,"[np.float32(0.0), np.float32(0.0), np.float32(1.0), np.float32(0.0), np.float32(0.0), np.float32(1.0), np.float32(1.0), np.float32(1.0), np.float32(0.0), np.float32(0.0), np.float32(0.0), np.float32(1.0), np.float32(1.0), np.float32(1.0), np.float32(0.0), np.float32(0.0)]",1.0,99270.5,2
2025-08-14_08-18-36,9905,"[np.float32(1.0), np.float32(0.0), np.float32(0.0), np.float32(0.0), np.float32(0.0), np.float32(1.0), np.float32(1.0), np.float32(1.0), np.float32(0.0), np.float32(0.0), np.float32(1.0), np.float32(0.0), np.float32(1.0), np.float32(0.0), np.float32(0.0), np.float32(0.0)]",-1.0,99269.5,9
2025-08-14_08-18-36,9906,"[np.float32(0.0), np.float32(1.0), np.float32(0.0), np.float32(0.0), np.float32(1.0), np.float32(1.0), np.float32(1.0), np.float32(1.0), np.float32(1.0), np.float32(0.0), np.float32(0.0), np.float32(0.0), np.float32(0.0), np.float32(1.0), np.float32(0.0), np.float32(0.0)]",3.0,99272.5,29
2025-08-14_08-18-36,9907,"[np.float32(1.0), np.float32(0.0), np.float32(1.0), np.float32(1.0), np.float32(1.0), np.float32(0.0), np.float32(1.0), np.float32(0.0), np.float32(0.0), np.float32(0.0), np.float32(0.0), np.float32(1.0), np.float32(1.0), np.float32(0.0), np.float32(0.0), np.float32(0.0)]",5.0,99277.5,9
2025-08-14_08-18-36,9908,"[np.float32(0.0), np.float32(1.0), np.float32(1.0), np.float32(1.0), np.float32(0.0), np.float32(0.0), np.float32(0.0), np.float32(0.0), np.float32(1.0), np.float32(0.0), np.float32(1.0), np.float32(1.0), np.float32(1.0), np.float32(0.0), np.float32(0.0), np.float32(1.0)]",-1.0,99276.5,24
2025-08-14_08-18-36,9909,"[np.float32(0.0), np.float32(1.0), np.float32(1.0), np.float32(1.0), np.float32(0.0), np.float32(1.0), np.float32(1.0), np.float32(0.0), np.float32(0.0), np.float32(0.0), np.float32(0.0), np.float32(1.0), np.float32(0.0), np.float32(1.0), np.float32(0.0), np.float32(0.0)]",3.0,99279.5,15
2025-08-14_08-18-36,9910,"[np.float32(1.0), np.float32(0.0), np.float32(0.0), np.float32(1.0), np.float32(0.0), np.float32(1.0), np.float32(0.0), np.float32(1.0), np.float32(1.0), np.float32(0.0), np.float32(1.0), np.float32(0.0), np.float32(1.0), np.float32(0.0), np.float32(0.0), np.float32(0.0)]",-2.0,99277.5,28
2025-08-14_08-18-36,9911,"[np.float32(1.0), np.float32(1.0), np.float32(1.0), np.float32(1.0), np.float32(1.0), np.float32(1.0), np.float32(0.0), np.float32(0.0), np.float32(0.0), np.float32(0.0), np.float32(1.0), np.float32(0.0), np.float32(1.0), np.float32(0.0), np.float32(0.0), np.float32(0.0)]",-2.0,99275.5,0
2025-08-14_08-18-36,9912,"[np.float32(1.0), np.float32(1.0), np.float32(0.0), np.float32(1.0), np.float32(0.0), np.float32(0.0), np.float32(1.0), np.float32(1.0), np.float32(0.0), np.float32(0.0), np.float32(0.0), np.float32(0.0), np.float32(1.0), np.float32(1.0), np.float32(0.0), np.float32(0.0)]",3.0,99278.5,3
2025-08-14_08-18-36,9913,"[np.float32(0.0), np.float32(0.0), np.float32(0.0), np.float32(0.0), np.float32(0.0), np.float32(0.0), np.float32(0.0), np.float32(1.0), np.float32(0.0), np.float32(0.0), np.float32(1.0), np.float32(0.0), np.float32(1.0), np.float32(1.0), np.float32(0.0), np.float32(0.0)]",-1.0,99277.5,25
2025-08-14_08-18-36,9914,"[np.float32(0.0), np.float32(1.0), np.float32(1.0), np.float32(1.0), np.float32(1.0), np.float32(0.0), np.float32(1.0), np.float32(0.0), np.float32(0.0), np.float32(1.0), np.float32(1.0), np.float32(1.0), np.float32(1.0), np.float32(1.0), np.float32(1.0), np.float32(0.0)]",-3.0,99274.5,27
2025-08-14_08-18-36,9915,"[np.float32(0.0), np.float32(0.0), np.float32(1.0), np.float32(0.0), np.float32(0.0), np.float32(0.0), np.float32(0.0), np.float32(1.0), np.float32(1.0), np.float32(1.0), np.float32(1.0), np.float32(0.0), np.float32(0.0), np.float32(1.0), np.float32(0.0), np.float32(0.0)]",2.0,99276.5,18
2025-08-14_08-18-36,9916,"[np.float32(0.0), np.float32(1.0), np.float32(1.0), np.float32(0.0), np.float32(0.0), np.float32(1.0), np.float32(0.0), np.float32(1.0), np.float32(1.0), np.float32(1.0), np.float32(1.0), np.float32(0.0), np.float32(0.0), np.float32(0.0), np.float32(0.0), np.float32(1.0)]",2.0,99278.5,32
2025-08-14_08-18-36,9917,"[np.float32(0.0), np.float32(0.0), np.float32(0.0), np.float32(0.0), np.float32(0.0), np.float32(1.0), np.float32(0.0), np.float32(1.0), np.float32(0.0), np.float32(0.0), np.float32(0.0), np.float32(1.0), np.float32(0.0), np.float32(0.0), np.float32(0.0), np.float32(1.0)]",1.0,99279.5,34
2025-08-14_08-18-36,9918,"[np.float32(0.0), np.float32(1.0), np.float32(0.0), np.float32(0.0), np.float32(1.0), np.float32(1.0), np.float32(0.0), np.float32(1.0), np.float32(1.0), np.float32(0.0), np.float32(0.0), np.float32(0.0), np.float32(1.0), np.float32(0.0), np.float32(0.0), np.float32(1.0)]",-2.0,99277.5,25
2025-08-14_08-18-36,9919,"[np.float32(1.0), np.float32(0.0), np.float32(1.0), np.float32(0.0), np.float32(0.0), np.float32(1.0), np.float32(0.0), np.float32(0.0), np.float32(1.0), np.float32(1.0), np.float32(0.0), np.float32(1.0), np.float32(1.0), np.float32(0.0), np.float32(1.0), np.float32(1.0)]",-2.0,99275.5,23
2025-08-14_08-18-36,9920,"[np.float32(0.0), np.float32(1.0), np.float32(0.0), np.float32(1.0), np.float32(1.0), np.float32(1.0), np.float32(0.0), np.float32(0.0), np.float32(1.0), np.float32(0.0), np.float32(0.0), np.float32(0.0), np.float32(1.0), np.float32(0.0), np.float32(0.0), np.float32(0.0)]",1.0,99276.5,28
2025-08-14_08-18-36,9921,"[np.float32(0.0), np.float32(1.0), np.float32(1.0), np.float32(0.0), np.float32(0.0), np.float32(1.0), np.float32(1.0), np.float32(1.0), np.float32(1.0), np.float32(1.0), np.float32(0.0), np.float32(1.0), np.float32(1.0), np.float32(0.0), np.float32(1.0), np.float32(0.0)]",2.0,99278.5,28
2025-08-14_08-18-36,9922,"[np.float32(0.0), np.float32(1.0), np.float32(0.0), np.float32(1.0), np.float32(1.0), np.float32(1.0), np.float32(0.0), np.float32(1.0), np.float32(1.0), np.float32(1.0), np.float32(1.0), np.float32(1.0), np.float32(1.0), np.float32(1.0), np.float32(0.0), np.float32(0.0)]",-4.0,99274.5,1
2025-08-14_08-18-36,9923,"[np.float32(0.0), np.float32(0.0), np.float32(0.0), np.float32(1.0), np.float32(1.0), np.float32(1.0), np.float32(1.0), np.float32(1.0), np.float32(1.0), np.float32(1.0), np.float32(1.0), np.float32(0.0), np.float32(0.0), np.float32(0.0), np.float32(0.0), np.float32(1.0)]",-2.0,99272.5,33
2025-08-14_08-18-36,9924,"[np.float32(1.0), np.float32(1.0), np.float32(0.0), np.float32(1.0), np.float32(0.0), np.float32(1.0), np.float32(0.0), np.float32(1.0), np.float32(1.0), np.float32(0.0), np.float32(0.0), np.float32(0.0), np.float32(0.0), np.float32(1.0), np.float32(0.0), np.float32(1.0)]",-1.0,99271.5,7
2025-08-14_08-18-36,9925,"[np.float32(0.0), np.float32(0.0), np.float32(1.0), np.float32(1.0), np.float32(0.0), np.float32(0.0), np.float32(0.0), np.float32(0.0), np.float32(1.0), np.float32(0.0), np.float32(1.0), np.float32(0.0), np.float32(0.0), np.float32(1.0), np.float32(0.0), np.float32(1.0)]",-1.0,99270.5,5
2025-08-14_08-18-36,9926,"[np.float32(0.0), np.float32(1.0), np.float32(1.0), np.float32(0.0), np.float32(0.0), np.float32(0.0), np.float32(1.0), np.float32(1.0), np.float32(1.0), np.float32(1.0), np.float32(1.0), np.float32(0.0), np.float32(1.0), np.float32(1.0), np.float32(0.0), np.float32(1.0)]",-3.0,99267.5,0
2025-08-14_08-18-36,9927,"[np.float32(1.0), np.float32(0.0), np.float32(0.0), np.float32(1.0), np.float32(0.0), np.float32(1.0), np.float32(0.0), np.float32(0.0), np.float32(0.0), np.float32(0.0), np.float32(0.0), np.float32(0.0), np.float32(0.0), np.float32(1.0), np.float32(0.0), np.float32(0.0)]",3.0,99270.5,29
2025-08-14_08-18-36,9928,"[np.float32(0.0), np.float32(1.0), np.float32(0.0), np.float32(0.0), np.float32(0.0), np.float32(0.0), np.float32(1.0), np.float32(0.0), np.float32(1.0), np.float32(0.0), np.float32(0.0), np.float32(1.0), np.float32(0.0), np.float32(0.0), np.float32(0.0), np.float32(0.0)]",-1.0,99269.5,32
2025-08-14_08-18-36,9929,"[np.float32(1.0), np.float32(0.0), np.float32(1.0), np.float32(1.0), np.float32(1.0), np.float32(1.0), np.float32(0.0), np.float32(1.0), np.float32(1.0), np.float32(1.0), np.float32(1.0), np.float32(0.0), np.float32(0.0), np.float32(1.0), np.float32(0.0), np.float32(0.0)]",5.0,99274.5,32
2025-08-14_08-18-36,9930,"[np.float32(1.0), np.float32(1.0), np.float32(1.0), np.float32(0.0), np.float32(1.0), np.float32(1.0), np.float32(0.0), np.float32(0.0), np.float32(0.0), np.float32(1.0), np.float32(0.0), np.float32(0.0), np.float32(1.0), np.float32(1.0), np.float32(1.0), np.float32(0.0)]",1.0,99275.5,13
2025-08-14_08-18-36,9931,"[np.float32(1.0), np.float32(0.0), np.float32(0.0), np.float32(0.0), np.float32(0.0), np.float32(0.0), np.float32(0.0), np.float32(1.0), np.float32(1.0), np.float32(0.0), np.float32(1.0), np.float32(0.0), np.float32(1.0), np.float32(1.0), np.float32(0.0), np.float32(0.0)]",-1.0,99274.5,30
2025-08-14_08-18-36,9932,"[np.float32(0.0), np.float32(1.0), np.float32(0.0), np.float32(0.0), np.float32(1.0), np.float32(0.0), np.float32(0.0), np.float32(1.0), np.float32(0.0), np.float32(0.0), np.float32(1.0), np.float32(0.0), np.float32(1.0), np.float32(1.0), np.float32(0.0), np.float32(0.0)]",-4.0,99270.5,1
2025-08-14_08-18-36,9933,"[np.float32(0.0), np.float32(1.0), np.float32(0.0), np.float32(0.0), np.float32(1.0), np.float32(1.0), np.float32(1.0), np.float32(0.0), np.float32(1.0), np.float32(0.0), np.float32(1.0), np.float32(0.0), np.float32(0.0), np.float32(1.0), np.float32(1.0), np.float32(0.0)]",5.0,99275.5,26
2025-08-14_08-18-36,9934,"[np.float32(1.0), np.float32(0.0), np.float32(1.0), np.float32(0.0), np.float32(0.0), np.float32(0.0), np.float32(0.0), np.float32(0.0), np.float32(1.0), np.float32(0.0), np.float32(0.0), np.float32(1.0), np.float32(1.0), np.float32(1.0), np.float32(0.0), np.float32(0.0)]",2.0,99277.5,25
2025-08-14_08-18-36,9935,"[np.float32(1.0), np.float32(1.0), np.float32(0.0), np.float32(1.0), np.float32(1.0), np.float32(0.0), np.float32(1.0), np.float32(0.0), np.float32(1.0), np.float32(0.0), np.float32(0.0), np.float32(1.0), np.float32(0.0), np.float32(1.0), np.float32(1.0), np.float32(0.0)]",0.0,99277.5,13
2025-08-14_08-18-36,9936,"[np.float32(0.0), np.float32(1.0), np.float32(0.0), np.float32(1.0), np.float32(0.0), np.float32(0.0), np.float32(0.0), np.float32(0.0), np.float32(1.0), np.float32(1.0), np.float32(0.0), np.float32(1.0), np.float32(1.0), np.float32(1.0), np.float32(0.0), np.float32(1.0)]",0.0,99277.5,3
2025-08-14_08-18-36,9937,"[np.float32(0.0), np.float32(1.0), np.float32(0.0), np.float32(0.0), np.float32(0.0), np.float32(1.0), np.float32(1.0), np.float32(1.0), np.float32(1.0), np.float32(1.0), np.float32(0.0), np.float32(1.0), np.float32(0.0), np.float32(1.0), np.float32(1.0), np.float32(1.0)]",-2.0,99275.5,17
2025-08-14_08-18-36,9938,"[np.float32(0.0), np.float32(1.0), np.float32(0.0), np.float32(0.0), np.float32(0.0), np.float32(1.0), np.float32(1.0), np.float32(1.0), np.float32(1.0), np.float32(1.0), np.float32(0.0), np.float32(0.0), np.float32(1.0), np.float32(0.0), np.float32(0.0), np.float32(0.0)]",-4.0,99271.5,12
2025-08-14_08-18-36,9939,"[np.float32(0.0), np.float32(1.0), np.float32(1.0), np.float32(1.0), np.float32(0.0), np.float32(1.0), np.float32(0.0), np.float32(1.0), np.float32(1.0), np.float32(1.0), np.float32(0.0), np.float32(1.0), np.float32(1.0), np.float32(1.0), np.float32(1.0), np.float32(1.0)]",32.0,99303.5,7
2025-08-14_08-18-36,9940,"[np.float32(0.0), np.float32(0.0), np.float32(1.0), np.float32(0.0), np.float32(0.0), np.float32(1.0), np.float32(0.0), np.float32(1.0), np.float32(0.0), np.float32(0.0), np.float32(1.0), np.float32(0.0), np.float32(1.0), np.float32(1.0), np.float32(1.0), np.float32(0.0)]",-2.0,99301.5,27
2025-08-14_08-18-36,9941,"[np.float32(0.0), np.float32(1.0), np.float32(1.0), np.float32(0.0), np.float32(1.0), np.float32(1.0), np.float32(0.0), np.float32(1.0), np.float32(0.0), np.float32(1.0), np.float32(0.0), np.float32(1.0), np.float32(0.0), np.float32(1.0), np.float32(0.0), np.float32(1.0)]",2.0,99303.5,21
2025-08-14_08-18-36,9942,"[np.float32(1.0), np.float32(0.0), np.float32(1.0), np.float32(1.0), np.float32(0.0), np.float32(1.0), np.float32(1.0), np.float32(0.0), np.float32(1.0), np.float32(1.0), np.float32(0.0), np.float32(1.0), np.float32(1.0), np.float32(1.0), np.float32(0.0), np.float32(1.0)]",0.0,99303.5,6
2025-08-14_08-18-36,9943,"[np.float32(1.0), np.float32(0.0), np.float32(1.0), np.float32(1.0), np.float32(0.0), np.float32(1.0), np.float32(0.0), np.float32(1.0), np.float32(0.0), np.float32(1.0), np.float32(1.0), np.float32(1.0), np.float32(0.0), np.float32(1.0), np.float32(0.0), np.float32(0.0)]",3.0,99306.5,23
2025-08-14_08-18-36,9944,"[np.float32(0.0), np.float32(1.0), np.float32(1.0), np.float32(0.0), np.float32(0.0), np.float32(1.0), np.float32(1.0), np.float32(1.0), np.float32(0.0), np.float32(1.0), np.float32(0.0), np.float32(0.0), np.float32(0.0), np.float32(1.0), np.float32(0.0), np.float32(0.0)]",1.0,99307.5,25
2025-08-14_08-18-36,9945,"[np.float32(0.0), np.float32(1.0), np.float32(1.0), np.float32(0.0), np.float32(1.0), np.float32(1.0), np.float32(0.0), np.float32(1.0), np.float32(1.0), np.float32(0.0), np.float32(1.0), np.float32(1.0), np.float32(0.0), np.float32(1.0), np.float32(0.0), np.float32(1.0)]",-1.0,99306.5,0
2025-08-14_08-18-36,9946,"[np.float32(1.0), np.float32(1.0), np.float32(0.0), np.float32(0.0), np.float32(1.0), np.float32(0.0), np.float32(0.0), np.float32(1.0), np.float32(0.0), np.float32(1.0), np.float32(0.0), np.float32(1.0), np.float32(0.0), np.float32(1.0), np.float32(0.0), np.float32(1.0)]",-3.0,99303.5,35
2025-08-14_08-18-36,9947,"[np.float32(0.0), np.float32(0.0), np.float32(1.0), np.float32(0.0), np.float32(0.0), np.float32(1.0), np.float32(1.0), np.float32(1.0), np.float32(0.0), np.float32(1.0), np.float32(0.0), np.float32(1.0), np.float32(0.0), np.float32(1.0), np.float32(1.0), np.float32(0.0)]",-1.0,99302.5,32
2025-08-14_08-18-36,9948,"[np.float32(0.0), np.float32(0.0), np.float32(1.0), np.float32(0.0), np.float32(1.0), np.float32(0.0), np.float32(0.0), np.float32(1.0), np.float32(0.0), np.float32(0.0), np.float32(0.0), np.float32(0.0), np.float32(0.0), np.float32(0.0), np.float32(1.0), np.float32(0.0)]",1.0,99303.5,30
2025-08-14_08-18-36,9949,"[np.float32(0.0), np.float32(0.0), np.float32(0.0), np.float32(1.0), np.float32(0.0), np.float32(0.0), np.float32(1.0), np.float32(1.0), np.float32(0.0), np.float32(0.0), np.float32(0.0), np.float32(0.0), np.float32(0.0), np.float32(1.0), np.float32(0.0), np.float32(0.0)]",-2.0,99301.5,31
2025-08-14_08-18-36,9950,"[np.float32(1.0), np.float32(0.0), np.float32(0.0), np.float32(0.0), np.float32(1.0), np.float32(1.0), np.float32(0.0), np.float32(0.0), np.float32(1.0), np.float32(0.0), np.float32(0.0), np.float32(0.0), np.float32(1.0), np.float32(0.0), np.float32(1.0), np.float32(1.0)]",-2.0,99299.5,35
2025-08-14_08-18-36,9951,"[np.float32(0.0), np.float32(0.0), np.float32(0.0), np.float32(1.0), np.float32(1.0), np.float32(1.0), np.float32(0.0), np.float32(1.0), np.float32(0.0), np.float32(0.0), np.float32(0.0), np.float32(1.0), np.float32(0.0), np.float32(1.0), np.float32(0.0), np.float32(0.0)]",1.0,99300.5,7
2025-08-14_08-18-36,9952,"[np.float32(1.0), np.float32(1.0), np.float32(0.0), np.float32(1.0), np.float32(1.0), np.float32(1.0), np.float32(0.0), np.float32(1.0), np.float32(0.0), np.float32(0.0), np.float32(1.0), np.float32(0.0), np.float32(0.0), np.float32(1.0), np.float32(0.0), np.float32(0.0)]",4.0,99304.5,21
2025-08-14_08-18-36,9953,"[np.float32(1.0), np.float32(1.0), np.float32(1.0), np.float32(1.0), np.float32(0.0), np.float32(0.0), np.float32(0.0), np.float32(1.0), np.float32(0.0), np.float32(0.0), np.float32(0.0), np.float32(0.0), np.float32(1.0), np.float32(1.0), np.float32(0.0), np.float32(1.0)]",2.0,99306.5,14
2025-08-14_08-18-36,9954,"[np.float32(1.0), np.float32(0.0), np.float32(1.0), np.float32(1.0), np.float32(1.0), np.float32(1.0), np.float32(0.0), np.float32(1.0), np.float32(1.0), np.float32(1.0), np.float32(0.0), np.float32(1.0), np.float32(1.0), np.float32(0.0), np.float32(0.0), np.float32(0.0)]",-1.0,99305.5,14
2025-08-14_08-18-36,9955,"[np.float32(0.0), np.float32(1.0), np.float32(1.0), np.float32(0.0), np.float32(0.0), np.float32(1.0), np.float32(0.0), np.float32(0.0), np.float32(1.0), np.float32(0.0), np.float32(0.0), np.float32(1.0), np.float32(0.0), np.float32(0.0), np.float32(0.0), np.float32(1.0)]",3.0,99308.5,24
2025-08-14_08-18-36,9956,"[np.float32(1.0), np.float32(1.0), np.float32(0.0), np.float32(0.0), np.float32(1.0), np.float32(1.0), np.float32(0.0), np.float32(0.0), np.float32(0.0), np.float32(0.0), np.float32(0.0), np.float32(1.0), np.float32(1.0), np.float32(1.0), np.float32(1.0), np.float32(0.0)]",-1.0,99307.5,13
2025-08-14_08-18-36,9957,"[np.float32(0.0), np.float32(1.0), np.float32(1.0), np.float32(0.0), np.float32(1.0), np.float32(0.0), np.float32(1.0), np.float32(1.0), np.float32(0.0), np.float32(1.0), np.float32(0.0), np.float32(0.0), np.float32(0.0), np.float32(1.0), np.float32(1.0), np.float32(0.0)]",4.0,99311.5,8
2025-08-14_08-18-36,9958,"[np.float32(0.0), np.float32(0.0), np.float32(0.0), np.float32(1.0), np.float32(1.0), np.float32(1.0), np.float32(1.0), np.float32(0.0), np.float32(1.0), np.float32(1.0), np.float32(1.0), np.float32(1.0), np.float32(1.0), np.float32(0.0), np.float32(1.0), np.float32(0.0)]",-2.0,99309.5,4
2025-08-14_08-18-36,9959,"[np.float32(0.0), np.float32(0.0), np.float32(0.0), np.float32(0.0), np.float32(0.0), np.float32(1.0), np.float32(0.0), np.float32(0.0), np.float32(0.0), np.float32(0.0), np.float32(1.0), np.float32(0.0), np.float32(0.0), np.float32(0.0), np.float32(1.0), np.float32(1.0)]",-2.0,99307.5,21
2025-08-14_08-18-36,9960,"[np.float32(0.0), np.float32(1.0), np.float32(0.0), np.float32(1.0), np.float32(1.0), np.float32(1.0), np.float32(1.0), np.float32(0.0), np.float32(1.0), np.float32(1.0), np.float32(1.0), np.float32(0.0), np.float32(0.0), np.float32(0.0), np.float32(1.0), np.float32(1.0)]",0.0,99307.5,26
2025-08-14_08-18-36,9961,"[np.float32(0.0), np.float32(0.0), np.float32(1.0), np.float32(1.0), np.float32(0.0), np.float32(1.0), np.float32(0.0), np.float32(1.0), np.float32(1.0), np.float32(0.0), np.float32(1.0), np.float32(0.0), np.float32(0.0), np.float32(1.0), np.float32(1.0), np.float32(0.0)]",0.0,99307.5,5
2025-08-14_08-18-36,9962,"[np.float32(1.0), np.float32(0.0), np.float32(0.0), np.float32(1.0), np.float32(0.0), np.float32(0.0), np.float32(0.0), np.float32(1.0), np.float32(0.0), np.float32(1.0), np.float32(0.0), np.float32(0.0), np.float32(1.0), np.float32(1.0), np.float32(1.0), np.float32(0.0)]",-2.0,99305.5,29
2025-08-14_08-18-36,9963,"[np.float32(1.0), np.float32(1.0), np.float32(1.0), np.float32(0.0), np.float32(1.0), np.float32(1.0), np.float32(0.0), np.float32(1.0), np.float32(1.0), np.float32(1.0), np.float32(0.0), np.float32(1.0), np.float32(1.0), np.float32(1.0), np.float32(0.0), np.float32(1.0)]",-8.0,99297.5,11
2025-08-14_08-18-36,9964,"[np.float32(0.0), np.float32(0.0), np.float32(0.0), np.float32(0.0), np.float32(0.0), np.float32(1.0), np.float32(0.0), np.float32(0.0), np.float32(0.0), np.float32(1.0), np.float32(0.0), np.float32(0.0), np.float32(1.0), np.float32(0.0), np.float32(1.0), np.float32(0.0)]",1.0,99298.5,27
2025-08-14_08-18-36,9965,"[np.float32(0.0), np.float32(0.0), np.float32(0.0), np.float32(1.0), np.float32(0.0), np.float32(0.0), np.float32(1.0), np.float32(1.0), np.float32(1.0), np.float32(0.0), np.float32(1.0), np.float32(0.0), np.float32(0.0), np.float32(0.0), np.float32(0.0), np.float32(0.0)]",1.0,99299.5,20
2025-08-14_08-18-36,9966,"[np.float32(0.0), np.float32(0.0), np.float32(0.0), np.float32(1.0), np.float32(1.0), np.float32(0.0), np.float32(0.0), np.float32(0.0), np.float32(0.0), np.float32(0.0), np.float32(0.0), np.float32(1.0), np.float32(0.0), np.float32(0.0), np.float32(1.0), np.float32(1.0)]",-1.0,99298.5,7
2025-08-14_08-18-36,9967,"[np.float32(0.0), np.float32(1.0), np.float32(0.0), np.float32(0.0), np.float32(0.0), np.float32(1.0), np.float32(1.0), np.float32(1.0), np.float32(0.0), np.float32(0.0), np.float32(1.0), np.float32(1.0), np.float32(0.0), np.float32(0.0), np.float32(0.0), np.float32(1.0)]",-3.0,99295.5,0
2025-08-14_08-18-36,9968,"[np.float32(0.0), np.float32(0.0), np.float32(1.0), np.float32(1.0), np.float32(1.0), np.float32(1.0), np.float32(0.0), np.float32(0.0), np.float32(0.0), np.float32(1.0), np.float32(0.0), np.float32(1.0), np.float32(0.0), np.float32(0.0), np.float32(0.0), np.float32(0.0)]",1.0,99296.5,25
2025-08-14_08-18-36,9969,"[np.float32(0.0), np.float32(0.0), np.float32(0.0), np.float32(1.0), np.float32(1.0), np.float32(0.0), np.float32(0.0), np.float32(0.0), np.float32(0.0), np.float32(0.0), np.float32(1.0), np.float32(0.0), np.float32(0.0), np.float32(0.0), np.float32(1.0), np.float32(1.0)]",0.0,99296.5,33
2025-08-14_08-18-36,9970,"[np.float32(0.0), np.float32(1.0), np.float32(1.0), np.float32(0.0), np.float32(1.0), np.float32(1.0), np.float32(1.0), np.float32(1.0), np.float32(1.0), np.float32(0.0), np.float32(1.0), np.float32(0.0), np.float32(1.0), np.float32(0.0), np.float32(1.0), np.float32(0.0)]",-1.0,99295.5,6
2025-08-14_08-18-36,9971,"[np.float32(0.0), np.float32(1.0), np.float32(0.0), np.float32(0.0), np.float32(0.0), np.float32(0.0), np.float32(0.0), np.float32(1.0), np.float32(0.0), np.float32(1.0), np.float32(0.0), np.float32(0.0), np.float32(1.0), np.float32(1.0), np.float32(1.0), np.float32(1.0)]",-4.0,99291.5,5
2025-08-14_08-18-36,9972,"[np.float32(0.0), np.float32(1.0), np.float32(1.0), np.float32(0.0), np.float32(1.0), np.float32(1.0), np.float32(1.0), np.float32(1.0), np.float32(0.0), np.float32(0.0), np.float32(0.0), np.float32(0.0), np.float32(0.0), np.float32(0.0), np.float32(0.0), np.float32(0.0)]",3.0,99294.5,8
2025-08-14_08-18-36,9973,"[np.float32(0.0), np.float32(1.0), np.float32(1.0), np.float32(1.0), np.float32(1.0), np.float32(1.0), np.float32(1.0), np.float32(0.0), np.float32(1.0), np.float32(0.0), np.float32(0.0), np.float32(0.0), np.float32(0.0), np.float32(1.0), np.float32(0.0), np.float32(0.0)]",4.0,99298.5,35
2025-08-14_08-18-36,9974,"[np.float32(0.0), np.float32(1.0), np.float32(0.0), np.float32(0.0), np.float32(1.0), np.float32(1.0), np.float32(1.0), np.float32(1.0), np.float32(1.0), np.float32(0.0), np.float32(1.0), np.float32(1.0), np.float32(0.0), np.float32(0.0), np.float32(0.0), np.float32(0.0)]",0.0,99298.5,18
2025-08-14_08-18-36,9975,"[np.float32(0.0), np.float32(1.0), np.float32(0.0), np.float32(0.0), np.float32(1.0), np.float32(1.0), np.float32(0.0), np.float32(0.0), np.float32(0.0), np.float32(1.0), np.float32(1.0), np.float32(1.0), np.float32(0.0), np.float32(0.0), np.float32(0.0), np.float32(1.0)]",1.0,99299.5,1
2025-08-14_08-18-36,9976,"[np.float32(1.0), np.float32(0.0), np.float32(0.0), np.float32(1.0), np.float32(0.0), np.float32(1.0), np.float32(1.0), np.float32(1.0), np.float32(0.0), np.float32(0.0), np.float32(1.0), np.float32(1.0), np.float32(0.0), np.float32(0.0), np.float32(0.0), np.float32(1.0)]",-1.0,99298.5,33
2025-08-14_08-18-36,9977,"[np.float32(1.0), np.float32(1.0), np.float32(0.0), np.float32(1.0), np.float32(0.0), np.float32(0.0), np.float32(1.0), np.float32(0.0), np.float32(1.0), np.float32(1.0), np.float32(1.0), np.float32(1.0), np.float32(1.0), np.float32(0.0), np.float32(0.0), np.float32(1.0)]",0.0,99298.5,27
2025-08-14_08-18-36,9978,"[np.float32(0.0), np.float32(0.0), np.float32(0.0), np.float32(0.0), np.float32(0.0), np.float32(0.0), np.float32(0.0), np.float32(0.0), np.float32(0.0), np.float32(0.0), np.float32(1.0), np.float32(1.0), np.float32(0.0), np.float32(0.0), np.float32(0.0), np.float32(0.0)]",1.0,99299.5,27
2025-08-14_08-18-36,9979,"[np.float32(1.0), np.float32(1.0), np.float32(1.0), np.float32(0.0), np.float32(1.0), np.float32(0.0), np.float32(1.0), np.float32(0.0), np.float32(0.0), np.float32(0.0), np.float32(0.0), np.float32(0.0), np.float32(1.0), np.float32(0.0), np.float32(0.0), np.float32(1.0)]",0.0,99299.5,5
2025-08-14_08-18-36,9980,"[np.float32(0.0), np.float32(1.0), np.float32(1.0), np.float32(1.0), np.float32(0.0), np.float32(1.0), np.float32(1.0), np.float32(1.0), np.float32(0.0), np.float32(1.0), np.float32(1.0), np.float32(1.0), np.float32(0.0), np.float32(1.0), np.float32(1.0), np.float32(1.0)]",-1.0,99298.5,18
2025-08-14_08-18-36,9981,"[np.float32(0.0), np.float32(0.0), np.float32(0.0), np.float32(1.0), np.float32(0.0), np.float32(0.0), np.float32(1.0), np.float32(1.0), np.float32(0.0), np.float32(0.0), np.float32(1.0), np.float32(1.0), np.float32(1.0), np.float32(0.0), np.float32(1.0), np.float32(0.0)]",-1.0,99297.5,16
2025-08-14_08-18-36,9982,"[np.float32(1.0), np.float32(0.0), np.float32(0.0), np.float32(0.0), np.float32(1.0), np.float32(0.0), np.float32(0.0), np.float32(1.0), np.float32(1.0), np.float32(1.0), np.float32(0.0), np.float32(0.0), np.float32(1.0), np.float32(0.0), np.float32(0.0), np.float32(1.0)]",-2.0,99295.5,23
2025-08-14_08-18-36,9983,"[np.float32(1.0), np.float32(1.0), np.float32(1.0), np.float32(0.0), np.float32(0.0), np.float32(0.0), np.float32(0.0), np.float32(0.0), np.float32(1.0), np.float32(1.0), np.float32(0.0), np.float32(0.0), np.float32(0.0), np.float32(0.0), np.float32(1.0), np.float32(0.0)]",2.0,99297.5,13
2025-08-14_08-18-36,9984,"[np.float32(0.0), np.float32(1.0), np.float32(0.0), np.float32(0.0), np.float32(0.0), np.float32(1.0), np.float32(1.0), np.float32(1.0), np.float32(0.0), np.float32(1.0), np.float32(1.0), np.float32(0.0), np.float32(0.0), np.float32(0.0), np.float32(0.0), np.float32(1.0)]",1.0,99298.5,10
2025-08-14_08-18-36,9985,"[np.float32(0.0), np.float32(1.0), np.float32(0.0), np.float32(1.0), np.float32(0.0), np.float32(1.0), np.float32(0.0), np.float32(0.0), np.float32(0.0), np.float32(0.0), np.float32(0.0), np.float32(0.0), np.float32(0.0), np.float32(0.0), np.float32(1.0), np.float32(1.0)]",0.0,99298.5,8
2025-08-14_08-18-36,9986,"[np.float32(1.0), np.float32(1.0), np.float32(1.0), np.float32(0.0), np.float32(0.0), np.float32(1.0), np.float32(1.0), np.float32(1.0), np.float32(1.0), np.float32(1.0), np.float32(0.0), np.float32(0.0), np.float32(0.0), np.float32(0.0), np.float32(0.0), np.float32(1.0)]",6.0,99304.5,34
2025-08-14_08-18-36,9987,"[np.float32(1.0), np.float32(0.0), np.float32(1.0), np.float32(0.0), np.float32(0.0), np.float32(1.0), np.float32(0.0), np.float32(0.0), np.float32(1.0), np.float32(0.0), np.float32(0.0), np.float32(0.0), np.float32(1.0), np.float32(0.0), np.float32(1.0), np.float32(0.0)]",6.0,99310.5,36
2025-08-14_08-18-36,9988,"[np.float32(0.0), np.float32(1.0), np.float32(1.0), np.float32(1.0), np.float32(1.0), np.float32(0.0), np.float32(1.0), np.float32(1.0), np.float32(1.0), np.float32(0.0), np.float32(0.0), np.float32(1.0), np.float32(1.0), np.float32(1.0), np.float32(0.0), np.float32(1.0)]",-1.0,99309.5,20
2025-08-14_08-18-36,9989,"[np.float32(1.0), np.float32(1.0), np.float32(0.0), np.float32(0.0), np.float32(1.0), np.float32(1.0), np.float32(1.0), np.float32(1.0), np.float32(0.0), np.float32(0.0), np.float32(0.0), np.float32(1.0), np.float32(1.0), np.float32(1.0), np.float32(0.0), np.float32(0.0)]",4.0,99313.5,21
2025-08-14_08-18-36,9990,"[np.float32(0.0), np.float32(1.0), np.float32(1.0), np.float32(1.0), np.float32(0.0), np.float32(1.0), np.float32(0.0), np.float32(1.0), np.float32(0.0), np.float32(0.0), np.float32(1.0), np.float32(1.0), np.float32(1.0), np.float32(0.0), np.float32(0.0), np.float32(1.0)]",-3.0,99310.5,0
2025-08-14_08-18-36,9991,"[np.float32(0.0), np.float32(1.0), np.float32(0.0), np.float32(1.0), np.float32(0.0), np.float32(0.0), np.float32(1.0), np.float32(1.0), np.float32(0.0), np.float32(0.0), np.float32(1.0), np.float32(0.0), np.float32(1.0), np.float32(0.0), np.float32(0.0), np.float32(0.0)]",-1.0,99309.5,24
2025-08-14_08-18-36,9992,"[np.float32(0.0), np.float32(0.0), np.float32(1.0), np.float32(0.0), np.float32(0.0), np.float32(1.0), np.float32(0.0), np.float32(0.0), np.float32(1.0), np.float32(1.0), np.float32(1.0), np.float32(1.0), np.float32(0.0), np.float32(1.0), np.float32(0.0), np.float32(1.0)]",5.0,99314.5,28
2025-08-14_08-18-36,9993,"[np.float32(0.0), np.float32(1.0), np.float32(0.0), np.float32(1.0), np.float32(0.0), np.float32(0.0), np.float32(0.0), np.float32(1.0), np.float32(0.0), np.float32(1.0), np.float32(1.0), np.float32(0.0), np.float32(1.0), np.float32(1.0), np.float32(1.0), np.float32(0.0)]",0.0,99314.5,8
2025-08-14_08-18-36,9994,"[np.float32(0.0), np.float32(0.0), np.float32(0.0), np.float32(1.0), np.float32(0.0), np.float32(1.0), np.float32(0.0), np.float32(0.0), np.float32(1.0), np.float32(1.0), np.float32(1.0), np.float32(0.0), np.float32(1.0), np.float32(1.0), np.float32(1.0), np.float32(0.0)]",0.0,99314.5,30
2025-08-14_08-18-36,9995,"[np.float32(0.0), np.float32(0.0), np.float32(0.0), np.float32(1.0), np.float32(0.0), np.float32(0.0), np.float32(1.0), np.float32(1.0), np.float32(1.0), np.float32(0.0), np.float32(1.0), np.float32(0.0), np.float32(0.0), np.float32(0.0), np.float32(0.0), np.float32(0.0)]",-2.0,99312.5,12
2025-08-14_08-18-36,9996,"[np.float32(0.0), np.float32(1.0), np.float32(0.0), np.float32(1.0), np.float32(0.0), np.float32(0.0), np.float32(0.0), np.float32(1.0), np.float32(0.0), np.float32(0.0), np.float32(0.0), np.float32(0.0), np.float32(1.0), np.float32(1.0), np.float32(0.0), np.float32(1.0)]",-6.0,99306.5,36
2025-08-14_08-18-36,9997,"[np.float32(1.0), np.float32(0.0), np.float32(1.0), np.float32(0.0), np.float32(0.0), np.float32(1.0), np.float32(0.0), np.float32(1.0), np.float32(1.0), np.float32(0.0), np.float32(0.0), np.float32(1.0), np.float32(0.0), np.float32(1.0), np.float32(1.0), np.float32(0.0)]",3.0,99309.5,33
2025-08-14_08-18-36,9998,"[np.float32(0.0), np.float32(1.0), np.float32(0.0), np.float32(1.0), np.float32(0.0), np.float32(1.0), np.float32(1.0), np.float32(1.0), np.float32(0.0), np.float32(0.0), np.float32(0.0), np.float32(0.0), np.float32(0.0), np.float32(1.0), np.float32(1.0), np.float32(0.0)]",-1.0,99308.5,16
2025-08-14_08-18-36,9999,"[np.float32(0.0), np.float32(0.0), np.float32(1.0), np.float32(0.0), np.float32(0.0), np.float32(0.0), np.float32(0.0), np.float32(0.0), np.float32(0.0), np.float32(1.0), np.float32(1.0), np.float32(1.0), np.float32(0.0), np.float32(1.0), np.float32(0.0), np.float32(1.0)]",-1.0,99307.5,30
2025-08-14_08-18-36,10000,"[np.float32(1.0), np.float32(1.0), np.float32(0.0), np.float32(0.0), np.float32(1.0), np.float32(1.0), np.float32(1.0), np.float32(1.0), np.float32(1.0), np.float32(0.0), np.float32(1.0), np.float32(0.0), np.float32(1.0), np.float32(1.0), np.float32(0.0), np.float32(0.0)]",0.0,99307.5,3
